1888-09-08,1888,Bolton Wanderers,Derby County,3-6,3,6,1,1,9,-3,A
1888-09-08,1888,Everton,Accrington F.C.,2-1,2,1,1,1,3,1,H
1888-09-08,1888,Preston North End,Burnley,5-2,5,2,1,1,7,3,H
1888-09-08,1888,Stoke City,West Bromwich Albion,0-2,0,2,1,1,2,-2,A
1888-09-08,1888,Wolverhampton Wanderers,Aston Villa,1-1,1,1,1,1,2,0,D
1888-09-15,1888,Aston Villa,Stoke City,5-1,5,1,1,1,6,4,H
1888-09-15,1888,Blackburn Rovers,Accrington F.C.,5-5,5,5,1,1,10,0,D
1888-09-15,1888,Bolton Wanderers,Burnley,3-4,3,4,1,1,7,-1,A
1888-09-15,1888,Derby County,West Bromwich Albion,1-2,1,2,1,1,3,-1,A
1888-09-15,1888,Everton,Notts County,2-1,2,1,1,1,3,1,H
1888-09-15,1888,Wolverhampton Wanderers,Preston North End,0-4,0,4,1,1,4,-4,A
1888-09-22,1888,Aston Villa,Everton,2-1,2,1,1,1,3,1,H
1888-09-22,1888,Blackburn Rovers,West Bromwich Albion,6-2,6,2,1,1,8,4,H
1888-09-22,1888,Derby County,Accrington F.C.,1-1,1,1,1,1,2,0,D
1888-09-22,1888,Preston North End,Bolton Wanderers,3-1,3,1,1,1,4,2,H
1888-09-22,1888,Stoke City,Notts County,3-0,3,0,1,1,3,3,H
1888-09-22,1888,Wolverhampton Wanderers,Burnley,4-1,4,1,1,1,5,3,H
1888-09-29,1888,Aston Villa,Notts County,9-1,9,1,1,1,10,8,H
1888-09-29,1888,Bolton Wanderers,Everton,6-2,6,2,1,1,8,4,H
1888-09-29,1888,Derby County,Preston North End,2-3,2,3,1,1,5,-1,A
1888-09-29,1888,Stoke City,Accrington F.C.,2-4,2,4,1,1,6,-2,A
1888-09-29,1888,West Bromwich Albion,Burnley,4-3,4,3,1,1,7,1,H
1888-09-29,1888,Wolverhampton Wanderers,Blackburn Rovers,2-2,2,2,1,1,4,0,D
1888-10-06,1888,Accrington F.C.,Wolverhampton Wanderers,4-4,4,4,1,1,8,0,D
1888-10-06,1888,Burnley,Bolton Wanderers,4-1,4,1,1,1,5,3,H
1888-10-06,1888,Everton,Aston Villa,2-0,2,0,1,1,2,2,H
1888-10-06,1888,Notts County,Blackburn Rovers,3-3,3,3,1,1,6,0,D
1888-10-06,1888,Preston North End,Stoke City,7-0,7,0,1,1,7,7,H
1888-10-06,1888,West Bromwich Albion,Derby County,5-0,5,0,1,1,5,5,H
1888-10-13,1888,Accrington F.C.,Derby County,6-2,6,2,1,1,8,4,H
1888-10-13,1888,Aston Villa,Blackburn Rovers,6-1,6,1,1,1,7,5,H
1888-10-13,1888,Bolton Wanderers,Stoke City,2-1,2,1,1,1,3,1,H
1888-10-13,1888,Burnley,Wolverhampton Wanderers,0-4,0,4,1,1,4,-4,A
1888-10-13,1888,Notts County,Everton,3-1,3,1,1,1,4,2,H
1888-10-13,1888,Preston North End,West Bromwich Albion,3-0,3,0,1,1,3,3,H
1888-10-20,1888,Accrington F.C.,Preston North End,0-0,0,0,1,1,0,0,D
1888-10-20,1888,Blackburn Rovers,Wolverhampton Wanderers,2-2,2,2,1,1,4,0,D
1888-10-20,1888,Bolton Wanderers,Aston Villa,2-3,2,3,1,1,5,-1,A
1888-10-20,1888,Derby County,Everton,2-4,2,4,1,1,6,-2,A
1888-10-20,1888,Stoke City,Burnley,4-3,4,3,1,1,7,1,H
1888-10-20,1888,West Bromwich Albion,Notts County,4-2,4,2,1,1,6,2,H
1888-10-27,1888,Aston Villa,Accrington F.C.,4-3,4,3,1,1,7,1,H
1888-10-27,1888,Blackburn Rovers,Stoke City,5-2,5,2,1,1,7,3,H
1888-10-27,1888,Everton,Derby County,6-2,6,2,1,1,8,4,H
1888-10-27,1888,Notts County,Burnley,6-1,6,1,1,1,7,5,H
1888-10-27,1888,Preston North End,Wolverhampton Wanderers,5-2,5,2,1,1,7,3,H
1888-11-03,1888,Burnley,Blackburn Rovers,1-7,1,7,1,1,8,-6,A
1888-11-03,1888,Everton,Bolton Wanderers,2-1,2,1,1,1,3,1,H
1888-11-03,1888,Notts County,Preston North End,0-7,0,7,1,1,7,-7,A
1888-11-03,1888,Stoke City,Aston Villa,1-1,1,1,1,1,2,0,D
1888-11-03,1888,West Bromwich Albion,Accrington F.C.,2-2,2,2,1,1,4,0,D
1888-11-03,1888,Wolverhampton Wanderers,Derby County,4-1,4,1,1,1,5,3,H
1888-11-05,1888,West Bromwich Albion,Bolton Wanderers,1-5,1,5,1,1,6,-4,A
1888-11-10,1888,Blackburn Rovers,Everton,3-0,3,0,1,1,3,3,H
1888-11-10,1888,Burnley,West Bromwich Albion,2-0,2,0,1,1,2,2,H
1888-11-10,1888,Notts County,Accrington F.C.,3-3,3,3,1,1,6,0,D
1888-11-10,1888,Preston North End,Aston Villa,1-1,1,1,1,1,2,0,D
1888-11-10,1888,Wolverhampton Wanderers,Bolton Wanderers,3-2,3,2,1,1,5,1,H
1888-11-12,1888,Stoke City,Preston North End,0-3,0,3,1,1,3,-3,A
1888-11-17,1888,Blackburn Rovers,Aston Villa,5-1,5,1,1,1,6,4,H
1888-11-17,1888,Bolton Wanderers,West Bromwich Albion,1-2,1,2,1,1,3,-1,A
1888-11-17,1888,Burnley,Everton,2-2,2,2,1,1,4,0,D
1888-11-17,1888,Preston North End,Accrington F.C.,2-0,2,0,1,1,2,2,H
1888-11-17,1888,Stoke City,Wolverhampton Wanderers,0-1,0,1,1,1,1,-1,A
1888-11-24,1888,Accrington F.C.,West Bromwich Albion,2-1,2,1,1,1,3,1,H
1888-11-24,1888,Aston Villa,Wolverhampton Wanderers,2-1,2,1,1,1,3,1,H
1888-11-24,1888,Bolton Wanderers,Preston North End,2-5,2,5,1,1,7,-3,A
1888-11-24,1888,Derby County,Blackburn Rovers,0-2,0,2,1,1,2,-2,A
1888-11-24,1888,Everton,Burnley,3-2,3,2,1,1,5,1,H
1888-11-24,1888,Notts County,Stoke City,0-3,0,3,1,1,3,-3,A
1888-12-01,1888,Accrington F.C.,Burnley,5-1,5,1,1,1,6,4,H
1888-12-01,1888,Everton,West Bromwich Albion,1-4,1,4,1,1,5,-3,A
1888-12-01,1888,Stoke City,Blackburn Rovers,2-1,2,1,1,1,3,1,H
1888-12-08,1888,Blackburn Rovers,Bolton Wanderers,4-4,4,4,1,1,8,0,D
1888-12-08,1888,Burnley,Stoke City,2-1,2,1,1,1,3,1,H
1888-12-08,1888,Notts County,Aston Villa,2-4,2,4,1,1,6,-2,A
1888-12-08,1888,Preston North End,Derby County,5-0,5,0,1,1,5,5,H
1888-12-08,1888,Wolverhampton Wanderers,Accrington F.C.,4-0,4,0,1,1,4,4,H
1888-12-15,1888,Accrington F.C.,Aston Villa,1-1,1,1,1,1,2,0,D
1888-12-15,1888,Blackburn Rovers,Notts County,5-2,5,2,1,1,7,3,H
1888-12-15,1888,Burnley,Preston North End,2-2,2,2,1,1,4,0,D
1888-12-15,1888,Stoke City,Everton,0-0,0,0,1,1,0,0,D
1888-12-15,1888,Wolverhampton Wanderers,West Bromwich Albion,2-1,2,1,1,1,3,1,H
1888-12-22,1888,Aston Villa,Burnley,4-2,4,2,1,1,6,2,H
1888-12-22,1888,Bolton Wanderers,Accrington F.C.,4-1,4,1,1,1,5,3,H
1888-12-22,1888,Derby County,Notts County,3-2,3,2,1,1,5,1,H
1888-12-22,1888,Preston North End,Everton,3-0,3,0,1,1,3,3,H
1888-12-22,1888,West Bromwich Albion,Blackburn Rovers,2-1,2,1,1,1,3,1,H
1888-12-22,1888,Wolverhampton Wanderers,Stoke City,4-1,4,1,1,1,5,3,H
1888-12-26,1888,Derby County,Bolton Wanderers,2-3,2,3,1,1,5,-1,A
1888-12-26,1888,West Bromwich Albion,Preston North End,0-5,0,5,1,1,5,-5,A
1888-12-29,1888,Accrington F.C.,Everton,3-1,3,1,1,1,4,2,H
1888-12-29,1888,Aston Villa,Derby County,4-2,4,2,1,1,6,2,H
1888-12-29,1888,Bolton Wanderers,Wolverhampton Wanderers,2-1,2,1,1,1,3,1,H
1888-12-29,1888,Burnley,Notts County,1-0,1,0,1,1,1,1,H
1888-12-29,1888,Preston North End,Blackburn Rovers,1-0,1,0,1,1,1,1,H
1888-12-29,1888,West Bromwich Albion,Stoke City,2-0,2,0,1,1,2,2,H
1889-01-05,1888,Burnley,Aston Villa,4-0,4,0,1,1,4,4,H
1889-01-05,1888,Preston North End,Notts County,4-1,4,1,1,1,5,3,H
1889-01-05,1888,West Bromwich Albion,Wolverhampton Wanderers,1-3,1,3,1,1,4,-2,A
1889-01-12,1888,Aston Villa,Bolton Wanderers,6-2,6,2,1,1,8,4,H
1889-01-12,1888,Blackburn Rovers,Preston North End,2-2,2,2,1,1,4,0,D
1889-01-12,1888,Burnley,Accrington F.C.,2-2,2,2,1,1,4,0,D
1889-01-12,1888,Derby County,Wolverhampton Wanderers,3-0,3,0,1,1,3,3,H
1889-01-12,1888,Everton,Stoke City,2-1,2,1,1,1,3,1,H
1889-01-12,1888,Notts County,West Bromwich Albion,2-1,2,1,1,1,3,1,H
1889-01-19,1888,Accrington F.C.,Blackburn Rovers,0-2,0,2,1,1,2,-2,A
1889-01-19,1888,Aston Villa,West Bromwich Albion,2-0,2,0,1,1,2,2,H
1889-01-19,1888,Burnley,Derby County,1-0,1,0,1,1,1,1,H
1889-01-19,1888,Everton,Preston North End,0-2,0,2,1,1,2,-2,A
1889-01-19,1888,Notts County,Wolverhampton Wanderers,3-0,3,0,1,1,3,3,H
1889-01-19,1888,Stoke City,Bolton Wanderers,2-2,2,2,1,1,4,0,D
1889-01-26,1888,Accrington F.C.,Notts County,1-2,1,2,1,1,3,-1,A
1889-01-26,1888,Bolton Wanderers,Blackburn Rovers,3-2,3,2,1,1,5,1,H
1889-01-26,1888,Derby County,Stoke City,2-1,2,1,1,1,3,1,H
1889-01-26,1888,West Bromwich Albion,Aston Villa,3-3,3,3,1,1,6,0,D
1889-01-26,1888,Wolverhampton Wanderers,Everton,4-0,4,0,1,1,4,4,H
1889-02-04,1888,Blackburn Rovers,Burnley,4-2,4,2,1,1,6,2,H
1889-02-09,1888,Aston Villa,Preston North End,0-2,0,2,1,1,2,-2,A
1889-02-09,1888,Everton,Wolverhampton Wanderers,1-2,1,2,1,1,3,-1,A
1889-02-23,1888,West Bromwich Albion,Everton,1-0,1,0,1,1,1,1,H
1889-02-23,1888,Wolverhampton Wanderers,Notts County,2-1,2,1,1,1,3,1,H
1889-03-02,1888,Derby County,Burnley,1-0,1,0,1,1,1,1,H
1889-03-05,1888,Notts County,Bolton Wanderers,0-4,0,4,1,1,4,-4,A
1889-03-09,1888,Bolton Wanderers,Notts County,7-3,7,3,1,1,10,4,H
1889-03-09,1888,Derby County,Aston Villa,5-2,5,2,1,1,7,3,H
1889-03-16,1888,Notts County,Derby County,3-5,3,5,1,1,8,-2,A
1889-03-23,1888,Accrington F.C.,Bolton Wanderers,2-3,2,3,1,1,5,-1,A
1889-03-30,1888,Everton,Blackburn Rovers,3-1,3,1,1,1,4,2,H
1889-04-06,1888,Stoke City,Derby County,1-1,1,1,1,1,2,0,D
1889-04-15,1888,Blackburn Rovers,Derby County,3-0,3,0,1,1,3,3,H
1889-04-20,1888,Accrington F.C.,Stoke City,2-0,2,0,1,1,2,2,H
1889-09-07,1889,Aston Villa,Burnley,2-2,2,2,1,1,4,0,D
1889-09-07,1889,Everton,Blackburn Rovers,3-2,3,2,1,1,5,1,H
1889-09-07,1889,Stoke City,Derby County,1-1,1,1,1,1,2,0,D
1889-09-07,1889,Wolverhampton Wanderers,Notts County,2-0,2,0,1,1,2,2,H
1889-09-14,1889,Aston Villa,Notts County,1-1,1,1,1,1,2,0,D
1889-09-14,1889,Blackburn Rovers,Wolverhampton Wanderers,4-3,4,3,1,1,7,1,H
1889-09-14,1889,Bolton Wanderers,Accrington F.C.,2-4,2,4,1,1,6,-2,A
1889-09-14,1889,Derby County,West Bromwich Albion,3-1,3,1,1,1,4,2,H
1889-09-14,1889,Everton,Burnley,2-1,2,1,1,1,3,1,H
1889-09-14,1889,Preston North End,Stoke City,10-0,10,0,1,1,10,10,H
1889-09-16,1889,Wolverhampton Wanderers,Everton,2-1,2,1,1,1,3,1,H
1889-09-21,1889,Aston Villa,Preston North End,5-3,5,3,1,1,8,2,H
1889-09-21,1889,Blackburn Rovers,Derby County,4-2,4,2,1,1,6,2,H
1889-09-21,1889,Bolton Wanderers,Everton,3-4,3,4,1,1,7,-1,A
1889-09-21,1889,Burnley,Accrington F.C.,2-2,2,2,1,1,4,0,D
1889-09-21,1889,Notts County,West Bromwich Albion,1-2,1,2,1,1,3,-1,A
1889-09-28,1889,Accrington F.C.,Blackburn Rovers,2-2,2,2,1,1,4,0,D
1889-09-28,1889,Burnley,Preston North End,0-3,0,3,1,1,3,-3,A
1889-09-28,1889,Derby County,Notts County,2-0,2,0,1,1,2,2,H
1889-09-28,1889,Everton,Bolton Wanderers,3-0,3,0,1,1,3,3,H
1889-09-28,1889,Stoke City,Wolverhampton Wanderers,2-1,2,1,1,1,3,1,H
1889-09-28,1889,West Bromwich Albion,Aston Villa,3-0,3,0,1,1,3,3,H
1889-09-30,1889,Everton,Wolverhampton Wanderers,1-1,1,1,1,1,2,0,D
1889-10-05,1889,Burnley,Aston Villa,2-6,2,6,1,1,8,-4,A
1889-10-05,1889,Derby County,Everton,2-2,2,2,1,1,4,0,D
1889-10-05,1889,Notts County,Stoke City,3-1,3,1,1,1,4,2,H
1889-10-05,1889,Preston North End,West Bromwich Albion,5-0,5,0,1,1,5,5,H
1889-10-05,1889,Wolverhampton Wanderers,Accrington F.C.,2-1,2,1,1,1,3,1,H
1889-10-12,1889,Accrington F.C.,Notts County,1-8,1,8,1,1,9,-7,A
1889-10-12,1889,Aston Villa,Derby County,7-1,7,1,1,1,8,6,H
1889-10-12,1889,Bolton Wanderers,Preston North End,2-6,2,6,1,1,8,-4,A
1889-10-12,1889,Burnley,West Bromwich Albion,1-2,1,2,1,1,3,-1,A
1889-10-12,1889,Wolverhampton Wanderers,Stoke City,2-2,2,2,1,1,4,0,D
1889-10-19,1889,Accrington F.C.,Burnley,2-2,2,2,1,1,4,0,D
1889-10-19,1889,Blackburn Rovers,Aston Villa,7-0,7,0,1,1,7,7,H
1889-10-19,1889,Derby County,Preston North End,2-1,2,1,1,1,3,1,H
1889-10-19,1889,Notts County,Everton,4-3,4,3,1,1,7,1,H
1889-10-19,1889,Stoke City,Bolton Wanderers,0-1,0,1,1,1,1,-1,A
1889-10-19,1889,West Bromwich Albion,Wolverhampton Wanderers,1-4,1,4,1,1,5,-3,A
1889-10-26,1889,Aston Villa,West Bromwich Albion,1-0,1,0,1,1,1,1,H
1889-10-26,1889,Blackburn Rovers,Burnley,7-1,7,1,1,1,8,6,H
1889-10-26,1889,Bolton Wanderers,Notts County,0-4,0,4,1,1,4,-4,A
1889-10-26,1889,Derby County,Stoke City,2-0,2,0,1,1,2,2,H
1889-10-26,1889,Everton,Accrington F.C.,2-2,2,2,1,1,4,0,D
1889-10-26,1889,Preston North End,Wolverhampton Wanderers,0-2,0,2,1,1,2,-2,A
1889-11-02,1889,Aston Villa,Wolverhampton Wanderers,2-1,2,1,1,1,3,1,H
1889-11-02,1889,Blackburn Rovers,Preston North End,3-4,3,4,1,1,7,-1,A
1889-11-02,1889,Everton,Stoke City,8-0,8,0,1,1,8,8,H
1889-11-02,1889,Notts County,Burnley,1-1,1,1,1,1,2,0,D
1889-11-04,1889,West Bromwich Albion,Bolton Wanderers,6-3,6,3,1,1,9,3,H
1889-11-09,1889,Bolton Wanderers,Blackburn Rovers,3-2,3,2,1,1,5,1,H
1889-11-09,1889,Burnley,Wolverhampton Wanderers,1-2,1,2,1,1,3,-1,A
1889-11-09,1889,Notts County,Aston Villa,1-1,1,1,1,1,2,0,D
1889-11-09,1889,Preston North End,Accrington F.C.,3-1,3,1,1,1,4,2,H
1889-11-09,1889,Stoke City,Everton,1-2,1,2,1,1,3,-1,A
1889-11-09,1889,West Bromwich Albion,Derby County,2-3,2,3,1,1,5,-1,A
1889-11-11,1889,Stoke City,Preston North End,1-2,1,2,1,1,3,-1,A
1889-11-16,1889,Accrington F.C.,Derby County,6-1,6,1,1,1,7,5,H
1889-11-16,1889,Blackburn Rovers,Notts County,9-1,9,1,1,1,10,8,H
1889-11-16,1889,Bolton Wanderers,Aston Villa,2-0,2,0,1,1,2,2,H
1889-11-16,1889,Everton,Preston North End,1-5,1,5,1,1,6,-4,A
1889-11-16,1889,Stoke City,West Bromwich Albion,1-3,1,3,1,1,4,-2,A
1889-11-23,1889,Aston Villa,Everton,1-2,1,2,1,1,3,-1,A
1889-11-23,1889,Blackburn Rovers,Accrington F.C.,3-2,3,2,1,1,5,1,H
1889-11-23,1889,Derby County,Wolverhampton Wanderers,3-3,3,3,1,1,6,0,D
1889-11-23,1889,Preston North End,Bolton Wanderers,3-1,3,1,1,1,4,2,H
1889-11-23,1889,West Bromwich Albion,Burnley,6-1,6,1,1,1,7,5,H
1889-11-30,1889,Accrington F.C.,Aston Villa,4-2,4,2,1,1,6,2,H
1889-11-30,1889,Blackburn Rovers,West Bromwich Albion,5-0,5,0,1,1,5,5,H
1889-11-30,1889,Bolton Wanderers,Derby County,7-1,7,1,1,1,8,6,H
1889-11-30,1889,Preston North End,Burnley,6-0,6,0,1,1,6,6,H
1889-12-07,1889,Aston Villa,Stoke City,6-1,6,1,1,1,7,5,H
1889-12-07,1889,Bolton Wanderers,West Bromwich Albion,7-0,7,0,1,1,7,7,H
1889-12-07,1889,Everton,Notts County,5-3,5,3,1,1,8,2,H
1889-12-07,1889,Preston North End,Blackburn Rovers,1-1,1,1,1,1,2,0,D
1889-12-07,1889,Wolverhampton Wanderers,Burnley,9-1,9,1,1,1,10,8,H
1889-12-14,1889,Notts County,Wolverhampton Wanderers,0-2,0,2,1,1,2,-2,A
1889-12-21,1889,Blackburn Rovers,Bolton Wanderers,7-1,7,1,1,1,8,6,H
1889-12-21,1889,Notts County,Derby County,3-1,3,1,1,1,4,2,H
1889-12-21,1889,Preston North End,Everton,1-2,1,2,1,1,3,-1,A
1889-12-21,1889,West Bromwich Albion,Accrington F.C.,4-1,4,1,1,1,5,3,H
1889-12-21,1889,Wolverhampton Wanderers,Aston Villa,1-1,1,1,1,1,2,0,D
1889-12-23,1889,Stoke City,Blackburn Rovers,0-3,0,3,1,1,3,-3,A
1889-12-25,1889,Preston North End,Aston Villa,3-2,3,2,1,1,5,1,H
1889-12-26,1889,Aston Villa,Accrington F.C.,1-2,1,2,1,1,3,-1,A
1889-12-26,1889,Derby County,Bolton Wanderers,3-2,3,2,1,1,5,1,H
1889-12-26,1889,West Bromwich Albion,Preston North End,2-2,2,2,1,1,4,0,D
1889-12-26,1889,Wolverhampton Wanderers,Blackburn Rovers,2-4,2,4,1,1,6,-2,A
1889-12-28,1889,Accrington F.C.,Stoke City,2-1,2,1,1,1,3,1,H
1889-12-28,1889,Blackburn Rovers,Everton,2-4,2,4,1,1,6,-2,A
1889-12-28,1889,Derby County,Aston Villa,5-0,5,0,1,1,5,5,H
1889-12-28,1889,Wolverhampton Wanderers,West Bromwich Albion,1-1,1,1,1,1,2,0,D
1890-01-01,1889,Accrington F.C.,Wolverhampton Wanderers,6-3,6,3,1,1,9,3,H
1890-01-04,1889,Accrington F.C.,Bolton Wanderers,3-1,3,1,1,1,4,2,H
1890-01-04,1889,Blackburn Rovers,Stoke City,8-0,8,0,1,1,8,8,H
1890-01-04,1889,Derby County,Burnley,4-1,4,1,1,1,5,3,H
1890-01-04,1889,Everton,Aston Villa,7-0,7,0,1,1,7,7,H
1890-01-04,1889,West Bromwich Albion,Notts County,4-2,4,2,1,1,6,2,H
1890-01-04,1889,Wolverhampton Wanderers,Preston North End,0-1,0,1,1,1,1,-1,A
1890-01-11,1889,Burnley,Stoke City,1-3,1,3,1,1,4,-2,A
1890-01-11,1889,Notts County,Bolton Wanderers,3-5,3,5,1,1,8,-2,A
1890-01-11,1889,Preston North End,Derby County,5-0,5,0,1,1,5,5,H
1890-01-11,1889,West Bromwich Albion,Blackburn Rovers,3-2,3,2,1,1,5,1,H
1890-01-25,1889,Aston Villa,Bolton Wanderers,1-2,1,2,1,1,3,-1,A
1890-01-25,1889,Wolverhampton Wanderers,Derby County,2-1,2,1,1,1,3,1,H
1890-02-08,1889,Accrington F.C.,West Bromwich Albion,0-0,0,0,1,1,0,0,D
1890-02-08,1889,Bolton Wanderers,Stoke City,5-0,5,0,1,1,5,5,H
1890-02-08,1889,Burnley,Everton,0-1,0,1,1,1,1,-1,A
1890-02-08,1889,Derby County,Blackburn Rovers,4-0,4,0,1,1,4,4,H
1890-02-15,1889,Derby County,Accrington F.C.,2-3,2,3,1,1,5,-1,A
1890-02-18,1889,Notts County,Blackburn Rovers,1-1,1,1,1,1,2,0,D
1890-02-22,1889,Accrington F.C.,Everton,5-3,5,3,1,1,8,2,H
1890-02-22,1889,Burnley,Blackburn Rovers,1-2,1,2,1,1,3,-1,A
1890-02-24,1889,Bolton Wanderers,Wolverhampton Wanderers,4-1,4,1,1,1,5,3,H
1890-03-01,1889,Burnley,Bolton Wanderers,7-0,7,0,1,1,7,7,H
1890-03-01,1889,Preston North End,Notts County,4-3,4,3,1,1,7,1,H
1890-03-01,1889,Stoke City,Accrington F.C.,7-1,7,1,1,1,8,6,H
1890-03-08,1889,Burnley,Derby County,2-0,2,0,1,1,2,2,H
1890-03-08,1889,Everton,West Bromwich Albion,5-1,5,1,1,1,6,4,H
1890-03-10,1889,Stoke City,Burnley,3-4,3,4,1,1,7,-1,A
1890-03-13,1889,Notts County,Accrington F.C.,3-1,3,1,1,1,4,2,H
1890-03-15,1889,Accrington F.C.,Preston North End,2-2,2,2,1,1,4,0,D
1890-03-15,1889,Burnley,Notts County,3-0,3,0,1,1,3,3,H
1890-03-15,1889,Everton,Derby County,3-0,3,0,1,1,3,3,H
1890-03-15,1889,West Bromwich Albion,Stoke City,2-1,2,1,1,1,3,1,H
1890-03-15,1889,Wolverhampton Wanderers,Bolton Wanderers,5-1,5,1,1,1,6,4,H
1890-03-17,1889,Bolton Wanderers,Burnley,2-2,2,2,1,1,4,0,D
1890-03-17,1889,Stoke City,Aston Villa,1-1,1,1,1,1,2,0,D
1890-03-22,1889,West Bromwich Albion,Everton,4-1,4,1,1,1,5,3,H
1890-03-24,1889,Stoke City,Notts County,1-1,1,1,1,1,2,0,D
1890-03-27,1889,Notts County,Preston North End,0-1,0,1,1,1,1,-1,A
1890-03-31,1889,Aston Villa,Blackburn Rovers,3-0,3,0,1,1,3,3,H
1890-09-06,1890,Accrington F.C.,Burnley,1-1,1,1,1,1,2,0,D
1890-09-06,1890,Bolton Wanderers,Notts County,4-2,4,2,1,1,6,2,H
1890-09-06,1890,Derby County,Blackburn Rovers,8-5,8,5,1,1,13,3,H
1890-09-06,1890,West Bromwich Albion,Everton,1-4,1,4,1,1,5,-3,A
1890-09-06,1890,Wolverhampton Wanderers,Aston Villa,2-1,2,1,1,1,3,1,H
1890-09-13,1890,Aston Villa,Notts County,3-2,3,2,1,1,5,1,H
1890-09-13,1890,Blackburn Rovers,Accrington F.C.,0-0,0,0,1,1,0,0,D
1890-09-13,1890,Bolton Wanderers,Derby County,3-1,3,1,1,1,4,2,H
1890-09-13,1890,Everton,Wolverhampton Wanderers,5-0,5,0,1,1,5,5,H
1890-09-13,1890,Preston North End,West Bromwich Albion,3-0,3,0,1,1,3,3,H
1890-09-13,1890,Sunderland,Burnley,2-3,2,3,1,1,5,-1,A
1890-09-15,1890,Sunderland,Wolverhampton Wanderers,3-4,3,4,1,1,7,-1,A
1890-09-20,1890,Bolton Wanderers,Everton,0-5,0,5,1,1,5,-5,A
1890-09-20,1890,Burnley,Aston Villa,2-1,2,1,1,1,3,1,H
1890-09-20,1890,Derby County,Preston North End,1-3,1,3,1,1,4,-2,A
1890-09-20,1890,Notts County,Accrington F.C.,5-0,5,0,1,1,5,5,H
1890-09-20,1890,West Bromwich Albion,Sunderland,0-4,0,4,1,1,4,-4,A
1890-09-22,1890,Wolverhampton Wanderers,Notts County,1-1,1,1,1,1,2,0,D
1890-09-27,1890,Accrington F.C.,Everton,1-2,1,2,1,1,3,-1,A
1890-09-27,1890,Aston Villa,West Bromwich Albion,0-4,0,4,1,1,4,-4,A
1890-09-27,1890,Blackburn Rovers,Wolverhampton Wanderers,2-3,2,3,1,1,5,-1,A
1890-09-27,1890,Burnley,Sunderland,3-3,3,3,1,1,6,0,D
1890-09-27,1890,Notts County,Derby County,2-1,2,1,1,1,3,1,H
1890-09-27,1890,Preston North End,Bolton Wanderers,1-0,1,0,1,1,1,1,H
1890-10-02,1890,Notts County,Bolton Wanderers,3-1,3,1,1,1,4,2,H
1890-10-04,1890,Bolton Wanderers,Aston Villa,4-0,4,0,1,1,4,4,H
1890-10-04,1890,Everton,Derby County,7-0,7,0,1,1,7,7,H
1890-10-04,1890,Preston North End,Blackburn Rovers,1-2,1,2,1,1,3,-1,A
1890-10-04,1890,West Bromwich Albion,Burnley,3-1,3,1,1,1,4,2,H
1890-10-04,1890,Wolverhampton Wanderers,Accrington F.C.,3-0,3,0,1,1,3,3,H
1890-10-11,1890,Accrington F.C.,Preston North End,1-3,1,3,1,1,4,-2,A
1890-10-11,1890,Aston Villa,Everton,2-2,2,2,1,1,4,0,D
1890-10-11,1890,Blackburn Rovers,Sunderland,3-2,3,2,1,1,5,1,H
1890-10-11,1890,Burnley,Bolton Wanderers,1-2,1,2,1,1,3,-1,A
1890-10-11,1890,Notts County,West Bromwich Albion,3-2,3,2,1,1,5,1,H
1890-10-11,1890,Wolverhampton Wanderers,Derby County,5-1,5,1,1,1,6,4,H
1890-10-18,1890,Burnley,Blackburn Rovers,1-6,1,6,1,1,7,-5,A
1890-10-18,1890,Derby County,Aston Villa,5-4,5,4,1,1,9,1,H
1890-10-18,1890,Everton,Bolton Wanderers,2-0,2,0,1,1,2,2,H
1890-10-18,1890,Preston North End,Wolverhampton Wanderers,5-1,5,1,1,1,6,4,H
1890-10-18,1890,Sunderland,Accrington F.C.,2-2,2,2,1,1,4,0,D
1890-10-18,1890,West Bromwich Albion,Notts County,1-1,1,1,1,1,2,0,D
1890-10-25,1890,Accrington F.C.,Notts County,3-2,3,2,1,1,5,1,H
1890-10-25,1890,Aston Villa,Derby County,4-0,4,0,1,1,4,4,H
1890-10-25,1890,Blackburn Rovers,Preston North End,1-0,1,0,1,1,1,1,H
1890-10-25,1890,Bolton Wanderers,Sunderland,2-5,2,5,1,1,7,-3,A
1890-10-25,1890,Everton,West Bromwich Albion,2-3,2,3,1,1,5,-1,A
1890-10-25,1890,Wolverhampton Wanderers,Burnley,3-1,3,1,1,1,4,2,H
1890-11-01,1890,Burnley,Wolverhampton Wanderers,4-2,4,2,1,1,6,2,H
1890-11-01,1890,Notts County,Everton,3-1,3,1,1,1,4,2,H
1890-11-01,1890,Preston North End,Accrington F.C.,1-1,1,1,1,1,2,0,D
1890-11-01,1890,Sunderland,Blackburn Rovers,3-1,3,1,1,1,4,2,H
1890-11-01,1890,West Bromwich Albion,Aston Villa,0-3,0,3,1,1,3,-3,A
1890-11-03,1890,West Bromwich Albion,Bolton Wanderers,2-4,2,4,1,1,6,-2,A
1890-11-08,1890,Accrington F.C.,Derby County,4-0,4,0,1,1,4,4,H
1890-11-08,1890,Aston Villa,Burnley,4-4,4,4,1,1,8,0,D
1890-11-08,1890,Blackburn Rovers,Everton,2-1,2,1,1,1,3,1,H
1890-11-08,1890,Preston North End,Notts County,0-0,0,0,1,1,0,0,D
1890-11-08,1890,Sunderland,West Bromwich Albion,1-1,1,1,1,1,2,0,D
1890-11-08,1890,Wolverhampton Wanderers,Bolton Wanderers,1-0,1,0,1,1,1,1,H
1890-11-15,1890,Aston Villa,Accrington F.C.,3-1,3,1,1,1,4,2,H
1890-11-15,1890,Bolton Wanderers,Preston North End,1-0,1,0,1,1,1,1,H
1890-11-15,1890,Burnley,Derby County,6-1,6,1,1,1,7,5,H
1890-11-15,1890,Everton,Sunderland,1-0,1,0,1,1,1,1,H
1890-11-15,1890,Notts County,Blackburn Rovers,1-2,1,2,1,1,3,-1,A
1890-11-22,1890,Accrington F.C.,Sunderland,4-1,4,1,1,1,5,3,H
1890-11-22,1890,Aston Villa,Bolton Wanderers,5-0,5,0,1,1,5,5,H
1890-11-22,1890,Blackburn Rovers,Burnley,5-2,5,2,1,1,7,3,H
1890-11-22,1890,Derby County,West Bromwich Albion,3-1,3,1,1,1,4,2,H
1890-11-22,1890,Notts County,Wolverhampton Wanderers,1-1,1,1,1,1,2,0,D
1890-11-22,1890,Preston North End,Everton,2-0,2,0,1,1,2,2,H
1890-11-29,1890,Burnley,Accrington F.C.,2-0,2,0,1,1,2,2,H
1890-11-29,1890,Everton,Blackburn Rovers,3-1,3,1,1,1,4,2,H
1890-11-29,1890,Notts County,Aston Villa,7-1,7,1,1,1,8,6,H
1890-11-29,1890,West Bromwich Albion,Derby County,3-4,3,4,1,1,7,-1,A
1890-11-29,1890,Wolverhampton Wanderers,Preston North End,2-0,2,0,1,1,2,2,H
1890-12-06,1890,Blackburn Rovers,Aston Villa,5-1,5,1,1,1,6,4,H
1890-12-06,1890,Burnley,West Bromwich Albion,5-4,5,4,1,1,9,1,H
1890-12-06,1890,Derby County,Accrington F.C.,1-2,1,2,1,1,3,-1,A
1890-12-06,1890,Notts County,Preston North End,2-1,2,1,1,1,3,1,H
1890-12-06,1890,Wolverhampton Wanderers,Everton,0-1,0,1,1,1,1,-1,A
1890-12-13,1890,Aston Villa,Blackburn Rovers,2-2,2,2,1,1,4,0,D
1890-12-13,1890,Bolton Wanderers,Accrington F.C.,6-0,6,0,1,1,6,6,H
1890-12-13,1890,Derby County,Everton,2-6,2,6,1,1,8,-4,A
1890-12-13,1890,West Bromwich Albion,Wolverhampton Wanderers,0-1,0,1,1,1,1,-1,A
1890-12-15,1890,Notts County,Sunderland,2-1,2,1,1,1,3,1,H
1890-12-20,1890,Blackburn Rovers,West Bromwich Albion,2-1,2,1,1,1,3,1,H
1890-12-20,1890,Burnley,Notts County,0-1,0,1,1,1,1,-1,A
1890-12-20,1890,Preston North End,Derby County,6-0,6,0,1,1,6,6,H
1890-12-20,1890,Sunderland,Everton,1-0,1,0,1,1,1,1,H
1890-12-26,1890,Aston Villa,Sunderland,0-0,0,0,1,1,0,0,D
1890-12-26,1890,Derby County,Bolton Wanderers,1-1,1,1,1,1,2,0,D
1890-12-26,1890,Everton,Accrington F.C.,3-2,3,2,1,1,5,1,H
1890-12-26,1890,Wolverhampton Wanderers,Blackburn Rovers,2-0,2,0,1,1,2,2,H
1890-12-27,1890,Derby County,Notts County,3-1,3,1,1,1,4,2,H
1890-12-27,1890,Everton,Burnley,7-3,7,3,1,1,10,4,H
1890-12-27,1890,Wolverhampton Wanderers,Sunderland,0-3,0,3,1,1,3,-3,A
1890-12-29,1890,Bolton Wanderers,Wolverhampton Wanderers,6-0,6,0,1,1,6,6,H
1891-01-01,1890,Accrington F.C.,Wolverhampton Wanderers,1-2,1,2,1,1,3,-1,A
1891-01-01,1890,Everton,Aston Villa,5-0,5,0,1,1,5,5,H
1891-01-03,1890,Blackburn Rovers,Derby County,8-0,8,0,1,1,8,8,H
1891-01-03,1890,Everton,Notts County,4-2,4,2,1,1,6,2,H
1891-01-03,1890,Wolverhampton Wanderers,West Bromwich Albion,4-0,4,0,1,1,4,4,H
1891-01-10,1890,Accrington F.C.,Bolton Wanderers,2-1,2,1,1,1,3,1,H
1891-01-10,1890,Derby County,Wolverhampton Wanderers,9-0,9,0,1,1,9,9,H
1891-01-10,1890,Everton,Preston North End,0-1,0,1,1,1,1,-1,A
1891-01-10,1890,Sunderland,Aston Villa,5-1,5,1,1,1,6,4,H
1891-01-24,1890,Derby County,Burnley,2-4,2,4,1,1,6,-2,A
1891-01-24,1890,Preston North End,Aston Villa,4-1,4,1,1,1,5,3,H
1891-01-24,1890,Sunderland,Notts County,4-0,4,0,1,1,4,4,H
1891-02-05,1890,Preston North End,Burnley,7-0,7,0,1,1,7,7,H
1891-02-07,1890,Derby County,Sunderland,3-1,3,1,1,1,4,2,H
1891-02-07,1890,West Bromwich Albion,Preston North End,1-3,1,3,1,1,4,-2,A
1891-02-10,1890,Notts County,Burnley,4-0,4,0,1,1,4,4,H
1891-02-10,1890,Sunderland,Bolton Wanderers,2-0,2,0,1,1,2,2,H
1891-02-21,1890,Preston North End,Sunderland,0-0,0,0,1,1,0,0,D
1891-03-04,1890,Accrington F.C.,Blackburn Rovers,0-4,0,4,1,1,4,-4,A
1891-03-07,1890,Blackburn Rovers,Bolton Wanderers,0-2,0,2,1,1,2,-2,A
1891-03-07,1890,Burnley,Preston North End,6-2,6,2,1,1,8,4,H
1891-03-07,1890,West Bromwich Albion,Accrington F.C.,5-1,5,1,1,1,6,4,H
1891-03-09,1890,Aston Villa,Preston North End,0-1,0,1,1,1,1,-1,A
1891-03-09,1890,West Bromwich Albion,Blackburn Rovers,1-0,1,0,1,1,1,1,H
1891-03-14,1890,Aston Villa,Wolverhampton Wanderers,6-2,6,2,1,1,8,4,H
1891-03-14,1890,Blackburn Rovers,Notts County,1-7,1,7,1,1,8,-6,A
1891-03-14,1890,Bolton Wanderers,West Bromwich Albion,7-1,7,1,1,1,8,6,H
1891-03-14,1890,Burnley,Everton,3-2,3,2,1,1,5,1,H
1891-03-14,1890,Sunderland,Preston North End,3-0,3,0,1,1,3,3,H
1891-03-21,1890,Accrington F.C.,Aston Villa,1-3,1,3,1,1,4,-2,A
1891-03-21,1890,Bolton Wanderers,Burnley,1-0,1,0,1,1,1,1,H
1891-03-21,1890,Sunderland,Derby County,5-1,5,1,1,1,6,4,H
1891-03-28,1890,Bolton Wanderers,Blackburn Rovers,2-0,2,0,1,1,2,2,H
1891-04-18,1890,Accrington F.C.,West Bromwich Albion,1-0,1,0,1,1,1,1,H
1891-09-05,1891,Accrington F.C.,Burnley,1-0,1,0,1,1,1,1,H
1891-09-05,1891,Aston Villa,Blackburn Rovers,5-1,5,1,1,1,6,4,H
1891-09-05,1891,Darwen,Bolton Wanderers,1-2,1,2,1,1,3,-1,A
1891-09-05,1891,Notts County,Preston North End,2-0,2,0,1,1,2,2,H
1891-09-05,1891,Stoke City,Derby County,2-1,2,1,1,1,3,1,H
1891-09-05,1891,Sunderland,Wolverhampton Wanderers,5-2,5,2,1,1,7,3,H
1891-09-05,1891,West Bromwich Albion,Everton,4-0,4,0,1,1,4,4,H
1891-09-07,1891,Burnley,Preston North End,2-0,2,0,1,1,2,2,H
1891-09-07,1891,Everton,Darwen,5-3,5,3,1,1,8,2,H
1891-09-12,1891,Aston Villa,West Bromwich Albion,5-1,5,1,1,1,6,4,H
1891-09-12,1891,Blackburn Rovers,Notts County,5-4,5,4,1,1,9,1,H
1891-09-12,1891,Bolton Wanderers,Darwen,1-0,1,0,1,1,1,1,H
1891-09-12,1891,Derby County,Accrington F.C.,3-1,3,1,1,1,4,2,H
1891-09-12,1891,Preston North End,Sunderland,3-1,3,1,1,1,4,2,H
1891-09-12,1891,Stoke City,Wolverhampton Wanderers,1-3,1,3,1,1,4,-2,A
1891-09-14,1891,Wolverhampton Wanderers,Accrington F.C.,5-0,5,0,1,1,5,5,H
1891-09-19,1891,Bolton Wanderers,Sunderland,4-3,4,3,1,1,7,1,H
1891-09-19,1891,Burnley,Stoke City,4-1,4,1,1,1,5,3,H
1891-09-19,1891,Darwen,Accrington F.C.,5-2,5,2,1,1,7,3,H
1891-09-19,1891,Derby County,Notts County,3-0,3,0,1,1,3,3,H
1891-09-19,1891,Everton,Blackburn Rovers,3-1,3,1,1,1,4,2,H
1891-09-19,1891,Preston North End,Aston Villa,0-1,0,1,1,1,1,-1,A
1891-09-19,1891,West Bromwich Albion,Wolverhampton Wanderers,4-3,4,3,1,1,7,1,H
1891-09-21,1891,Preston North End,Burnley,5-1,5,1,1,1,6,4,H
1891-09-26,1891,Accrington F.C.,Everton,1-1,1,1,1,1,2,0,D
1891-09-26,1891,Blackburn Rovers,Burnley,3-3,3,3,1,1,6,0,D
1891-09-26,1891,Bolton Wanderers,Preston North End,3-0,3,0,1,1,3,3,H
1891-09-26,1891,Notts County,Stoke City,1-1,1,1,1,1,2,0,D
1891-09-26,1891,Wolverhampton Wanderers,Derby County,1-3,1,3,1,1,4,-2,A
1891-09-28,1891,Aston Villa,Sunderland,5-3,5,3,1,1,8,2,H
1891-09-28,1891,Wolverhampton Wanderers,Darwen,2-2,2,2,1,1,4,0,D
1891-10-01,1891,Notts County,Bolton Wanderers,2-0,2,0,1,1,2,2,H
1891-10-03,1891,Bolton Wanderers,Accrington F.C.,3-4,3,4,1,1,7,-1,A
1891-10-03,1891,Darwen,Stoke City,9-3,9,3,1,1,12,6,H
1891-10-03,1891,Derby County,Aston Villa,4-2,4,2,1,1,6,2,H
1891-10-03,1891,Preston North End,Wolverhampton Wanderers,2-0,2,0,1,1,2,2,H
1891-10-03,1891,Sunderland,Everton,2-1,2,1,1,1,3,1,H
1891-10-03,1891,West Bromwich Albion,Blackburn Rovers,2-2,2,2,1,1,4,0,D
1891-10-10,1891,Accrington F.C.,Darwen,1-1,1,1,1,1,2,0,D
1891-10-10,1891,Aston Villa,Bolton Wanderers,1-2,1,2,1,1,3,-1,A
1891-10-10,1891,Blackburn Rovers,Wolverhampton Wanderers,2-0,2,0,1,1,2,2,H
1891-10-10,1891,Everton,Preston North End,1-1,1,1,1,1,2,0,D
1891-10-10,1891,Notts County,West Bromwich Albion,4-0,4,0,1,1,4,4,H
1891-10-10,1891,Stoke City,Burnley,3-0,3,0,1,1,3,3,H
1891-10-17,1891,Bolton Wanderers,Everton,1-0,1,0,1,1,1,1,H
1891-10-17,1891,Burnley,Aston Villa,4-1,4,1,1,1,5,3,H
1891-10-17,1891,Darwen,Blackburn Rovers,3-5,3,5,1,1,8,-2,A
1891-10-17,1891,Derby County,Stoke City,3-3,3,3,1,1,6,0,D
1891-10-17,1891,West Bromwich Albion,Sunderland,2-5,2,5,1,1,7,-3,A
1891-10-17,1891,Wolverhampton Wanderers,Notts County,2-1,2,1,1,1,3,1,H
1891-10-24,1891,Accrington F.C.,Wolverhampton Wanderers,3-2,3,2,1,1,5,1,H
1891-10-24,1891,Blackburn Rovers,Preston North End,2-4,2,4,1,1,6,-2,A
1891-10-24,1891,Bolton Wanderers,Burnley,2-0,2,0,1,1,2,2,H
1891-10-24,1891,Derby County,Everton,0-3,0,3,1,1,3,-3,A
1891-10-24,1891,Notts County,Darwen,5-0,5,0,1,1,5,5,H
1891-10-24,1891,Stoke City,Aston Villa,2-3,2,3,1,1,5,-1,A
1891-10-24,1891,Sunderland,West Bromwich Albion,4-0,4,0,1,1,4,4,H
1891-10-31,1891,Bolton Wanderers,Blackburn Rovers,4-2,4,2,1,1,6,2,H
1891-10-31,1891,Darwen,Aston Villa,1-5,1,5,1,1,6,-4,A
1891-10-31,1891,Derby County,Wolverhampton Wanderers,2-1,2,1,1,1,3,1,H
1891-10-31,1891,Preston North End,Everton,4-0,4,0,1,1,4,4,H
1891-10-31,1891,Sunderland,Accrington F.C.,4-1,4,1,1,1,5,3,H
1891-10-31,1891,West Bromwich Albion,Notts County,2-2,2,2,1,1,4,0,D
1891-11-02,1891,West Bromwich Albion,Bolton Wanderers,0-2,0,2,1,1,2,-2,A
1891-11-07,1891,Accrington F.C.,Bolton Wanderers,0-3,0,3,1,1,3,-3,A
1891-11-07,1891,Aston Villa,Notts County,5-1,5,1,1,1,6,4,H
1891-11-07,1891,Blackburn Rovers,Sunderland,3-1,3,1,1,1,4,2,H
1891-11-07,1891,Everton,West Bromwich Albion,4-3,4,3,1,1,7,1,H
1891-11-07,1891,Stoke City,Preston North End,0-1,0,1,1,1,1,-1,A
1891-11-07,1891,Wolverhampton Wanderers,Burnley,0-0,0,0,1,1,0,0,D
1891-11-09,1891,Stoke City,Blackburn Rovers,0-1,0,1,1,1,1,-1,A
1891-11-14,1891,Bolton Wanderers,Stoke City,1-1,1,1,1,1,2,0,D
1891-11-14,1891,Burnley,Accrington F.C.,2-1,2,1,1,1,3,1,H
1891-11-14,1891,Darwen,Everton,3-1,3,1,1,1,4,2,H
1891-11-14,1891,Notts County,Wolverhampton Wanderers,2-2,2,2,1,1,4,0,D
1891-11-14,1891,Preston North End,Blackburn Rovers,3-2,3,2,1,1,5,1,H
1891-11-14,1891,Sunderland,Derby County,7-1,7,1,1,1,8,6,H
1891-11-14,1891,West Bromwich Albion,Aston Villa,0-3,0,3,1,1,3,-3,A
1891-11-21,1891,Accrington F.C.,Notts County,2-0,2,0,1,1,2,2,H
1891-11-21,1891,Aston Villa,Stoke City,2-1,2,1,1,1,3,1,H
1891-11-21,1891,Blackburn Rovers,Bolton Wanderers,4-0,4,0,1,1,4,4,H
1891-11-21,1891,Derby County,Darwen,7-0,7,0,1,1,7,7,H
1891-11-21,1891,Sunderland,Burnley,2-1,2,1,1,1,3,1,H
1891-11-21,1891,West Bromwich Albion,Preston North End,1-2,1,2,1,1,3,-1,A
1891-11-21,1891,Wolverhampton Wanderers,Everton,5-1,5,1,1,1,6,4,H
1891-11-28,1891,Burnley,West Bromwich Albion,3-2,3,2,1,1,5,1,H
1891-11-28,1891,Darwen,Derby County,2-0,2,0,1,1,2,2,H
1891-11-28,1891,Everton,Aston Villa,5-1,5,1,1,1,6,4,H
1891-11-28,1891,Notts County,Accrington F.C.,9-0,9,0,1,1,9,9,H
1891-11-28,1891,Preston North End,Bolton Wanderers,4-0,4,0,1,1,4,4,H
1891-11-28,1891,Stoke City,Sunderland,1-3,1,3,1,1,4,-2,A
1891-11-28,1891,Wolverhampton Wanderers,Blackburn Rovers,6-1,6,1,1,1,7,5,H
1891-12-05,1891,Aston Villa,Burnley,6-1,6,1,1,1,7,5,H
1891-12-05,1891,Blackburn Rovers,Everton,2-2,2,2,1,1,4,0,D
1891-12-05,1891,Bolton Wanderers,Wolverhampton Wanderers,3-0,3,0,1,1,3,3,H
1891-12-05,1891,Derby County,Preston North End,1-2,1,2,1,1,3,-1,A
1891-12-05,1891,Stoke City,Darwen,5-1,5,1,1,1,6,4,H
1891-12-05,1891,Sunderland,Notts County,4-0,4,0,1,1,4,4,H
1891-12-05,1891,West Bromwich Albion,Accrington F.C.,3-1,3,1,1,1,4,2,H
1891-12-12,1891,Burnley,Blackburn Rovers,3-0,3,0,1,1,3,3,H
1891-12-12,1891,Everton,Wolverhampton Wanderers,2-1,2,1,1,1,3,1,H
1891-12-12,1891,Preston North End,Notts County,6-0,6,0,1,1,6,6,H
1891-12-12,1891,Stoke City,Bolton Wanderers,0-1,0,1,1,1,1,-1,A
1891-12-12,1891,Sunderland,Darwen,7-0,7,0,1,1,7,7,H
1891-12-12,1891,West Bromwich Albion,Derby County,4-2,4,2,1,1,6,2,H
1891-12-19,1891,Bolton Wanderers,West Bromwich Albion,1-1,1,1,1,1,2,0,D
1891-12-19,1891,Derby County,Burnley,0-1,0,1,1,1,1,-1,A
1891-12-19,1891,Notts County,Blackburn Rovers,2-2,2,2,1,1,4,0,D
1891-12-19,1891,Stoke City,Accrington F.C.,3-1,3,1,1,1,4,2,H
1891-12-19,1891,Wolverhampton Wanderers,Aston Villa,2-0,2,0,1,1,2,2,H
1891-12-25,1891,Blackburn Rovers,Darwen,4-0,4,0,1,1,4,4,H
1891-12-25,1891,Everton,Sunderland,0-4,0,4,1,1,4,-4,A
1891-12-25,1891,Preston North End,Stoke City,3-2,3,2,1,1,5,1,H
1891-12-26,1891,Aston Villa,Darwen,7-0,7,0,1,1,7,7,H
1891-12-26,1891,Blackburn Rovers,Accrington F.C.,2-2,2,2,1,1,4,0,D
1891-12-26,1891,Derby County,Bolton Wanderers,3-2,3,2,1,1,5,1,H
1891-12-26,1891,West Bromwich Albion,Burnley,1-0,1,0,1,1,1,1,H
1891-12-26,1891,Wolverhampton Wanderers,Sunderland,1-3,1,3,1,1,4,-2,A
1891-12-28,1891,Aston Villa,Everton,3-4,3,4,1,1,7,-1,A
1891-12-28,1891,Wolverhampton Wanderers,West Bromwich Albion,2-1,2,1,1,1,3,1,H
1892-01-01,1891,Bolton Wanderers,Derby County,3-1,3,1,1,1,4,2,H
1892-01-01,1891,Darwen,Preston North End,0-4,0,4,1,1,4,-4,A
1892-01-02,1891,Accrington F.C.,Preston North End,1-3,1,3,1,1,4,-2,A
1892-01-02,1891,Blackburn Rovers,Derby County,0-2,0,2,1,1,2,-2,A
1892-01-02,1891,Everton,Burnley,1-1,1,1,1,1,2,0,D
1892-01-02,1891,Notts County,Aston Villa,5-2,5,2,1,1,7,3,H
1892-01-02,1891,Wolverhampton Wanderers,Stoke City,4-1,4,1,1,1,5,3,H
1892-01-04,1891,Accrington F.C.,Aston Villa,3-2,3,2,1,1,5,1,H
1892-01-09,1891,Accrington F.C.,Stoke City,3-0,3,0,1,1,3,3,H
1892-01-09,1891,Aston Villa,Derby County,6-0,6,0,1,1,6,6,H
1892-01-09,1891,Burnley,Darwen,9-0,9,0,1,1,9,9,H
1892-01-09,1891,Notts County,Everton,1-3,1,3,1,1,4,-2,A
1892-01-09,1891,Preston North End,West Bromwich Albion,1-0,1,0,1,1,1,1,H
1892-01-23,1891,Accrington F.C.,West Bromwich Albion,4-2,4,2,1,1,6,2,H
1892-02-06,1891,Derby County,West Bromwich Albion,1-1,1,1,1,1,2,0,D
1892-02-06,1891,Stoke City,Notts County,1-3,1,3,1,1,4,-2,A
1892-02-13,1891,Burnley,Everton,1-0,1,0,1,1,1,1,H
1892-02-20,1891,Notts County,Derby County,2-1,2,1,1,1,3,1,H
1892-02-27,1891,Accrington F.C.,Blackburn Rovers,1-0,1,0,1,1,1,1,H
1892-02-27,1891,Darwen,Notts County,2-3,2,3,1,1,5,-1,A
1892-03-01,1891,Darwen,Wolverhampton Wanderers,1-4,1,4,1,1,5,-3,A
1892-03-01,1891,Notts County,Burnley,5-1,5,1,1,1,6,4,H
1892-03-01,1891,Sunderland,Bolton Wanderers,4-1,4,1,1,1,5,3,H
1892-03-05,1891,Accrington F.C.,Sunderland,3-5,3,5,1,1,8,-2,A
1892-03-05,1891,Blackburn Rovers,Aston Villa,4-3,4,3,1,1,7,1,H
1892-03-05,1891,Burnley,Bolton Wanderers,1-2,1,2,1,1,3,-1,A
1892-03-05,1891,Everton,Stoke City,1-0,1,0,1,1,1,1,H
1892-03-05,1891,Preston North End,Derby County,3-0,3,0,1,1,3,3,H
1892-03-12,1891,Aston Villa,Accrington F.C.,12-2,12,2,1,1,14,10,H
1892-03-12,1891,Blackburn Rovers,West Bromwich Albion,3-2,3,2,1,1,5,1,H
1892-03-12,1891,Stoke City,Everton,0-1,0,1,1,1,1,-1,A
1892-03-12,1891,Sunderland,Preston North End,4-1,4,1,1,1,5,3,H
1892-03-19,1891,Blackburn Rovers,Stoke City,5-3,5,3,1,1,8,2,H
1892-03-19,1891,Derby County,Sunderland,0-1,0,1,1,1,1,-1,A
1892-03-19,1891,Everton,Accrington F.C.,3-0,3,0,1,1,3,3,H
1892-03-26,1891,Bolton Wanderers,Notts County,2-0,2,0,1,1,2,2,H
1892-03-26,1891,Burnley,Wolverhampton Wanderers,1-1,1,1,1,1,2,0,D
1892-03-26,1891,Derby County,Blackburn Rovers,1-1,1,1,1,1,2,0,D
1892-03-26,1891,Sunderland,Aston Villa,2-1,2,1,1,1,3,1,H
1892-04-02,1891,Accrington F.C.,Derby County,1-1,1,1,1,1,2,0,D
1892-04-02,1891,Bolton Wanderers,Aston Villa,1-2,1,2,1,1,3,-1,A
1892-04-02,1891,Darwen,Burnley,2-6,2,6,1,1,8,-4,A
1892-04-02,1891,Sunderland,Stoke City,4-1,4,1,1,1,5,3,H
1892-04-02,1891,Wolverhampton Wanderers,Preston North End,3-0,3,0,1,1,3,3,H
1892-04-04,1891,West Bromwich Albion,Darwen,12-0,12,0,1,1,12,12,H
1892-04-09,1891,Notts County,Sunderland,1-0,1,0,1,1,1,1,H
1892-04-11,1891,West Bromwich Albion,Stoke City,2-2,2,2,1,1,4,0,D
1892-04-15,1891,Burnley,Notts County,1-0,1,0,1,1,1,1,H
1892-04-15,1891,Everton,Derby County,1-2,1,2,1,1,3,-1,A
1892-04-15,1891,Preston North End,Accrington F.C.,4-1,4,1,1,1,5,3,H
1892-04-16,1891,Aston Villa,Preston North End,3-1,3,1,1,1,4,2,H
1892-04-16,1891,Burnley,Derby County,2-4,2,4,1,1,6,-2,A
1892-04-16,1891,Darwen,West Bromwich Albion,1-1,1,1,1,1,2,0,D
1892-04-16,1891,Everton,Notts County,4-0,4,0,1,1,4,4,H
1892-04-16,1891,Sunderland,Blackburn Rovers,6-1,6,1,1,1,7,5,H
1892-04-16,1891,Wolverhampton Wanderers,Bolton Wanderers,1-2,1,2,1,1,3,-1,A
1892-04-18,1891,Aston Villa,Wolverhampton Wanderers,3-6,3,6,1,1,9,-3,A
1892-04-18,1891,Everton,Bolton Wanderers,2-5,2,5,1,1,7,-3,A
1892-04-18,1891,Preston North End,Darwen,4-0,4,0,1,1,4,4,H
1892-04-23,1891,Darwen,Sunderland,1-7,1,7,1,1,8,-6,A
1892-04-23,1891,Stoke City,West Bromwich Albion,1-0,1,0,1,1,1,1,H
1892-04-30,1891,Burnley,Sunderland,1-2,1,2,1,1,3,-1,A
1892-09-03,1892,Accrington F.C.,Sunderland,0-6,0,6,1,1,6,-6,A
1892-09-03,1892,Blackburn Rovers,Manchester United,4-3,4,3,1,1,7,1,H
1892-09-03,1892,Everton,Nottingham Forest,2-2,2,2,1,1,4,0,D
1892-09-03,1892,Notts County,Sheffield Wednesday,0-1,0,1,1,1,1,-1,A
1892-09-03,1892,Preston North End,Bolton Wanderers,2-1,2,1,1,1,3,1,H
1892-09-03,1892,Stoke City,Derby County,1-3,1,3,1,1,4,-2,A
1892-09-03,1892,Wolverhampton Wanderers,Burnley,1-0,1,0,1,1,1,1,H
1892-09-05,1892,Burnley,Aston Villa,0-2,0,2,1,1,2,-2,A
1892-09-10,1892,Aston Villa,Everton,4-1,4,1,1,1,5,3,H
1892-09-10,1892,Bolton Wanderers,West Bromwich Albion,3-1,3,1,1,1,4,2,H
1892-09-10,1892,Derby County,Preston North End,1-2,1,2,1,1,3,-1,A
1892-09-10,1892,Manchester United,Burnley,1-1,1,1,1,1,2,0,D
1892-09-10,1892,Nottingham Forest,Stoke City,3-4,3,4,1,1,7,-1,A
1892-09-10,1892,Sheffield Wednesday,Accrington F.C.,5-2,5,2,1,1,7,3,H
1892-09-10,1892,Sunderland,Notts County,2-2,2,2,1,1,4,0,D
1892-09-10,1892,Wolverhampton Wanderers,Blackburn Rovers,4-2,4,2,1,1,6,2,H
1892-09-12,1892,Preston North End,Sheffield Wednesday,4-1,4,1,1,1,5,3,H
1892-09-12,1892,Stoke City,Aston Villa,0-1,0,1,1,1,1,-1,A
1892-09-17,1892,Aston Villa,Sunderland,1-6,1,6,1,1,7,-5,A
1892-09-17,1892,Blackburn Rovers,Everton,2-2,2,2,1,1,4,0,D
1892-09-17,1892,Bolton Wanderers,Sheffield Wednesday,1-0,1,0,1,1,1,1,H
1892-09-17,1892,Burnley,Manchester United,4-1,4,1,1,1,5,3,H
1892-09-17,1892,Notts County,Derby County,1-1,1,1,1,1,2,0,D
1892-09-17,1892,Preston North End,Nottingham Forest,1-0,1,0,1,1,1,1,H
1892-09-17,1892,Stoke City,Accrington F.C.,2-2,2,2,1,1,4,0,D
1892-09-17,1892,West Bromwich Albion,Wolverhampton Wanderers,2-1,2,1,1,1,3,1,H
1892-09-19,1892,West Bromwich Albion,Aston Villa,3-2,3,2,1,1,5,1,H
1892-09-24,1892,Accrington F.C.,Sheffield Wednesday,4-2,4,2,1,1,6,2,H
1892-09-24,1892,Bolton Wanderers,Aston Villa,5-0,5,0,1,1,5,5,H
1892-09-24,1892,Burnley,Stoke City,3-2,3,2,1,1,5,1,H
1892-09-24,1892,Derby County,West Bromwich Albion,1-1,1,1,1,1,2,0,D
1892-09-24,1892,Everton,Manchester United,6-0,6,0,1,1,6,6,H
1892-09-24,1892,Nottingham Forest,Preston North End,1-2,1,2,1,1,3,-1,A
1892-09-24,1892,Sunderland,Blackburn Rovers,5-0,5,0,1,1,5,5,H
1892-09-24,1892,Wolverhampton Wanderers,Notts County,3-0,3,0,1,1,3,3,H
1892-10-01,1892,Blackburn Rovers,Accrington F.C.,3-3,3,3,1,1,6,0,D
1892-10-01,1892,Bolton Wanderers,Wolverhampton Wanderers,3-1,3,1,1,1,4,2,H
1892-10-01,1892,Derby County,Nottingham Forest,2-3,2,3,1,1,5,-1,A
1892-10-01,1892,Everton,Aston Villa,1-0,1,0,1,1,1,1,H
1892-10-01,1892,Notts County,Preston North End,3-1,3,1,1,1,4,2,H
1892-10-01,1892,Sheffield Wednesday,Burnley,2-0,2,0,1,1,2,2,H
1892-10-01,1892,Sunderland,Stoke City,3-1,3,1,1,1,4,2,H
1892-10-01,1892,West Bromwich Albion,Manchester United,0-0,0,0,1,1,0,0,D
1892-10-03,1892,Sheffield Wednesday,Nottingham Forest,2-2,2,2,1,1,4,0,D
1892-10-06,1892,Notts County,Bolton Wanderers,2-2,2,2,1,1,4,0,D
1892-10-08,1892,Accrington F.C.,Bolton Wanderers,1-1,1,1,1,1,2,0,D
1892-10-08,1892,Burnley,Derby County,2-1,2,1,1,1,3,1,H
1892-10-08,1892,Everton,Sunderland,1-4,1,4,1,1,5,-3,A
1892-10-08,1892,Manchester United,West Bromwich Albion,2-4,2,4,1,1,6,-2,A
1892-10-08,1892,Notts County,Nottingham Forest,3-0,3,0,1,1,3,3,H
1892-10-08,1892,Preston North End,Blackburn Rovers,2-1,2,1,1,1,3,1,H
1892-10-08,1892,Wolverhampton Wanderers,Aston Villa,2-1,2,1,1,1,3,1,H
1892-10-10,1892,Aston Villa,Stoke City,3-2,3,2,1,1,5,1,H
1892-10-15,1892,Aston Villa,Nottingham Forest,1-0,1,0,1,1,1,1,H
1892-10-15,1892,Blackburn Rovers,Sheffield Wednesday,0-2,0,2,1,1,2,-2,A
1892-10-15,1892,Bolton Wanderers,Stoke City,4-4,4,4,1,1,8,0,D
1892-10-15,1892,Manchester United,Wolverhampton Wanderers,10-1,10,1,1,1,11,9,H
1892-10-15,1892,Preston North End,Burnley,2-0,2,0,1,1,2,2,H
1892-10-15,1892,Sunderland,Accrington F.C.,4-2,4,2,1,1,6,2,H
1892-10-15,1892,West Bromwich Albion,Everton,3-0,3,0,1,1,3,3,H
1892-10-19,1892,Derby County,Notts County,4-5,4,5,1,1,9,-1,A
1892-10-19,1892,Manchester United,Everton,3-4,3,4,1,1,7,-1,A
1892-10-20,1892,Nottingham Forest,Bolton Wanderers,2-0,2,0,1,1,2,2,H
1892-10-22,1892,Burnley,Notts County,3-0,3,0,1,1,3,3,H
1892-10-22,1892,Derby County,Blackburn Rovers,3-0,3,0,1,1,3,3,H
1892-10-22,1892,Everton,Accrington F.C.,1-1,1,1,1,1,2,0,D
1892-10-22,1892,Preston North End,Aston Villa,4-1,4,1,1,1,5,3,H
1892-10-22,1892,Sheffield Wednesday,Manchester United,1-0,1,0,1,1,1,1,H
1892-10-22,1892,Stoke City,Nottingham Forest,3-0,3,0,1,1,3,3,H
1892-10-22,1892,Sunderland,West Bromwich Albion,8-1,8,1,1,1,9,7,H
1892-10-22,1892,Wolverhampton Wanderers,Bolton Wanderers,1-2,1,2,1,1,3,-1,A
1892-10-29,1892,Aston Villa,Derby County,6-1,6,1,1,1,7,5,H
1892-10-29,1892,Blackburn Rovers,Preston North End,0-0,0,0,1,1,0,0,D
1892-10-29,1892,Bolton Wanderers,Everton,4-1,4,1,1,1,5,3,H
1892-10-29,1892,Burnley,Accrington F.C.,1-3,1,3,1,1,4,-2,A
1892-10-29,1892,Nottingham Forest,Manchester United,1-1,1,1,1,1,2,0,D
1892-10-29,1892,Sheffield Wednesday,Sunderland,3-2,3,2,1,1,5,1,H
1892-10-29,1892,Stoke City,Wolverhampton Wanderers,2-1,2,1,1,1,3,1,H
1892-10-29,1892,West Bromwich Albion,Notts County,4-2,4,2,1,1,6,2,H
1892-11-05,1892,Accrington F.C.,Preston North End,1-2,1,2,1,1,3,-1,A
1892-11-05,1892,Aston Villa,West Bromwich Albion,5-2,5,2,1,1,7,3,H
1892-11-05,1892,Derby County,Everton,1-6,1,6,1,1,7,-5,A
1892-11-05,1892,Manchester United,Blackburn Rovers,4-4,4,4,1,1,8,0,D
1892-11-05,1892,Notts County,Stoke City,0-1,0,1,1,1,1,-1,A
1892-11-05,1892,Sheffield Wednesday,Bolton Wanderers,4-2,4,2,1,1,6,2,H
1892-11-05,1892,Sunderland,Burnley,2-0,2,0,1,1,2,2,H
1892-11-05,1892,Wolverhampton Wanderers,Nottingham Forest,2-2,2,2,1,1,4,0,D
1892-11-07,1892,West Bromwich Albion,Bolton Wanderers,1-0,1,0,1,1,1,1,H
1892-11-12,1892,Blackburn Rovers,Wolverhampton Wanderers,3-3,3,3,1,1,6,0,D
1892-11-12,1892,Derby County,Burnley,1-0,1,0,1,1,1,1,H
1892-11-12,1892,Everton,Stoke City,2-2,2,2,1,1,4,0,D
1892-11-12,1892,Manchester United,Notts County,1-3,1,3,1,1,4,-2,A
1892-11-12,1892,Nottingham Forest,Aston Villa,4-5,4,5,1,1,9,-1,A
1892-11-12,1892,West Bromwich Albion,Accrington F.C.,4-0,4,0,1,1,4,4,H
1892-11-14,1892,Stoke City,Preston North End,2-1,2,1,1,1,3,1,H
1892-11-19,1892,Bolton Wanderers,Preston North End,2-4,2,4,1,1,6,-2,A
1892-11-19,1892,Manchester United,Aston Villa,2-0,2,0,1,1,2,2,H
1892-11-19,1892,Notts County,West Bromwich Albion,8-1,8,1,1,1,9,7,H
1892-11-19,1892,Sheffield Wednesday,Blackburn Rovers,0-3,0,3,1,1,3,-3,A
1892-11-19,1892,Stoke City,Burnley,4-1,4,1,1,1,5,3,H
1892-11-19,1892,Sunderland,Nottingham Forest,1-0,1,0,1,1,1,1,H
1892-11-19,1892,Wolverhampton Wanderers,Accrington F.C.,5-3,5,3,1,1,8,2,H
1892-11-26,1892,Accrington F.C.,Manchester United,2-2,2,2,1,1,4,0,D
1892-11-26,1892,Aston Villa,Preston North End,3-1,3,1,1,1,4,2,H
1892-11-26,1892,Blackburn Rovers,Bolton Wanderers,3-0,3,0,1,1,3,3,H
1892-11-26,1892,Burnley,Nottingham Forest,1-1,1,1,1,1,2,0,D
1892-11-26,1892,Derby County,Wolverhampton Wanderers,2-2,2,2,1,1,4,0,D
1892-11-26,1892,Everton,Sheffield Wednesday,3-5,3,5,1,1,8,-2,A
1892-11-26,1892,Notts County,Sunderland,3-1,3,1,1,1,4,2,H
1892-11-26,1892,West Bromwich Albion,Stoke City,1-2,1,2,1,1,3,-1,A
1892-12-01,1892,Nottingham Forest,Sheffield Wednesday,2-0,2,0,1,1,2,2,H
1892-12-03,1892,Bolton Wanderers,Manchester United,4-1,4,1,1,1,5,3,H
1892-12-03,1892,Burnley,Blackburn Rovers,0-0,0,0,1,1,0,0,D
1892-12-03,1892,Derby County,Accrington F.C.,3-3,3,3,1,1,6,0,D
1892-12-03,1892,Nottingham Forest,Sunderland,0-5,0,5,1,1,5,-5,A
1892-12-03,1892,Preston North End,Everton,5-0,5,0,1,1,5,5,H
1892-12-03,1892,Sheffield Wednesday,Aston Villa,5-3,5,3,1,1,8,2,H
1892-12-03,1892,Wolverhampton Wanderers,Stoke City,1-0,1,0,1,1,1,1,H
1892-12-08,1892,Notts County,Burnley,3-1,3,1,1,1,4,2,H
1892-12-10,1892,Accrington F.C.,Notts County,4-2,4,2,1,1,6,2,H
1892-12-10,1892,Aston Villa,Blackburn Rovers,4-1,4,1,1,1,5,3,H
1892-12-10,1892,Everton,Wolverhampton Wanderers,3-2,3,2,1,1,5,1,H
1892-12-10,1892,Manchester United,Bolton Wanderers,1-0,1,0,1,1,1,1,H
1892-12-10,1892,Nottingham Forest,Burnley,2-2,2,2,1,1,4,0,D
1892-12-10,1892,Sheffield Wednesday,Derby County,3-3,3,3,1,1,6,0,D
1892-12-10,1892,West Bromwich Albion,Preston North End,0-1,0,1,1,1,1,-1,A
1892-12-17,1892,Accrington F.C.,West Bromwich Albion,5-4,5,4,1,1,9,1,H
1892-12-17,1892,Blackburn Rovers,Burnley,2-0,2,0,1,1,2,2,H
1892-12-17,1892,Derby County,Aston Villa,2-1,2,1,1,1,3,1,H
1892-12-17,1892,Notts County,Everton,1-2,1,2,1,1,3,-1,A
1892-12-17,1892,Stoke City,Sheffield Wednesday,2-0,2,0,1,1,2,2,H
1892-12-17,1892,Sunderland,Preston North End,2-0,2,0,1,1,2,2,H
1892-12-17,1892,Wolverhampton Wanderers,Manchester United,2-0,2,0,1,1,2,2,H
1892-12-24,1892,Aston Villa,Bolton Wanderers,1-1,1,1,1,1,2,0,D
1892-12-24,1892,Blackburn Rovers,Notts County,1-0,1,0,1,1,1,1,H
1892-12-24,1892,Derby County,Stoke City,1-0,1,0,1,1,1,1,H
1892-12-24,1892,Everton,Burnley,0-1,0,1,1,1,1,-1,A
1892-12-24,1892,Manchester United,Sheffield Wednesday,1-5,1,5,1,1,6,-4,A
1892-12-24,1892,Nottingham Forest,Wolverhampton Wanderers,3-1,3,1,1,1,4,2,H
1892-12-24,1892,West Bromwich Albion,Sunderland,1-3,1,3,1,1,4,-2,A
1892-12-26,1892,Accrington F.C.,Stoke City,5-2,5,2,1,1,7,3,H
1892-12-26,1892,Derby County,Bolton Wanderers,1-1,1,1,1,1,2,0,D
1892-12-26,1892,Preston North End,Manchester United,2-1,2,1,1,1,3,1,H
1892-12-26,1892,West Bromwich Albion,Blackburn Rovers,1-2,1,2,1,1,3,-1,A
1892-12-26,1892,Wolverhampton Wanderers,Sunderland,2-0,2,0,1,1,2,2,H
1892-12-27,1892,Wolverhampton Wanderers,West Bromwich Albion,1-1,1,1,1,1,2,0,D
1892-12-31,1892,Accrington F.C.,Wolverhampton Wanderers,4-0,4,0,1,1,4,4,H
1892-12-31,1892,Blackburn Rovers,Nottingham Forest,0-1,0,1,1,1,1,-1,A
1892-12-31,1892,Burnley,West Bromwich Albion,5-0,5,0,1,1,5,5,H
1892-12-31,1892,Manchester United,Derby County,7-1,7,1,1,1,8,6,H
1892-12-31,1892,Notts County,Aston Villa,1-4,1,4,1,1,5,-3,A
1892-12-31,1892,Preston North End,Stoke City,2-1,2,1,1,1,3,1,H
1893-01-02,1892,Accrington F.C.,Blackburn Rovers,1-1,1,1,1,1,2,0,D
1893-01-02,1892,Bolton Wanderers,Derby County,0-3,0,3,1,1,3,-3,A
1893-01-02,1892,Sheffield Wednesday,West Bromwich Albion,6-0,6,0,1,1,6,6,H
1893-01-02,1892,Sunderland,Wolverhampton Wanderers,5-2,5,2,1,1,7,3,H
1893-01-03,1892,Sunderland,Everton,4-3,4,3,1,1,7,1,H
1893-01-07,1892,Aston Villa,Sheffield Wednesday,5-1,5,1,1,1,6,4,H
1893-01-07,1892,Blackburn Rovers,Derby County,2-2,2,2,1,1,4,0,D
1893-01-07,1892,Everton,Notts County,6-0,6,0,1,1,6,6,H
1893-01-07,1892,Nottingham Forest,Accrington F.C.,3-0,3,0,1,1,3,3,H
1893-01-07,1892,Preston North End,Sunderland,1-2,1,2,1,1,3,-1,A
1893-01-07,1892,Stoke City,Manchester United,7-1,7,1,1,1,8,6,H
1893-01-07,1892,West Bromwich Albion,Burnley,7-1,7,1,1,1,8,6,H
1893-01-12,1892,Nottingham Forest,Everton,2-1,2,1,1,1,3,1,H
1893-01-14,1892,Accrington F.C.,Burnley,0-4,0,4,1,1,4,-4,A
1893-01-14,1892,Everton,West Bromwich Albion,1-0,1,0,1,1,1,1,H
1893-01-14,1892,Manchester United,Nottingham Forest,1-3,1,3,1,1,4,-2,A
1893-01-14,1892,Notts County,Blackburn Rovers,0-0,0,0,1,1,0,0,D
1893-01-14,1892,Sheffield Wednesday,Preston North End,0-5,0,5,1,1,5,-5,A
1893-01-14,1892,Stoke City,Bolton Wanderers,6-0,6,0,1,1,6,6,H
1893-01-14,1892,Sunderland,Aston Villa,6-0,6,0,1,1,6,6,H
1893-01-26,1892,Notts County,Manchester United,4-0,4,0,1,1,4,4,H
1893-01-28,1892,Blackburn Rovers,West Bromwich Albion,2-1,2,1,1,1,3,1,H
1893-01-28,1892,Nottingham Forest,Derby County,1-0,1,0,1,1,1,1,H
1893-01-28,1892,Stoke City,Everton,0-1,0,1,1,1,1,-1,A
1893-01-28,1892,Sunderland,Sheffield Wednesday,4-2,4,2,1,1,6,2,H
1893-02-11,1892,Blackburn Rovers,Aston Villa,2-2,2,2,1,1,4,0,D
1893-02-11,1892,Burnley,Bolton Wanderers,3-0,3,0,1,1,3,3,H
1893-02-11,1892,Derby County,Manchester United,5-1,5,1,1,1,6,4,H
1893-02-11,1892,Everton,Preston North End,6-0,6,0,1,1,6,6,H
1893-02-11,1892,Notts County,Accrington F.C.,2-0,2,0,1,1,2,2,H
1893-02-11,1892,Stoke City,West Bromwich Albion,1-2,1,2,1,1,3,-1,A
1893-02-11,1892,Wolverhampton Wanderers,Sheffield Wednesday,2-0,2,0,1,1,2,2,H
1893-02-13,1892,Sheffield Wednesday,Everton,0-2,0,2,1,1,2,-2,A
1893-02-14,1892,Sunderland,Bolton Wanderers,3-3,3,3,1,1,6,0,D
1893-02-25,1892,Accrington F.C.,Everton,0-3,0,3,1,1,3,-3,A
1893-02-25,1892,Blackburn Rovers,Stoke City,3-3,3,3,1,1,6,0,D
1893-02-25,1892,Bolton Wanderers,Burnley,1-0,1,0,1,1,1,1,H
1893-02-25,1892,Nottingham Forest,Notts County,3-1,3,1,1,1,4,2,H
1893-02-25,1892,Wolverhampton Wanderers,Derby County,2-1,2,1,1,1,3,1,H
1893-03-02,1892,Nottingham Forest,West Bromwich Albion,3-4,3,4,1,1,7,-1,A
1893-03-04,1892,Bolton Wanderers,Accrington F.C.,5-2,5,2,1,1,7,3,H
1893-03-04,1892,Manchester United,Sunderland,0-5,0,5,1,1,5,-5,A
1893-03-06,1892,Aston Villa,Manchester United,2-0,2,0,1,1,2,2,H
1893-03-11,1892,Nottingham Forest,Blackburn Rovers,0-1,0,1,1,1,1,-1,A
1893-03-11,1892,Sheffield Wednesday,Wolverhampton Wanderers,0-1,0,1,1,1,1,-1,A
1893-03-11,1892,Stoke City,Notts County,1-0,1,0,1,1,1,1,H
1893-03-11,1892,Sunderland,Derby County,3-1,3,1,1,1,4,2,H
1893-03-18,1892,Accrington F.C.,Nottingham Forest,1-1,1,1,1,1,2,0,D
1893-03-18,1892,Aston Villa,Notts County,3-1,3,1,1,1,4,2,H
1893-03-18,1892,Bolton Wanderers,Blackburn Rovers,2-1,2,1,1,1,3,1,H
1893-03-18,1892,Burnley,Preston North End,4-2,4,2,1,1,6,2,H
1893-03-18,1892,Stoke City,Sunderland,0-1,0,1,1,1,1,-1,A
1893-03-18,1892,West Bromwich Albion,Sheffield Wednesday,3-0,3,0,1,1,3,3,H
1893-03-18,1892,Wolverhampton Wanderers,Everton,2-4,2,4,1,1,6,-2,A
1893-03-25,1892,Aston Villa,Accrington F.C.,6-4,6,4,1,1,10,2,H
1893-03-25,1892,Bolton Wanderers,Notts County,4-1,4,1,1,1,5,3,H
1893-03-25,1892,Derby County,Sheffield Wednesday,2-2,2,2,1,1,4,0,D
1893-03-31,1892,Accrington F.C.,Derby County,0-3,0,3,1,1,3,-3,A
1893-03-31,1892,Blackburn Rovers,Sunderland,2-2,2,2,1,1,4,0,D
1893-03-31,1892,Bolton Wanderers,Nottingham Forest,3-1,3,1,1,1,4,2,H
1893-03-31,1892,Burnley,Sheffield Wednesday,4-0,4,0,1,1,4,4,H
1893-03-31,1892,Manchester United,Stoke City,1-0,1,0,1,1,1,1,H
1893-03-31,1892,Preston North End,Notts County,4-0,4,0,1,1,4,4,H
1893-04-01,1892,Bolton Wanderers,Sunderland,2-1,2,1,1,1,3,1,H
1893-04-01,1892,Burnley,Wolverhampton Wanderers,2-0,2,0,1,1,2,2,H
1893-04-01,1892,Everton,Blackburn Rovers,4-0,4,0,1,1,4,4,H
1893-04-01,1892,Manchester United,Preston North End,2-1,2,1,1,1,3,1,H
1893-04-01,1892,Sheffield Wednesday,Stoke City,0-1,0,1,1,1,1,-1,A
1893-04-01,1892,West Bromwich Albion,Derby County,3-1,3,1,1,1,4,2,H
1893-04-03,1892,Aston Villa,Wolverhampton Wanderers,5-0,5,0,1,1,5,5,H
1893-04-03,1892,Everton,Bolton Wanderers,3-0,3,0,1,1,3,3,H
1893-04-03,1892,Preston North End,Accrington F.C.,0-0,0,0,1,1,0,0,D
1893-04-03,1892,Sheffield Wednesday,Notts County,3-2,3,2,1,1,5,1,H
1893-04-03,1892,Stoke City,Blackburn Rovers,2-2,2,2,1,1,4,0,D
1893-04-03,1892,West Bromwich Albion,Nottingham Forest,2-2,2,2,1,1,4,0,D
1893-04-04,1892,Aston Villa,Burnley,1-3,1,3,1,1,4,-2,A
1893-04-04,1892,Sunderland,Manchester United,6-0,6,0,1,1,6,6,H
1893-04-08,1892,Burnley,Everton,3-0,3,0,1,1,3,3,H
1893-04-08,1892,Derby County,Sunderland,1-1,1,1,1,1,2,0,D
1893-04-08,1892,Manchester United,Accrington F.C.,3-3,3,3,1,1,6,0,D
1893-04-08,1892,Notts County,Wolverhampton Wanderers,3-0,3,0,1,1,3,3,H
1893-04-10,1892,Preston North End,Wolverhampton Wanderers,4-0,4,0,1,1,4,4,H
1893-04-13,1892,Preston North End,West Bromwich Albion,1-1,1,1,1,1,2,0,D
1893-04-15,1892,Accrington F.C.,Aston Villa,1-1,1,1,1,1,2,0,D
1893-04-15,1892,Burnley,Sunderland,2-3,2,3,1,1,5,-1,A
1893-04-15,1892,Everton,Derby County,5-0,5,0,1,1,5,5,H
1893-04-15,1892,Wolverhampton Wanderers,Preston North End,2-1,2,1,1,1,3,1,H
1893-04-17,1892,Preston North End,Derby County,0-1,0,1,1,1,1,-1,A
1893-09-02,1893,Aston Villa,West Bromwich Albion,3-2,3,2,1,1,5,1,H
1893-09-02,1893,Bolton Wanderers,Stoke City,4-1,4,1,1,1,5,3,H
1893-09-02,1893,Darwen,Blackburn Rovers,2-3,2,3,1,1,5,-1,A
1893-09-02,1893,Everton,Sheffield United,2-3,2,3,1,1,5,-1,A
1893-09-02,1893,Manchester United,Burnley,3-2,3,2,1,1,5,1,H
1893-09-02,1893,Nottingham Forest,Wolverhampton Wanderers,7-1,7,1,1,1,8,6,H
1893-09-02,1893,Preston North End,Derby County,1-0,1,0,1,1,1,1,H
1893-09-02,1893,Sheffield Wednesday,Sunderland,2-2,2,2,1,1,4,0,D
1893-09-04,1893,Burnley,Darwen,5-1,5,1,1,1,6,4,H
1893-09-04,1893,Everton,Nottingham Forest,4-0,4,0,1,1,4,4,H
1893-09-04,1893,Sheffield United,Derby County,1-2,1,2,1,1,3,-1,A
1893-09-04,1893,Wolverhampton Wanderers,Sheffield Wednesday,3-1,3,1,1,1,4,2,H
1893-09-09,1893,Blackburn Rovers,Sheffield Wednesday,5-1,5,1,1,1,6,4,H
1893-09-09,1893,Burnley,Preston North End,4-1,4,1,1,1,5,3,H
1893-09-09,1893,Derby County,Everton,7-3,7,3,1,1,10,4,H
1893-09-09,1893,Sheffield United,Darwen,2-1,2,1,1,1,3,1,H
1893-09-09,1893,Stoke City,Nottingham Forest,2-1,2,1,1,1,3,1,H
1893-09-09,1893,Sunderland,Aston Villa,1-1,1,1,1,1,2,0,D
1893-09-09,1893,West Bromwich Albion,Manchester United,3-1,3,1,1,1,4,2,H
1893-09-09,1893,Wolverhampton Wanderers,Bolton Wanderers,2-1,2,1,1,1,3,1,H
1893-09-11,1893,Aston Villa,Stoke City,5-1,5,1,1,1,6,4,H
1893-09-16,1893,Bolton Wanderers,Blackburn Rovers,2-1,2,1,1,1,3,1,H
1893-09-16,1893,Darwen,Stoke City,3-1,3,1,1,1,4,2,H
1893-09-16,1893,Derby County,West Bromwich Albion,2-3,2,3,1,1,5,-1,A
1893-09-16,1893,Everton,Aston Villa,4-2,4,2,1,1,6,2,H
1893-09-16,1893,Nottingham Forest,Burnley,5-0,5,0,1,1,5,5,H
1893-09-16,1893,Preston North End,Sunderland,1-2,1,2,1,1,3,-1,A
1893-09-16,1893,Sheffield Wednesday,Manchester United,0-1,0,1,1,1,1,-1,A
1893-09-18,1893,Wolverhampton Wanderers,Darwen,2-1,2,1,1,1,3,1,H
1893-09-23,1893,Aston Villa,Everton,3-1,3,1,1,1,4,2,H
1893-09-23,1893,Blackburn Rovers,Wolverhampton Wanderers,3-0,3,0,1,1,3,3,H
1893-09-23,1893,Manchester United,Nottingham Forest,1-1,1,1,1,1,2,0,D
1893-09-23,1893,Preston North End,Darwen,4-1,4,1,1,1,5,3,H
1893-09-23,1893,Sheffield United,Bolton Wanderers,4-2,4,2,1,1,6,2,H
1893-09-23,1893,Stoke City,Derby County,3-1,3,1,1,1,4,2,H
1893-09-23,1893,Sunderland,Sheffield Wednesday,1-1,1,1,1,1,2,0,D
1893-09-23,1893,West Bromwich Albion,Burnley,1-1,1,1,1,1,2,0,D
1893-09-25,1893,Sheffield Wednesday,West Bromwich Albion,2-4,2,4,1,1,6,-2,A
1893-09-30,1893,Aston Villa,Derby County,1-1,1,1,1,1,2,0,D
1893-09-30,1893,Bolton Wanderers,Preston North End,0-3,0,3,1,1,3,-3,A
1893-09-30,1893,Burnley,Stoke City,4-0,4,0,1,1,4,4,H
1893-09-30,1893,Darwen,Manchester United,1-0,1,0,1,1,1,1,H
1893-09-30,1893,Everton,Sunderland,7-1,7,1,1,1,8,6,H
1893-09-30,1893,Nottingham Forest,West Bromwich Albion,2-3,2,3,1,1,5,-1,A
1893-09-30,1893,Sheffield Wednesday,Blackburn Rovers,4-2,4,2,1,1,6,2,H
1893-09-30,1893,Wolverhampton Wanderers,Sheffield United,3-4,3,4,1,1,7,-1,A
1893-10-02,1893,Sheffield United,Aston Villa,3-0,3,0,1,1,3,3,H
1893-10-05,1893,Nottingham Forest,Bolton Wanderers,1-0,1,0,1,1,1,1,H
1893-10-07,1893,Blackburn Rovers,Preston North End,1-0,1,0,1,1,1,1,H
1893-10-07,1893,Bolton Wanderers,Darwen,1-0,1,0,1,1,1,1,H
1893-10-07,1893,Burnley,Everton,2-1,2,1,1,1,3,1,H
1893-10-07,1893,Derby County,Manchester United,2-0,2,0,1,1,2,2,H
1893-10-07,1893,Nottingham Forest,Aston Villa,1-2,1,2,1,1,3,-1,A
1893-10-07,1893,Sheffield United,Sunderland,1-0,1,0,1,1,1,1,H
1893-10-07,1893,Stoke City,Sheffield Wednesday,4-1,4,1,1,1,5,3,H
1893-10-07,1893,West Bromwich Albion,Wolverhampton Wanderers,0-0,0,0,1,1,0,0,D
1893-10-14,1893,Bolton Wanderers,Sheffield United,0-1,0,1,1,1,1,-1,A
1893-10-14,1893,Darwen,Aston Villa,1-1,1,1,1,1,2,0,D
1893-10-14,1893,Everton,Blackburn Rovers,2-2,2,2,1,1,4,0,D
1893-10-14,1893,Manchester United,West Bromwich Albion,4-1,4,1,1,1,5,3,H
1893-10-14,1893,Preston North End,Burnley,1-2,1,2,1,1,3,-1,A
1893-10-14,1893,Sheffield Wednesday,Derby County,4-0,4,0,1,1,4,4,H
1893-10-14,1893,Sunderland,Stoke City,4-0,4,0,1,1,4,4,H
1893-10-14,1893,Wolverhampton Wanderers,Nottingham Forest,3-1,3,1,1,1,4,2,H
1893-10-16,1893,Sheffield United,Sheffield Wednesday,1-1,1,1,1,1,2,0,D
1893-10-16,1893,Stoke City,Aston Villa,3-3,3,3,1,1,6,0,D
1893-10-21,1893,Blackburn Rovers,Sunderland,4-3,4,3,1,1,7,1,H
1893-10-21,1893,Bolton Wanderers,Wolverhampton Wanderers,2-0,2,0,1,1,2,2,H
1893-10-21,1893,Burnley,Manchester United,4-1,4,1,1,1,5,3,H
1893-10-21,1893,Derby County,Sheffield Wednesday,3-3,3,3,1,1,6,0,D
1893-10-21,1893,Everton,Darwen,8-1,8,1,1,1,9,7,H
1893-10-21,1893,Nottingham Forest,Stoke City,2-0,2,0,1,1,2,2,H
1893-10-21,1893,West Bromwich Albion,Aston Villa,3-6,3,6,1,1,9,-3,A
1893-10-28,1893,Aston Villa,Burnley,4-0,4,0,1,1,4,4,H
1893-10-28,1893,Darwen,Bolton Wanderers,1-3,1,3,1,1,4,-2,A
1893-10-28,1893,Everton,Preston North End,2-3,2,3,1,1,5,-1,A
1893-10-28,1893,Nottingham Forest,Sheffield Wednesday,1-0,1,0,1,1,1,1,H
1893-10-28,1893,Sheffield United,West Bromwich Albion,0-2,0,2,1,1,2,-2,A
1893-10-28,1893,Stoke City,Blackburn Rovers,3-1,3,1,1,1,4,2,H
1893-10-28,1893,Sunderland,Derby County,5-0,5,0,1,1,5,5,H
1893-10-28,1893,Wolverhampton Wanderers,Manchester United,2-0,2,0,1,1,2,2,H
1893-10-30,1893,Aston Villa,Sheffield United,4-0,4,0,1,1,4,4,H
1893-11-04,1893,Blackburn Rovers,Aston Villa,2-0,2,0,1,1,2,2,H
1893-11-04,1893,Burnley,Nottingham Forest,3-1,3,1,1,1,4,2,H
1893-11-04,1893,Derby County,Sheffield United,2-1,2,1,1,1,3,1,H
1893-11-04,1893,Manchester United,Darwen,0-1,0,1,1,1,1,-1,A
1893-11-04,1893,Preston North End,Bolton Wanderers,1-0,1,0,1,1,1,1,H
1893-11-04,1893,Sheffield Wednesday,Everton,1-1,1,1,1,1,2,0,D
1893-11-04,1893,Sunderland,Wolverhampton Wanderers,6-0,6,0,1,1,6,6,H
1893-11-04,1893,West Bromwich Albion,Stoke City,4-2,4,2,1,1,6,2,H
1893-11-06,1893,West Bromwich Albion,Bolton Wanderers,5-2,5,2,1,1,7,3,H
1893-11-11,1893,Aston Villa,Sunderland,2-1,2,1,1,1,3,1,H
1893-11-11,1893,Darwen,West Bromwich Albion,2-1,2,1,1,1,3,1,H
1893-11-11,1893,Everton,Derby County,1-2,1,2,1,1,3,-1,A
1893-11-11,1893,Manchester United,Wolverhampton Wanderers,1-0,1,0,1,1,1,1,H
1893-11-11,1893,Preston North End,Blackburn Rovers,0-1,0,1,1,1,1,-1,A
1893-11-11,1893,Stoke City,Burnley,4-2,4,2,1,1,6,2,H
1893-11-13,1893,Sheffield Wednesday,Sheffield United,1-2,1,2,1,1,3,-1,A
1893-11-13,1893,Stoke City,Preston North End,2-1,2,1,1,1,3,1,H
1893-11-18,1893,Blackburn Rovers,Burnley,3-2,3,2,1,1,5,1,H
1893-11-18,1893,Bolton Wanderers,Aston Villa,0-1,0,1,1,1,1,-1,A
1893-11-18,1893,Derby County,Darwen,2-1,2,1,1,1,3,1,H
1893-11-18,1893,Nottingham Forest,Sheffield United,1-1,1,1,1,1,2,0,D
1893-11-20,1893,Sheffield United,Preston North End,1-1,1,1,1,1,2,0,D
1893-11-25,1893,Aston Villa,Preston North End,2-0,2,0,1,1,2,2,H
1893-11-25,1893,Everton,Burnley,4-3,4,3,1,1,7,1,H
1893-11-25,1893,Nottingham Forest,Blackburn Rovers,0-0,0,0,1,1,0,0,D
1893-11-25,1893,Sheffield United,Manchester United,3-1,3,1,1,1,4,2,H
1893-11-25,1893,Sunderland,West Bromwich Albion,2-1,2,1,1,1,3,1,H
1893-11-25,1893,Wolverhampton Wanderers,Stoke City,4-2,4,2,1,1,6,2,H
1893-11-27,1893,West Bromwich Albion,Sheffield Wednesday,2-2,2,2,1,1,4,0,D
1893-12-02,1893,Blackburn Rovers,Bolton Wanderers,0-1,0,1,1,1,1,-1,A
1893-12-02,1893,Burnley,Sunderland,1-0,1,0,1,1,1,1,H
1893-12-02,1893,Derby County,Aston Villa,0-3,0,3,1,1,3,-3,A
1893-12-02,1893,Manchester United,Everton,0-3,0,3,1,1,3,-3,A
1893-12-02,1893,Preston North End,Nottingham Forest,0-2,0,2,1,1,2,-2,A
1893-12-02,1893,Sheffield Wednesday,Wolverhampton Wanderers,1-4,1,4,1,1,5,-3,A
1893-12-02,1893,Stoke City,Darwen,3-1,3,1,1,1,4,2,H
1893-12-04,1893,West Bromwich Albion,Preston North End,2-0,2,0,1,1,2,2,H
1893-12-04,1893,Wolverhampton Wanderers,Everton,2-0,2,0,1,1,2,2,H
1893-12-06,1893,Sunderland,Manchester United,4-1,4,1,1,1,5,3,H
1893-12-07,1893,Sheffield Wednesday,Stoke City,4-1,4,1,1,1,5,3,H
1893-12-09,1893,Aston Villa,Sheffield Wednesday,3-0,3,0,1,1,3,3,H
1893-12-09,1893,Bolton Wanderers,Manchester United,2-0,2,0,1,1,2,2,H
1893-12-09,1893,Burnley,West Bromwich Albion,3-0,3,0,1,1,3,3,H
1893-12-09,1893,Derby County,Nottingham Forest,3-4,3,4,1,1,7,-1,A
1893-12-09,1893,Sheffield United,Everton,0-3,0,3,1,1,3,-3,A
1893-12-09,1893,Sunderland,Blackburn Rovers,2-3,2,3,1,1,5,-1,A
1893-12-09,1893,Wolverhampton Wanderers,Preston North End,0-0,0,0,1,1,0,0,D
1893-12-11,1893,Darwen,Sheffield Wednesday,2-1,2,1,1,1,3,1,H
1893-12-16,1893,Blackburn Rovers,Everton,4-3,4,3,1,1,7,1,H
1893-12-16,1893,Manchester United,Aston Villa,1-3,1,3,1,1,4,-2,A
1893-12-16,1893,Preston North End,Wolverhampton Wanderers,1-3,1,3,1,1,4,-2,A
1893-12-16,1893,Sheffield Wednesday,Bolton Wanderers,2-1,2,1,1,1,3,1,H
1893-12-16,1893,Stoke City,Sheffield United,5-0,5,0,1,1,5,5,H
1893-12-16,1893,Sunderland,Burnley,2-2,2,2,1,1,4,0,D
1893-12-16,1893,West Bromwich Albion,Darwen,2-2,2,2,1,1,4,0,D
1893-12-23,1893,Burnley,Blackburn Rovers,1-0,1,0,1,1,1,1,H
1893-12-23,1893,Darwen,Nottingham Forest,0-4,0,4,1,1,4,-4,A
1893-12-23,1893,Derby County,Stoke City,5-2,5,2,1,1,7,3,H
1893-12-23,1893,Everton,Sheffield Wednesday,8-1,8,1,1,1,9,7,H
1893-12-23,1893,Preston North End,Manchester United,2-0,2,0,1,1,2,2,H
1893-12-23,1893,West Bromwich Albion,Sunderland,2-3,2,3,1,1,5,-1,A
1893-12-23,1893,Wolverhampton Wanderers,Aston Villa,3-0,3,0,1,1,3,3,H
1893-12-25,1893,Blackburn Rovers,Darwen,4-1,4,1,1,1,5,3,H
1893-12-25,1893,Bolton Wanderers,Sheffield Wednesday,1-1,1,1,1,1,2,0,D
1893-12-25,1893,Burnley,Sheffield United,4-1,4,1,1,1,5,3,H
1893-12-25,1893,Preston North End,Stoke City,3-3,3,3,1,1,6,0,D
1893-12-26,1893,Aston Villa,Darwen,9-0,9,0,1,1,9,9,H
1893-12-26,1893,Derby County,Bolton Wanderers,6-1,6,1,1,1,7,5,H
1893-12-26,1893,Sheffield Wednesday,Burnley,0-1,0,1,1,1,1,-1,A
1893-12-26,1893,West Bromwich Albion,Sheffield United,3-1,3,1,1,1,4,2,H
1893-12-26,1893,Wolverhampton Wanderers,Blackburn Rovers,5-1,5,1,1,1,6,4,H
1893-12-27,1893,Wolverhampton Wanderers,West Bromwich Albion,0-8,0,8,1,1,8,-8,A
1893-12-30,1893,Everton,West Bromwich Albion,7-1,7,1,1,1,8,6,H
1893-12-30,1893,Nottingham Forest,Derby County,4-2,4,2,1,1,6,2,H
1893-12-30,1893,Stoke City,Wolverhampton Wanderers,0-3,0,3,1,1,3,-3,A
1893-12-30,1893,Sunderland,Bolton Wanderers,2-1,2,1,1,1,3,1,H
1894-01-01,1893,Bolton Wanderers,Derby County,1-1,1,1,1,1,2,0,D
1894-01-01,1893,Darwen,Everton,3-3,3,3,1,1,6,0,D
1894-01-01,1893,Sheffield United,Nottingham Forest,0-2,0,2,1,1,2,-2,A
1894-01-01,1893,Sunderland,Preston North End,6-3,6,3,1,1,9,3,H
1894-01-06,1893,Bolton Wanderers,Burnley,2-0,2,0,1,1,2,2,H
1894-01-06,1893,Darwen,Sheffield United,3-3,3,3,1,1,6,0,D
1894-01-06,1893,Derby County,Preston North End,2-1,2,1,1,1,3,1,H
1894-01-06,1893,Everton,Manchester United,2-0,2,0,1,1,2,2,H
1894-01-06,1893,Sheffield Wednesday,Aston Villa,2-2,2,2,1,1,4,0,D
1894-01-06,1893,West Bromwich Albion,Blackburn Rovers,2-1,2,1,1,1,3,1,H
1894-01-06,1893,Wolverhampton Wanderers,Sunderland,2-1,2,1,1,1,3,1,H
1894-01-13,1893,Blackburn Rovers,West Bromwich Albion,3-0,3,0,1,1,3,3,H
1894-01-13,1893,Manchester United,Sheffield Wednesday,1-2,1,2,1,1,3,-1,A
1894-01-13,1893,Nottingham Forest,Sunderland,1-2,1,2,1,1,3,-1,A
1894-01-13,1893,Preston North End,Everton,2-4,2,4,1,1,6,-2,A
1894-01-13,1893,Sheffield United,Wolverhampton Wanderers,3-2,3,2,1,1,5,1,H
1894-01-13,1893,Stoke City,Bolton Wanderers,5-0,5,0,1,1,5,5,H
1894-01-15,1893,Blackburn Rovers,Sheffield United,4-1,4,1,1,1,5,3,H
1894-01-15,1893,Sheffield Wednesday,Darwen,5-0,5,0,1,1,5,5,H
1894-01-18,1893,Nottingham Forest,Everton,3-2,3,2,1,1,5,1,H
1894-01-18,1893,Preston North End,Aston Villa,2-5,2,5,1,1,7,-3,A
1894-01-20,1893,Stoke City,West Bromwich Albion,3-1,3,1,1,1,4,2,H
1894-01-20,1893,Sunderland,Sheffield United,4-1,4,1,1,1,5,3,H
1894-01-20,1893,Wolverhampton Wanderers,Derby County,2-4,2,4,1,1,6,-2,A
1894-02-03,1893,Aston Villa,Manchester United,5-1,5,1,1,1,6,4,H
1894-02-03,1893,Blackburn Rovers,Nottingham Forest,6-1,6,1,1,1,7,5,H
1894-02-03,1893,Burnley,Bolton Wanderers,2-1,2,1,1,1,3,1,H
1894-02-03,1893,Darwen,Preston North End,2-1,2,1,1,1,3,1,H
1894-02-03,1893,Derby County,Wolverhampton Wanderers,4-1,4,1,1,1,5,3,H
1894-02-03,1893,Sheffield United,Stoke City,3-3,3,3,1,1,6,0,D
1894-02-03,1893,West Bromwich Albion,Everton,3-1,3,1,1,1,4,2,H
1894-02-06,1893,Darwen,Burnley,0-0,0,0,1,1,0,0,D
1894-02-06,1893,Sheffield Wednesday,Preston North End,3-0,3,0,1,1,3,3,H
1894-02-06,1893,Sunderland,Everton,1-0,1,0,1,1,1,1,H
1894-03-03,1893,Aston Villa,Bolton Wanderers,2-3,2,3,1,1,5,-1,A
1894-03-03,1893,Manchester United,Sunderland,2-4,2,4,1,1,6,-2,A
1894-03-03,1893,Preston North End,West Bromwich Albion,3-1,3,1,1,1,4,2,H
1894-03-03,1893,Sheffield United,Blackburn Rovers,3-2,3,2,1,1,5,1,H
1894-03-03,1893,Stoke City,Everton,3-1,3,1,1,1,4,2,H
1894-03-03,1893,Wolverhampton Wanderers,Burnley,1-0,1,0,1,1,1,1,H
1894-03-05,1893,Sheffield Wednesday,Nottingham Forest,1-0,1,0,1,1,1,1,H
1894-03-07,1893,Derby County,Sunderland,1-4,1,4,1,1,5,-3,A
1894-03-10,1893,Burnley,Derby County,3-1,3,1,1,1,4,2,H
1894-03-10,1893,Darwen,Wolverhampton Wanderers,3-1,3,1,1,1,4,2,H
1894-03-10,1893,Manchester United,Sheffield United,0-2,0,2,1,1,2,-2,A
1894-03-12,1893,Manchester United,Blackburn Rovers,5-1,5,1,1,1,6,4,H
1894-03-15,1893,Nottingham Forest,Darwen,4-1,4,1,1,1,5,3,H
1894-03-17,1893,Manchester United,Derby County,2-6,2,6,1,1,8,-4,A
1894-03-17,1893,Sunderland,Nottingham Forest,2-0,2,0,1,1,2,2,H
1894-03-23,1893,Blackburn Rovers,Derby County,0-2,0,2,1,1,2,-2,A
1894-03-23,1893,Bolton Wanderers,Nottingham Forest,1-1,1,1,1,1,2,0,D
1894-03-23,1893,Burnley,Sheffield Wednesday,0-1,0,1,1,1,1,-1,A
1894-03-23,1893,Manchester United,Stoke City,6-2,6,2,1,1,8,4,H
1894-03-24,1893,Aston Villa,Blackburn Rovers,2-1,2,1,1,1,3,1,H
1894-03-24,1893,Everton,Wolverhampton Wanderers,3-0,3,0,1,1,3,3,H
1894-03-24,1893,Manchester United,Bolton Wanderers,2-2,2,2,1,1,4,0,D
1894-03-24,1893,Nottingham Forest,Preston North End,4-2,4,2,1,1,6,2,H
1894-03-24,1893,Stoke City,Sunderland,2-0,2,0,1,1,2,2,H
1894-03-24,1893,West Bromwich Albion,Derby County,0-1,0,1,1,1,1,-1,A
1894-03-26,1893,Aston Villa,Wolverhampton Wanderers,1-1,1,1,1,1,2,0,D
1894-03-26,1893,Blackburn Rovers,Manchester United,4-0,4,0,1,1,4,4,H
1894-03-26,1893,Everton,Bolton Wanderers,3-2,3,2,1,1,5,1,H
1894-03-26,1893,Preston North End,Sheffield Wednesday,1-0,1,0,1,1,1,1,H
1894-03-26,1893,Sheffield United,Burnley,1-0,1,0,1,1,1,1,H
1894-03-26,1893,West Bromwich Albion,Nottingham Forest,3-0,3,0,1,1,3,3,H
1894-03-27,1893,Sunderland,Darwen,4-0,4,0,1,1,4,4,H
1894-03-31,1893,Derby County,Blackburn Rovers,5-2,5,2,1,1,7,3,H
1894-03-31,1893,Stoke City,Manchester United,3-1,3,1,1,1,4,2,H
1894-04-02,1893,Derby County,Burnley,3-3,3,3,1,1,6,0,D
1894-04-07,1893,Bolton Wanderers,West Bromwich Albion,0-3,0,3,1,1,3,-3,A
1894-04-07,1893,Burnley,Aston Villa,3-6,3,6,1,1,9,-3,A
1894-04-07,1893,Darwen,Sunderland,0-3,0,3,1,1,3,-3,A
1894-04-07,1893,Everton,Stoke City,6-2,6,2,1,1,8,4,H
1894-04-07,1893,Nottingham Forest,Manchester United,2-0,2,0,1,1,2,2,H
1894-04-07,1893,Preston North End,Sheffield United,3-0,3,0,1,1,3,3,H
1894-04-14,1893,Aston Villa,Nottingham Forest,3-1,3,1,1,1,4,2,H
1894-04-14,1893,Blackburn Rovers,Stoke City,5-0,5,0,1,1,5,5,H
1894-04-14,1893,Burnley,Wolverhampton Wanderers,4-2,4,2,1,1,6,2,H
1894-04-14,1893,Darwen,Derby County,2-3,2,3,1,1,5,-1,A
1894-04-14,1893,Manchester United,Preston North End,1-3,1,3,1,1,4,-2,A
1894-04-16,1893,Bolton Wanderers,Everton,0-1,0,1,1,1,1,-1,A
1894-04-23,1893,Bolton Wanderers,Sunderland,2-0,2,0,1,1,2,2,H
1894-09-01,1894,Aston Villa,Birmingham City,2-1,2,1,1,1,3,1,H
1894-09-01,1894,Blackburn Rovers,Liverpool,1-1,1,1,1,1,2,0,D
1894-09-01,1894,Bolton Wanderers,Stoke City,2-2,2,2,1,1,4,0,D
1894-09-01,1894,Everton,Sheffield Wednesday,3-1,3,1,1,1,4,2,H
1894-09-01,1894,Nottingham Forest,Burnley,2-1,2,1,1,1,3,1,H
1894-09-01,1894,Sheffield United,West Bromwich Albion,2-1,2,1,1,1,3,1,H
1894-09-01,1894,Sunderland,Derby County,8-0,8,0,1,1,8,8,H
1894-09-01,1894,Wolverhampton Wanderers,Preston North End,1-3,1,3,1,1,4,-2,A
1894-09-03,1894,Burnley,Liverpool,3-3,3,3,1,1,6,0,D
1894-09-03,1894,Everton,Birmingham City,5-0,5,0,1,1,5,5,H
1894-09-03,1894,Sheffield Wednesday,Preston North End,3-1,3,1,1,1,4,2,H
1894-09-03,1894,Wolverhampton Wanderers,Sheffield United,0-3,0,3,1,1,3,-3,A
1894-09-08,1894,Birmingham City,Bolton Wanderers,2-0,2,0,1,1,2,2,H
1894-09-08,1894,Derby County,Nottingham Forest,4-2,4,2,1,1,6,2,H
1894-09-08,1894,Liverpool,Aston Villa,1-2,1,2,1,1,3,-1,A
1894-09-08,1894,Preston North End,Sheffield United,2-1,2,1,1,1,3,1,H
1894-09-08,1894,Sheffield Wednesday,Blackburn Rovers,4-1,4,1,1,1,5,3,H
1894-09-08,1894,Stoke City,Everton,1-3,1,3,1,1,4,-2,A
1894-09-08,1894,Sunderland,Burnley,3-0,3,0,1,1,3,3,H
1894-09-08,1894,West Bromwich Albion,Wolverhampton Wanderers,5-1,5,1,1,1,6,4,H
1894-09-13,1894,Liverpool,Bolton Wanderers,1-2,1,2,1,1,3,-1,A
1894-09-15,1894,Aston Villa,Sunderland,1-2,1,2,1,1,3,-1,A
1894-09-15,1894,Blackburn Rovers,Stoke City,6-0,6,0,1,1,6,6,H
1894-09-15,1894,Bolton Wanderers,Preston North End,1-2,1,2,1,1,3,-1,A
1894-09-15,1894,Derby County,Sheffield Wednesday,1-2,1,2,1,1,3,-1,A
1894-09-15,1894,Everton,Nottingham Forest,6-1,6,1,1,1,7,5,H
1894-09-15,1894,Sheffield United,Burnley,2-2,2,2,1,1,4,0,D
1894-09-15,1894,West Bromwich Albion,Liverpool,5-0,5,0,1,1,5,5,H
1894-09-15,1894,Wolverhampton Wanderers,Birmingham City,2-1,2,1,1,1,3,1,H
1894-09-22,1894,Burnley,Wolverhampton Wanderers,2-1,2,1,1,1,3,1,H
1894-09-22,1894,Derby County,Aston Villa,0-2,0,2,1,1,2,-2,A
1894-09-22,1894,Liverpool,Blackburn Rovers,2-2,2,2,1,1,4,0,D
1894-09-22,1894,Nottingham Forest,Everton,2-3,2,3,1,1,5,-1,A
1894-09-22,1894,Preston North End,Birmingham City,0-1,0,1,1,1,1,-1,A
1894-09-22,1894,Sheffield Wednesday,Bolton Wanderers,2-1,2,1,1,1,3,1,H
1894-09-22,1894,Stoke City,Sheffield United,1-3,1,3,1,1,4,-2,A
1894-09-22,1894,Sunderland,West Bromwich Albion,3-0,3,0,1,1,3,3,H
1894-09-29,1894,Birmingham City,Preston North End,4-4,4,4,1,1,8,0,D
1894-09-29,1894,Blackburn Rovers,Sheffield Wednesday,3-1,3,1,1,1,4,2,H
1894-09-29,1894,Bolton Wanderers,Sunderland,4-1,4,1,1,1,5,3,H
1894-09-29,1894,Burnley,Derby County,2-0,2,0,1,1,2,2,H
1894-09-29,1894,Everton,West Bromwich Albion,4-1,4,1,1,1,5,3,H
1894-09-29,1894,Sheffield United,Nottingham Forest,3-2,3,2,1,1,5,1,H
1894-09-29,1894,Stoke City,Aston Villa,4-1,4,1,1,1,5,3,H
1894-09-29,1894,Wolverhampton Wanderers,Liverpool,3-1,3,1,1,1,4,2,H
1894-10-04,1894,Nottingham Forest,Preston North End,0-2,0,2,1,1,2,-2,A
1894-10-06,1894,Birmingham City,Wolverhampton Wanderers,4-3,4,3,1,1,7,1,H
1894-10-06,1894,Bolton Wanderers,Everton,1-3,1,3,1,1,4,-2,A
1894-10-06,1894,Liverpool,Sheffield United,2-2,2,2,1,1,4,0,D
1894-10-06,1894,Nottingham Forest,Aston Villa,2-1,2,1,1,1,3,1,H
1894-10-06,1894,Preston North End,Blackburn Rovers,1-1,1,1,1,1,2,0,D
1894-10-06,1894,Sheffield Wednesday,Burnley,4-3,4,3,1,1,7,1,H
1894-10-06,1894,Sunderland,Stoke City,3-1,3,1,1,1,4,2,H
1894-10-08,1894,Sheffield United,Blackburn Rovers,3-0,3,0,1,1,3,3,H
1894-10-13,1894,Aston Villa,West Bromwich Albion,3-1,3,1,1,1,4,2,H
1894-10-13,1894,Blackburn Rovers,Bolton Wanderers,2-1,2,1,1,1,3,1,H
1894-10-13,1894,Burnley,Birmingham City,3-1,3,1,1,1,4,2,H
1894-10-13,1894,Derby County,Sunderland,1-2,1,2,1,1,3,-1,A
1894-10-13,1894,Everton,Liverpool,3-0,3,0,1,1,3,3,H
1894-10-13,1894,Sheffield United,Preston North End,0-1,0,1,1,1,1,-1,A
1894-10-13,1894,Stoke City,Nottingham Forest,0-3,0,3,1,1,3,-3,A
1894-10-13,1894,Wolverhampton Wanderers,Sheffield Wednesday,2-0,2,0,1,1,2,2,H
1894-10-20,1894,Birmingham City,Aston Villa,2-2,2,2,1,1,4,0,D
1894-10-20,1894,Blackburn Rovers,Everton,4-3,4,3,1,1,7,1,H
1894-10-20,1894,Bolton Wanderers,Burnley,1-1,1,1,1,1,2,0,D
1894-10-20,1894,Liverpool,Stoke City,2-0,2,0,1,1,2,2,H
1894-10-20,1894,Preston North End,Wolverhampton Wanderers,2-0,2,0,1,1,2,2,H
1894-10-20,1894,West Bromwich Albion,Derby County,2-2,2,2,1,1,4,0,D
1894-10-22,1894,Sheffield United,Aston Villa,2-1,2,1,1,1,3,1,H
1894-10-27,1894,Aston Villa,Liverpool,5-0,5,0,1,1,5,5,H
1894-10-27,1894,Blackburn Rovers,Preston North End,1-1,1,1,1,1,2,0,D
1894-10-27,1894,Burnley,Nottingham Forest,0-1,0,1,1,1,1,-1,A
1894-10-27,1894,Derby County,West Bromwich Albion,1-1,1,1,1,1,2,0,D
1894-10-27,1894,Everton,Sunderland,2-2,2,2,1,1,4,0,D
1894-10-27,1894,Sheffield Wednesday,Sheffield United,2-3,2,3,1,1,5,-1,A
1894-10-27,1894,Stoke City,Birmingham City,2-2,2,2,1,1,4,0,D
1894-10-27,1894,Wolverhampton Wanderers,Bolton Wanderers,4-2,4,2,1,1,6,2,H
1894-11-03,1894,Birmingham City,Everton,4-4,4,4,1,1,8,0,D
1894-11-03,1894,Bolton Wanderers,Blackburn Rovers,1-3,1,3,1,1,4,-2,A
1894-11-03,1894,Liverpool,Burnley,0-3,0,3,1,1,3,-3,A
1894-11-03,1894,Nottingham Forest,Derby County,2-1,2,1,1,1,3,1,H
1894-11-03,1894,Sheffield Wednesday,Aston Villa,1-0,1,0,1,1,1,1,H
1894-11-03,1894,Sunderland,Wolverhampton Wanderers,2-0,2,0,1,1,2,2,H
1894-11-03,1894,West Bromwich Albion,Sheffield United,1-0,1,0,1,1,1,1,H
1894-11-05,1894,West Bromwich Albion,Bolton Wanderers,1-1,1,1,1,1,2,0,D
1894-11-10,1894,Aston Villa,Preston North End,4-1,4,1,1,1,5,3,H
1894-11-10,1894,Blackburn Rovers,Sunderland,1-1,1,1,1,1,2,0,D
1894-11-10,1894,Burnley,Sheffield Wednesday,3-0,3,0,1,1,3,3,H
1894-11-10,1894,Stoke City,Liverpool,3-1,3,1,1,1,4,2,H
1894-11-10,1894,West Bromwich Albion,Birmingham City,4-1,4,1,1,1,5,3,H
1894-11-10,1894,Wolverhampton Wanderers,Nottingham Forest,1-1,1,1,1,1,2,0,D
1894-11-12,1894,Aston Villa,Sheffield United,5-0,5,0,1,1,5,5,H
1894-11-12,1894,Stoke City,Preston North End,2-1,2,1,1,1,3,1,H
1894-11-17,1894,Birmingham City,Stoke City,4-2,4,2,1,1,6,2,H
1894-11-17,1894,Blackburn Rovers,Burnley,1-0,1,0,1,1,1,1,H
1894-11-17,1894,Liverpool,Everton,2-2,2,2,1,1,4,0,D
1894-11-17,1894,Nottingham Forest,Sheffield United,3-0,3,0,1,1,3,3,H
1894-11-17,1894,Preston North End,Derby County,3-2,3,2,1,1,5,1,H
1894-11-17,1894,Sheffield Wednesday,Wolverhampton Wanderers,3-1,3,1,1,1,4,2,H
1894-11-17,1894,Sunderland,Bolton Wanderers,4-0,4,0,1,1,4,4,H
1894-11-17,1894,West Bromwich Albion,Aston Villa,3-2,3,2,1,1,5,1,H
1894-11-24,1894,Aston Villa,Nottingham Forest,4-1,4,1,1,1,5,3,H
1894-11-24,1894,Bolton Wanderers,Birmingham City,1-2,1,2,1,1,3,-1,A
1894-11-24,1894,Burnley,West Bromwich Albion,2-0,2,0,1,1,2,2,H
1894-11-24,1894,Derby County,Preston North End,2-1,2,1,1,1,3,1,H
1894-11-24,1894,Everton,Blackburn Rovers,2-1,2,1,1,1,3,1,H
1894-11-24,1894,Sunderland,Liverpool,3-2,3,2,1,1,5,1,H
1894-11-24,1894,Wolverhampton Wanderers,Stoke City,0-0,0,0,1,1,0,0,D
1894-12-01,1894,Birmingham City,Sheffield United,4-2,4,2,1,1,6,2,H
1894-12-01,1894,Blackburn Rovers,Aston Villa,1-3,1,3,1,1,4,-2,A
1894-12-01,1894,Liverpool,Wolverhampton Wanderers,3-3,3,3,1,1,6,0,D
1894-12-01,1894,Preston North End,Bolton Wanderers,2-2,2,2,1,1,4,0,D
1894-12-01,1894,West Bromwich Albion,Everton,1-4,1,4,1,1,5,-3,A
1894-12-03,1894,Aston Villa,Sheffield Wednesday,3-1,3,1,1,1,4,2,H
1894-12-08,1894,Aston Villa,Blackburn Rovers,3-0,3,0,1,1,3,3,H
1894-12-08,1894,Burnley,Preston North End,2-1,2,1,1,1,3,1,H
1894-12-08,1894,Everton,Bolton Wanderers,3-1,3,1,1,1,4,2,H
1894-12-08,1894,Nottingham Forest,West Bromwich Albion,5-3,5,3,1,1,8,2,H
1894-12-08,1894,Sheffield United,Liverpool,2-2,2,2,1,1,4,0,D
1894-12-08,1894,Stoke City,Sheffield Wednesday,0-2,0,2,1,1,2,-2,A
1894-12-08,1894,Sunderland,Birmingham City,7-1,7,1,1,1,8,6,H
1894-12-08,1894,Wolverhampton Wanderers,Derby County,2-2,2,2,1,1,4,0,D
1894-12-12,1894,Derby County,Burnley,0-2,0,2,1,1,2,-2,A
1894-12-15,1894,Bolton Wanderers,Wolverhampton Wanderers,6-1,6,1,1,1,7,5,H
1894-12-15,1894,Derby County,Sheffield United,4-1,4,1,1,1,5,3,H
1894-12-15,1894,Liverpool,Birmingham City,3-1,3,1,1,1,4,2,H
1894-12-15,1894,Preston North End,Everton,1-2,1,2,1,1,3,-1,A
1894-12-15,1894,Sheffield Wednesday,Nottingham Forest,0-0,0,0,1,1,0,0,D
1894-12-15,1894,Sunderland,Blackburn Rovers,3-2,3,2,1,1,5,1,H
1894-12-15,1894,West Bromwich Albion,Stoke City,3-2,3,2,1,1,5,1,H
1894-12-22,1894,Birmingham City,Nottingham Forest,1-2,1,2,1,1,3,-1,A
1894-12-22,1894,Blackburn Rovers,West Bromwich Albion,3-0,3,0,1,1,3,3,H
1894-12-22,1894,Burnley,Sheffield United,2-4,2,4,1,1,6,-2,A
1894-12-22,1894,Wolverhampton Wanderers,Aston Villa,0-4,0,4,1,1,4,-4,A
1894-12-25,1894,Bolton Wanderers,Liverpool,1-0,1,0,1,1,1,1,H
1894-12-25,1894,Preston North End,Stoke City,3-0,3,0,1,1,3,3,H
1894-12-25,1894,Sheffield United,Derby County,1-4,1,4,1,1,5,-3,A
1894-12-26,1894,Aston Villa,Stoke City,6-0,6,0,1,1,6,6,H
1894-12-26,1894,Blackburn Rovers,Sheffield United,3-2,3,2,1,1,5,1,H
1894-12-26,1894,Derby County,Bolton Wanderers,2-2,2,2,1,1,4,0,D
1894-12-26,1894,Sheffield Wednesday,Birmingham City,2-0,2,0,1,1,2,2,H
1894-12-26,1894,West Bromwich Albion,Sunderland,0-2,0,2,1,1,2,-2,A
1894-12-26,1894,Wolverhampton Wanderers,Burnley,1-0,1,0,1,1,1,1,H
1894-12-27,1894,Nottingham Forest,Sunderland,2-1,2,1,1,1,3,1,H
1894-12-27,1894,Sheffield Wednesday,Derby County,1-1,1,1,1,1,2,0,D
1894-12-27,1894,Wolverhampton Wanderers,West Bromwich Albion,3-1,3,1,1,1,4,2,H
1894-12-29,1894,Birmingham City,Liverpool,3-0,3,0,1,1,3,3,H
1894-12-29,1894,Nottingham Forest,Blackburn Rovers,2-3,2,3,1,1,5,-1,A
1894-12-29,1894,Preston North End,Sunderland,1-0,1,0,1,1,1,1,H
1894-12-29,1894,West Bromwich Albion,Burnley,0-1,0,1,1,1,1,-1,A
1895-01-01,1894,Blackburn Rovers,Nottingham Forest,0-0,0,0,1,1,0,0,D
1895-01-01,1894,Bolton Wanderers,Derby County,6-0,6,0,1,1,6,6,H
1895-01-01,1894,Liverpool,West Bromwich Albion,4-0,4,0,1,1,4,4,H
1895-01-01,1894,Sheffield Wednesday,Everton,3-0,3,0,1,1,3,3,H
1895-01-01,1894,Sunderland,Preston North End,2-0,2,0,1,1,2,2,H
1895-01-02,1894,Sunderland,Aston Villa,4-4,4,4,1,1,8,0,D
1895-01-05,1894,Aston Villa,Derby County,4-0,4,0,1,1,4,4,H
1895-01-05,1894,Blackburn Rovers,Birmingham City,9-1,9,1,1,1,10,8,H
1895-01-05,1894,Burnley,Bolton Wanderers,1-0,1,0,1,1,1,1,H
1895-01-05,1894,Sheffield Wednesday,Liverpool,5-0,5,0,1,1,5,5,H
1895-01-05,1894,Sunderland,Nottingham Forest,2-2,2,2,1,1,4,0,D
1895-01-05,1894,West Bromwich Albion,Preston North End,4-5,4,5,1,1,9,-1,A
1895-01-05,1894,Wolverhampton Wanderers,Everton,1-0,1,0,1,1,1,1,H
1895-01-07,1894,Bolton Wanderers,Sheffield Wednesday,2-2,2,2,1,1,4,0,D
1895-01-07,1894,Everton,Stoke City,3-0,3,0,1,1,3,3,H
1895-01-09,1894,Derby County,Liverpool,0-1,0,1,1,1,1,-1,A
1895-01-12,1894,Burnley,Blackburn Rovers,2-1,2,1,1,1,3,1,H
1895-01-12,1894,Derby County,Everton,2-2,2,2,1,1,4,0,D
1895-01-12,1894,Liverpool,Nottingham Forest,5-0,5,0,1,1,5,5,H
1895-01-12,1894,Preston North End,Aston Villa,0-1,0,1,1,1,1,-1,A
1895-01-12,1894,Sheffield United,Sheffield Wednesday,1-0,1,0,1,1,1,1,H
1895-01-12,1894,Stoke City,Bolton Wanderers,5-0,5,0,1,1,5,5,H
1895-01-12,1894,Wolverhampton Wanderers,Sunderland,1-4,1,4,1,1,5,-3,A
1895-01-14,1894,Bolton Wanderers,Sheffield United,6-2,6,2,1,1,8,4,H
1895-01-17,1894,Everton,Aston Villa,4-2,4,2,1,1,6,2,H
1895-01-19,1894,Derby County,Stoke City,1-1,1,1,1,1,2,0,D
1895-01-19,1894,Nottingham Forest,Sheffield Wednesday,2-1,2,1,1,1,3,1,H
1895-01-19,1894,Sheffield United,Wolverhampton Wanderers,1-0,1,0,1,1,1,1,H
1895-01-26,1894,Aston Villa,Bolton Wanderers,2-1,2,1,1,1,3,1,H
1895-01-26,1894,Derby County,Wolverhampton Wanderers,1-3,1,3,1,1,4,-2,A
1895-01-26,1894,Everton,Sheffield United,1-1,1,1,1,1,2,0,D
1895-01-26,1894,Nottingham Forest,Birmingham City,2-0,2,0,1,1,2,2,H
1895-01-26,1894,Preston North End,Burnley,4-0,4,0,1,1,4,4,H
1895-01-26,1894,Stoke City,Sunderland,2-5,2,5,1,1,7,-3,A
1895-01-26,1894,West Bromwich Albion,Blackburn Rovers,2-0,2,0,1,1,2,2,H
1895-02-04,1894,Stoke City,Wolverhampton Wanderers,0-0,0,0,1,1,0,0,D
1895-02-09,1894,Birmingham City,Sunderland,1-1,1,1,1,1,2,0,D
1895-02-09,1894,Sheffield United,Stoke City,3-0,3,0,1,1,3,3,H
1895-02-23,1894,Birmingham City,West Bromwich Albion,1-2,1,2,1,1,3,-1,A
1895-02-23,1894,Burnley,Aston Villa,3-3,3,3,1,1,6,0,D
1895-02-23,1894,Everton,Preston North End,4-2,4,2,1,1,6,2,H
1895-02-23,1894,Nottingham Forest,Stoke City,3-1,3,1,1,1,4,2,H
1895-02-23,1894,Sunderland,Sheffield United,2-0,2,0,1,1,2,2,H
1895-02-23,1894,Wolverhampton Wanderers,Blackburn Rovers,3-3,3,3,1,1,6,0,D
1895-02-26,1894,Preston North End,West Bromwich Albion,5-0,5,0,1,1,5,5,H
1895-02-26,1894,Sheffield United,Everton,4-2,4,2,1,1,6,2,H
1895-02-26,1894,Sunderland,Sheffield Wednesday,3-1,3,1,1,1,4,2,H
1895-03-02,1894,Birmingham City,Blackburn Rovers,1-1,1,1,1,1,2,0,D
1895-03-02,1894,Liverpool,Derby County,5-1,5,1,1,1,6,4,H
1895-03-09,1894,Sheffield United,Sunderland,4-0,4,0,1,1,4,4,H
1895-03-16,1894,Birmingham City,Derby County,3-5,3,5,1,1,8,-2,A
1895-03-16,1894,Burnley,Everton,2-4,2,4,1,1,6,-2,A
1895-03-16,1894,Nottingham Forest,Bolton Wanderers,3-3,3,3,1,1,6,0,D
1895-03-21,1894,Everton,Burnley,3-2,3,2,1,1,5,1,H
1895-03-23,1894,Birmingham City,Burnley,1-0,1,0,1,1,1,1,H
1895-03-23,1894,Blackburn Rovers,Wolverhampton Wanderers,5-1,5,1,1,1,6,4,H
1895-03-23,1894,Bolton Wanderers,Aston Villa,4-3,4,3,1,1,7,1,H
1895-03-23,1894,Preston North End,Nottingham Forest,3-1,3,1,1,1,4,2,H
1895-03-23,1894,Sheffield Wednesday,Sunderland,1-2,1,2,1,1,3,-1,A
1895-03-23,1894,Stoke City,Derby County,4-1,4,1,1,1,5,3,H
1895-03-25,1894,Birmingham City,Sheffield Wednesday,0-0,0,0,1,1,0,0,D
1895-03-25,1894,Liverpool,Sunderland,2-3,2,3,1,1,5,-1,A
1895-03-25,1894,Stoke City,West Bromwich Albion,1-1,1,1,1,1,2,0,D
1895-03-30,1894,Derby County,Birmingham City,4-1,4,1,1,1,5,3,H
1895-03-30,1894,Liverpool,Sheffield Wednesday,4-2,4,2,1,1,6,2,H
1895-03-30,1894,Stoke City,Burnley,5-1,5,1,1,1,6,4,H
1895-04-01,1894,Sheffield Wednesday,West Bromwich Albion,3-2,3,2,1,1,5,1,H
1895-04-06,1894,Aston Villa,Burnley,5-0,5,0,1,1,5,5,H
1895-04-06,1894,Derby County,Blackburn Rovers,0-0,0,0,1,1,0,0,D
1895-04-06,1894,Nottingham Forest,Liverpool,3-0,3,0,1,1,3,3,H
1895-04-08,1894,Everton,Wolverhampton Wanderers,2-1,2,1,1,1,3,1,H
1895-04-12,1894,Blackburn Rovers,Derby County,0-0,0,0,1,1,0,0,D
1895-04-12,1894,Bolton Wanderers,Nottingham Forest,4-1,4,1,1,1,5,3,H
1895-04-12,1894,Preston North End,Liverpool,2-2,2,2,1,1,4,0,D
1895-04-13,1894,Bolton Wanderers,West Bromwich Albion,5-0,5,0,1,1,5,5,H
1895-04-13,1894,Burnley,Sunderland,0-3,0,3,1,1,3,-3,A
1895-04-13,1894,Everton,Derby County,2-3,2,3,1,1,5,-1,A
1895-04-13,1894,Nottingham Forest,Wolverhampton Wanderers,0-2,0,2,1,1,2,-2,A
1895-04-13,1894,Preston North End,Sheffield Wednesday,3-1,3,1,1,1,4,2,H
1895-04-13,1894,Sheffield United,Birmingham City,0-2,0,2,1,1,2,-2,A
1895-04-13,1894,Stoke City,Blackburn Rovers,5-1,5,1,1,1,6,4,H
1895-04-15,1894,Aston Villa,Wolverhampton Wanderers,2-2,2,2,1,1,4,0,D
1895-04-15,1894,Sheffield United,Bolton Wanderers,5-0,5,0,1,1,5,5,H
1895-04-15,1894,West Bromwich Albion,Nottingham Forest,1-0,1,0,1,1,1,1,H
1895-04-17,1894,Sheffield Wednesday,Stoke City,2-4,2,4,1,1,6,-2,A
1895-04-20,1894,Burnley,Stoke City,1-2,1,2,1,1,3,-1,A
1895-04-20,1894,Liverpool,Preston North End,2-5,2,5,1,1,7,-3,A
1895-04-20,1894,Sunderland,Everton,2-1,2,1,1,1,3,1,H
1895-04-22,1894,West Bromwich Albion,Sheffield Wednesday,6-0,6,0,1,1,6,6,H
1895-04-24,1894,Aston Villa,Everton,2-2,2,2,1,1,4,0,D
1895-09-02,1895,Aston Villa,West Bromwich Albion,1-0,1,0,1,1,1,1,H
1895-09-02,1895,Everton,Sheffield Wednesday,2-2,2,2,1,1,4,0,D
1895-09-02,1895,Sheffield United,Birmingham City,2-0,2,0,1,1,2,2,H
1895-09-02,1895,Stoke City,Bolton Wanderers,2-0,2,0,1,1,2,2,H
1895-09-02,1895,Sunderland,Preston North End,4-1,4,1,1,1,5,3,H
1895-09-02,1895,Wolverhampton Wanderers,Burnley,5-1,5,1,1,1,6,4,H
1895-09-05,1895,Nottingham Forest,Bury,5-0,5,0,1,1,5,5,H
1895-09-07,1895,Aston Villa,Birmingham City,7-3,7,3,1,1,10,4,H
1895-09-07,1895,Bury,Bolton Wanderers,0-3,0,3,1,1,3,-3,A
1895-09-07,1895,Everton,Nottingham Forest,6-2,6,2,1,1,8,4,H
1895-09-07,1895,Preston North End,Wolverhampton Wanderers,4-3,4,3,1,1,7,1,H
1895-09-07,1895,Sheffield Wednesday,Sheffield United,1-0,1,0,1,1,1,1,H
1895-09-07,1895,Stoke City,Derby County,2-1,2,1,1,1,3,1,H
1895-09-07,1895,Sunderland,Blackburn Rovers,2-1,2,1,1,1,3,1,H
1895-09-07,1895,West Bromwich Albion,Burnley,0-2,0,2,1,1,2,-2,A
1895-09-09,1895,Burnley,Sunderland,0-0,0,0,1,1,0,0,D
1895-09-09,1895,Everton,Bury,3-2,3,2,1,1,5,1,H
1895-09-14,1895,Birmingham City,Stoke City,1-2,1,2,1,1,3,-1,A
1895-09-14,1895,Blackburn Rovers,Nottingham Forest,2-0,2,0,1,1,2,2,H
1895-09-14,1895,Bolton Wanderers,Everton,3-1,3,1,1,1,4,2,H
1895-09-14,1895,Burnley,Bury,3-0,3,0,1,1,3,3,H
1895-09-14,1895,Derby County,Sunderland,2-0,2,0,1,1,2,2,H
1895-09-14,1895,Sheffield United,Aston Villa,2-1,2,1,1,1,3,1,H
1895-09-14,1895,West Bromwich Albion,Preston North End,1-2,1,2,1,1,3,-1,A
1895-09-14,1895,Wolverhampton Wanderers,Sheffield Wednesday,4-0,4,0,1,1,4,4,H
1895-09-21,1895,Aston Villa,Derby County,4-1,4,1,1,1,5,3,H
1895-09-21,1895,Bolton Wanderers,Burnley,1-0,1,0,1,1,1,1,H
1895-09-21,1895,Bury,Sheffield United,1-0,1,0,1,1,1,1,H
1895-09-21,1895,Everton,Blackburn Rovers,0-2,0,2,1,1,2,-2,A
1895-09-21,1895,Nottingham Forest,Birmingham City,3-0,3,0,1,1,3,3,H
1895-09-21,1895,Stoke City,West Bromwich Albion,3-1,3,1,1,1,4,2,H
1895-09-21,1895,Sunderland,Wolverhampton Wanderers,2-2,2,2,1,1,4,0,D
1895-09-28,1895,Birmingham City,Bolton Wanderers,1-2,1,2,1,1,3,-1,A
1895-09-28,1895,Blackburn Rovers,Aston Villa,1-1,1,1,1,1,2,0,D
1895-09-28,1895,Burnley,Preston North End,1-0,1,0,1,1,1,1,H
1895-09-28,1895,Derby County,Sheffield Wednesday,3-1,3,1,1,1,4,2,H
1895-09-28,1895,Sheffield United,Stoke City,1-0,1,0,1,1,1,1,H
1895-09-28,1895,Sunderland,Bury,0-0,0,0,1,1,0,0,D
1895-09-28,1895,West Bromwich Albion,Nottingham Forest,3-1,3,1,1,1,4,2,H
1895-09-28,1895,Wolverhampton Wanderers,Everton,2-3,2,3,1,1,5,-1,A
1895-09-30,1895,Aston Villa,Everton,4-3,4,3,1,1,7,1,H
1895-09-30,1895,Sheffield United,Preston North End,2-1,2,1,1,1,3,1,H
1895-10-05,1895,Aston Villa,Sunderland,2-1,2,1,1,1,3,1,H
1895-10-05,1895,Blackburn Rovers,Burnley,1-0,1,0,1,1,1,1,H
1895-10-05,1895,Bolton Wanderers,Bury,2-4,2,4,1,1,6,-2,A
1895-10-05,1895,Everton,Sheffield United,5-0,5,0,1,1,5,5,H
1895-10-05,1895,Nottingham Forest,Derby County,2-5,2,5,1,1,7,-3,A
1895-10-05,1895,Preston North End,Birmingham City,3-2,3,2,1,1,5,1,H
1895-10-05,1895,Sheffield Wednesday,West Bromwich Albion,5-3,5,3,1,1,8,2,H
1895-10-05,1895,Wolverhampton Wanderers,Stoke City,1-0,1,0,1,1,1,1,H
1895-10-07,1895,Sheffield United,Sunderland,1-2,1,2,1,1,3,-1,A
1895-10-12,1895,Blackburn Rovers,Preston North End,3-0,3,0,1,1,3,3,H
1895-10-12,1895,Burnley,Bolton Wanderers,1-2,1,2,1,1,3,-1,A
1895-10-12,1895,Bury,Birmingham City,4-5,4,5,1,1,9,-1,A
1895-10-12,1895,Derby County,Stoke City,2-1,2,1,1,1,3,1,H
1895-10-12,1895,Nottingham Forest,Everton,2-1,2,1,1,1,3,1,H
1895-10-12,1895,Sheffield Wednesday,Wolverhampton Wanderers,3-1,3,1,1,1,4,2,H
1895-10-12,1895,West Bromwich Albion,Aston Villa,1-1,1,1,1,1,2,0,D
1895-10-19,1895,Aston Villa,Blackburn Rovers,3-1,3,1,1,1,4,2,H
1895-10-19,1895,Bolton Wanderers,Nottingham Forest,2-1,2,1,1,1,3,1,H
1895-10-19,1895,Derby County,Bury,2-1,2,1,1,1,3,1,H
1895-10-19,1895,Everton,West Bromwich Albion,1-1,1,1,1,1,2,0,D
1895-10-19,1895,Preston North End,Burnley,1-1,1,1,1,1,2,0,D
1895-10-19,1895,Sheffield Wednesday,Sunderland,3-0,3,0,1,1,3,3,H
1895-10-19,1895,Stoke City,Birmingham City,6-1,6,1,1,1,7,5,H
1895-10-19,1895,Wolverhampton Wanderers,Sheffield United,4-1,4,1,1,1,5,3,H
1895-10-26,1895,Birmingham City,Aston Villa,1-4,1,4,1,1,5,-3,A
1895-10-26,1895,Blackburn Rovers,Sunderland,2-4,2,4,1,1,6,-2,A
1895-10-26,1895,Bolton Wanderers,Stoke City,3-1,3,1,1,1,4,2,H
1895-10-26,1895,Burnley,Everton,1-1,1,1,1,1,2,0,D
1895-10-26,1895,Derby County,Wolverhampton Wanderers,5-2,5,2,1,1,7,3,H
1895-10-26,1895,Nottingham Forest,Preston North End,0-1,0,1,1,1,1,-1,A
1895-10-26,1895,West Bromwich Albion,Sheffield Wednesday,2-3,2,3,1,1,5,-1,A
1895-11-02,1895,Aston Villa,Burnley,5-1,5,1,1,1,6,4,H
1895-11-02,1895,Bury,West Bromwich Albion,3-0,3,0,1,1,3,3,H
1895-11-02,1895,Everton,Wolverhampton Wanderers,2-0,2,0,1,1,2,2,H
1895-11-02,1895,Preston North End,Blackburn Rovers,1-1,1,1,1,1,2,0,D
1895-11-02,1895,Sheffield Wednesday,Bolton Wanderers,1-1,1,1,1,1,2,0,D
1895-11-02,1895,Stoke City,Sheffield United,4-0,4,0,1,1,4,4,H
1895-11-02,1895,Sunderland,Derby County,2-2,2,2,1,1,4,0,D
1895-11-04,1895,West Bromwich Albion,Bolton Wanderers,2-3,2,3,1,1,5,-1,A
1895-11-09,1895,Birmingham City,Nottingham Forest,1-0,1,0,1,1,1,1,H
1895-11-09,1895,Blackburn Rovers,Wolverhampton Wanderers,3-1,3,1,1,1,4,2,H
1895-11-09,1895,Bury,Sheffield Wednesday,6-1,6,1,1,1,7,5,H
1895-11-09,1895,Derby County,Burnley,5-1,5,1,1,1,6,4,H
1895-11-09,1895,Preston North End,Bolton Wanderers,1-0,1,0,1,1,1,1,H
1895-11-09,1895,Sheffield United,Everton,1-2,1,2,1,1,3,-1,A
1895-11-09,1895,Sunderland,Aston Villa,2-1,2,1,1,1,3,1,H
1895-11-09,1895,West Bromwich Albion,Stoke City,1-0,1,0,1,1,1,1,H
1895-11-11,1895,Stoke City,Preston North End,4-0,4,0,1,1,4,4,H
1895-11-16,1895,Aston Villa,Sheffield United,2-2,2,2,1,1,4,0,D
1895-11-16,1895,Everton,Sunderland,1-0,1,0,1,1,1,1,H
1895-11-16,1895,Nottingham Forest,West Bromwich Albion,2-0,2,0,1,1,2,2,H
1895-11-16,1895,Sheffield Wednesday,Stoke City,2-1,2,1,1,1,3,1,H
1895-11-16,1895,Wolverhampton Wanderers,Derby County,2-0,2,0,1,1,2,2,H
1895-11-23,1895,Birmingham City,Preston North End,5-2,5,2,1,1,7,3,H
1895-11-23,1895,Blackburn Rovers,Sheffield Wednesday,2-1,2,1,1,1,3,1,H
1895-11-23,1895,Burnley,Aston Villa,3-4,3,4,1,1,7,-1,A
1895-11-23,1895,Bury,Derby County,1-2,1,2,1,1,3,-1,A
1895-11-23,1895,Sheffield United,Nottingham Forest,2-1,2,1,1,1,3,1,H
1895-11-23,1895,Stoke City,Wolverhampton Wanderers,4-1,4,1,1,1,5,3,H
1895-11-23,1895,Sunderland,Bolton Wanderers,1-0,1,0,1,1,1,1,H
1895-11-23,1895,West Bromwich Albion,Everton,0-3,0,3,1,1,3,-3,A
1895-11-28,1895,Nottingham Forest,Stoke City,4-0,4,0,1,1,4,4,H
1895-11-30,1895,Bolton Wanderers,Blackburn Rovers,1-1,1,1,1,1,2,0,D
1895-11-30,1895,Bury,Stoke City,0-1,0,1,1,1,1,-1,A
1895-11-30,1895,Derby County,Birmingham City,8-0,8,0,1,1,8,8,H
1895-11-30,1895,Everton,Burnley,2-1,2,1,1,1,3,1,H
1895-11-30,1895,Preston North End,Sheffield United,4-3,4,3,1,1,7,1,H
1895-11-30,1895,Sheffield Wednesday,Nottingham Forest,3-0,3,0,1,1,3,3,H
1895-11-30,1895,West Bromwich Albion,Wolverhampton Wanderers,2-1,2,1,1,1,3,1,H
1895-12-07,1895,Birmingham City,Everton,0-3,0,3,1,1,3,-3,A
1895-12-07,1895,Blackburn Rovers,Bolton Wanderers,3-2,3,2,1,1,5,1,H
1895-12-07,1895,Derby County,Nottingham Forest,4-0,4,0,1,1,4,4,H
1895-12-07,1895,Preston North End,Aston Villa,4-3,4,3,1,1,7,1,H
1895-12-07,1895,Stoke City,Burnley,2-1,2,1,1,1,3,1,H
1895-12-14,1895,Aston Villa,Bolton Wanderers,2-0,2,0,1,1,2,2,H
1895-12-14,1895,Bury,Preston North End,1-2,1,2,1,1,3,-1,A
1895-12-14,1895,Derby County,West Bromwich Albion,4-1,4,1,1,1,5,3,H
1895-12-14,1895,Everton,Stoke City,7-2,7,2,1,1,9,5,H
1895-12-14,1895,Nottingham Forest,Sheffield United,3-1,3,1,1,1,4,2,H
1895-12-14,1895,Sheffield Wednesday,Burnley,1-0,1,0,1,1,1,1,H
1895-12-14,1895,Sunderland,Birmingham City,2-1,2,1,1,1,3,1,H
1895-12-14,1895,Wolverhampton Wanderers,Blackburn Rovers,1-2,1,2,1,1,3,-1,A
1895-12-21,1895,Birmingham City,West Bromwich Albion,2-2,2,2,1,1,4,0,D
1895-12-21,1895,Bolton Wanderers,Sunderland,1-0,1,0,1,1,1,1,H
1895-12-21,1895,Burnley,Nottingham Forest,0-0,0,0,1,1,0,0,D
1895-12-21,1895,Everton,Aston Villa,2-0,2,0,1,1,2,2,H
1895-12-21,1895,Sheffield United,Derby County,1-1,1,1,1,1,2,0,D
1895-12-21,1895,Stoke City,Sheffield Wednesday,5-0,5,0,1,1,5,5,H
1895-12-21,1895,Wolverhampton Wanderers,Preston North End,2-1,2,1,1,1,3,1,H
1895-12-25,1895,Preston North End,Stoke City,0-1,0,1,1,1,1,-1,A
1895-12-26,1895,Birmingham City,Burnley,1-0,1,0,1,1,1,1,H
1895-12-26,1895,Derby County,Bolton Wanderers,2-1,2,1,1,1,3,1,H
1895-12-26,1895,Sheffield United,Sheffield Wednesday,1-1,1,1,1,1,2,0,D
1895-12-26,1895,Stoke City,Bury,0-2,0,2,1,1,2,-2,A
1895-12-26,1895,West Bromwich Albion,Sunderland,1-1,1,1,1,1,2,0,D
1895-12-26,1895,Wolverhampton Wanderers,Aston Villa,1-2,1,2,1,1,3,-1,A
1895-12-27,1895,Wolverhampton Wanderers,Sunderland,1-3,1,3,1,1,4,-2,A
1895-12-28,1895,Aston Villa,Bury,2-0,2,0,1,1,2,2,H
1895-12-28,1895,Nottingham Forest,Blackburn Rovers,4-2,4,2,1,1,6,2,H
1895-12-28,1895,Sheffield Wednesday,Derby County,0-4,0,4,1,1,4,-4,A
1895-12-30,1895,Sheffield United,Bolton Wanderers,1-0,1,0,1,1,1,1,H
1896-01-01,1895,Blackburn Rovers,Everton,2-3,2,3,1,1,5,-1,A
1896-01-01,1895,Bolton Wanderers,Derby County,2-1,2,1,1,1,3,1,H
1896-01-01,1895,Bury,Burnley,3-4,3,4,1,1,7,-1,A
1896-01-01,1895,Sheffield Wednesday,Preston North End,1-1,1,1,1,1,2,0,D
1896-01-04,1895,Birmingham City,Derby County,1-3,1,3,1,1,4,-2,A
1896-01-04,1895,Blackburn Rovers,Bury,0-2,0,2,1,1,2,-2,A
1896-01-04,1895,Bolton Wanderers,Wolverhampton Wanderers,4-0,4,0,1,1,4,4,H
1896-01-04,1895,Burnley,Sheffield Wednesday,2-0,2,0,1,1,2,2,H
1896-01-04,1895,Preston North End,Sunderland,4-1,4,1,1,1,5,3,H
1896-01-04,1895,Sheffield United,West Bromwich Albion,2-0,2,0,1,1,2,2,H
1896-01-04,1895,Stoke City,Aston Villa,1-2,1,2,1,1,3,-1,A
1896-01-11,1895,Aston Villa,Preston North End,1-0,1,0,1,1,1,1,H
1896-01-11,1895,Burnley,West Bromwich Albion,3-0,3,0,1,1,3,3,H
1896-01-11,1895,Bury,Everton,1-1,1,1,1,1,2,0,D
1896-01-11,1895,Nottingham Forest,Bolton Wanderers,0-0,0,0,1,1,0,0,D
1896-01-11,1895,Sheffield Wednesday,Blackburn Rovers,3-0,3,0,1,1,3,3,H
1896-01-11,1895,Sunderland,Sheffield United,1-1,1,1,1,1,2,0,D
1896-01-18,1895,Birmingham City,Wolverhampton Wanderers,3-2,3,2,1,1,5,1,H
1896-01-18,1895,Nottingham Forest,Sunderland,3-1,3,1,1,1,4,2,H
1896-01-18,1895,Sheffield Wednesday,Aston Villa,1-3,1,3,1,1,4,-2,A
1896-01-18,1895,West Bromwich Albion,Derby County,0-0,0,0,1,1,0,0,D
1896-01-25,1895,Aston Villa,Nottingham Forest,3-1,3,1,1,1,4,2,H
1896-01-25,1895,Blackburn Rovers,Sheffield United,1-0,1,0,1,1,1,1,H
1896-01-25,1895,Preston North End,Everton,1-1,1,1,1,1,2,0,D
1896-01-25,1895,Sunderland,West Bromwich Albion,7-1,7,1,1,1,8,6,H
1896-01-25,1895,Wolverhampton Wanderers,Birmingham City,7-2,7,2,1,1,9,5,H
1896-02-03,1895,Burnley,Sheffield United,5-0,5,0,1,1,5,5,H
1896-02-03,1895,Everton,Birmingham City,3-0,3,0,1,1,3,3,H
1896-02-08,1895,Birmingham City,Sheffield Wednesday,1-1,1,1,1,1,2,0,D
1896-02-08,1895,Derby County,Aston Villa,2-2,2,2,1,1,4,0,D
1896-02-08,1895,Sheffield United,Wolverhampton Wanderers,2-1,2,1,1,1,3,1,H
1896-02-08,1895,Sunderland,Nottingham Forest,1-1,1,1,1,1,2,0,D
1896-02-17,1895,Blackburn Rovers,West Bromwich Albion,1-0,1,0,1,1,1,1,H
1896-02-18,1895,Bury,Wolverhampton Wanderers,3-0,3,0,1,1,3,3,H
1896-02-18,1895,Sheffield Wednesday,Everton,3-1,3,1,1,1,4,2,H
1896-02-18,1895,Sunderland,Burnley,3-1,3,1,1,1,4,2,H
1896-02-22,1895,Aston Villa,Stoke City,5-2,5,2,1,1,7,3,H
1896-02-22,1895,Blackburn Rovers,Derby County,0-2,0,2,1,1,2,-2,A
1896-02-22,1895,Bolton Wanderers,Birmingham City,4-1,4,1,1,1,5,3,H
1896-02-22,1895,Burnley,Wolverhampton Wanderers,3-1,3,1,1,1,4,2,H
1896-02-22,1895,Preston North End,Nottingham Forest,6-0,6,0,1,1,6,6,H
1896-02-22,1895,Sheffield Wednesday,Bury,1-3,1,3,1,1,4,-2,A
1896-02-22,1895,Sunderland,Everton,3-0,3,0,1,1,3,3,H
1896-02-22,1895,West Bromwich Albion,Sheffield United,1-0,1,0,1,1,1,1,H
1896-02-29,1895,Birmingham City,Blackburn Rovers,2-1,2,1,1,1,3,1,H
1896-03-04,1895,Derby County,Preston North End,1-0,1,0,1,1,1,1,H
1896-03-07,1895,Birmingham City,Bury,1-0,1,0,1,1,1,1,H
1896-03-07,1895,Bolton Wanderers,Aston Villa,2-2,2,2,1,1,4,0,D
1896-03-07,1895,Everton,Preston North End,3-2,3,2,1,1,5,1,H
1896-03-07,1895,Nottingham Forest,Burnley,2-1,2,1,1,1,3,1,H
1896-03-07,1895,Sheffield United,Blackburn Rovers,1-1,1,1,1,1,2,0,D
1896-03-07,1895,Sunderland,Sheffield Wednesday,2-1,2,1,1,1,3,1,H
1896-03-07,1895,Wolverhampton Wanderers,West Bromwich Albion,1-2,1,2,1,1,3,-1,A
1896-03-09,1895,West Bromwich Albion,Bury,1-3,1,3,1,1,4,-2,A
1896-03-14,1895,Aston Villa,Sheffield Wednesday,2-1,2,1,1,1,3,1,H
1896-03-14,1895,Bolton Wanderers,Preston North End,1-0,1,0,1,1,1,1,H
1896-03-14,1895,Derby County,Sheffield United,0-2,0,2,1,1,2,-2,A
1896-03-14,1895,Stoke City,Sunderland,5-0,5,0,1,1,5,5,H
1896-03-16,1895,Burnley,Stoke City,2-0,2,0,1,1,2,2,H
1896-03-21,1895,Blackburn Rovers,Birmingham City,2-1,2,1,1,1,3,1,H
1896-03-21,1895,Bury,Aston Villa,5-3,5,3,1,1,8,2,H
1896-03-21,1895,Stoke City,Nottingham Forest,1-0,1,0,1,1,1,1,H
1896-03-24,1895,Bury,Nottingham Forest,1-0,1,0,1,1,1,1,H
1896-03-28,1895,Preston North End,Derby County,1-0,1,0,1,1,1,1,H
1896-03-28,1895,Sunderland,Stoke City,4-1,4,1,1,1,5,3,H
1896-03-28,1895,Wolverhampton Wanderers,Nottingham Forest,6-1,6,1,1,1,7,5,H
1896-03-30,1895,Sheffield United,Burnley,1-1,1,1,1,1,2,0,D
1896-04-03,1895,Blackburn Rovers,Stoke City,3-1,3,1,1,1,4,2,H
1896-04-03,1895,Bolton Wanderers,Sheffield United,4-1,4,1,1,1,5,3,H
1896-04-03,1895,Burnley,Birmingham City,1-1,1,1,1,1,2,0,D
1896-04-03,1895,Bury,Sunderland,1-2,1,2,1,1,3,-1,A
1896-04-03,1895,Everton,Derby County,2-2,2,2,1,1,4,0,D
1896-04-03,1895,Nottingham Forest,Aston Villa,0-2,0,2,1,1,2,-2,A
1896-04-03,1895,Preston North End,West Bromwich Albion,0-0,0,0,1,1,0,0,D
1896-04-04,1895,Bolton Wanderers,West Bromwich Albion,2-1,2,1,1,1,3,1,H
1896-04-04,1895,Burnley,Derby County,2-2,2,2,1,1,4,0,D
1896-04-04,1895,Nottingham Forest,Wolverhampton Wanderers,3-2,3,2,1,1,5,1,H
1896-04-04,1895,Preston North End,Bury,1-1,1,1,1,1,2,0,D
1896-04-04,1895,Sheffield Wednesday,Birmingham City,3-0,3,0,1,1,3,3,H
1896-04-04,1895,Stoke City,Blackburn Rovers,3-0,3,0,1,1,3,3,H
1896-04-06,1895,Aston Villa,Wolverhampton Wanderers,4-1,4,1,1,1,5,3,H
1896-04-06,1895,Everton,Bolton Wanderers,1-1,1,1,1,1,2,0,D
1896-04-06,1895,Preston North End,Sheffield Wednesday,0-1,0,1,1,1,1,-1,A
1896-04-06,1895,Sheffield United,Bury,8-0,8,0,1,1,8,8,H
1896-04-06,1895,West Bromwich Albion,Birmingham City,0-0,0,0,1,1,0,0,D
1896-04-07,1895,Birmingham City,Sheffield United,2-1,2,1,1,1,3,1,H
1896-04-07,1895,Derby County,Everton,2-1,2,1,1,1,3,1,H
1896-04-07,1895,Nottingham Forest,Sheffield Wednesday,1-0,1,0,1,1,1,1,H
1896-04-07,1895,Wolverhampton Wanderers,Bury,1-0,1,0,1,1,1,1,H
1896-04-11,1895,Birmingham City,Sunderland,0-1,0,1,1,1,1,-1,A
1896-04-11,1895,Derby County,Blackburn Rovers,0-0,0,0,1,1,0,0,D
1896-04-11,1895,Stoke City,Everton,1-2,1,2,1,1,3,-1,A
1896-04-11,1895,Wolverhampton Wanderers,Bolton Wanderers,5-0,5,0,1,1,5,5,H
1896-04-18,1895,Burnley,Blackburn Rovers,6-0,6,0,1,1,6,6,H
1896-04-25,1895,Bolton Wanderers,Sheffield Wednesday,2-0,2,0,1,1,2,2,H
1896-04-25,1895,Bury,Blackburn Rovers,2-0,2,0,1,1,2,2,H
1896-04-29,1895,West Bromwich Albion,Blackburn Rovers,3-2,3,2,1,1,5,1,H
1896-09-01,1896,Blackburn Rovers,West Bromwich Albion,1-2,1,2,1,1,3,-1,A
1896-09-01,1896,Sheffield Wednesday,Liverpool,1-2,1,2,1,1,3,-1,A
1896-09-01,1896,Sunderland,Bury,0-1,0,1,1,1,1,-1,A
1896-09-01,1896,Wolverhampton Wanderers,Derby County,1-0,1,0,1,1,1,1,H
1896-09-02,1896,Aston Villa,Stoke City,2-1,2,1,1,1,3,1,H
1896-09-05,1896,Blackburn Rovers,Liverpool,1-0,1,0,1,1,1,1,H
1896-09-05,1896,Bury,Preston North End,0-0,0,0,1,1,0,0,D
1896-09-05,1896,Derby County,Nottingham Forest,1-1,1,1,1,1,2,0,D
1896-09-05,1896,Everton,Sheffield Wednesday,2-1,2,1,1,1,3,1,H
1896-09-05,1896,Sheffield United,Burnley,1-0,1,0,1,1,1,1,H
1896-09-05,1896,Stoke City,Wolverhampton Wanderers,2-1,2,1,1,1,3,1,H
1896-09-05,1896,Sunderland,Bolton Wanderers,1-1,1,1,1,1,2,0,D
1896-09-05,1896,West Bromwich Albion,Aston Villa,3-1,3,1,1,1,4,2,H
1896-09-07,1896,Burnley,Sunderland,1-1,1,1,1,1,2,0,D
1896-09-07,1896,Liverpool,Bolton Wanderers,0-2,0,2,1,1,2,-2,A
1896-09-12,1896,Aston Villa,Sheffield United,2-2,2,2,1,1,4,0,D
1896-09-12,1896,Bolton Wanderers,Blackburn Rovers,0-0,0,0,1,1,0,0,D
1896-09-12,1896,Burnley,Bury,1-0,1,0,1,1,1,1,H
1896-09-12,1896,Liverpool,Derby County,2-0,2,0,1,1,2,2,H
1896-09-12,1896,Nottingham Forest,Stoke City,4-0,4,0,1,1,4,4,H
1896-09-12,1896,Preston North End,Sunderland,5-3,5,3,1,1,8,2,H
1896-09-12,1896,Sheffield Wednesday,West Bromwich Albion,3-1,3,1,1,1,4,2,H
1896-09-12,1896,Wolverhampton Wanderers,Everton,0-1,0,1,1,1,1,-1,A
1896-09-19,1896,Blackburn Rovers,Sheffield Wednesday,4-0,4,0,1,1,4,4,H
1896-09-19,1896,Burnley,Nottingham Forest,2-2,2,2,1,1,4,0,D
1896-09-19,1896,Bury,Liverpool,1-2,1,2,1,1,3,-1,A
1896-09-19,1896,Derby County,Wolverhampton Wanderers,4-3,4,3,1,1,7,1,H
1896-09-19,1896,Everton,Aston Villa,2-3,2,3,1,1,5,-1,A
1896-09-19,1896,Sheffield United,Sunderland,3-0,3,0,1,1,3,3,H
1896-09-19,1896,Stoke City,Bolton Wanderers,2-3,2,3,1,1,5,-1,A
1896-09-19,1896,West Bromwich Albion,Preston North End,1-1,1,1,1,1,2,0,D
1896-09-26,1896,Aston Villa,Everton,1-2,1,2,1,1,3,-1,A
1896-09-26,1896,Bolton Wanderers,Sunderland,1-0,1,0,1,1,1,1,H
1896-09-26,1896,Derby County,Bury,7-2,7,2,1,1,9,5,H
1896-09-26,1896,Liverpool,West Bromwich Albion,0-0,0,0,1,1,0,0,D
1896-09-26,1896,Nottingham Forest,Sheffield United,2-2,2,2,1,1,4,0,D
1896-09-26,1896,Preston North End,Burnley,5-3,5,3,1,1,8,2,H
1896-09-26,1896,Sheffield Wednesday,Stoke City,4-3,4,3,1,1,7,1,H
1896-09-26,1896,Wolverhampton Wanderers,Blackburn Rovers,1-1,1,1,1,1,2,0,D
1896-10-03,1896,Blackburn Rovers,Burnley,3-2,3,2,1,1,5,1,H
1896-10-03,1896,Bolton Wanderers,Preston North End,3-1,3,1,1,1,4,2,H
1896-10-03,1896,Everton,Liverpool,2-1,2,1,1,1,3,1,H
1896-10-03,1896,Sheffield United,Aston Villa,0-0,0,0,1,1,0,0,D
1896-10-03,1896,Sunderland,Wolverhampton Wanderers,0-3,0,3,1,1,3,-3,A
1896-10-03,1896,West Bromwich Albion,Sheffield Wednesday,0-2,0,2,1,1,2,-2,A
1896-10-10,1896,Aston Villa,West Bromwich Albion,2-0,2,0,1,1,2,2,H
1896-10-10,1896,Bolton Wanderers,Bury,2-0,2,0,1,1,2,2,H
1896-10-10,1896,Burnley,Everton,2-1,2,1,1,1,3,1,H
1896-10-10,1896,Derby County,Sheffield United,1-3,1,3,1,1,4,-2,A
1896-10-10,1896,Liverpool,Nottingham Forest,3-0,3,0,1,1,3,3,H
1896-10-10,1896,Preston North End,Blackburn Rovers,3-1,3,1,1,1,4,2,H
1896-10-10,1896,Sheffield Wednesday,Sunderland,0-0,0,0,1,1,0,0,D
1896-10-10,1896,Wolverhampton Wanderers,Stoke City,1-2,1,2,1,1,3,-1,A
1896-10-17,1896,Blackburn Rovers,Bolton Wanderers,1-0,1,0,1,1,1,1,H
1896-10-17,1896,Burnley,Preston North End,2-2,2,2,1,1,4,0,D
1896-10-17,1896,Bury,Sheffield Wednesday,1-1,1,1,1,1,2,0,D
1896-10-17,1896,Derby County,Aston Villa,1-3,1,3,1,1,4,-2,A
1896-10-17,1896,Everton,Sheffield United,1-2,1,2,1,1,3,-1,A
1896-10-17,1896,Stoke City,Nottingham Forest,3-0,3,0,1,1,3,3,H
1896-10-17,1896,Sunderland,Liverpool,4-3,4,3,1,1,7,1,H
1896-10-17,1896,West Bromwich Albion,Wolverhampton Wanderers,1-0,1,0,1,1,1,1,H
1896-10-19,1896,Sheffield United,Liverpool,1-1,1,1,1,1,2,0,D
1896-10-24,1896,Aston Villa,Derby County,2-1,2,1,1,1,3,1,H
1896-10-24,1896,Bolton Wanderers,Stoke City,4-0,4,0,1,1,4,4,H
1896-10-24,1896,Liverpool,Blackburn Rovers,4-0,4,0,1,1,4,4,H
1896-10-24,1896,Nottingham Forest,Burnley,4-1,4,1,1,1,5,3,H
1896-10-24,1896,Preston North End,Sheffield United,1-0,1,0,1,1,1,1,H
1896-10-24,1896,Sheffield Wednesday,Everton,4-1,4,1,1,1,5,3,H
1896-10-24,1896,West Bromwich Albion,Bury,0-0,0,0,1,1,0,0,D
1896-10-24,1896,Wolverhampton Wanderers,Sunderland,0-1,0,1,1,1,1,-1,A
1896-10-31,1896,Blackburn Rovers,Preston North End,0-4,0,4,1,1,4,-4,A
1896-10-31,1896,Bury,Bolton Wanderers,2-2,2,2,1,1,4,0,D
1896-10-31,1896,Everton,Wolverhampton Wanderers,0-0,0,0,1,1,0,0,D
1896-10-31,1896,Nottingham Forest,Sheffield Wednesday,2-2,2,2,1,1,4,0,D
1896-10-31,1896,Sheffield United,Derby County,2-2,2,2,1,1,4,0,D
1896-10-31,1896,Stoke City,Aston Villa,0-2,0,2,1,1,2,-2,A
1896-10-31,1896,West Bromwich Albion,Liverpool,0-1,0,1,1,1,1,-1,A
1896-11-02,1896,West Bromwich Albion,Bolton Wanderers,1-0,1,0,1,1,1,1,H
1896-11-07,1896,Aston Villa,Bury,1-1,1,1,1,1,2,0,D
1896-11-07,1896,Burnley,Blackburn Rovers,0-1,0,1,1,1,1,-1,A
1896-11-07,1896,Derby County,Stoke City,5-1,5,1,1,1,6,4,H
1896-11-07,1896,Liverpool,Sunderland,3-0,3,0,1,1,3,3,H
1896-11-07,1896,Preston North End,Nottingham Forest,3-2,3,2,1,1,5,1,H
1896-11-09,1896,Stoke City,Preston North End,2-1,2,1,1,1,3,1,H
1896-11-14,1896,Blackburn Rovers,Nottingham Forest,0-0,0,0,1,1,0,0,D
1896-11-14,1896,Bury,Stoke City,4-2,4,2,1,1,6,2,H
1896-11-14,1896,Derby County,Burnley,3-2,3,2,1,1,5,1,H
1896-11-14,1896,Everton,Bolton Wanderers,2-3,2,3,1,1,5,-1,A
1896-11-14,1896,Preston North End,Liverpool,1-1,1,1,1,1,2,0,D
1896-11-14,1896,Sheffield Wednesday,Aston Villa,1-3,1,3,1,1,4,-2,A
1896-11-14,1896,West Bromwich Albion,Sheffield United,0-1,0,1,1,1,1,-1,A
1896-11-18,1896,Nottingham Forest,Derby County,1-2,1,2,1,1,3,-1,A
1896-11-21,1896,Aston Villa,Sheffield Wednesday,4-0,4,0,1,1,4,4,H
1896-11-21,1896,Derby County,Blackburn Rovers,6-0,6,0,1,1,6,6,H
1896-11-21,1896,Liverpool,Everton,0-0,0,0,1,1,0,0,D
1896-11-21,1896,Nottingham Forest,Sunderland,2-1,2,1,1,1,3,1,H
1896-11-21,1896,Preston North End,Bolton Wanderers,2-3,2,3,1,1,5,-1,A
1896-11-21,1896,Sheffield United,Bury,2-2,2,2,1,1,4,0,D
1896-11-21,1896,Stoke City,West Bromwich Albion,2-2,2,2,1,1,4,0,D
1896-11-21,1896,Wolverhampton Wanderers,Burnley,2-0,2,0,1,1,2,2,H
1896-11-28,1896,Blackburn Rovers,Aston Villa,1-5,1,5,1,1,6,-4,A
1896-11-28,1896,Bury,Wolverhampton Wanderers,3-2,3,2,1,1,5,1,H
1896-11-28,1896,Everton,Burnley,6-0,6,0,1,1,6,6,H
1896-11-28,1896,Nottingham Forest,Liverpool,2-0,2,0,1,1,2,2,H
1896-11-28,1896,Preston North End,Stoke City,3-0,3,0,1,1,3,3,H
1896-11-28,1896,Sheffield Wednesday,Derby County,2-0,2,0,1,1,2,2,H
1896-11-28,1896,West Bromwich Albion,Sunderland,1-0,1,0,1,1,1,1,H
1896-12-05,1896,Sheffield United,West Bromwich Albion,0-1,0,1,1,1,1,-1,A
1896-12-05,1896,Stoke City,Derby County,2-2,2,2,1,1,4,0,D
1896-12-05,1896,Sunderland,Sheffield Wednesday,0-0,0,0,1,1,0,0,D
1896-12-05,1896,Wolverhampton Wanderers,Nottingham Forest,4-1,4,1,1,1,5,3,H
1896-12-07,1896,Bolton Wanderers,Everton,2-0,2,0,1,1,2,2,H
1896-12-12,1896,Liverpool,Bury,3-1,3,1,1,1,4,2,H
1896-12-12,1896,Nottingham Forest,Blackburn Rovers,2-1,2,1,1,1,3,1,H
1896-12-12,1896,Sheffield Wednesday,Wolverhampton Wanderers,0-0,0,0,1,1,0,0,D
1896-12-12,1896,Sunderland,Everton,1-1,1,1,1,1,2,0,D
1896-12-12,1896,West Bromwich Albion,Stoke City,1-2,1,2,1,1,3,-1,A
1896-12-19,1896,Aston Villa,Nottingham Forest,3-2,3,2,1,1,5,1,H
1896-12-19,1896,Bolton Wanderers,West Bromwich Albion,2-2,2,2,1,1,4,0,D
1896-12-19,1896,Burnley,Sheffield Wednesday,1-1,1,1,1,1,2,0,D
1896-12-19,1896,Derby County,Liverpool,3-2,3,2,1,1,5,1,H
1896-12-19,1896,Everton,Stoke City,4-2,4,2,1,1,6,2,H
1896-12-19,1896,Sunderland,Blackburn Rovers,0-1,0,1,1,1,1,-1,A
1896-12-19,1896,Wolverhampton Wanderers,Preston North End,1-1,1,1,1,1,2,0,D
1896-12-25,1896,Blackburn Rovers,Sunderland,1-2,1,2,1,1,3,-1,A
1896-12-25,1896,Bury,Nottingham Forest,2-0,2,0,1,1,2,2,H
1896-12-25,1896,Derby County,West Bromwich Albion,8-1,8,1,1,1,9,7,H
1896-12-25,1896,Liverpool,Aston Villa,3-3,3,3,1,1,6,0,D
1896-12-26,1896,Burnley,Liverpool,4-1,4,1,1,1,5,3,H
1896-12-26,1896,Derby County,Bolton Wanderers,1-0,1,0,1,1,1,1,H
1896-12-26,1896,Everton,Sunderland,5-2,5,2,1,1,7,3,H
1896-12-26,1896,Preston North End,Bury,2-2,2,2,1,1,4,0,D
1896-12-26,1896,Sheffield United,Sheffield Wednesday,2-0,2,0,1,1,2,2,H
1896-12-26,1896,West Bromwich Albion,Blackburn Rovers,1-0,1,0,1,1,1,1,H
1896-12-26,1896,Wolverhampton Wanderers,Aston Villa,1-2,1,2,1,1,3,-1,A
1896-12-28,1896,Nottingham Forest,Bury,3-0,3,0,1,1,3,3,H
1896-12-28,1896,Sheffield Wednesday,Blackburn Rovers,6-0,6,0,1,1,6,6,H
1896-12-28,1896,Wolverhampton Wanderers,West Bromwich Albion,6-1,6,1,1,1,7,5,H
1896-12-29,1896,Sheffield United,Bolton Wanderers,1-0,1,0,1,1,1,1,H
1897-01-01,1896,Bolton Wanderers,Liverpool,1-4,1,4,1,1,5,-3,A
1897-01-01,1896,Bury,Burnley,1-1,1,1,1,1,2,0,D
1897-01-01,1896,Sheffield United,Everton,1-2,1,2,1,1,3,-1,A
1897-01-01,1896,Sunderland,Preston North End,1-1,1,1,1,1,2,0,D
1897-01-02,1896,Aston Villa,Burnley,0-3,0,3,1,1,3,-3,A
1897-01-02,1896,Blackburn Rovers,Wolverhampton Wanderers,2-0,2,0,1,1,2,2,H
1897-01-02,1896,Liverpool,Sheffield United,0-0,0,0,1,1,0,0,D
1897-01-02,1896,Nottingham Forest,West Bromwich Albion,0-1,0,1,1,1,1,-1,A
1897-01-02,1896,Sheffield Wednesday,Preston North End,1-0,1,0,1,1,1,1,H
1897-01-02,1896,Stoke City,Everton,2-3,2,3,1,1,5,-1,A
1897-01-02,1896,Sunderland,Derby County,1-2,1,2,1,1,3,-1,A
1897-01-09,1896,Burnley,Stoke City,1-3,1,3,1,1,4,-2,A
1897-01-09,1896,Derby County,Sheffield Wednesday,2-1,2,1,1,1,3,1,H
1897-01-09,1896,Everton,Nottingham Forest,3-1,3,1,1,1,4,2,H
1897-01-09,1896,Sheffield United,Blackburn Rovers,7-0,7,0,1,1,7,7,H
1897-01-09,1896,Sunderland,Aston Villa,4-2,4,2,1,1,6,2,H
1897-01-09,1896,Wolverhampton Wanderers,Liverpool,1-2,1,2,1,1,3,-1,A
1897-01-16,1896,Aston Villa,Sunderland,2-1,2,1,1,1,3,1,H
1897-01-16,1896,Blackburn Rovers,Derby County,5-2,5,2,1,1,7,3,H
1897-01-16,1896,Burnley,Sheffield United,1-1,1,1,1,1,2,0,D
1897-01-16,1896,Liverpool,Stoke City,1-0,1,0,1,1,1,1,H
1897-01-16,1896,Nottingham Forest,Bolton Wanderers,2-0,2,0,1,1,2,2,H
1897-01-16,1896,Preston North End,Wolverhampton Wanderers,4-0,4,0,1,1,4,4,H
1897-01-16,1896,West Bromwich Albion,Everton,1-4,1,4,1,1,5,-3,A
1897-01-23,1896,Derby County,Sunderland,1-0,1,0,1,1,1,1,H
1897-01-23,1896,Sheffield United,Wolverhampton Wanderers,1-3,1,3,1,1,4,-2,A
1897-01-23,1896,Stoke City,Sheffield Wednesday,0-0,0,0,1,1,0,0,D
1897-01-23,1896,West Bromwich Albion,Nottingham Forest,4-0,4,0,1,1,4,4,H
1897-02-06,1896,Blackburn Rovers,Sheffield United,1-3,1,3,1,1,4,-2,A
1897-02-06,1896,Burnley,Bolton Wanderers,0-2,0,2,1,1,2,-2,A
1897-02-06,1896,Bury,Aston Villa,0-2,0,2,1,1,2,-2,A
1897-02-06,1896,Everton,Preston North End,3-4,3,4,1,1,7,-1,A
1897-02-06,1896,Stoke City,Liverpool,6-1,6,1,1,1,7,5,H
1897-02-06,1896,West Bromwich Albion,Derby County,1-4,1,4,1,1,5,-3,A
1897-02-08,1896,Burnley,Aston Villa,3-4,3,4,1,1,7,-1,A
1897-02-20,1896,Blackburn Rovers,Bury,1-2,1,2,1,1,3,-1,A
1897-02-20,1896,Preston North End,Sheffield Wednesday,2-2,2,2,1,1,4,0,D
1897-02-20,1896,Sheffield United,Nottingham Forest,0-3,0,3,1,1,3,-3,A
1897-02-20,1896,Sunderland,Stoke City,4-1,4,1,1,1,5,3,H
1897-02-22,1896,Aston Villa,Preston North End,3-1,3,1,1,1,4,2,H
1897-02-27,1896,Sheffield Wednesday,Bolton Wanderers,0-0,0,0,1,1,0,0,D
1897-02-27,1896,Stoke City,Burnley,3-2,3,2,1,1,5,1,H
1897-02-27,1896,Sunderland,Sheffield United,0-1,0,1,1,1,1,-1,A
1897-02-27,1896,Wolverhampton Wanderers,Bury,1-1,1,1,1,1,2,0,D
1897-03-02,1896,Bury,Everton,3-1,3,1,1,1,4,2,H
1897-03-02,1896,Sheffield Wednesday,Sheffield United,1-1,1,1,1,1,2,0,D
1897-03-02,1896,Sunderland,Burnley,1-1,1,1,1,1,2,0,D
1897-03-04,1896,Liverpool,Wolverhampton Wanderers,3-0,3,0,1,1,3,3,H
1897-03-06,1896,Blackburn Rovers,Everton,4-2,4,2,1,1,6,2,H
1897-03-06,1896,Bolton Wanderers,Derby County,1-3,1,3,1,1,4,-2,A
1897-03-06,1896,Nottingham Forest,Aston Villa,2-4,2,4,1,1,6,-2,A
1897-03-06,1896,Sheffield Wednesday,Burnley,1-0,1,0,1,1,1,1,H
1897-03-06,1896,Sunderland,West Bromwich Albion,2-1,2,1,1,1,3,1,H
1897-03-06,1896,Wolverhampton Wanderers,Sheffield United,1-1,1,1,1,1,2,0,D
1897-03-10,1896,Nottingham Forest,Everton,3-0,3,0,1,1,3,3,H
1897-03-13,1896,Aston Villa,Liverpool,0-0,0,0,1,1,0,0,D
1897-03-13,1896,Bolton Wanderers,Burnley,2-1,2,1,1,1,3,1,H
1897-03-13,1896,Bury,West Bromwich Albion,3-0,3,0,1,1,3,3,H
1897-03-13,1896,Everton,Blackburn Rovers,0-3,0,3,1,1,3,-3,A
1897-03-13,1896,Sheffield United,Preston North End,0-2,0,2,1,1,2,-2,A
1897-03-13,1896,Sunderland,Nottingham Forest,2-2,2,2,1,1,4,0,D
1897-03-13,1896,Wolverhampton Wanderers,Sheffield Wednesday,2-0,2,0,1,1,2,2,H
1897-03-20,1896,Blackburn Rovers,Stoke City,2-1,2,1,1,1,3,1,H
1897-03-20,1896,Bolton Wanderers,Nottingham Forest,0-0,0,0,1,1,0,0,D
1897-03-20,1896,Burnley,Wolverhampton Wanderers,0-3,0,3,1,1,3,-3,A
1897-03-20,1896,Bury,Sheffield United,0-1,0,1,1,1,1,-1,A
1897-03-22,1896,Aston Villa,Bolton Wanderers,6-2,6,2,1,1,8,4,H
1897-03-27,1896,Bolton Wanderers,Aston Villa,1-2,1,2,1,1,3,-1,A
1897-03-27,1896,Bury,Blackburn Rovers,3-0,3,0,1,1,3,3,H
1897-03-27,1896,Derby County,Preston North End,2-2,2,2,1,1,4,0,D
1897-03-27,1896,Liverpool,Burnley,1-2,1,2,1,1,3,-1,A
1897-03-27,1896,Sheffield United,Stoke City,1-0,1,0,1,1,1,1,H
1897-04-03,1896,Liverpool,Sheffield Wednesday,2-2,2,2,1,1,4,0,D
1897-04-03,1896,Preston North End,Everton,4-1,4,1,1,1,5,3,H
1897-04-03,1896,Stoke City,Sunderland,0-1,0,1,1,1,1,-1,A
1897-04-03,1896,West Bromwich Albion,Burnley,3-0,3,0,1,1,3,3,H
1897-04-05,1896,Bolton Wanderers,Wolverhampton Wanderers,1-2,1,2,1,1,3,-1,A
1897-04-05,1896,Burnley,Derby County,2-3,2,3,1,1,5,-1,A
1897-04-05,1896,Sheffield Wednesday,Nottingham Forest,3-0,3,0,1,1,3,3,H
1897-04-08,1896,Nottingham Forest,Preston North End,0-0,0,0,1,1,0,0,D
1897-04-10,1896,Bolton Wanderers,Sheffield Wednesday,2-1,2,1,1,1,3,1,H
1897-04-10,1896,Burnley,West Bromwich Albion,5-0,5,0,1,1,5,5,H
1897-04-10,1896,Bury,Derby County,1-0,1,0,1,1,1,1,H
1897-04-10,1896,Liverpool,Preston North End,0-0,0,0,1,1,0,0,D
1897-04-10,1896,Nottingham Forest,Wolverhampton Wanderers,1-2,1,2,1,1,3,-1,A
1897-04-10,1896,Stoke City,Blackburn Rovers,1-0,1,0,1,1,1,1,H
1897-04-12,1896,Stoke City,Bury,3-0,3,0,1,1,3,3,H
1897-04-15,1896,Stoke City,Sheffield United,2-0,2,0,1,1,2,2,H
1897-04-16,1896,Bolton Wanderers,Sheffield United,0-2,0,2,1,1,2,-2,A
1897-04-16,1896,Bury,Sunderland,1-1,1,1,1,1,2,0,D
1897-04-16,1896,Everton,Derby County,5-2,5,2,1,1,7,3,H
1897-04-16,1896,Preston North End,West Bromwich Albion,0-0,0,0,1,1,0,0,D
1897-04-17,1896,Aston Villa,Blackburn Rovers,3-0,3,0,1,1,3,3,H
1897-04-17,1896,Everton,West Bromwich Albion,6-3,6,3,1,1,9,3,H
1897-04-17,1896,Sheffield Wednesday,Bury,2-0,2,0,1,1,2,2,H
1897-04-19,1896,Aston Villa,Wolverhampton Wanderers,5-0,5,0,1,1,5,5,H
1897-04-19,1896,Preston North End,Derby County,0-2,0,2,1,1,2,-2,A
1897-04-20,1896,Derby County,Everton,0-1,0,1,1,1,1,-1,A
1897-04-20,1896,Wolverhampton Wanderers,Bolton Wanderers,4-0,4,0,1,1,4,4,H
1897-04-24,1896,Everton,Bury,1-2,1,2,1,1,3,-1,A
1897-04-26,1896,Preston North End,Aston Villa,0-1,0,1,1,1,1,-1,A
1897-09-01,1897,Aston Villa,Sheffield Wednesday,5-2,5,2,1,1,7,3,H
1897-09-01,1897,Sheffield United,Derby County,2-1,2,1,1,1,3,1,H
1897-09-01,1897,Wolverhampton Wanderers,Preston North End,3-0,3,0,1,1,3,3,H
1897-09-02,1897,Stoke City,Notts County,2-0,2,0,1,1,2,2,H
1897-09-04,1897,Aston Villa,West Bromwich Albion,4-3,4,3,1,1,7,1,H
1897-09-04,1897,Derby County,Blackburn Rovers,3-1,3,1,1,1,4,2,H
1897-09-04,1897,Everton,Bolton Wanderers,2-1,2,1,1,1,3,1,H
1897-09-04,1897,Nottingham Forest,Notts County,1-1,1,1,1,1,2,0,D
1897-09-04,1897,Preston North End,Sheffield United,1-3,1,3,1,1,4,-2,A
1897-09-04,1897,Sheffield Wednesday,Sunderland,0-1,0,1,1,1,1,-1,A
1897-09-04,1897,Stoke City,Liverpool,2-2,2,2,1,1,4,0,D
1897-09-04,1897,Wolverhampton Wanderers,Bury,3-0,3,0,1,1,3,3,H
1897-09-11,1897,Blackburn Rovers,Bolton Wanderers,1-3,1,3,1,1,4,-2,A
1897-09-11,1897,Bury,Sheffield Wednesday,3-0,3,0,1,1,3,3,H
1897-09-11,1897,Derby County,Everton,5-1,5,1,1,1,6,4,H
1897-09-11,1897,Liverpool,Preston North End,0-0,0,0,1,1,0,0,D
1897-09-11,1897,Notts County,Aston Villa,2-3,2,3,1,1,5,-1,A
1897-09-11,1897,Sheffield United,Stoke City,4-3,4,3,1,1,7,1,H
1897-09-11,1897,Sunderland,Wolverhampton Wanderers,3-2,3,2,1,1,5,1,H
1897-09-11,1897,West Bromwich Albion,Nottingham Forest,2-0,2,0,1,1,2,2,H
1897-09-18,1897,Aston Villa,Bury,3-1,3,1,1,1,4,2,H
1897-09-18,1897,Bolton Wanderers,Notts County,1-0,1,0,1,1,1,1,H
1897-09-18,1897,Derby County,West Bromwich Albion,3-2,3,2,1,1,5,1,H
1897-09-18,1897,Everton,Wolverhampton Wanderers,3-0,3,0,1,1,3,3,H
1897-09-18,1897,Nottingham Forest,Sheffield United,1-1,1,1,1,1,2,0,D
1897-09-18,1897,Preston North End,Sunderland,2-0,2,0,1,1,2,2,H
1897-09-18,1897,Sheffield Wednesday,Liverpool,4-2,4,2,1,1,6,2,H
1897-09-18,1897,Stoke City,Blackburn Rovers,2-1,2,1,1,1,3,1,H
1897-09-25,1897,Blackburn Rovers,Aston Villa,4-3,4,3,1,1,7,1,H
1897-09-25,1897,Bolton Wanderers,Preston North End,1-0,1,0,1,1,1,1,H
1897-09-25,1897,Liverpool,Everton,3-1,3,1,1,1,4,2,H
1897-09-25,1897,Notts County,Derby County,1-1,1,1,1,1,2,0,D
1897-09-25,1897,Sheffield United,Bury,1-1,1,1,1,1,2,0,D
1897-09-25,1897,Sunderland,Sheffield Wednesday,1-0,1,0,1,1,1,1,H
1897-09-25,1897,West Bromwich Albion,Stoke City,2-0,2,0,1,1,2,2,H
1897-09-25,1897,Wolverhampton Wanderers,Nottingham Forest,0-0,0,0,1,1,0,0,D
1897-09-27,1897,Sheffield Wednesday,Aston Villa,3-0,3,0,1,1,3,3,H
1897-10-02,1897,Aston Villa,Bolton Wanderers,3-2,3,2,1,1,5,1,H
1897-10-02,1897,Bury,West Bromwich Albion,3-2,3,2,1,1,5,1,H
1897-10-02,1897,Everton,Blackburn Rovers,1-1,1,1,1,1,2,0,D
1897-10-02,1897,Nottingham Forest,Sunderland,1-1,1,1,1,1,2,0,D
1897-10-02,1897,Preston North End,Liverpool,1-1,1,1,1,1,2,0,D
1897-10-02,1897,Sheffield Wednesday,Notts County,3-1,3,1,1,1,4,2,H
1897-10-02,1897,Stoke City,Derby County,2-1,2,1,1,1,3,1,H
1897-10-02,1897,Wolverhampton Wanderers,Sheffield United,1-1,1,1,1,1,2,0,D
1897-10-04,1897,Sheffield United,Blackburn Rovers,5-2,5,2,1,1,7,3,H
1897-10-07,1897,Notts County,Preston North End,1-1,1,1,1,1,2,0,D
1897-10-09,1897,Blackburn Rovers,Preston North End,1-0,1,0,1,1,1,1,H
1897-10-09,1897,Bolton Wanderers,Sheffield Wednesday,0-3,0,3,1,1,3,-3,A
1897-10-09,1897,Bury,Sheffield United,2-5,2,5,1,1,7,-3,A
1897-10-09,1897,Liverpool,Stoke City,4-0,4,0,1,1,4,4,H
1897-10-09,1897,Notts County,Nottingham Forest,1-3,1,3,1,1,4,-2,A
1897-10-09,1897,Sunderland,Derby County,2-1,2,1,1,1,3,1,H
1897-10-09,1897,West Bromwich Albion,Aston Villa,1-1,1,1,1,1,2,0,D
1897-10-09,1897,Wolverhampton Wanderers,Everton,2-3,2,3,1,1,5,-1,A
1897-10-16,1897,Aston Villa,Notts County,4-2,4,2,1,1,6,2,H
1897-10-16,1897,Derby County,Bury,2-2,2,2,1,1,4,0,D
1897-10-16,1897,Everton,Liverpool,3-0,3,0,1,1,3,3,H
1897-10-16,1897,Nottingham Forest,Blackburn Rovers,3-1,3,1,1,1,4,2,H
1897-10-16,1897,Preston North End,Bolton Wanderers,0-0,0,0,1,1,0,0,D
1897-10-16,1897,Sheffield Wednesday,Sheffield United,0-1,0,1,1,1,1,-1,A
1897-10-16,1897,Stoke City,Wolverhampton Wanderers,0-2,0,2,1,1,2,-2,A
1897-10-16,1897,Sunderland,West Bromwich Albion,0-2,0,2,1,1,2,-2,A
1897-10-23,1897,Blackburn Rovers,Sheffield Wednesday,1-1,1,1,1,1,2,0,D
1897-10-23,1897,Bolton Wanderers,Nottingham Forest,2-0,2,0,1,1,2,2,H
1897-10-23,1897,Bury,Everton,0-1,0,1,1,1,1,-1,A
1897-10-23,1897,Liverpool,Derby County,4-2,4,2,1,1,6,2,H
1897-10-23,1897,Notts County,Stoke City,4-0,4,0,1,1,4,4,H
1897-10-23,1897,Sheffield United,Preston North End,2-1,2,1,1,1,3,1,H
1897-10-23,1897,Sunderland,Aston Villa,0-0,0,0,1,1,0,0,D
1897-10-23,1897,West Bromwich Albion,Wolverhampton Wanderers,2-2,2,2,1,1,4,0,D
1897-10-30,1897,Aston Villa,Liverpool,3-1,3,1,1,1,4,2,H
1897-10-30,1897,Bolton Wanderers,Sunderland,1-0,1,0,1,1,1,1,H
1897-10-30,1897,Everton,Sheffield United,1-4,1,4,1,1,5,-3,A
1897-10-30,1897,Nottingham Forest,Derby County,3-4,3,4,1,1,7,-1,A
1897-10-30,1897,Preston North End,Blackburn Rovers,1-4,1,4,1,1,5,-3,A
1897-10-30,1897,Stoke City,West Bromwich Albion,0-0,0,0,1,1,0,0,D
1897-10-30,1897,Wolverhampton Wanderers,Notts County,3-1,3,1,1,1,4,2,H
1897-11-01,1897,West Bromwich Albion,Bolton Wanderers,2-0,2,0,1,1,2,2,H
1897-11-06,1897,Bury,Wolverhampton Wanderers,2-1,2,1,1,1,3,1,H
1897-11-06,1897,Derby County,Stoke City,4-1,4,1,1,1,5,3,H
1897-11-06,1897,Liverpool,Nottingham Forest,1-2,1,2,1,1,3,-1,A
1897-11-06,1897,Notts County,Bolton Wanderers,1-2,1,2,1,1,3,-1,A
1897-11-06,1897,Preston North End,Aston Villa,3-1,3,1,1,1,4,2,H
1897-11-06,1897,West Bromwich Albion,Everton,2-2,2,2,1,1,4,0,D
1897-11-08,1897,Stoke City,Preston North End,1-2,1,2,1,1,3,-1,A
1897-11-13,1897,Aston Villa,Everton,3-0,3,0,1,1,3,3,H
1897-11-13,1897,Bolton Wanderers,Stoke City,2-1,2,1,1,1,3,1,H
1897-11-13,1897,Derby County,Sheffield United,1-1,1,1,1,1,2,0,D
1897-11-13,1897,Nottingham Forest,Preston North End,4-1,4,1,1,1,5,3,H
1897-11-13,1897,Sheffield Wednesday,Blackburn Rovers,4-1,4,1,1,1,5,3,H
1897-11-13,1897,West Bromwich Albion,Liverpool,2-1,2,1,1,1,3,1,H
1897-11-13,1897,Wolverhampton Wanderers,Sunderland,4-2,4,2,1,1,6,2,H
1897-11-20,1897,Blackburn Rovers,Sheffield United,1-1,1,1,1,1,2,0,D
1897-11-20,1897,Bolton Wanderers,Aston Villa,2-0,2,0,1,1,2,2,H
1897-11-20,1897,Liverpool,Wolverhampton Wanderers,1-0,1,0,1,1,1,1,H
1897-11-20,1897,Preston North End,Everton,1-1,1,1,1,1,2,0,D
1897-11-20,1897,Sheffield Wednesday,Bury,3-0,3,0,1,1,3,3,H
1897-11-20,1897,Stoke City,Nottingham Forest,1-2,1,2,1,1,3,-1,A
1897-11-20,1897,West Bromwich Albion,Derby County,3-1,3,1,1,1,4,2,H
1897-11-27,1897,Aston Villa,Sunderland,4-3,4,3,1,1,7,1,H
1897-11-27,1897,Blackburn Rovers,Derby County,1-1,1,1,1,1,2,0,D
1897-11-27,1897,Bury,Notts County,0-0,0,0,1,1,0,0,D
1897-11-27,1897,Everton,West Bromwich Albion,6-1,6,1,1,1,7,5,H
1897-11-27,1897,Nottingham Forest,Liverpool,2-3,2,3,1,1,5,-1,A
1897-11-27,1897,Preston North End,Wolverhampton Wanderers,1-2,1,2,1,1,3,-1,A
1897-11-27,1897,Sheffield Wednesday,Bolton Wanderers,3-0,3,0,1,1,3,3,H
1897-12-04,1897,Notts County,Sheffield Wednesday,0-0,0,0,1,1,0,0,D
1897-12-04,1897,Sheffield United,Nottingham Forest,1-1,1,1,1,1,2,0,D
1897-12-04,1897,Sunderland,Stoke City,4-0,4,0,1,1,4,4,H
1897-12-04,1897,Wolverhampton Wanderers,Derby County,2-0,2,0,1,1,2,2,H
1897-12-11,1897,Aston Villa,Blackburn Rovers,5-1,5,1,1,1,6,4,H
1897-12-11,1897,Bury,Bolton Wanderers,2-1,2,1,1,1,3,1,H
1897-12-11,1897,Derby County,Sunderland,2-2,2,2,1,1,4,0,D
1897-12-11,1897,Everton,Notts County,1-0,1,0,1,1,1,1,H
1897-12-11,1897,Nottingham Forest,West Bromwich Albion,0-1,0,1,1,1,1,-1,A
1897-12-11,1897,Sheffield Wednesday,Preston North End,2-1,2,1,1,1,3,1,H
1897-12-11,1897,Stoke City,Sheffield United,2-1,2,1,1,1,3,1,H
1897-12-11,1897,Wolverhampton Wanderers,Liverpool,2-1,2,1,1,1,3,1,H
1897-12-18,1897,Liverpool,Blackburn Rovers,0-1,0,1,1,1,1,-1,A
1897-12-18,1897,Notts County,Wolverhampton Wanderers,2-2,2,2,1,1,4,0,D
1897-12-18,1897,Preston North End,Sheffield Wednesday,2-0,2,0,1,1,2,2,H
1897-12-18,1897,Stoke City,Aston Villa,0-0,0,0,1,1,0,0,D
1897-12-18,1897,Sunderland,Everton,0-0,0,0,1,1,0,0,D
1897-12-18,1897,West Bromwich Albion,Bury,1-0,1,0,1,1,1,1,H
1897-12-25,1897,Blackburn Rovers,Sunderland,2-1,2,1,1,1,3,1,H
1897-12-25,1897,Bolton Wanderers,Liverpool,0-2,0,2,1,1,2,-2,A
1897-12-25,1897,Derby County,Notts County,1-2,1,2,1,1,3,-1,A
1897-12-25,1897,Everton,Aston Villa,2-1,2,1,1,1,3,1,H
1897-12-25,1897,Preston North End,Nottingham Forest,3-0,3,0,1,1,3,3,H
1897-12-25,1897,Sheffield Wednesday,Stoke City,4-0,4,0,1,1,4,4,H
1897-12-27,1897,Derby County,Bolton Wanderers,1-0,1,0,1,1,1,1,H
1897-12-27,1897,Liverpool,Sunderland,0-2,0,2,1,1,2,-2,A
1897-12-27,1897,Sheffield United,Sheffield Wednesday,1-1,1,1,1,1,2,0,D
1897-12-27,1897,Stoke City,Bury,3-1,3,1,1,1,4,2,H
1897-12-27,1897,West Bromwich Albion,Blackburn Rovers,1-1,1,1,1,1,2,0,D
1897-12-27,1897,Wolverhampton Wanderers,Aston Villa,1-1,1,1,1,1,2,0,D
1897-12-28,1897,Wolverhampton Wanderers,West Bromwich Albion,1-1,1,1,1,1,2,0,D
1897-12-29,1897,Sheffield United,Liverpool,1-2,1,2,1,1,3,-1,A
1898-01-01,1897,Blackburn Rovers,Everton,1-1,1,1,1,1,2,0,D
1898-01-01,1897,Bolton Wanderers,Derby County,3-3,3,3,1,1,6,0,D
1898-01-01,1897,Bury,Stoke City,3-3,3,3,1,1,6,0,D
1898-01-01,1897,Liverpool,West Bromwich Albion,1-1,1,1,1,1,2,0,D
1898-01-01,1897,Notts County,Sheffield United,1-3,1,3,1,1,4,-2,A
1898-01-01,1897,Sheffield Wednesday,Nottingham Forest,3-6,3,6,1,1,9,-3,A
1898-01-01,1897,Sunderland,Preston North End,1-0,1,0,1,1,1,1,H
1898-01-03,1897,Bolton Wanderers,Bury,0-0,0,0,1,1,0,0,D
1898-01-03,1897,Sunderland,Notts County,2-0,2,0,1,1,2,2,H
1898-01-08,1897,Blackburn Rovers,Liverpool,2-1,2,1,1,1,3,1,H
1898-01-08,1897,Derby County,Wolverhampton Wanderers,3-2,3,2,1,1,5,1,H
1898-01-08,1897,Everton,Sheffield Wednesday,1-0,1,0,1,1,1,1,H
1898-01-08,1897,Nottingham Forest,Bolton Wanderers,2-0,2,0,1,1,2,2,H
1898-01-08,1897,Preston North End,Bury,2-1,2,1,1,1,3,1,H
1898-01-08,1897,Sheffield United,Aston Villa,1-0,1,0,1,1,1,1,H
1898-01-08,1897,Stoke City,Sunderland,0-1,0,1,1,1,1,-1,A
1898-01-15,1897,Aston Villa,Sheffield United,1-2,1,2,1,1,3,-1,A
1898-01-15,1897,Blackburn Rovers,Nottingham Forest,1-1,1,1,1,1,2,0,D
1898-01-15,1897,Notts County,Everton,3-2,3,2,1,1,5,1,H
1898-01-15,1897,Sheffield Wednesday,Derby County,3-1,3,1,1,1,4,2,H
1898-01-15,1897,Stoke City,Bolton Wanderers,2-0,2,0,1,1,2,2,H
1898-01-15,1897,Sunderland,Bury,2-1,2,1,1,1,3,1,H
1898-01-15,1897,West Bromwich Albion,Preston North End,3-1,3,1,1,1,4,2,H
1898-01-17,1897,Everton,Stoke City,1-1,1,1,1,1,2,0,D
1898-01-22,1897,Derby County,Aston Villa,3-1,3,1,1,1,4,2,H
1898-01-22,1897,Nottingham Forest,Sheffield Wednesday,1-0,1,0,1,1,1,1,H
1898-01-22,1897,Sheffield United,Wolverhampton Wanderers,2-1,2,1,1,1,3,1,H
1898-01-22,1897,Sunderland,Liverpool,1-0,1,0,1,1,1,1,H
1898-02-05,1897,Aston Villa,Preston North End,4-0,4,0,1,1,4,4,H
1898-02-05,1897,Blackburn Rovers,West Bromwich Albion,1-3,1,3,1,1,4,-2,A
1898-02-05,1897,Liverpool,Sheffield United,0-4,0,4,1,1,4,-4,A
1898-02-05,1897,Notts County,Sunderland,0-1,0,1,1,1,1,-1,A
1898-02-05,1897,Sheffield Wednesday,Everton,2-1,2,1,1,1,3,1,H
1898-02-05,1897,Wolverhampton Wanderers,Stoke City,4-2,4,2,1,1,6,2,H
1898-02-07,1897,Sheffield United,Bolton Wanderers,4-0,4,0,1,1,4,4,H
1898-02-12,1897,Bury,Preston North End,1-0,1,0,1,1,1,1,H
1898-02-19,1897,Derby County,Sheffield Wednesday,1-2,1,2,1,1,3,-1,A
1898-02-19,1897,Nottingham Forest,Stoke City,3-1,3,1,1,1,4,2,H
1898-02-19,1897,Sheffield United,Notts County,0-1,0,1,1,1,1,-1,A
1898-02-19,1897,West Bromwich Albion,Sunderland,2-2,2,2,1,1,4,0,D
1898-02-22,1897,Sheffield United,Everton,0-0,0,0,1,1,0,0,D
1898-02-22,1897,Sunderland,Bolton Wanderers,2-0,2,0,1,1,2,2,H
1898-02-26,1897,Blackburn Rovers,Wolverhampton Wanderers,2-3,2,3,1,1,5,-1,A
1898-02-26,1897,Notts County,Bury,2-1,2,1,1,1,3,1,H
1898-03-05,1897,Aston Villa,Derby County,4-1,4,1,1,1,5,3,H
1898-03-05,1897,Everton,Bury,4-2,4,2,1,1,6,2,H
1898-03-05,1897,Notts County,Blackburn Rovers,0-0,0,0,1,1,0,0,D
1898-03-05,1897,Preston North End,Stoke City,0-0,0,0,1,1,0,0,D
1898-03-05,1897,Sheffield Wednesday,Wolverhampton Wanderers,2-0,2,0,1,1,2,2,H
1898-03-05,1897,Sunderland,Sheffield United,3-1,3,1,1,1,4,2,H
1898-03-12,1897,Bolton Wanderers,Wolverhampton Wanderers,2-1,2,1,1,1,3,1,H
1898-03-12,1897,Bury,Aston Villa,1-2,1,2,1,1,3,-1,A
1898-03-12,1897,Derby County,Preston North End,3-1,3,1,1,1,4,2,H
1898-03-12,1897,Liverpool,Notts County,2-0,2,0,1,1,2,2,H
1898-03-12,1897,Nottingham Forest,Everton,2-2,2,2,1,1,4,0,D
1898-03-12,1897,Sunderland,Blackburn Rovers,2-1,2,1,1,1,3,1,H
1898-03-12,1897,West Bromwich Albion,Sheffield Wednesday,0-2,0,2,1,1,2,-2,A
1898-03-19,1897,Blackburn Rovers,Bury,1-1,1,1,1,1,2,0,D
1898-03-19,1897,Liverpool,Bolton Wanderers,1-1,1,1,1,1,2,0,D
1898-03-19,1897,Notts County,West Bromwich Albion,2-2,2,2,1,1,4,0,D
1898-03-21,1897,Everton,Preston North End,1-1,1,1,1,1,2,0,D
1898-03-26,1897,Bolton Wanderers,Everton,1-0,1,0,1,1,1,1,H
1898-03-26,1897,Bury,Liverpool,0-2,0,2,1,1,2,-2,A
1898-03-26,1897,Nottingham Forest,Aston Villa,3-1,3,1,1,1,4,2,H
1898-03-26,1897,Stoke City,Sheffield Wednesday,2-1,2,1,1,1,3,1,H
1898-03-26,1897,West Bromwich Albion,Sheffield United,2-0,2,0,1,1,2,2,H
1898-03-29,1897,Bury,Derby County,4-0,4,0,1,1,4,4,H
1898-03-31,1897,Liverpool,Bury,2-2,2,2,1,1,4,0,D
1898-03-31,1897,Preston North End,West Bromwich Albion,1-1,1,1,1,1,2,0,D
1898-04-02,1897,Aston Villa,Stoke City,1-1,1,1,1,1,2,0,D
1898-04-02,1897,Bolton Wanderers,West Bromwich Albion,2-0,2,0,1,1,2,2,H
1898-04-02,1897,Everton,Nottingham Forest,2-0,2,0,1,1,2,2,H
1898-04-02,1897,Notts County,Liverpool,3-2,3,2,1,1,5,1,H
1898-04-02,1897,Sheffield United,Sunderland,1-0,1,0,1,1,1,1,H
1898-04-02,1897,Wolverhampton Wanderers,Blackburn Rovers,3-2,3,2,1,1,5,1,H
1898-04-04,1897,Bury,Nottingham Forest,2-2,2,2,1,1,4,0,D
1898-04-04,1897,West Bromwich Albion,Notts County,0-3,0,3,1,1,3,-3,A
1898-04-08,1897,Blackburn Rovers,Stoke City,1-1,1,1,1,1,2,0,D
1898-04-08,1897,Bolton Wanderers,Sheffield United,0-1,0,1,1,1,1,-1,A
1898-04-08,1897,Bury,Sunderland,1-0,1,0,1,1,1,1,H
1898-04-08,1897,Everton,Derby County,3-0,3,0,1,1,3,3,H
1898-04-08,1897,Nottingham Forest,Wolverhampton Wanderers,1-1,1,1,1,1,2,0,D
1898-04-08,1897,Preston North End,Notts County,3-1,3,1,1,1,4,2,H
1898-04-09,1897,Blackburn Rovers,Notts County,0-1,0,1,1,1,1,-1,A
1898-04-09,1897,Nottingham Forest,Bury,3-1,3,1,1,1,4,2,H
1898-04-09,1897,Preston North End,Derby County,5-0,5,0,1,1,5,5,H
1898-04-09,1897,Sheffield Wednesday,West Bromwich Albion,3-0,3,0,1,1,3,3,H
1898-04-09,1897,Stoke City,Everton,2-0,2,0,1,1,2,2,H
1898-04-09,1897,Wolverhampton Wanderers,Bolton Wanderers,2-0,2,0,1,1,2,2,H
1898-04-11,1897,Aston Villa,Wolverhampton Wanderers,1-2,1,2,1,1,3,-1,A
1898-04-11,1897,Derby County,Nottingham Forest,5-0,5,0,1,1,5,5,H
1898-04-11,1897,Everton,Sunderland,2-0,2,0,1,1,2,2,H
1898-04-11,1897,Liverpool,Sheffield Wednesday,4-0,4,0,1,1,4,4,H
1898-04-11,1897,Sheffield United,West Bromwich Albion,2-0,2,0,1,1,2,2,H
1898-04-12,1897,Derby County,Liverpool,3-1,3,1,1,1,4,2,H
1898-04-14,1897,Bolton Wanderers,Blackburn Rovers,1-2,1,2,1,1,3,-1,A
1898-04-16,1897,Bury,Blackburn Rovers,1-0,1,0,1,1,1,1,H
1898-04-16,1897,Liverpool,Aston Villa,4-0,4,0,1,1,4,4,H
1898-04-16,1897,Wolverhampton Wanderers,Sheffield Wednesday,5-0,5,0,1,1,5,5,H
1898-04-23,1897,Sunderland,Nottingham Forest,4-0,4,0,1,1,4,4,H
1898-04-30,1897,Aston Villa,Nottingham Forest,2-0,2,0,1,1,2,2,H
1898-09-01,1898,Everton,Blackburn Rovers,2-1,2,1,1,1,3,1,H
1898-09-01,1898,Stoke City,Derby County,0-0,0,0,1,1,0,0,D
1898-09-03,1898,Aston Villa,Stoke City,3-1,3,1,1,1,4,2,H
1898-09-03,1898,Bolton Wanderers,West Bromwich Albion,3-3,3,3,1,1,6,0,D
1898-09-03,1898,Burnley,Notts County,1-1,1,1,1,1,2,0,D
1898-09-03,1898,Derby County,Bury,1-2,1,2,1,1,3,-1,A
1898-09-03,1898,Liverpool,Sheffield Wednesday,4-0,4,0,1,1,4,4,H
1898-09-03,1898,Newcastle United,Wolverhampton Wanderers,2-4,2,4,1,1,6,-2,A
1898-09-03,1898,Nottingham Forest,Blackburn Rovers,0-1,0,1,1,1,1,-1,A
1898-09-03,1898,Preston North End,Sunderland,2-3,2,3,1,1,5,-1,A
1898-09-03,1898,Sheffield United,Everton,1-1,1,1,1,1,2,0,D
1898-09-05,1898,Burnley,Preston North End,3-1,3,1,1,1,4,2,H
1898-09-10,1898,Blackburn Rovers,Bolton Wanderers,4-1,4,1,1,1,5,3,H
1898-09-10,1898,Bury,Aston Villa,2-1,2,1,1,1,3,1,H
1898-09-10,1898,Everton,Newcastle United,3-0,3,0,1,1,3,3,H
1898-09-10,1898,Notts County,Sheffield United,2-2,2,2,1,1,4,0,D
1898-09-10,1898,Sheffield Wednesday,Nottingham Forest,2-1,2,1,1,1,3,1,H
1898-09-10,1898,Stoke City,Burnley,4-1,4,1,1,1,5,3,H
1898-09-10,1898,Sunderland,Liverpool,1-0,1,0,1,1,1,1,H
1898-09-10,1898,West Bromwich Albion,Derby County,1-1,1,1,1,1,2,0,D
1898-09-10,1898,Wolverhampton Wanderers,Preston North End,0-0,0,0,1,1,0,0,D
1898-09-12,1898,Sheffield United,Wolverhampton Wanderers,1-0,1,0,1,1,1,1,H
1898-09-17,1898,Bolton Wanderers,Sheffield Wednesday,0-0,0,0,1,1,0,0,D
1898-09-17,1898,Burnley,Aston Villa,2-4,2,4,1,1,6,-2,A
1898-09-17,1898,Derby County,Blackburn Rovers,0-0,0,0,1,1,0,0,D
1898-09-17,1898,Liverpool,Wolverhampton Wanderers,1-0,1,0,1,1,1,1,H
1898-09-17,1898,Newcastle United,Notts County,1-2,1,2,1,1,3,-1,A
1898-09-17,1898,Nottingham Forest,Sunderland,1-1,1,1,1,1,2,0,D
1898-09-17,1898,Preston North End,Everton,0-0,0,0,1,1,0,0,D
1898-09-17,1898,Sheffield United,Stoke City,1-1,1,1,1,1,2,0,D
1898-09-17,1898,West Bromwich Albion,Bury,2-0,2,0,1,1,2,2,H
1898-09-19,1898,Sheffield Wednesday,Preston North End,2-1,2,1,1,1,3,1,H
1898-09-24,1898,Aston Villa,Sheffield United,1-1,1,1,1,1,2,0,D
1898-09-24,1898,Blackburn Rovers,West Bromwich Albion,4-1,4,1,1,1,5,3,H
1898-09-24,1898,Bury,Burnley,1-1,1,1,1,1,2,0,D
1898-09-24,1898,Everton,Liverpool,1-2,1,2,1,1,3,-1,A
1898-09-24,1898,Notts County,Preston North End,1-0,1,0,1,1,1,1,H
1898-09-24,1898,Sheffield Wednesday,Derby County,3-1,3,1,1,1,4,2,H
1898-09-24,1898,Stoke City,Newcastle United,0-0,0,0,1,1,0,0,D
1898-09-24,1898,Sunderland,Bolton Wanderers,0-0,0,0,1,1,0,0,D
1898-09-24,1898,Wolverhampton Wanderers,Nottingham Forest,0-2,0,2,1,1,2,-2,A
1898-09-26,1898,Sheffield United,Newcastle United,2-2,2,2,1,1,4,0,D
1898-10-01,1898,Blackburn Rovers,Bury,0-0,0,0,1,1,0,0,D
1898-10-01,1898,Bolton Wanderers,Wolverhampton Wanderers,2-1,2,1,1,1,3,1,H
1898-10-01,1898,Derby County,Sunderland,4-2,4,2,1,1,6,2,H
1898-10-01,1898,Liverpool,Notts County,0-0,0,0,1,1,0,0,D
1898-10-01,1898,Newcastle United,Aston Villa,1-1,1,1,1,1,2,0,D
1898-10-01,1898,Nottingham Forest,Everton,0-0,0,0,1,1,0,0,D
1898-10-01,1898,Preston North End,Stoke City,4-2,4,2,1,1,6,2,H
1898-10-01,1898,Sheffield United,Burnley,1-1,1,1,1,1,2,0,D
1898-10-01,1898,West Bromwich Albion,Sheffield Wednesday,2-0,2,0,1,1,2,2,H
1898-10-03,1898,Sheffield Wednesday,Sheffield United,1-1,1,1,1,1,2,0,D
1898-10-06,1898,Nottingham Forest,Preston North End,2-2,2,2,1,1,4,0,D
1898-10-08,1898,Aston Villa,Preston North End,4-2,4,2,1,1,6,2,H
1898-10-08,1898,Burnley,Newcastle United,2-1,2,1,1,1,3,1,H
1898-10-08,1898,Bury,Sheffield United,1-3,1,3,1,1,4,-2,A
1898-10-08,1898,Everton,Bolton Wanderers,1-0,1,0,1,1,1,1,H
1898-10-08,1898,Notts County,Nottingham Forest,2-2,2,2,1,1,4,0,D
1898-10-08,1898,Sheffield Wednesday,Blackburn Rovers,1-2,1,2,1,1,3,-1,A
1898-10-08,1898,Stoke City,Liverpool,2-1,2,1,1,1,3,1,H
1898-10-08,1898,Sunderland,West Bromwich Albion,2-0,2,0,1,1,2,2,H
1898-10-08,1898,Wolverhampton Wanderers,Derby County,2-2,2,2,1,1,4,0,D
1898-10-15,1898,Blackburn Rovers,Sunderland,3-2,3,2,1,1,5,1,H
1898-10-15,1898,Bolton Wanderers,Notts County,0-1,0,1,1,1,1,-1,A
1898-10-15,1898,Derby County,Everton,5-5,5,5,1,1,10,0,D
1898-10-15,1898,Liverpool,Aston Villa,0-3,0,3,1,1,3,-3,A
1898-10-15,1898,Newcastle United,Sheffield United,1-2,1,2,1,1,3,-1,A
1898-10-15,1898,Nottingham Forest,Stoke City,2-1,2,1,1,1,3,1,H
1898-10-15,1898,Preston North End,Burnley,1-1,1,1,1,1,2,0,D
1898-10-15,1898,Sheffield Wednesday,Bury,3-2,3,2,1,1,5,1,H
1898-10-15,1898,West Bromwich Albion,Wolverhampton Wanderers,1-2,1,2,1,1,3,-1,A
1898-10-22,1898,Aston Villa,Nottingham Forest,3-0,3,0,1,1,3,3,H
1898-10-22,1898,Burnley,Liverpool,2-1,2,1,1,1,3,1,H
1898-10-22,1898,Bury,Newcastle United,1-1,1,1,1,1,2,0,D
1898-10-22,1898,Everton,West Bromwich Albion,1-0,1,0,1,1,1,1,H
1898-10-22,1898,Notts County,Derby County,2-2,2,2,1,1,4,0,D
1898-10-22,1898,Sheffield United,Preston North End,1-1,1,1,1,1,2,0,D
1898-10-22,1898,Stoke City,Bolton Wanderers,2-3,2,3,1,1,5,-1,A
1898-10-22,1898,Sunderland,Sheffield Wednesday,2-0,2,0,1,1,2,2,H
1898-10-22,1898,Wolverhampton Wanderers,Blackburn Rovers,2-1,2,1,1,1,3,1,H
1898-10-29,1898,Aston Villa,Bolton Wanderers,2-1,2,1,1,1,3,1,H
1898-10-29,1898,Blackburn Rovers,Everton,1-3,1,3,1,1,4,-2,A
1898-10-29,1898,Derby County,Stoke City,1-1,1,1,1,1,2,0,D
1898-10-29,1898,Liverpool,Sheffield United,2-1,2,1,1,1,3,1,H
1898-10-29,1898,Nottingham Forest,Burnley,0-1,0,1,1,1,1,-1,A
1898-10-29,1898,Preston North End,Newcastle United,1-0,1,0,1,1,1,1,H
1898-10-29,1898,Sheffield Wednesday,Wolverhampton Wanderers,3-0,3,0,1,1,3,3,H
1898-10-29,1898,Sunderland,Bury,3-0,3,0,1,1,3,3,H
1898-10-29,1898,West Bromwich Albion,Notts County,2-0,2,0,1,1,2,2,H
1898-11-05,1898,Aston Villa,Derby County,7-1,7,1,1,1,8,6,H
1898-11-05,1898,Burnley,Bolton Wanderers,2-0,2,0,1,1,2,2,H
1898-11-05,1898,Bury,Preston North End,3-1,3,1,1,1,4,2,H
1898-11-05,1898,Everton,Sheffield Wednesday,2-0,2,0,1,1,2,2,H
1898-11-05,1898,Newcastle United,Liverpool,3-0,3,0,1,1,3,3,H
1898-11-05,1898,Notts County,Blackburn Rovers,5-3,5,3,1,1,8,2,H
1898-11-05,1898,Sheffield United,Nottingham Forest,2-2,2,2,1,1,4,0,D
1898-11-05,1898,Stoke City,West Bromwich Albion,2-1,2,1,1,1,3,1,H
1898-11-05,1898,Wolverhampton Wanderers,Sunderland,2-0,2,0,1,1,2,2,H
1898-11-07,1898,West Bromwich Albion,Everton,3-0,3,0,1,1,3,3,H
1898-11-12,1898,Blackburn Rovers,Stoke City,4-1,4,1,1,1,5,3,H
1898-11-12,1898,Bolton Wanderers,Sheffield United,3-0,3,0,1,1,3,3,H
1898-11-12,1898,Derby County,Burnley,2-1,2,1,1,1,3,1,H
1898-11-12,1898,Liverpool,Preston North End,3-1,3,1,1,1,4,2,H
1898-11-12,1898,Nottingham Forest,Newcastle United,2-0,2,0,1,1,2,2,H
1898-11-12,1898,Sheffield Wednesday,Notts County,1-1,1,1,1,1,2,0,D
1898-11-12,1898,Sunderland,Everton,2-1,2,1,1,1,3,1,H
1898-11-12,1898,West Bromwich Albion,Aston Villa,0-1,0,1,1,1,1,-1,A
1898-11-12,1898,Wolverhampton Wanderers,Bury,1-2,1,2,1,1,3,-1,A
1898-11-14,1898,Stoke City,Preston North End,2-1,2,1,1,1,3,1,H
1898-11-19,1898,Aston Villa,Blackburn Rovers,3-1,3,1,1,1,4,2,H
1898-11-19,1898,Burnley,West Bromwich Albion,1-1,1,1,1,1,2,0,D
1898-11-19,1898,Bury,Liverpool,3-0,3,0,1,1,3,3,H
1898-11-19,1898,Everton,Wolverhampton Wanderers,2-1,2,1,1,1,3,1,H
1898-11-19,1898,Newcastle United,Bolton Wanderers,4-1,4,1,1,1,5,3,H
1898-11-19,1898,Notts County,Sunderland,5-2,5,2,1,1,7,3,H
1898-11-19,1898,Preston North End,Nottingham Forest,1-0,1,0,1,1,1,1,H
1898-11-19,1898,Sheffield United,Derby County,2-1,2,1,1,1,3,1,H
1898-11-19,1898,Stoke City,Sheffield Wednesday,1-0,1,0,1,1,1,1,H
1898-11-26,1898,Bolton Wanderers,Preston North End,2-2,2,2,1,1,4,0,D
1898-11-26,1898,Burnley,Blackburn Rovers,2-0,2,0,1,1,2,2,H
1898-11-26,1898,Derby County,Newcastle United,3-1,3,1,1,1,4,2,H
1898-11-26,1898,Everton,Bury,0-1,0,1,1,1,1,-1,A
1898-11-26,1898,Nottingham Forest,Liverpool,0-3,0,3,1,1,3,-3,A
1898-11-26,1898,Sunderland,Stoke City,2-0,2,0,1,1,2,2,H
1898-11-26,1898,West Bromwich Albion,Sheffield United,3-0,3,0,1,1,3,3,H
1898-11-26,1898,Wolverhampton Wanderers,Notts County,1-0,1,0,1,1,1,1,H
1898-12-03,1898,Aston Villa,Sunderland,2-0,2,0,1,1,2,2,H
1898-12-03,1898,Burnley,Sheffield Wednesday,5-0,5,0,1,1,5,5,H
1898-12-03,1898,Bury,Nottingham Forest,2-0,2,0,1,1,2,2,H
1898-12-03,1898,Liverpool,Bolton Wanderers,2-0,2,0,1,1,2,2,H
1898-12-03,1898,Newcastle United,West Bromwich Albion,3-0,3,0,1,1,3,3,H
1898-12-03,1898,Notts County,Everton,0-1,0,1,1,1,1,-1,A
1898-12-03,1898,Preston North End,Derby County,3-1,3,1,1,1,4,2,H
1898-12-03,1898,Sheffield United,Blackburn Rovers,1-1,1,1,1,1,2,0,D
1898-12-03,1898,Stoke City,Wolverhampton Wanderers,2-4,2,4,1,1,6,-2,A
1898-12-10,1898,Aston Villa,Wolverhampton Wanderers,1-1,1,1,1,1,2,0,D
1898-12-10,1898,Blackburn Rovers,Newcastle United,4-2,4,2,1,1,6,2,H
1898-12-10,1898,Bolton Wanderers,Nottingham Forest,0-2,0,2,1,1,2,-2,A
1898-12-10,1898,Derby County,Liverpool,1-0,1,0,1,1,1,1,H
1898-12-10,1898,Everton,Stoke City,2-0,2,0,1,1,2,2,H
1898-12-10,1898,Notts County,Bury,4-1,4,1,1,1,5,3,H
1898-12-10,1898,Sunderland,Burnley,0-1,0,1,1,1,1,-1,A
1898-12-10,1898,West Bromwich Albion,Preston North End,2-0,2,0,1,1,2,2,H
1898-12-17,1898,Aston Villa,Everton,3-0,3,0,1,1,3,3,H
1898-12-17,1898,Bolton Wanderers,Bury,0-1,0,1,1,1,1,-1,A
1898-12-17,1898,Burnley,Wolverhampton Wanderers,4-2,4,2,1,1,6,2,H
1898-12-17,1898,Liverpool,West Bromwich Albion,2-2,2,2,1,1,4,0,D
1898-12-17,1898,Newcastle United,Sheffield Wednesday,2-2,2,2,1,1,4,0,D
1898-12-17,1898,Nottingham Forest,Derby County,3-3,3,3,1,1,6,0,D
1898-12-17,1898,Preston North End,Blackburn Rovers,1-1,1,1,1,1,2,0,D
1898-12-17,1898,Sheffield United,Sunderland,2-0,2,0,1,1,2,2,H
1898-12-17,1898,Stoke City,Notts County,1-1,1,1,1,1,2,0,D
1898-12-24,1898,Blackburn Rovers,Liverpool,1-3,1,3,1,1,4,-2,A
1898-12-24,1898,Bury,Stoke City,5-2,5,2,1,1,7,3,H
1898-12-24,1898,Everton,Burnley,4-0,4,0,1,1,4,4,H
1898-12-24,1898,Notts County,Aston Villa,1-0,1,0,1,1,1,1,H
1898-12-24,1898,Sunderland,Newcastle United,2-3,2,3,1,1,5,-1,A
1898-12-24,1898,West Bromwich Albion,Nottingham Forest,2-0,2,0,1,1,2,2,H
1898-12-24,1898,Wolverhampton Wanderers,Sheffield United,4-1,4,1,1,1,5,3,H
1898-12-26,1898,Aston Villa,Newcastle United,1-0,1,0,1,1,1,1,H
1898-12-26,1898,Blackburn Rovers,Burnley,0-2,0,2,1,1,2,-2,A
1898-12-26,1898,Derby County,Bolton Wanderers,1-1,1,1,1,1,2,0,D
1898-12-26,1898,Preston North End,Bury,3-1,3,1,1,1,4,2,H
1898-12-26,1898,Sheffield United,Sheffield Wednesday,2-1,2,1,1,1,3,1,H
1898-12-26,1898,Stoke City,Nottingham Forest,2-1,2,1,1,1,3,1,H
1898-12-26,1898,West Bromwich Albion,Liverpool,0-1,0,1,1,1,1,-1,A
1898-12-27,1898,Notts County,Liverpool,1-1,1,1,1,1,2,0,D
1898-12-27,1898,Wolverhampton Wanderers,West Bromwich Albion,5-1,5,1,1,1,6,4,H
1898-12-31,1898,Blackburn Rovers,Nottingham Forest,3-3,3,3,1,1,6,0,D
1898-12-31,1898,Bury,Derby County,0-0,0,0,1,1,0,0,D
1898-12-31,1898,Everton,Sheffield United,1-0,1,0,1,1,1,1,H
1898-12-31,1898,Notts County,Burnley,2-2,2,2,1,1,4,0,D
1898-12-31,1898,Sheffield Wednesday,Liverpool,0-3,0,3,1,1,3,-3,A
1898-12-31,1898,Stoke City,Aston Villa,3-0,3,0,1,1,3,3,H
1898-12-31,1898,Sunderland,Preston North End,1-0,1,0,1,1,1,1,H
1898-12-31,1898,West Bromwich Albion,Bolton Wanderers,1-0,1,0,1,1,1,1,H
1898-12-31,1898,Wolverhampton Wanderers,Newcastle United,0-0,0,0,1,1,0,0,D
1899-01-02,1898,Blackburn Rovers,Notts County,6-0,6,0,1,1,6,6,H
1899-01-02,1898,Bury,Sheffield Wednesday,0-0,0,0,1,1,0,0,D
1899-01-02,1898,Everton,Nottingham Forest,1-3,1,3,1,1,4,-2,A
1899-01-02,1898,Sheffield United,Liverpool,0-2,0,2,1,1,2,-2,A
1899-01-02,1898,Sunderland,Derby County,1-0,1,0,1,1,1,1,H
1899-01-03,1898,Bolton Wanderers,Burnley,2-0,2,0,1,1,2,2,H
1899-01-07,1898,Aston Villa,Bury,3-2,3,2,1,1,5,1,H
1899-01-07,1898,Bolton Wanderers,Blackburn Rovers,0-2,0,2,1,1,2,-2,A
1899-01-07,1898,Derby County,West Bromwich Albion,4-1,4,1,1,1,5,3,H
1899-01-07,1898,Liverpool,Sunderland,0-0,0,0,1,1,0,0,D
1899-01-07,1898,Newcastle United,Everton,2-2,2,2,1,1,4,0,D
1899-01-07,1898,Nottingham Forest,Sheffield Wednesday,1-1,1,1,1,1,2,0,D
1899-01-07,1898,Preston North End,Wolverhampton Wanderers,2-1,2,1,1,1,3,1,H
1899-01-07,1898,Sheffield United,Notts County,2-2,2,2,1,1,4,0,D
1899-01-14,1898,Aston Villa,Burnley,4-0,4,0,1,1,4,4,H
1899-01-14,1898,Blackburn Rovers,Derby County,3-0,3,0,1,1,3,3,H
1899-01-14,1898,Bury,West Bromwich Albion,1-1,1,1,1,1,2,0,D
1899-01-14,1898,Everton,Preston North End,2-0,2,0,1,1,2,2,H
1899-01-14,1898,Notts County,Newcastle United,3-1,3,1,1,1,4,2,H
1899-01-14,1898,Sheffield Wednesday,Bolton Wanderers,1-0,1,0,1,1,1,1,H
1899-01-14,1898,Stoke City,Sheffield United,4-1,4,1,1,1,5,3,H
1899-01-14,1898,Sunderland,Nottingham Forest,1-1,1,1,1,1,2,0,D
1899-01-14,1898,Wolverhampton Wanderers,Liverpool,0-0,0,0,1,1,0,0,D
1899-01-21,1898,Bolton Wanderers,Sunderland,6-1,6,1,1,1,7,5,H
1899-01-21,1898,Burnley,Bury,2-1,2,1,1,1,3,1,H
1899-01-21,1898,Derby County,Sheffield Wednesday,9-0,9,0,1,1,9,9,H
1899-01-21,1898,Liverpool,Everton,2-0,2,0,1,1,2,2,H
1899-01-21,1898,Newcastle United,Stoke City,3-0,3,0,1,1,3,3,H
1899-01-21,1898,Nottingham Forest,Wolverhampton Wanderers,3-0,3,0,1,1,3,3,H
1899-01-21,1898,Sheffield United,Aston Villa,1-3,1,3,1,1,4,-2,A
1899-01-21,1898,West Bromwich Albion,Blackburn Rovers,6-2,6,2,1,1,8,4,H
1899-02-04,1898,Blackburn Rovers,Sheffield Wednesday,2-0,2,0,1,1,2,2,H
1899-02-04,1898,Derby County,Wolverhampton Wanderers,6-2,6,2,1,1,8,4,H
1899-02-04,1898,Liverpool,Stoke City,1-0,1,0,1,1,1,1,H
1899-02-04,1898,Newcastle United,Burnley,4-1,4,1,1,1,5,3,H
1899-02-04,1898,Nottingham Forest,Notts County,0-0,0,0,1,1,0,0,D
1899-02-04,1898,Preston North End,Aston Villa,2-0,2,0,1,1,2,2,H
1899-02-04,1898,Sheffield United,Bury,4-1,4,1,1,1,5,3,H
1899-02-04,1898,West Bromwich Albion,Sunderland,1-0,1,0,1,1,1,1,H
1899-02-14,1898,Bury,Blackburn Rovers,3-2,3,2,1,1,5,1,H
1899-02-14,1898,Sheffield Wednesday,West Bromwich Albion,1-2,1,2,1,1,3,-1,A
1899-02-18,1898,Blackburn Rovers,Wolverhampton Wanderers,2-2,2,2,1,1,4,0,D
1899-02-18,1898,Bolton Wanderers,Stoke City,0-2,0,2,1,1,2,-2,A
1899-02-18,1898,Derby County,Notts County,4-2,4,2,1,1,6,2,H
1899-02-18,1898,Liverpool,Burnley,2-0,2,0,1,1,2,2,H
1899-02-18,1898,Newcastle United,Bury,2-0,2,0,1,1,2,2,H
1899-02-18,1898,Nottingham Forest,Aston Villa,1-0,1,0,1,1,1,1,H
1899-02-18,1898,Preston North End,Sheffield United,1-0,1,0,1,1,1,1,H
1899-02-18,1898,Sheffield Wednesday,Sunderland,0-1,0,1,1,1,1,-1,A
1899-02-25,1898,Bolton Wanderers,Everton,2-4,2,4,1,1,6,-2,A
1899-02-25,1898,Newcastle United,Preston North End,2-1,2,1,1,1,3,1,H
1899-02-25,1898,Wolverhampton Wanderers,Sheffield Wednesday,0-0,0,0,1,1,0,0,D
1899-03-04,1898,Derby County,Aston Villa,1-1,1,1,1,1,2,0,D
1899-03-04,1898,Nottingham Forest,Sheffield United,2-1,2,1,1,1,3,1,H
1899-03-04,1898,Sheffield Wednesday,Everton,1-2,1,2,1,1,3,-1,A
1899-03-04,1898,Sunderland,Wolverhampton Wanderers,3-0,3,0,1,1,3,3,H
1899-03-04,1898,West Bromwich Albion,Stoke City,0-1,0,1,1,1,1,-1,A
1899-03-06,1898,Burnley,Nottingham Forest,1-1,1,1,1,1,2,0,D
1899-03-09,1898,Notts County,West Bromwich Albion,0-0,0,0,1,1,0,0,D
1899-03-11,1898,Burnley,Derby County,2-1,2,1,1,1,3,1,H
1899-03-11,1898,Everton,Sunderland,0-0,0,0,1,1,0,0,D
1899-03-11,1898,Newcastle United,Nottingham Forest,0-1,0,1,1,1,1,-1,A
1899-03-11,1898,Notts County,Sheffield Wednesday,1-0,1,0,1,1,1,1,H
1899-03-11,1898,Preston North End,Liverpool,1-2,1,2,1,1,3,-1,A
1899-03-11,1898,Sheffield United,Bolton Wanderers,3-1,3,1,1,1,4,2,H
1899-03-11,1898,Stoke City,Blackburn Rovers,0-1,0,1,1,1,1,-1,A
1899-03-13,1898,Sheffield Wednesday,Aston Villa,4-1,4,1,1,1,5,3,H
1899-03-14,1898,Bury,Wolverhampton Wanderers,0-2,0,2,1,1,2,-2,A
1899-03-18,1898,Blackburn Rovers,Aston Villa,0-0,0,0,1,1,0,0,D
1899-03-18,1898,Bolton Wanderers,Newcastle United,0-0,0,0,1,1,0,0,D
1899-03-18,1898,Bury,Everton,3-1,3,1,1,1,4,2,H
1899-03-18,1898,Sunderland,Notts County,1-1,1,1,1,1,2,0,D
1899-03-18,1898,West Bromwich Albion,Burnley,0-1,0,1,1,1,1,-1,A
1899-03-20,1898,Preston North End,Notts County,2-0,2,0,1,1,2,2,H
1899-03-25,1898,Aston Villa,Sheffield Wednesday,3-1,3,1,1,1,4,2,H
1899-03-25,1898,Liverpool,Nottingham Forest,0-1,0,1,1,1,1,-1,A
1899-03-25,1898,Newcastle United,Derby County,2-0,2,0,1,1,2,2,H
1899-03-25,1898,Notts County,Wolverhampton Wanderers,0-2,0,2,1,1,2,-2,A
1899-03-25,1898,Sheffield United,West Bromwich Albion,5-0,5,0,1,1,5,5,H
1899-03-25,1898,Stoke City,Sunderland,1-0,1,0,1,1,1,1,H
1899-03-27,1898,Sheffield Wednesday,Stoke City,1-3,1,3,1,1,4,-2,A
1899-03-31,1898,Bolton Wanderers,Derby County,2-1,2,1,1,1,3,1,H
1899-03-31,1898,Burnley,Sheffield United,1-0,1,0,1,1,1,1,H
1899-03-31,1898,Bury,Sunderland,1-2,1,2,1,1,3,-1,A
1899-04-01,1898,Blackburn Rovers,Sheffield United,2-1,2,1,1,1,3,1,H
1899-04-01,1898,Bolton Wanderers,Liverpool,2-1,2,1,1,1,3,1,H
1899-04-01,1898,Derby County,Preston North End,1-0,1,0,1,1,1,1,H
1899-04-01,1898,Everton,Notts County,1-2,1,2,1,1,3,-1,A
1899-04-01,1898,Nottingham Forest,Bury,1-2,1,2,1,1,3,-1,A
1899-04-01,1898,Sheffield Wednesday,Burnley,1-0,1,0,1,1,1,1,H
1899-04-01,1898,Sunderland,Aston Villa,4-2,4,2,1,1,6,2,H
1899-04-01,1898,West Bromwich Albion,Newcastle United,2-0,2,0,1,1,2,2,H
1899-04-01,1898,Wolverhampton Wanderers,Stoke City,3-2,3,2,1,1,5,1,H
1899-04-03,1898,Everton,Derby County,1-2,1,2,1,1,3,-1,A
1899-04-03,1898,Liverpool,Newcastle United,3-2,3,2,1,1,5,1,H
1899-04-03,1898,Notts County,Bolton Wanderers,2-1,2,1,1,1,3,1,H
1899-04-03,1898,Sunderland,Blackburn Rovers,0-1,0,1,1,1,1,-1,A
1899-04-03,1898,Wolverhampton Wanderers,Aston Villa,4-0,4,0,1,1,4,4,H
1899-04-04,1898,Wolverhampton Wanderers,Bolton Wanderers,1-0,1,0,1,1,1,1,H
1899-04-08,1898,Burnley,Sunderland,1-0,1,0,1,1,1,1,H
1899-04-08,1898,Bury,Notts County,2-0,2,0,1,1,2,2,H
1899-04-08,1898,Liverpool,Derby County,4-0,4,0,1,1,4,4,H
1899-04-08,1898,Newcastle United,Blackburn Rovers,1-0,1,0,1,1,1,1,H
1899-04-08,1898,Nottingham Forest,Bolton Wanderers,1-2,1,2,1,1,3,-1,A
1899-04-08,1898,Preston North End,West Bromwich Albion,4-0,4,0,1,1,4,4,H
1899-04-08,1898,Stoke City,Everton,2-1,2,1,1,1,3,1,H
1899-04-15,1898,Blackburn Rovers,Preston North End,2-2,2,2,1,1,4,0,D
1899-04-15,1898,Bury,Bolton Wanderers,3-1,3,1,1,1,4,2,H
1899-04-15,1898,Everton,Aston Villa,1-1,1,1,1,1,2,0,D
1899-04-15,1898,Notts County,Stoke City,2-0,2,0,1,1,2,2,H
1899-04-15,1898,Sheffield Wednesday,Newcastle United,1-3,1,3,1,1,4,-2,A
1899-04-15,1898,Wolverhampton Wanderers,Burnley,4-0,4,0,1,1,4,4,H
1899-04-17,1898,Bolton Wanderers,Aston Villa,0-0,0,0,1,1,0,0,D
1899-04-17,1898,Burnley,Stoke City,1-1,1,1,1,1,2,0,D
1899-04-20,1898,Derby County,Nottingham Forest,2-0,2,0,1,1,2,2,H
1899-04-20,1898,Liverpool,Bury,1-0,1,0,1,1,1,1,H
1899-04-22,1898,Aston Villa,Notts County,6-1,6,1,1,1,7,5,H
1899-04-22,1898,Burnley,Everton,0-0,0,0,1,1,0,0,D
1899-04-22,1898,Derby County,Sheffield United,1-0,1,0,1,1,1,1,H
1899-04-22,1898,Liverpool,Blackburn Rovers,2-0,2,0,1,1,2,2,H
1899-04-22,1898,Newcastle United,Sunderland,0-1,0,1,1,1,1,-1,A
1899-04-22,1898,Nottingham Forest,West Bromwich Albion,3-0,3,0,1,1,3,3,H
1899-04-22,1898,Preston North End,Sheffield Wednesday,1-1,1,1,1,1,2,0,D
1899-04-22,1898,Stoke City,Bury,1-1,1,1,1,1,2,0,D
1899-04-24,1898,Aston Villa,West Bromwich Albion,7-1,7,1,1,1,8,6,H
1899-04-29,1898,Aston Villa,Liverpool,5-0,5,0,1,1,5,5,H
1899-04-29,1898,Preston North End,Bolton Wanderers,0-1,0,1,1,1,1,-1,A
1899-04-29,1898,Sunderland,Sheffield United,1-0,1,0,1,1,1,1,H
1899-04-29,1898,Wolverhampton Wanderers,Everton,1-2,1,2,1,1,3,-1,A
1899-09-02,1899,Blackburn Rovers,Manchester City,4-3,4,3,1,1,7,1,H
1899-09-02,1899,Bury,Wolverhampton Wanderers,3-0,3,0,1,1,3,3,H
1899-09-02,1899,Derby County,Notts County,0-1,0,1,1,1,1,-1,A
1899-09-02,1899,Everton,Sheffield United,1-2,1,2,1,1,3,-1,A
1899-09-02,1899,Glossop North End,Burnley,2-0,2,0,1,1,2,2,H
1899-09-02,1899,Nottingham Forest,Preston North End,3-1,3,1,1,1,4,2,H
1899-09-02,1899,Stoke City,Liverpool,3-2,3,2,1,1,5,1,H
1899-09-02,1899,Sunderland,Aston Villa,0-1,0,1,1,1,1,-1,A
1899-09-02,1899,West Bromwich Albion,Newcastle United,1-1,1,1,1,1,2,0,D
1899-09-04,1899,Aston Villa,Glossop North End,9-0,9,0,1,1,9,9,H
1899-09-09,1899,Aston Villa,West Bromwich Albion,0-2,0,2,1,1,2,-2,A
1899-09-09,1899,Burnley,Stoke City,2-2,2,2,1,1,4,0,D
1899-09-09,1899,Liverpool,Sunderland,0-2,0,2,1,1,2,-2,A
1899-09-09,1899,Manchester City,Derby County,4-0,4,0,1,1,4,4,H
1899-09-09,1899,Newcastle United,Everton,2-0,2,0,1,1,2,2,H
1899-09-09,1899,Notts County,Bury,2-2,2,2,1,1,4,0,D
1899-09-09,1899,Preston North End,Glossop North End,1-0,1,0,1,1,1,1,H
1899-09-09,1899,Sheffield United,Blackburn Rovers,3-0,3,0,1,1,3,3,H
1899-09-09,1899,Wolverhampton Wanderers,Nottingham Forest,2-2,2,2,1,1,4,0,D
1899-09-16,1899,Blackburn Rovers,Newcastle United,2-3,2,3,1,1,5,-1,A
1899-09-16,1899,Bury,Manchester City,1-4,1,4,1,1,5,-3,A
1899-09-16,1899,Derby County,Sheffield United,0-1,0,1,1,1,1,-1,A
1899-09-16,1899,Everton,Aston Villa,1-2,1,2,1,1,3,-1,A
1899-09-16,1899,Glossop North End,Nottingham Forest,3-0,3,0,1,1,3,3,H
1899-09-16,1899,Notts County,Wolverhampton Wanderers,0-0,0,0,1,1,0,0,D
1899-09-16,1899,Stoke City,Preston North End,3-1,3,1,1,1,4,2,H
1899-09-16,1899,Sunderland,Burnley,2-1,2,1,1,1,3,1,H
1899-09-16,1899,West Bromwich Albion,Liverpool,2-0,2,0,1,1,2,2,H
1899-09-18,1899,Stoke City,Wolverhampton Wanderers,1-3,1,3,1,1,4,-2,A
1899-09-23,1899,Aston Villa,Blackburn Rovers,3-1,3,1,1,1,4,2,H
1899-09-23,1899,Burnley,West Bromwich Albion,2-0,2,0,1,1,2,2,H
1899-09-23,1899,Liverpool,Everton,1-2,1,2,1,1,3,-1,A
1899-09-23,1899,Manchester City,Notts County,5-1,5,1,1,1,6,4,H
1899-09-23,1899,Newcastle United,Derby County,2-0,2,0,1,1,2,2,H
1899-09-23,1899,Nottingham Forest,Stoke City,1-0,1,0,1,1,1,1,H
1899-09-23,1899,Preston North End,Sunderland,0-1,0,1,1,1,1,-1,A
1899-09-23,1899,Sheffield United,Bury,4-0,4,0,1,1,4,4,H
1899-09-23,1899,Wolverhampton Wanderers,Glossop North End,4-0,4,0,1,1,4,4,H
1899-09-30,1899,Blackburn Rovers,Liverpool,2-0,2,0,1,1,2,2,H
1899-09-30,1899,Bury,Newcastle United,2-1,2,1,1,1,3,1,H
1899-09-30,1899,Derby County,Aston Villa,2-0,2,0,1,1,2,2,H
1899-09-30,1899,Everton,Burnley,2-0,2,0,1,1,2,2,H
1899-09-30,1899,Manchester City,Wolverhampton Wanderers,1-1,1,1,1,1,2,0,D
1899-09-30,1899,Notts County,Sheffield United,1-2,1,2,1,1,3,-1,A
1899-09-30,1899,Stoke City,Glossop North End,1-0,1,0,1,1,1,1,H
1899-09-30,1899,Sunderland,Nottingham Forest,1-0,1,0,1,1,1,1,H
1899-09-30,1899,West Bromwich Albion,Preston North End,1-0,1,0,1,1,1,1,H
1899-10-02,1899,Sheffield United,Sunderland,2-2,2,2,1,1,4,0,D
1899-10-05,1899,Notts County,Liverpool,2-1,2,1,1,1,3,1,H
1899-10-07,1899,Aston Villa,Bury,2-1,2,1,1,1,3,1,H
1899-10-07,1899,Burnley,Blackburn Rovers,1-0,1,0,1,1,1,1,H
1899-10-07,1899,Glossop North End,Sunderland,0-2,0,2,1,1,2,-2,A
1899-10-07,1899,Liverpool,Derby County,0-2,0,2,1,1,2,-2,A
1899-10-07,1899,Newcastle United,Notts County,6-0,6,0,1,1,6,6,H
1899-10-07,1899,Nottingham Forest,West Bromwich Albion,6-1,6,1,1,1,7,5,H
1899-10-07,1899,Preston North End,Everton,1-1,1,1,1,1,2,0,D
1899-10-07,1899,Sheffield United,Manchester City,3-0,3,0,1,1,3,3,H
1899-10-07,1899,Wolverhampton Wanderers,Stoke City,0-2,0,2,1,1,2,-2,A
1899-10-14,1899,Blackburn Rovers,Preston North End,3-0,3,0,1,1,3,3,H
1899-10-14,1899,Bury,Liverpool,2-1,2,1,1,1,3,1,H
1899-10-14,1899,Derby County,Burnley,4-1,4,1,1,1,5,3,H
1899-10-14,1899,Everton,Nottingham Forest,2-1,2,1,1,1,3,1,H
1899-10-14,1899,Manchester City,Newcastle United,1-0,1,0,1,1,1,1,H
1899-10-14,1899,Notts County,Aston Villa,1-4,1,4,1,1,5,-3,A
1899-10-14,1899,Sheffield United,Wolverhampton Wanderers,5-2,5,2,1,1,7,3,H
1899-10-14,1899,Sunderland,Stoke City,3-0,3,0,1,1,3,3,H
1899-10-14,1899,West Bromwich Albion,Glossop North End,3-3,3,3,1,1,6,0,D
1899-10-21,1899,Aston Villa,Manchester City,2-1,2,1,1,1,3,1,H
1899-10-21,1899,Burnley,Bury,1-0,1,0,1,1,1,1,H
1899-10-21,1899,Glossop North End,Everton,1-1,1,1,1,1,2,0,D
1899-10-21,1899,Liverpool,Notts County,3-1,3,1,1,1,4,2,H
1899-10-21,1899,Newcastle United,Sheffield United,0-0,0,0,1,1,0,0,D
1899-10-21,1899,Nottingham Forest,Blackburn Rovers,3-2,3,2,1,1,5,1,H
1899-10-21,1899,Preston North End,Derby County,0-0,0,0,1,1,0,0,D
1899-10-21,1899,Stoke City,West Bromwich Albion,1-0,1,0,1,1,1,1,H
1899-10-28,1899,Bury,Preston North End,2-0,2,0,1,1,2,2,H
1899-10-28,1899,Derby County,Nottingham Forest,2-2,2,2,1,1,4,0,D
1899-10-28,1899,Manchester City,Liverpool,0-1,0,1,1,1,1,-1,A
1899-10-28,1899,Newcastle United,Wolverhampton Wanderers,0-1,0,1,1,1,1,-1,A
1899-10-28,1899,Notts County,Burnley,6-1,6,1,1,1,7,5,H
1899-10-28,1899,Sheffield United,Aston Villa,2-1,2,1,1,1,3,1,H
1899-10-28,1899,Stoke City,Everton,1-1,1,1,1,1,2,0,D
1899-10-28,1899,West Bromwich Albion,Sunderland,1-0,1,0,1,1,1,1,H
1899-11-04,1899,Aston Villa,Newcastle United,2-1,2,1,1,1,3,1,H
1899-11-04,1899,Burnley,Manchester City,2-0,2,0,1,1,2,2,H
1899-11-04,1899,Liverpool,Sheffield United,2-2,2,2,1,1,4,0,D
1899-11-04,1899,Nottingham Forest,Bury,2-2,2,2,1,1,4,0,D
1899-11-04,1899,Preston North End,Notts County,4-3,4,3,1,1,7,1,H
1899-11-04,1899,Stoke City,Blackburn Rovers,2-0,2,0,1,1,2,2,H
1899-11-04,1899,Sunderland,Everton,1-0,1,0,1,1,1,1,H
1899-11-04,1899,Wolverhampton Wanderers,West Bromwich Albion,2-0,2,0,1,1,2,2,H
1899-11-06,1899,West Bromwich Albion,Sheffield United,1-2,1,2,1,1,3,-1,A
1899-11-11,1899,Aston Villa,Wolverhampton Wanderers,0-0,0,0,1,1,0,0,D
1899-11-11,1899,Blackburn Rovers,Sunderland,1-2,1,2,1,1,3,-1,A
1899-11-11,1899,Bury,Glossop North End,2-1,2,1,1,1,3,1,H
1899-11-11,1899,Derby County,Stoke City,2-0,2,0,1,1,2,2,H
1899-11-11,1899,Everton,West Bromwich Albion,1-3,1,3,1,1,4,-2,A
1899-11-11,1899,Manchester City,Preston North End,3-1,3,1,1,1,4,2,H
1899-11-11,1899,Newcastle United,Liverpool,1-1,1,1,1,1,2,0,D
1899-11-11,1899,Notts County,Nottingham Forest,1-2,1,2,1,1,3,-1,A
1899-11-11,1899,Sheffield United,Burnley,0-0,0,0,1,1,0,0,D
1899-11-13,1899,Stoke City,Aston Villa,0-2,0,2,1,1,2,-2,A
1899-11-18,1899,Burnley,Newcastle United,1-3,1,3,1,1,4,-2,A
1899-11-18,1899,Glossop North End,Notts County,0-0,0,0,1,1,0,0,D
1899-11-18,1899,Liverpool,Aston Villa,3-3,3,3,1,1,6,0,D
1899-11-18,1899,Preston North End,Sheffield United,0-1,0,1,1,1,1,-1,A
1899-11-25,1899,Aston Villa,Burnley,2-0,2,0,1,1,2,2,H
1899-11-25,1899,Blackburn Rovers,Everton,3-1,3,1,1,1,4,2,H
1899-11-25,1899,Bury,Sunderland,2-0,2,0,1,1,2,2,H
1899-11-25,1899,Derby County,West Bromwich Albion,4-1,4,1,1,1,5,3,H
1899-11-25,1899,Liverpool,Wolverhampton Wanderers,1-1,1,1,1,1,2,0,D
1899-11-25,1899,Manchester City,Glossop North End,4-1,4,1,1,1,5,3,H
1899-11-25,1899,Newcastle United,Preston North End,0-0,0,0,1,1,0,0,D
1899-11-25,1899,Notts County,Stoke City,1-3,1,3,1,1,4,-2,A
1899-11-25,1899,Sheffield United,Nottingham Forest,3-0,3,0,1,1,3,3,H
1899-12-02,1899,Burnley,Liverpool,2-1,2,1,1,1,3,1,H
1899-12-02,1899,Everton,Derby County,3-0,3,0,1,1,3,3,H
1899-12-02,1899,Glossop North End,Sheffield United,2-2,2,2,1,1,4,0,D
1899-12-02,1899,Nottingham Forest,Newcastle United,1-0,1,0,1,1,1,1,H
1899-12-02,1899,Preston North End,Aston Villa,0-5,0,5,1,1,5,-5,A
1899-12-02,1899,Stoke City,Manchester City,1-0,1,0,1,1,1,1,H
1899-12-02,1899,Sunderland,Notts County,5-0,5,0,1,1,5,5,H
1899-12-02,1899,West Bromwich Albion,Bury,0-1,0,1,1,1,1,-1,A
1899-12-02,1899,Wolverhampton Wanderers,Blackburn Rovers,4-0,4,0,1,1,4,4,H
1899-12-09,1899,Aston Villa,Nottingham Forest,2-2,2,2,1,1,4,0,D
1899-12-09,1899,Burnley,Wolverhampton Wanderers,0-1,0,1,1,1,1,-1,A
1899-12-09,1899,Bury,Everton,4-1,4,1,1,1,5,3,H
1899-12-09,1899,Derby County,Blackburn Rovers,0-2,0,2,1,1,2,-2,A
1899-12-09,1899,Liverpool,Preston North End,1-0,1,0,1,1,1,1,H
1899-12-09,1899,Manchester City,Sunderland,2-1,2,1,1,1,3,1,H
1899-12-09,1899,Notts County,West Bromwich Albion,1-2,1,2,1,1,3,-1,A
1899-12-09,1899,Sheffield United,Stoke City,1-0,1,0,1,1,1,1,H
1899-12-16,1899,Blackburn Rovers,Bury,3-2,3,2,1,1,5,1,H
1899-12-16,1899,Derby County,Wolverhampton Wanderers,0-2,0,2,1,1,2,-2,A
1899-12-16,1899,Everton,Notts County,0-2,0,2,1,1,2,-2,A
1899-12-16,1899,Glossop North End,Aston Villa,1-0,1,0,1,1,1,1,H
1899-12-16,1899,Nottingham Forest,Liverpool,1-0,1,0,1,1,1,1,H
1899-12-16,1899,Preston North End,Burnley,1-1,1,1,1,1,2,0,D
1899-12-16,1899,Stoke City,Newcastle United,2-2,2,2,1,1,4,0,D
1899-12-16,1899,Sunderland,Sheffield United,1-1,1,1,1,1,2,0,D
1899-12-16,1899,West Bromwich Albion,Manchester City,0-0,0,0,1,1,0,0,D
1899-12-23,1899,Aston Villa,Stoke City,4-1,4,1,1,1,5,3,H
1899-12-23,1899,Burnley,Nottingham Forest,2-2,2,2,1,1,4,0,D
1899-12-23,1899,Bury,Derby County,1-1,1,1,1,1,2,0,D
1899-12-23,1899,Liverpool,Glossop North End,5-2,5,2,1,1,7,3,H
1899-12-23,1899,Manchester City,Everton,1-2,1,2,1,1,3,-1,A
1899-12-23,1899,Newcastle United,Sunderland,2-4,2,4,1,1,6,-2,A
1899-12-23,1899,Notts County,Blackburn Rovers,5-1,5,1,1,1,6,4,H
1899-12-23,1899,Sheffield United,West Bromwich Albion,1-1,1,1,1,1,2,0,D
1899-12-23,1899,Wolverhampton Wanderers,Preston North End,1-3,1,3,1,1,4,-2,A
1899-12-25,1899,Bury,Nottingham Forest,2-1,2,1,1,1,3,1,H
1899-12-25,1899,Derby County,Liverpool,3-2,3,2,1,1,5,1,H
1899-12-25,1899,Everton,Stoke City,2-0,2,0,1,1,2,2,H
1899-12-25,1899,Manchester City,Sheffield United,1-2,1,2,1,1,3,-1,A
1899-12-26,1899,Derby County,Glossop North End,4-1,4,1,1,1,5,3,H
1899-12-26,1899,Stoke City,Burnley,3-0,3,0,1,1,3,3,H
1899-12-26,1899,West Bromwich Albion,Everton,0-0,0,0,1,1,0,0,D
1899-12-26,1899,Wolverhampton Wanderers,Sunderland,1-0,1,0,1,1,1,1,H
1899-12-27,1899,Nottingham Forest,Manchester City,2-0,2,0,1,1,2,2,H
1899-12-29,1899,Aston Villa,Sunderland,4-2,4,2,1,1,6,2,H
1899-12-29,1899,Burnley,Glossop North End,3-1,3,1,1,1,4,2,H
1899-12-29,1899,Liverpool,Stoke City,0-0,0,0,1,1,0,0,D
1899-12-29,1899,Manchester City,Blackburn Rovers,1-1,1,1,1,1,2,0,D
1899-12-29,1899,Newcastle United,West Bromwich Albion,4-2,4,2,1,1,6,2,H
1899-12-29,1899,Notts County,Derby County,0-0,0,0,1,1,0,0,D
1899-12-29,1899,Preston North End,Nottingham Forest,3-0,3,0,1,1,3,3,H
1899-12-29,1899,Sheffield United,Everton,5-0,5,0,1,1,5,5,H
1899-12-29,1899,Wolverhampton Wanderers,Bury,1-0,1,0,1,1,1,1,H
1900-01-01,1899,Blackburn Rovers,Burnley,2-0,2,0,1,1,2,2,H
1900-01-01,1899,Bury,Aston Villa,2-0,2,0,1,1,2,2,H
1900-01-01,1899,Everton,Preston North End,1-0,1,0,1,1,1,1,H
1900-01-01,1899,Sunderland,Wolverhampton Wanderers,1-2,1,2,1,1,3,-1,A
1900-01-06,1899,Bury,Notts County,0-1,0,1,1,1,1,-1,A
1900-01-06,1899,Derby County,Manchester City,0-0,0,0,1,1,0,0,D
1900-01-06,1899,Everton,Newcastle United,3-2,3,2,1,1,5,1,H
1900-01-06,1899,Glossop North End,Preston North End,0-2,0,2,1,1,2,-2,A
1900-01-06,1899,Nottingham Forest,Wolverhampton Wanderers,0-0,0,0,1,1,0,0,D
1900-01-06,1899,Sunderland,Liverpool,1-0,1,0,1,1,1,1,H
1900-01-06,1899,West Bromwich Albion,Aston Villa,0-2,0,2,1,1,2,-2,A
1900-01-13,1899,Aston Villa,Everton,1-1,1,1,1,1,2,0,D
1900-01-13,1899,Burnley,Sunderland,3-1,3,1,1,1,4,2,H
1900-01-13,1899,Liverpool,West Bromwich Albion,2-0,2,0,1,1,2,2,H
1900-01-13,1899,Manchester City,Bury,2-2,2,2,1,1,4,0,D
1900-01-13,1899,Newcastle United,Blackburn Rovers,4-1,4,1,1,1,5,3,H
1900-01-13,1899,Nottingham Forest,Glossop North End,5-0,5,0,1,1,5,5,H
1900-01-13,1899,Preston North End,Stoke City,3-0,3,0,1,1,3,3,H
1900-01-13,1899,Sheffield United,Derby County,1-1,1,1,1,1,2,0,D
1900-01-13,1899,Wolverhampton Wanderers,Notts County,2-2,2,2,1,1,4,0,D
1900-01-20,1899,Blackburn Rovers,Aston Villa,0-4,0,4,1,1,4,-4,A
1900-01-20,1899,Bury,Sheffield United,2-1,2,1,1,1,3,1,H
1900-01-20,1899,Derby County,Newcastle United,2-1,2,1,1,1,3,1,H
1900-01-20,1899,Everton,Liverpool,3-1,3,1,1,1,4,2,H
1900-01-20,1899,Glossop North End,Wolverhampton Wanderers,2-3,2,3,1,1,5,-1,A
1900-01-20,1899,Notts County,Manchester City,1-1,1,1,1,1,2,0,D
1900-01-20,1899,Stoke City,Nottingham Forest,0-0,0,0,1,1,0,0,D
1900-01-20,1899,Sunderland,Preston North End,1-0,1,0,1,1,1,1,H
1900-01-20,1899,West Bromwich Albion,Burnley,2-0,2,0,1,1,2,2,H
1900-02-03,1899,Aston Villa,Derby County,3-2,3,2,1,1,5,1,H
1900-02-03,1899,Burnley,Everton,3-1,3,1,1,1,4,2,H
1900-02-03,1899,Glossop North End,Stoke City,1-2,1,2,1,1,3,-1,A
1900-02-03,1899,Liverpool,Blackburn Rovers,3-1,3,1,1,1,4,2,H
1900-02-03,1899,Newcastle United,Bury,2-1,2,1,1,1,3,1,H
1900-02-03,1899,Preston North End,West Bromwich Albion,5-2,5,2,1,1,7,3,H
1900-02-03,1899,Sheffield United,Notts County,1-1,1,1,1,1,2,0,D
1900-02-03,1899,Wolverhampton Wanderers,Manchester City,1-1,1,1,1,1,2,0,D
1900-02-17,1899,Aston Villa,Notts County,6-2,6,2,1,1,8,4,H
1900-02-17,1899,Burnley,Derby County,1-2,1,2,1,1,3,-1,A
1900-02-17,1899,Nottingham Forest,Everton,4-2,4,2,1,1,6,2,H
1900-02-24,1899,Sunderland,Glossop North End,0-0,0,0,1,1,0,0,D
1900-02-27,1899,Glossop North End,Blackburn Rovers,4-2,4,2,1,1,6,2,H
1900-03-03,1899,Aston Villa,Sheffield United,1-1,1,1,1,1,2,0,D
1900-03-03,1899,Blackburn Rovers,Glossop North End,2-2,2,2,1,1,4,0,D
1900-03-03,1899,Burnley,Notts County,3-0,3,0,1,1,3,3,H
1900-03-03,1899,Liverpool,Manchester City,5-2,5,2,1,1,7,3,H
1900-03-03,1899,Nottingham Forest,Derby County,4-1,4,1,1,1,5,3,H
1900-03-03,1899,Preston North End,Bury,1-0,1,0,1,1,1,1,H
1900-03-03,1899,Sunderland,West Bromwich Albion,3-1,3,1,1,1,4,2,H
1900-03-03,1899,Wolverhampton Wanderers,Newcastle United,1-1,1,1,1,1,2,0,D
1900-03-05,1899,Blackburn Rovers,Nottingham Forest,2-1,2,1,1,1,3,1,H
1900-03-10,1899,Blackburn Rovers,Stoke City,3-0,3,0,1,1,3,3,H
1900-03-10,1899,Everton,Sunderland,1-0,1,0,1,1,1,1,H
1900-03-10,1899,Manchester City,Burnley,1-0,1,0,1,1,1,1,H
1900-03-10,1899,Newcastle United,Aston Villa,3-2,3,2,1,1,5,1,H
1900-03-10,1899,Notts County,Preston North End,3-0,3,0,1,1,3,3,H
1900-03-10,1899,Sheffield United,Liverpool,1-2,1,2,1,1,3,-1,A
1900-03-10,1899,West Bromwich Albion,Wolverhampton Wanderers,3-2,3,2,1,1,5,1,H
1900-03-14,1899,Bury,Burnley,1-1,1,1,1,1,2,0,D
1900-03-14,1899,Newcastle United,Glossop North End,1-0,1,0,1,1,1,1,H
1900-03-17,1899,Glossop North End,Bury,0-0,0,0,1,1,0,0,D
1900-03-17,1899,Liverpool,Newcastle United,2-0,2,0,1,1,2,2,H
1900-03-17,1899,Nottingham Forest,Notts County,0-3,0,3,1,1,3,-3,A
1900-03-17,1899,Stoke City,Derby County,1-1,1,1,1,1,2,0,D
1900-03-17,1899,Wolverhampton Wanderers,Everton,2-1,2,1,1,1,3,1,H
1900-03-19,1899,Manchester City,Aston Villa,0-2,0,2,1,1,2,-2,A
1900-03-19,1899,West Bromwich Albion,Stoke City,4-0,4,0,1,1,4,4,H
1900-03-21,1899,Sunderland,Derby County,2-0,2,0,1,1,2,2,H
1900-03-24,1899,Aston Villa,Liverpool,1-0,1,0,1,1,1,1,H
1900-03-24,1899,Blackburn Rovers,West Bromwich Albion,2-0,2,0,1,1,2,2,H
1900-03-24,1899,Derby County,Sunderland,2-0,2,0,1,1,2,2,H
1900-03-24,1899,Everton,Wolverhampton Wanderers,0-1,0,1,1,1,1,-1,A
1900-03-24,1899,Newcastle United,Burnley,2-0,2,0,1,1,2,2,H
1900-03-24,1899,Notts County,Glossop North End,0-0,0,0,1,1,0,0,D
1900-03-24,1899,Sheffield United,Preston North End,1-0,1,0,1,1,1,1,H
1900-03-26,1899,Sheffield United,Newcastle United,3-1,3,1,1,1,4,2,H
1900-03-26,1899,Stoke City,Sunderland,1-2,1,2,1,1,3,-1,A
1900-03-31,1899,Burnley,Aston Villa,1-2,1,2,1,1,3,-1,A
1900-03-31,1899,Everton,Blackburn Rovers,0-0,0,0,1,1,0,0,D
1900-03-31,1899,Glossop North End,Manchester City,0-2,0,2,1,1,2,-2,A
1900-03-31,1899,Nottingham Forest,Sheffield United,4-0,4,0,1,1,4,4,H
1900-03-31,1899,Preston North End,Newcastle United,4-1,4,1,1,1,5,3,H
1900-03-31,1899,Stoke City,Notts County,1-0,1,0,1,1,1,1,H
1900-03-31,1899,Sunderland,Bury,1-0,1,0,1,1,1,1,H
1900-03-31,1899,West Bromwich Albion,Derby County,0-0,0,0,1,1,0,0,D
1900-03-31,1899,Wolverhampton Wanderers,Liverpool,0-1,0,1,1,1,1,-1,A
1900-04-02,1899,West Bromwich Albion,Blackburn Rovers,1-0,1,0,1,1,1,1,H
1900-04-04,1899,Derby County,Preston North End,2-0,2,0,1,1,2,2,H
1900-04-07,1899,Aston Villa,Preston North End,3-1,3,1,1,1,4,2,H
1900-04-07,1899,Blackburn Rovers,Wolverhampton Wanderers,2-1,2,1,1,1,3,1,H
1900-04-07,1899,Bury,West Bromwich Albion,1-0,1,0,1,1,1,1,H
1900-04-07,1899,Derby County,Everton,2-1,2,1,1,1,3,1,H
1900-04-07,1899,Liverpool,Burnley,0-1,0,1,1,1,1,-1,A
1900-04-07,1899,Manchester City,Stoke City,1-0,1,0,1,1,1,1,H
1900-04-07,1899,Newcastle United,Nottingham Forest,3-1,3,1,1,1,4,2,H
1900-04-07,1899,Notts County,Sunderland,3-1,3,1,1,1,4,2,H
1900-04-07,1899,Sheffield United,Glossop North End,4-0,4,0,1,1,4,4,H
1900-04-09,1899,Liverpool,Bury,2-0,2,0,1,1,2,2,H
1900-04-09,1899,Manchester City,Nottingham Forest,2-0,2,0,1,1,2,2,H
1900-04-13,1899,Blackburn Rovers,Sheffield United,3-3,3,3,1,1,6,0,D
1900-04-13,1899,Bury,Stoke City,0-1,0,1,1,1,1,-1,A
1900-04-13,1899,Glossop North End,Derby County,1-3,1,3,1,1,4,-2,A
1900-04-13,1899,Newcastle United,Manchester City,0-0,0,0,1,1,0,0,D
1900-04-14,1899,Blackburn Rovers,Derby County,2-0,2,0,1,1,2,2,H
1900-04-14,1899,Everton,Bury,2-0,2,0,1,1,2,2,H
1900-04-14,1899,Glossop North End,Newcastle United,0-0,0,0,1,1,0,0,D
1900-04-14,1899,Nottingham Forest,Aston Villa,1-1,1,1,1,1,2,0,D
1900-04-14,1899,Preston North End,Liverpool,1-3,1,3,1,1,4,-2,A
1900-04-14,1899,Stoke City,Sheffield United,1-1,1,1,1,1,2,0,D
1900-04-14,1899,Sunderland,Manchester City,3-1,3,1,1,1,4,2,H
1900-04-14,1899,West Bromwich Albion,Notts County,0-0,0,0,1,1,0,0,D
1900-04-14,1899,Wolverhampton Wanderers,Burnley,3-0,3,0,1,1,3,3,H
1900-04-16,1899,Everton,Glossop North End,4-1,4,1,1,1,5,3,H
1900-04-16,1899,Notts County,Newcastle United,0-0,0,0,1,1,0,0,D
1900-04-16,1899,Preston North End,Manchester City,0-2,0,2,1,1,2,-2,A
1900-04-16,1899,Stoke City,Bury,2-0,2,0,1,1,2,2,H
1900-04-16,1899,Sunderland,Blackburn Rovers,1-0,1,0,1,1,1,1,H
1900-04-16,1899,West Bromwich Albion,Nottingham Forest,8-0,8,0,1,1,8,8,H
1900-04-16,1899,Wolverhampton Wanderers,Aston Villa,0-1,0,1,1,1,1,-1,A
1900-04-17,1899,Nottingham Forest,Sunderland,1-3,1,3,1,1,4,-2,A
1900-04-17,1899,Wolverhampton Wanderers,Sheffield United,1-2,1,2,1,1,3,-1,A
1900-04-21,1899,Burnley,Preston North End,0-1,0,1,1,1,1,-1,A
1900-04-21,1899,Liverpool,Nottingham Forest,1-0,1,0,1,1,1,1,H
1900-04-21,1899,Manchester City,West Bromwich Albion,4-0,4,0,1,1,4,4,H
1900-04-21,1899,Newcastle United,Stoke City,2-2,2,2,1,1,4,0,D
1900-04-21,1899,Notts County,Everton,2-2,2,2,1,1,4,0,D
1900-04-21,1899,Wolverhampton Wanderers,Derby County,3-0,3,0,1,1,3,3,H
1900-04-23,1899,Burnley,Sheffield United,1-0,1,0,1,1,1,1,H
1900-04-24,1899,Glossop North End,West Bromwich Albion,1-1,1,1,1,1,2,0,D
1900-04-25,1899,Bury,Blackburn Rovers,2-0,2,0,1,1,2,2,H
1900-04-28,1899,Blackburn Rovers,Notts County,2-0,2,0,1,1,2,2,H
1900-04-28,1899,Derby County,Bury,3-0,3,0,1,1,3,3,H
1900-04-28,1899,Everton,Manchester City,4-0,4,0,1,1,4,4,H
1900-04-28,1899,Glossop North End,Liverpool,1-2,1,2,1,1,3,-1,A
1900-04-28,1899,Nottingham Forest,Burnley,4-0,4,0,1,1,4,4,H
1900-04-28,1899,Preston North End,Wolverhampton Wanderers,2-0,2,0,1,1,2,2,H
1900-04-28,1899,Sunderland,Newcastle United,1-2,1,2,1,1,3,-1,A
1900-04-30,1899,Preston North End,Blackburn Rovers,2-0,2,0,1,1,2,2,H
1900-09-01,1900,Aston Villa,Stoke City,2-0,2,0,1,1,2,2,H
1900-09-01,1900,Bolton Wanderers,Derby County,0-1,0,1,1,1,1,-1,A
1900-09-01,1900,Liverpool,Blackburn Rovers,3-0,3,0,1,1,3,3,H
1900-09-01,1900,Manchester City,Sheffield Wednesday,2-2,2,2,1,1,4,0,D
1900-09-01,1900,Newcastle United,Nottingham Forest,0-0,0,0,1,1,0,0,D
1900-09-01,1900,Notts County,Sunderland,2-2,2,2,1,1,4,0,D
1900-09-01,1900,Preston North End,Everton,1-2,1,2,1,1,3,-1,A
1900-09-01,1900,Sheffield United,Bury,0-3,0,3,1,1,3,-3,A
1900-09-01,1900,Wolverhampton Wanderers,West Bromwich Albion,0-0,0,0,1,1,0,0,D
1900-09-03,1900,Aston Villa,Preston North End,4-0,4,0,1,1,4,4,H
1900-09-03,1900,West Bromwich Albion,Derby County,1-1,1,1,1,1,2,0,D
1900-09-03,1900,Wolverhampton Wanderers,Notts County,3-2,3,2,1,1,5,1,H
1900-09-08,1900,Blackburn Rovers,Newcastle United,0-0,0,0,1,1,0,0,D
1900-09-08,1900,Bury,Manchester City,4-0,4,0,1,1,4,4,H
1900-09-08,1900,Derby County,Notts County,2-1,2,1,1,1,3,1,H
1900-09-08,1900,Everton,Wolverhampton Wanderers,5-1,5,1,1,1,6,4,H
1900-09-08,1900,Nottingham Forest,Sheffield United,2-0,2,0,1,1,2,2,H
1900-09-08,1900,Sheffield Wednesday,Bolton Wanderers,1-0,1,0,1,1,1,1,H
1900-09-08,1900,Stoke City,Liverpool,1-2,1,2,1,1,3,-1,A
1900-09-08,1900,Sunderland,Preston North End,3-1,3,1,1,1,4,2,H
1900-09-08,1900,West Bromwich Albion,Aston Villa,0-1,0,1,1,1,1,-1,A
1900-09-10,1900,Aston Villa,Bury,1-0,1,0,1,1,1,1,H
1900-09-10,1900,Stoke City,Notts County,1-1,1,1,1,1,2,0,D
1900-09-15,1900,Aston Villa,Everton,1-2,1,2,1,1,3,-1,A
1900-09-15,1900,Bury,Sheffield Wednesday,2-0,2,0,1,1,2,2,H
1900-09-15,1900,Liverpool,West Bromwich Albion,5-0,5,0,1,1,5,5,H
1900-09-15,1900,Manchester City,Nottingham Forest,1-0,1,0,1,1,1,1,H
1900-09-15,1900,Newcastle United,Stoke City,2-1,2,1,1,1,3,1,H
1900-09-15,1900,Notts County,Bolton Wanderers,3-1,3,1,1,1,4,2,H
1900-09-15,1900,Preston North End,Derby County,3-2,3,2,1,1,5,1,H
1900-09-15,1900,Sheffield United,Blackburn Rovers,2-1,2,1,1,1,3,1,H
1900-09-15,1900,Wolverhampton Wanderers,Sunderland,2-2,2,2,1,1,4,0,D
1900-09-22,1900,Blackburn Rovers,Manchester City,1-0,1,0,1,1,1,1,H
1900-09-22,1900,Bolton Wanderers,Preston North End,1-1,1,1,1,1,2,0,D
1900-09-22,1900,Derby County,Wolverhampton Wanderers,4-5,4,5,1,1,9,-1,A
1900-09-22,1900,Everton,Liverpool,1-1,1,1,1,1,2,0,D
1900-09-22,1900,Nottingham Forest,Bury,1-1,1,1,1,1,2,0,D
1900-09-22,1900,Sheffield Wednesday,Notts County,4-1,4,1,1,1,5,3,H
1900-09-22,1900,Stoke City,Sheffield United,0-1,0,1,1,1,1,-1,A
1900-09-22,1900,Sunderland,Aston Villa,0-0,0,0,1,1,0,0,D
1900-09-22,1900,West Bromwich Albion,Newcastle United,0-1,0,1,1,1,1,-1,A
1900-09-29,1900,Aston Villa,Derby County,2-1,2,1,1,1,3,1,H
1900-09-29,1900,Bury,Blackburn Rovers,0-1,0,1,1,1,1,-1,A
1900-09-29,1900,Liverpool,Sunderland,1-2,1,2,1,1,3,-1,A
1900-09-29,1900,Manchester City,Stoke City,2-0,2,0,1,1,2,2,H
1900-09-29,1900,Newcastle United,Everton,1-0,1,0,1,1,1,1,H
1900-09-29,1900,Nottingham Forest,Sheffield Wednesday,1-0,1,0,1,1,1,1,H
1900-09-29,1900,Preston North End,Notts County,0-1,0,1,1,1,1,-1,A
1900-09-29,1900,Sheffield United,West Bromwich Albion,1-1,1,1,1,1,2,0,D
1900-09-29,1900,Wolverhampton Wanderers,Bolton Wanderers,1-1,1,1,1,1,2,0,D
1900-10-04,1900,Nottingham Forest,Preston North End,4-1,4,1,1,1,5,3,H
1900-10-06,1900,Blackburn Rovers,Nottingham Forest,1-3,1,3,1,1,4,-2,A
1900-10-06,1900,Bolton Wanderers,Aston Villa,1-0,1,0,1,1,1,1,H
1900-10-06,1900,Derby County,Liverpool,2-3,2,3,1,1,5,-1,A
1900-10-06,1900,Everton,Sheffield United,3-1,3,1,1,1,4,2,H
1900-10-06,1900,Notts County,Wolverhampton Wanderers,4-1,4,1,1,1,5,3,H
1900-10-06,1900,Sheffield Wednesday,Preston North End,0-1,0,1,1,1,1,-1,A
1900-10-06,1900,Stoke City,Bury,1-2,1,2,1,1,3,-1,A
1900-10-06,1900,Sunderland,Newcastle United,1-1,1,1,1,1,2,0,D
1900-10-06,1900,West Bromwich Albion,Manchester City,3-2,3,2,1,1,5,1,H
1900-10-13,1900,Aston Villa,Notts County,1-2,1,2,1,1,3,-1,A
1900-10-13,1900,Blackburn Rovers,Sheffield Wednesday,2-2,2,2,1,1,4,0,D
1900-10-13,1900,Bury,West Bromwich Albion,6-1,6,1,1,1,7,5,H
1900-10-13,1900,Liverpool,Bolton Wanderers,2-1,2,1,1,1,3,1,H
1900-10-13,1900,Manchester City,Everton,1-0,1,0,1,1,1,1,H
1900-10-13,1900,Newcastle United,Derby County,2-1,2,1,1,1,3,1,H
1900-10-13,1900,Nottingham Forest,Stoke City,1-1,1,1,1,1,2,0,D
1900-10-13,1900,Sheffield United,Sunderland,2-0,2,0,1,1,2,2,H
1900-10-13,1900,Wolverhampton Wanderers,Preston North End,2-2,2,2,1,1,4,0,D
1900-10-20,1900,Bolton Wanderers,Newcastle United,3-2,3,2,1,1,5,1,H
1900-10-20,1900,Derby County,Sheffield United,4-0,4,0,1,1,4,4,H
1900-10-20,1900,Notts County,Liverpool,3-0,3,0,1,1,3,3,H
1900-10-20,1900,Preston North End,Aston Villa,0-2,0,2,1,1,2,-2,A
1900-10-20,1900,Stoke City,Blackburn Rovers,2-0,2,0,1,1,2,2,H
1900-10-20,1900,Sunderland,Manchester City,3-0,3,0,1,1,3,3,H
1900-10-20,1900,West Bromwich Albion,Nottingham Forest,1-6,1,6,1,1,7,-5,A
1900-10-27,1900,Aston Villa,Wolverhampton Wanderers,0-0,0,0,1,1,0,0,D
1900-10-27,1900,Blackburn Rovers,West Bromwich Albion,1-1,1,1,1,1,2,0,D
1900-10-27,1900,Bury,Sunderland,0-0,0,0,1,1,0,0,D
1900-10-27,1900,Liverpool,Preston North End,3-2,3,2,1,1,5,1,H
1900-10-27,1900,Manchester City,Derby County,2-0,2,0,1,1,2,2,H
1900-10-27,1900,Newcastle United,Notts County,2-0,2,0,1,1,2,2,H
1900-10-27,1900,Nottingham Forest,Everton,2-1,2,1,1,1,3,1,H
1900-10-27,1900,Sheffield United,Bolton Wanderers,0-2,0,2,1,1,2,-2,A
1900-10-27,1900,Stoke City,Sheffield Wednesday,2-1,2,1,1,1,3,1,H
1900-10-29,1900,Aston Villa,Blackburn Rovers,3-3,3,3,1,1,6,0,D
1900-11-03,1900,Bolton Wanderers,Manchester City,0-0,0,0,1,1,0,0,D
1900-11-03,1900,Derby County,Bury,5-2,5,2,1,1,7,3,H
1900-11-03,1900,Everton,Blackburn Rovers,0-0,0,0,1,1,0,0,D
1900-11-03,1900,Notts County,Sheffield United,2-4,2,4,1,1,6,-2,A
1900-11-03,1900,Preston North End,Newcastle United,0-1,0,1,1,1,1,-1,A
1900-11-03,1900,Sheffield Wednesday,Aston Villa,3-2,3,2,1,1,5,1,H
1900-11-03,1900,Sunderland,Nottingham Forest,0-1,0,1,1,1,1,-1,A
1900-11-03,1900,West Bromwich Albion,Stoke City,2-2,2,2,1,1,4,0,D
1900-11-03,1900,Wolverhampton Wanderers,Liverpool,2-1,2,1,1,1,3,1,H
1900-11-05,1900,West Bromwich Albion,Notts County,1-0,1,0,1,1,1,1,H
1900-11-10,1900,Blackburn Rovers,Sunderland,0-1,0,1,1,1,1,-1,A
1900-11-10,1900,Bury,Bolton Wanderers,3-0,3,0,1,1,3,3,H
1900-11-10,1900,Liverpool,Aston Villa,5-1,5,1,1,1,6,4,H
1900-11-10,1900,Manchester City,Notts County,2-0,2,0,1,1,2,2,H
1900-11-10,1900,Newcastle United,Wolverhampton Wanderers,3-1,3,1,1,1,4,2,H
1900-11-10,1900,Nottingham Forest,Derby County,1-0,1,0,1,1,1,1,H
1900-11-10,1900,Sheffield United,Preston North End,2-1,2,1,1,1,3,1,H
1900-11-10,1900,Stoke City,Everton,0-2,0,2,1,1,2,-2,A
1900-11-10,1900,West Bromwich Albion,Sheffield Wednesday,1-1,1,1,1,1,2,0,D
1900-11-12,1900,Stoke City,Bolton Wanderers,2-1,2,1,1,1,3,1,H
1900-11-17,1900,Aston Villa,Newcastle United,2-2,2,2,1,1,4,0,D
1900-11-17,1900,Derby County,Blackburn Rovers,4-0,4,0,1,1,4,4,H
1900-11-17,1900,Everton,West Bromwich Albion,1-0,1,0,1,1,1,1,H
1900-11-17,1900,Notts County,Bury,1-0,1,0,1,1,1,1,H
1900-11-17,1900,Preston North End,Manchester City,0-4,0,4,1,1,4,-4,A
1900-11-17,1900,Sheffield Wednesday,Liverpool,3-2,3,2,1,1,5,1,H
1900-11-17,1900,Sunderland,Stoke City,6-1,6,1,1,1,7,5,H
1900-11-17,1900,Wolverhampton Wanderers,Sheffield United,3-0,3,0,1,1,3,3,H
1900-11-24,1900,Blackburn Rovers,Bolton Wanderers,2-0,2,0,1,1,2,2,H
1900-11-24,1900,Bury,Preston North End,2-1,2,1,1,1,3,1,H
1900-11-24,1900,Everton,Sheffield Wednesday,1-1,1,1,1,1,2,0,D
1900-11-24,1900,Manchester City,Wolverhampton Wanderers,3-2,3,2,1,1,5,1,H
1900-11-24,1900,Newcastle United,Liverpool,1-1,1,1,1,1,2,0,D
1900-11-24,1900,Nottingham Forest,Notts County,5-0,5,0,1,1,5,5,H
1900-11-24,1900,Sheffield United,Aston Villa,2-2,2,2,1,1,4,0,D
1900-11-24,1900,Stoke City,Derby County,0-1,0,1,1,1,1,-1,A
1900-11-24,1900,West Bromwich Albion,Sunderland,1-0,1,0,1,1,1,1,H
1900-12-01,1900,Aston Villa,Manchester City,7-1,7,1,1,1,8,6,H
1900-12-01,1900,Bolton Wanderers,Stoke City,1-0,1,0,1,1,1,1,H
1900-12-01,1900,Derby County,West Bromwich Albion,4-0,4,0,1,1,4,4,H
1900-12-01,1900,Liverpool,Sheffield United,1-2,1,2,1,1,3,-1,A
1900-12-01,1900,Notts County,Blackburn Rovers,2-1,2,1,1,1,3,1,H
1900-12-01,1900,Preston North End,Nottingham Forest,1-1,1,1,1,1,2,0,D
1900-12-01,1900,Sheffield Wednesday,Newcastle United,2-2,2,2,1,1,4,0,D
1900-12-01,1900,Sunderland,Everton,2-0,2,0,1,1,2,2,H
1900-12-01,1900,Wolverhampton Wanderers,Bury,1-1,1,1,1,1,2,0,D
1900-12-08,1900,Bury,Aston Villa,3-1,3,1,1,1,4,2,H
1900-12-08,1900,Everton,Derby County,2-0,2,0,1,1,2,2,H
1900-12-08,1900,Manchester City,Liverpool,3-4,3,4,1,1,7,-1,A
1900-12-08,1900,Nottingham Forest,Wolverhampton Wanderers,2-1,2,1,1,1,3,1,H
1900-12-08,1900,Preston North End,Blackburn Rovers,4-1,4,1,1,1,5,3,H
1900-12-08,1900,Sheffield United,Newcastle United,2-0,2,0,1,1,2,2,H
1900-12-08,1900,Sunderland,Sheffield Wednesday,1-0,1,0,1,1,1,1,H
1900-12-08,1900,West Bromwich Albion,Bolton Wanderers,7-2,7,2,1,1,9,5,H
1900-12-15,1900,Aston Villa,Nottingham Forest,2-1,2,1,1,1,3,1,H
1900-12-15,1900,Bolton Wanderers,Everton,1-0,1,0,1,1,1,1,H
1900-12-15,1900,Liverpool,Bury,1-0,1,0,1,1,1,1,H
1900-12-15,1900,Newcastle United,Manchester City,2-1,2,1,1,1,3,1,H
1900-12-15,1900,Notts County,West Bromwich Albion,1-0,1,0,1,1,1,1,H
1900-12-15,1900,Sheffield United,Sheffield Wednesday,1-0,1,0,1,1,1,1,H
1900-12-15,1900,Wolverhampton Wanderers,Blackburn Rovers,2-2,2,2,1,1,4,0,D
1900-12-22,1900,Blackburn Rovers,Aston Villa,2-2,2,2,1,1,4,0,D
1900-12-22,1900,Bury,Newcastle United,1-0,1,0,1,1,1,1,H
1900-12-22,1900,Everton,Notts County,0-1,0,1,1,1,1,-1,A
1900-12-22,1900,Manchester City,Sheffield United,2-1,2,1,1,1,3,1,H
1900-12-22,1900,Nottingham Forest,Liverpool,0-0,0,0,1,1,0,0,D
1900-12-22,1900,Sheffield Wednesday,Derby County,2-1,2,1,1,1,3,1,H
1900-12-22,1900,Stoke City,Wolverhampton Wanderers,3-0,3,0,1,1,3,3,H
1900-12-22,1900,West Bromwich Albion,Preston North End,0-1,0,1,1,1,1,-1,A
1900-12-25,1900,Liverpool,Derby County,0-0,0,0,1,1,0,0,D
1900-12-25,1900,Manchester City,Sunderland,1-1,1,1,1,1,2,0,D
1900-12-25,1900,Nottingham Forest,Bolton Wanderers,3-0,3,0,1,1,3,3,H
1900-12-25,1900,Preston North End,Stoke City,4-2,4,2,1,1,6,2,H
1900-12-25,1900,Sheffield United,Everton,2-1,2,1,1,1,3,1,H
1900-12-26,1900,Aston Villa,Bolton Wanderers,3-0,3,0,1,1,3,3,H
1900-12-26,1900,Derby County,Sunderland,1-1,1,1,1,1,2,0,D
1900-12-26,1900,Everton,Bury,3-3,3,3,1,1,6,0,D
1900-12-26,1900,Notts County,Nottingham Forest,1-0,1,0,1,1,1,1,H
1900-12-26,1900,Sheffield United,Manchester City,1-1,1,1,1,1,2,0,D
1900-12-26,1900,Stoke City,Preston North End,5-0,5,0,1,1,5,5,H
1900-12-26,1900,Wolverhampton Wanderers,Sheffield Wednesday,1-1,1,1,1,1,2,0,D
1900-12-29,1900,Blackburn Rovers,Liverpool,3-1,3,1,1,1,4,2,H
1900-12-29,1900,Bury,Sheffield United,1-1,1,1,1,1,2,0,D
1900-12-29,1900,Derby County,Bolton Wanderers,4-2,4,2,1,1,6,2,H
1900-12-29,1900,Everton,Preston North End,4-1,4,1,1,1,5,3,H
1900-12-29,1900,Nottingham Forest,Newcastle United,1-2,1,2,1,1,3,-1,A
1900-12-29,1900,Sheffield Wednesday,Manchester City,4-1,4,1,1,1,5,3,H
1900-12-29,1900,Stoke City,Aston Villa,0-0,0,0,1,1,0,0,D
1900-12-29,1900,Sunderland,Notts County,1-1,1,1,1,1,2,0,D
1900-12-29,1900,West Bromwich Albion,Wolverhampton Wanderers,1-2,1,2,1,1,3,-1,A
1901-01-01,1900,Blackburn Rovers,Preston North End,3-1,3,1,1,1,4,2,H
1901-01-01,1900,Bolton Wanderers,Nottingham Forest,4-2,4,2,1,1,6,2,H
1901-01-01,1900,Bury,Everton,3-0,3,0,1,1,3,3,H
1901-01-01,1900,Liverpool,Stoke City,3-1,3,1,1,1,4,2,H
1901-01-01,1900,Sheffield Wednesday,Wolverhampton Wanderers,2-0,2,0,1,1,2,2,H
1901-01-01,1900,Sunderland,Derby County,2-1,2,1,1,1,3,1,H
1901-01-02,1900,Bolton Wanderers,Sunderland,0-0,0,0,1,1,0,0,D
1901-01-05,1900,Aston Villa,West Bromwich Albion,0-1,0,1,1,1,1,-1,A
1901-01-05,1900,Bolton Wanderers,Sheffield Wednesday,1-1,1,1,1,1,2,0,D
1901-01-05,1900,Manchester City,Bury,1-0,1,0,1,1,1,1,H
1901-01-05,1900,Newcastle United,Blackburn Rovers,1-0,1,0,1,1,1,1,H
1901-01-05,1900,Notts County,Derby County,2-1,2,1,1,1,3,1,H
1901-01-05,1900,Preston North End,Sunderland,1-1,1,1,1,1,2,0,D
1901-01-05,1900,Sheffield United,Nottingham Forest,0-1,0,1,1,1,1,-1,A
1901-01-05,1900,Wolverhampton Wanderers,Everton,1-1,1,1,1,1,2,0,D
1901-01-12,1900,Blackburn Rovers,Sheffield United,1-0,1,0,1,1,1,1,H
1901-01-12,1900,Derby County,Preston North End,0-0,0,0,1,1,0,0,D
1901-01-12,1900,Everton,Aston Villa,2-1,2,1,1,1,3,1,H
1901-01-12,1900,Nottingham Forest,Manchester City,4-2,4,2,1,1,6,2,H
1901-01-12,1900,Sheffield Wednesday,Bury,1-2,1,2,1,1,3,-1,A
1901-01-12,1900,Stoke City,Newcastle United,2-0,2,0,1,1,2,2,H
1901-01-12,1900,Sunderland,Wolverhampton Wanderers,7-2,7,2,1,1,9,5,H
1901-01-19,1900,Aston Villa,Sunderland,2-2,2,2,1,1,4,0,D
1901-01-19,1900,Liverpool,Everton,1-2,1,2,1,1,3,-1,A
1901-01-19,1900,Manchester City,Blackburn Rovers,1-3,1,3,1,1,4,-2,A
1901-01-19,1900,Newcastle United,West Bromwich Albion,1-1,1,1,1,1,2,0,D
1901-01-19,1900,Notts County,Sheffield Wednesday,2-0,2,0,1,1,2,2,H
1901-01-19,1900,Sheffield United,Stoke City,0-4,0,4,1,1,4,-4,A
1901-01-19,1900,Wolverhampton Wanderers,Derby County,0-0,0,0,1,1,0,0,D
1901-01-26,1900,Stoke City,Manchester City,2-1,2,1,1,1,3,1,H
1901-02-16,1900,Bolton Wanderers,Liverpool,1-0,1,0,1,1,1,1,H
1901-02-16,1900,Derby County,Newcastle United,1-1,1,1,1,1,2,0,D
1901-02-16,1900,Everton,Manchester City,5-2,5,2,1,1,7,3,H
1901-02-16,1900,Notts County,Aston Villa,2-0,2,0,1,1,2,2,H
1901-02-16,1900,Preston North End,Wolverhampton Wanderers,1-1,1,1,1,1,2,0,D
1901-02-16,1900,Sheffield Wednesday,Blackburn Rovers,1-1,1,1,1,1,2,0,D
1901-02-16,1900,Stoke City,Nottingham Forest,0-3,0,3,1,1,3,-3,A
1901-02-16,1900,Sunderland,Sheffield United,3-0,3,0,1,1,3,3,H
1901-02-16,1900,West Bromwich Albion,Bury,1-2,1,2,1,1,3,-1,A
1901-02-23,1900,Blackburn Rovers,Stoke City,3-2,3,2,1,1,5,1,H
1901-02-23,1900,Manchester City,Preston North End,3-1,3,1,1,1,4,2,H
1901-02-23,1900,Sunderland,Liverpool,0-1,0,1,1,1,1,-1,A
1901-03-02,1900,Bolton Wanderers,Sheffield United,0-0,0,0,1,1,0,0,D
1901-03-02,1900,Derby County,Manchester City,2-0,2,0,1,1,2,2,H
1901-03-02,1900,Everton,Nottingham Forest,4-1,4,1,1,1,5,3,H
1901-03-02,1900,Notts County,Newcastle United,3-1,3,1,1,1,4,2,H
1901-03-02,1900,Preston North End,Liverpool,2-2,2,2,1,1,4,0,D
1901-03-02,1900,Sheffield Wednesday,Stoke City,4-0,4,0,1,1,4,4,H
1901-03-02,1900,Sunderland,Bury,4-1,4,1,1,1,5,3,H
1901-03-02,1900,West Bromwich Albion,Blackburn Rovers,1-1,1,1,1,1,2,0,D
1901-03-09,1900,Aston Villa,Sheffield Wednesday,2-1,2,1,1,1,3,1,H
1901-03-09,1900,Blackburn Rovers,Everton,2-1,2,1,1,1,3,1,H
1901-03-09,1900,Bury,Derby County,2-1,2,1,1,1,3,1,H
1901-03-09,1900,Liverpool,Wolverhampton Wanderers,1-0,1,0,1,1,1,1,H
1901-03-09,1900,Manchester City,Bolton Wanderers,1-1,1,1,1,1,2,0,D
1901-03-09,1900,Newcastle United,Preston North End,3-5,3,5,1,1,8,-2,A
1901-03-09,1900,Nottingham Forest,Sunderland,0-0,0,0,1,1,0,0,D
1901-03-09,1900,Sheffield United,Notts County,4-2,4,2,1,1,6,2,H
1901-03-09,1900,Stoke City,West Bromwich Albion,2-0,2,0,1,1,2,2,H
1901-03-11,1900,Sheffield United,Derby County,2-1,2,1,1,1,3,1,H
1901-03-13,1900,Nottingham Forest,West Bromwich Albion,2-3,2,3,1,1,5,-1,A
1901-03-16,1900,Aston Villa,Liverpool,0-2,0,2,1,1,2,-2,A
1901-03-16,1900,Bolton Wanderers,Bury,3-2,3,2,1,1,5,1,H
1901-03-16,1900,Derby County,Nottingham Forest,0-0,0,0,1,1,0,0,D
1901-03-16,1900,Everton,Stoke City,3-0,3,0,1,1,3,3,H
1901-03-16,1900,Notts County,Manchester City,0-0,0,0,1,1,0,0,D
1901-03-16,1900,Preston North End,Sheffield United,3-1,3,1,1,1,4,2,H
1901-03-16,1900,Sheffield Wednesday,West Bromwich Albion,2-1,2,1,1,1,3,1,H
1901-03-16,1900,Sunderland,Blackburn Rovers,2-0,2,0,1,1,2,2,H
1901-03-16,1900,Wolverhampton Wanderers,Newcastle United,1-0,1,0,1,1,1,1,H
1901-03-23,1900,Blackburn Rovers,Derby County,1-0,1,0,1,1,1,1,H
1901-03-23,1900,Bury,Notts County,1-0,1,0,1,1,1,1,H
1901-03-23,1900,Liverpool,Sheffield Wednesday,1-1,1,1,1,1,2,0,D
1901-03-23,1900,Preston North End,Bolton Wanderers,1-3,1,3,1,1,4,-2,A
1901-03-23,1900,Stoke City,Sunderland,0-0,0,0,1,1,0,0,D
1901-03-25,1900,Sheffield United,Wolverhampton Wanderers,1-1,1,1,1,1,2,0,D
1901-03-27,1900,Bury,Nottingham Forest,0-1,0,1,1,1,1,-1,A
1901-03-27,1900,Newcastle United,Bolton Wanderers,3-0,3,0,1,1,3,3,H
1901-03-27,1900,Notts County,Preston North End,6-1,6,1,1,1,7,5,H
1901-03-30,1900,Aston Villa,Sheffield United,0-0,0,0,1,1,0,0,D
1901-03-30,1900,Bolton Wanderers,Blackburn Rovers,1-0,1,0,1,1,1,1,H
1901-03-30,1900,Derby County,Stoke City,4-1,4,1,1,1,5,3,H
1901-03-30,1900,Liverpool,Newcastle United,3-0,3,0,1,1,3,3,H
1901-03-30,1900,Preston North End,Bury,3-1,3,1,1,1,4,2,H
1901-03-30,1900,Sheffield Wednesday,Everton,3-1,3,1,1,1,4,2,H
1901-03-30,1900,Sunderland,West Bromwich Albion,3-0,3,0,1,1,3,3,H
1901-03-30,1900,Wolverhampton Wanderers,Manchester City,1-0,1,0,1,1,1,1,H
1901-04-05,1900,Bolton Wanderers,Notts County,0-1,0,1,1,1,1,-1,A
1901-04-05,1900,Bury,Stoke City,3-2,3,2,1,1,5,1,H
1901-04-05,1900,Manchester City,West Bromwich Albion,1-0,1,0,1,1,1,1,H
1901-04-05,1900,Preston North End,Sheffield Wednesday,3-2,3,2,1,1,5,1,H
1901-04-06,1900,Blackburn Rovers,Notts County,0-2,0,2,1,1,2,-2,A
1901-04-06,1900,Bury,Wolverhampton Wanderers,0-1,0,1,1,1,1,-1,A
1901-04-06,1900,Everton,Sunderland,1-0,1,0,1,1,1,1,H
1901-04-06,1900,Newcastle United,Sheffield Wednesday,0-0,0,0,1,1,0,0,D
1901-04-08,1900,Everton,Newcastle United,0-1,0,1,1,1,1,-1,A
1901-04-08,1900,Liverpool,Notts County,1-0,1,0,1,1,1,1,H
1901-04-08,1900,Nottingham Forest,Blackburn Rovers,0-1,0,1,1,1,1,-1,A
1901-04-08,1900,Sunderland,Bolton Wanderers,5-1,5,1,1,1,6,4,H
1901-04-08,1900,Wolverhampton Wanderers,Aston Villa,0-0,0,0,1,1,0,0,D
1901-04-09,1900,Notts County,Everton,3-2,3,2,1,1,5,1,H
1901-04-09,1900,Sheffield Wednesday,Nottingham Forest,4-1,4,1,1,1,5,3,H
1901-04-09,1900,Wolverhampton Wanderers,Stoke City,0-2,0,2,1,1,2,-2,A
1901-04-13,1900,Blackburn Rovers,Bury,0-2,0,2,1,1,2,-2,A
1901-04-13,1900,Bolton Wanderers,West Bromwich Albion,3-2,3,2,1,1,5,1,H
1901-04-13,1900,Derby County,Everton,0-1,0,1,1,1,1,-1,A
1901-04-13,1900,Liverpool,Manchester City,3-1,3,1,1,1,4,2,H
1901-04-13,1900,Newcastle United,Sheffield United,3-0,3,0,1,1,3,3,H
1901-04-13,1900,Notts County,Stoke City,2-4,2,4,1,1,6,-2,A
1901-04-13,1900,Sheffield Wednesday,Sunderland,1-0,1,0,1,1,1,1,H
1901-04-13,1900,Wolverhampton Wanderers,Nottingham Forest,1-0,1,0,1,1,1,1,H
1901-04-15,1900,Preston North End,West Bromwich Albion,2-3,2,3,1,1,5,-1,A
1901-04-17,1900,Newcastle United,Aston Villa,3-0,3,0,1,1,3,3,H
1901-04-20,1900,Blackburn Rovers,Wolverhampton Wanderers,2-0,2,0,1,1,2,2,H
1901-04-20,1900,Bury,Liverpool,0-0,0,0,1,1,0,0,D
1901-04-20,1900,Everton,Bolton Wanderers,2-3,2,3,1,1,5,-1,A
1901-04-20,1900,Manchester City,Newcastle United,2-1,2,1,1,1,3,1,H
1901-04-20,1900,Nottingham Forest,Aston Villa,3-1,3,1,1,1,4,2,H
1901-04-22,1900,Derby County,Aston Villa,3-0,3,0,1,1,3,3,H
1901-04-22,1900,Sheffield United,Liverpool,0-2,0,2,1,1,2,-2,A
1901-04-22,1900,West Bromwich Albion,Everton,1-2,1,2,1,1,3,-1,A
1901-04-24,1900,Newcastle United,Sunderland,0-2,0,2,1,1,2,-2,A
1901-04-27,1900,Derby County,Sheffield Wednesday,3-1,3,1,1,1,4,2,H
1901-04-27,1900,Liverpool,Nottingham Forest,2-0,2,0,1,1,2,2,H
1901-04-27,1900,Manchester City,Aston Villa,4-0,4,0,1,1,4,4,H
1901-04-27,1900,Newcastle United,Bury,0-0,0,0,1,1,0,0,D
1901-04-29,1900,Bolton Wanderers,Wolverhampton Wanderers,1-0,1,0,1,1,1,1,H
1901-04-29,1900,Sheffield Wednesday,Sheffield United,1-0,1,0,1,1,1,1,H
1901-04-29,1900,West Bromwich Albion,Liverpool,0-1,0,1,1,1,1,-1,A
1901-04-30,1900,West Bromwich Albion,Sheffield United,0-2,0,2,1,1,2,-2,A
1901-09-02,1901,Birmingham City,Liverpool,0-0,0,0,1,1,0,0,D
1901-09-02,1901,Everton,Manchester City,3-1,3,1,1,1,4,2,H
1901-09-02,1901,Stoke City,Bury,1-2,1,2,1,1,3,-1,A
1901-09-02,1901,Sunderland,Sheffield United,3-1,3,1,1,1,4,2,H
1901-09-02,1901,Wolverhampton Wanderers,Nottingham Forest,2-0,2,0,1,1,2,2,H
1901-09-03,1901,Grimsby Town,Derby County,1-1,1,1,1,1,2,0,D
1901-09-07,1901,Birmingham City,Bolton Wanderers,2-0,2,0,1,1,2,2,H
1901-09-07,1901,Blackburn Rovers,Newcastle United,0-0,0,0,1,1,0,0,D
1901-09-07,1901,Bury,Aston Villa,0-0,0,0,1,1,0,0,D
1901-09-07,1901,Derby County,Notts County,2-0,2,0,1,1,2,2,H
1901-09-07,1901,Everton,Wolverhampton Wanderers,6-1,6,1,1,1,7,5,H
1901-09-07,1901,Nottingham Forest,Sheffield United,2-1,2,1,1,1,3,1,H
1901-09-07,1901,Sheffield Wednesday,Grimsby Town,3-1,3,1,1,1,4,2,H
1901-09-07,1901,Stoke City,Liverpool,1-0,1,0,1,1,1,1,H
1901-09-07,1901,Sunderland,Manchester City,1-0,1,0,1,1,1,1,H
1901-09-09,1901,Aston Villa,Notts County,2-0,2,0,1,1,2,2,H
1901-09-14,1901,Aston Villa,Blackburn Rovers,1-1,1,1,1,1,2,0,D
1901-09-14,1901,Bolton Wanderers,Derby County,2-1,2,1,1,1,3,1,H
1901-09-14,1901,Grimsby Town,Nottingham Forest,1-0,1,0,1,1,1,1,H
1901-09-14,1901,Liverpool,Everton,2-2,2,2,1,1,4,0,D
1901-09-14,1901,Manchester City,Birmingham City,1-4,1,4,1,1,5,-3,A
1901-09-14,1901,Newcastle United,Stoke City,5-1,5,1,1,1,6,4,H
1901-09-14,1901,Notts County,Sheffield Wednesday,6-1,6,1,1,1,7,5,H
1901-09-14,1901,Sheffield United,Bury,3-1,3,1,1,1,4,2,H
1901-09-14,1901,Wolverhampton Wanderers,Sunderland,4-2,4,2,1,1,6,2,H
1901-09-16,1901,Aston Villa,Sheffield United,1-2,1,2,1,1,3,-1,A
1901-09-21,1901,Birmingham City,Wolverhampton Wanderers,1-2,1,2,1,1,3,-1,A
1901-09-21,1901,Blackburn Rovers,Sheffield United,2-1,2,1,1,1,3,1,H
1901-09-21,1901,Bury,Nottingham Forest,1-1,1,1,1,1,2,0,D
1901-09-21,1901,Derby County,Manchester City,2-0,2,0,1,1,2,2,H
1901-09-21,1901,Everton,Newcastle United,0-0,0,0,1,1,0,0,D
1901-09-21,1901,Notts County,Grimsby Town,3-0,3,0,1,1,3,3,H
1901-09-21,1901,Sheffield Wednesday,Bolton Wanderers,5-1,5,1,1,1,6,4,H
1901-09-21,1901,Stoke City,Aston Villa,1-0,1,0,1,1,1,1,H
1901-09-21,1901,Sunderland,Liverpool,1-1,1,1,1,1,2,0,D
1901-09-28,1901,Aston Villa,Everton,1-1,1,1,1,1,2,0,D
1901-09-28,1901,Bolton Wanderers,Notts County,1-1,1,1,1,1,2,0,D
1901-09-28,1901,Grimsby Town,Bury,2-0,2,0,1,1,2,2,H
1901-09-28,1901,Liverpool,Birmingham City,3-1,3,1,1,1,4,2,H
1901-09-28,1901,Newcastle United,Sunderland,0-1,0,1,1,1,1,-1,A
1901-09-28,1901,Nottingham Forest,Blackburn Rovers,3-0,3,0,1,1,3,3,H
1901-09-28,1901,Sheffield United,Stoke City,1-1,1,1,1,1,2,0,D
1901-09-28,1901,Wolverhampton Wanderers,Derby County,0-0,0,0,1,1,0,0,D
1901-10-03,1901,Notts County,Newcastle United,0-2,0,2,1,1,2,-2,A
1901-10-05,1901,Birmingham City,Newcastle United,3-1,3,1,1,1,4,2,H
1901-10-05,1901,Blackburn Rovers,Bury,0-3,0,3,1,1,3,-3,A
1901-10-05,1901,Bolton Wanderers,Grimsby Town,4-0,4,0,1,1,4,4,H
1901-10-05,1901,Derby County,Liverpool,1-1,1,1,1,1,2,0,D
1901-10-05,1901,Everton,Sheffield United,2-1,2,1,1,1,3,1,H
1901-10-05,1901,Notts County,Manchester City,2-0,2,0,1,1,2,2,H
1901-10-05,1901,Sheffield Wednesday,Wolverhampton Wanderers,1-1,1,1,1,1,2,0,D
1901-10-05,1901,Stoke City,Nottingham Forest,1-1,1,1,1,1,2,0,D
1901-10-05,1901,Sunderland,Aston Villa,1-0,1,0,1,1,1,1,H
1901-10-12,1901,Birmingham City,Aston Villa,0-2,0,2,1,1,2,-2,A
1901-10-12,1901,Bury,Stoke City,4-2,4,2,1,1,6,2,H
1901-10-12,1901,Grimsby Town,Blackburn Rovers,2-1,2,1,1,1,3,1,H
1901-10-12,1901,Liverpool,Sheffield Wednesday,1-2,1,2,1,1,3,-1,A
1901-10-12,1901,Manchester City,Bolton Wanderers,1-0,1,0,1,1,1,1,H
1901-10-12,1901,Newcastle United,Derby County,0-1,0,1,1,1,1,-1,A
1901-10-12,1901,Nottingham Forest,Everton,4-0,4,0,1,1,4,4,H
1901-10-12,1901,Sheffield United,Sunderland,0-1,0,1,1,1,1,-1,A
1901-10-12,1901,Wolverhampton Wanderers,Notts County,3-1,3,1,1,1,4,2,H
1901-10-19,1901,Birmingham City,Sheffield United,5-1,5,1,1,1,6,4,H
1901-10-19,1901,Bolton Wanderers,Wolverhampton Wanderers,2-2,2,2,1,1,4,0,D
1901-10-19,1901,Derby County,Aston Villa,1-0,1,0,1,1,1,1,H
1901-10-19,1901,Everton,Bury,1-1,1,1,1,1,2,0,D
1901-10-19,1901,Manchester City,Grimsby Town,3-0,3,0,1,1,3,3,H
1901-10-19,1901,Notts County,Liverpool,2-2,2,2,1,1,4,0,D
1901-10-19,1901,Sheffield Wednesday,Newcastle United,0-0,0,0,1,1,0,0,D
1901-10-19,1901,Stoke City,Blackburn Rovers,2-2,2,2,1,1,4,0,D
1901-10-19,1901,Sunderland,Nottingham Forest,4-0,4,0,1,1,4,4,H
1901-10-26,1901,Aston Villa,Sheffield Wednesday,4-1,4,1,1,1,5,3,H
1901-10-26,1901,Blackburn Rovers,Everton,3-1,3,1,1,1,4,2,H
1901-10-26,1901,Bury,Sunderland,1-0,1,0,1,1,1,1,H
1901-10-26,1901,Grimsby Town,Stoke City,1-2,1,2,1,1,3,-1,A
1901-10-26,1901,Liverpool,Bolton Wanderers,1-1,1,1,1,1,2,0,D
1901-10-26,1901,Newcastle United,Notts County,8-0,8,0,1,1,8,8,H
1901-10-26,1901,Nottingham Forest,Birmingham City,1-1,1,1,1,1,2,0,D
1901-10-26,1901,Sheffield United,Derby County,3-0,3,0,1,1,3,3,H
1901-10-26,1901,Wolverhampton Wanderers,Manchester City,0-0,0,0,1,1,0,0,D
1901-11-02,1901,Birmingham City,Bury,1-0,1,0,1,1,1,1,H
1901-11-02,1901,Bolton Wanderers,Newcastle United,3-1,3,1,1,1,4,2,H
1901-11-02,1901,Derby County,Nottingham Forest,1-1,1,1,1,1,2,0,D
1901-11-02,1901,Everton,Stoke City,1-0,1,0,1,1,1,1,H
1901-11-02,1901,Manchester City,Liverpool,2-3,2,3,1,1,5,-1,A
1901-11-02,1901,Notts County,Aston Villa,0-3,0,3,1,1,3,-3,A
1901-11-02,1901,Sheffield Wednesday,Sheffield United,1-0,1,0,1,1,1,1,H
1901-11-02,1901,Sunderland,Blackburn Rovers,3-2,3,2,1,1,5,1,H
1901-11-02,1901,Wolverhampton Wanderers,Grimsby Town,2-0,2,0,1,1,2,2,H
1901-11-09,1901,Aston Villa,Bolton Wanderers,1-0,1,0,1,1,1,1,H
1901-11-09,1901,Blackburn Rovers,Birmingham City,3-1,3,1,1,1,4,2,H
1901-11-09,1901,Bury,Derby County,2-0,2,0,1,1,2,2,H
1901-11-09,1901,Grimsby Town,Everton,0-2,0,2,1,1,2,-2,A
1901-11-09,1901,Liverpool,Wolverhampton Wanderers,4-1,4,1,1,1,5,3,H
1901-11-09,1901,Newcastle United,Manchester City,3-0,3,0,1,1,3,3,H
1901-11-09,1901,Nottingham Forest,Sheffield Wednesday,1-1,1,1,1,1,2,0,D
1901-11-09,1901,Sheffield United,Notts County,3-0,3,0,1,1,3,3,H
1901-11-09,1901,Stoke City,Sunderland,3-0,3,0,1,1,3,3,H
1901-11-11,1901,Stoke City,Wolverhampton Wanderers,3-0,3,0,1,1,3,3,H
1901-11-16,1901,Derby County,Blackburn Rovers,1-1,1,1,1,1,2,0,D
1901-11-16,1901,Notts County,Nottingham Forest,3-0,3,0,1,1,3,3,H
1901-11-16,1901,Sheffield Wednesday,Bury,4-1,4,1,1,1,5,3,H
1901-11-16,1901,Sunderland,Everton,2-4,2,4,1,1,6,-2,A
1901-11-23,1901,Aston Villa,Wolverhampton Wanderers,2-1,2,1,1,1,3,1,H
1901-11-23,1901,Blackburn Rovers,Sheffield Wednesday,2-0,2,0,1,1,2,2,H
1901-11-23,1901,Bury,Notts County,3-0,3,0,1,1,3,3,H
1901-11-23,1901,Everton,Birmingham City,1-0,1,0,1,1,1,1,H
1901-11-23,1901,Grimsby Town,Sunderland,3-3,3,3,1,1,6,0,D
1901-11-23,1901,Newcastle United,Liverpool,1-0,1,0,1,1,1,1,H
1901-11-23,1901,Nottingham Forest,Bolton Wanderers,4-1,4,1,1,1,5,3,H
1901-11-23,1901,Sheffield United,Manchester City,5-0,5,0,1,1,5,5,H
1901-11-23,1901,Stoke City,Derby County,1-1,1,1,1,1,2,0,D
1901-11-30,1901,Birmingham City,Sunderland,2-3,2,3,1,1,5,-1,A
1901-11-30,1901,Bolton Wanderers,Bury,2-2,2,2,1,1,4,0,D
1901-11-30,1901,Derby County,Everton,3-1,3,1,1,1,4,2,H
1901-11-30,1901,Liverpool,Aston Villa,1-0,1,0,1,1,1,1,H
1901-11-30,1901,Manchester City,Nottingham Forest,3-1,3,1,1,1,4,2,H
1901-11-30,1901,Newcastle United,Grimsby Town,5-1,5,1,1,1,6,4,H
1901-11-30,1901,Notts County,Blackburn Rovers,3-0,3,0,1,1,3,3,H
1901-11-30,1901,Sheffield Wednesday,Stoke City,3-1,3,1,1,1,4,2,H
1901-11-30,1901,Wolverhampton Wanderers,Sheffield United,1-1,1,1,1,1,2,0,D
1901-12-07,1901,Aston Villa,Newcastle United,0-0,0,0,1,1,0,0,D
1901-12-07,1901,Blackburn Rovers,Bolton Wanderers,2-0,2,0,1,1,2,2,H
1901-12-07,1901,Bury,Manchester City,3-0,3,0,1,1,3,3,H
1901-12-07,1901,Everton,Sheffield Wednesday,5-0,5,0,1,1,5,5,H
1901-12-07,1901,Grimsby Town,Birmingham City,1-0,1,0,1,1,1,1,H
1901-12-07,1901,Nottingham Forest,Wolverhampton Wanderers,2-0,2,0,1,1,2,2,H
1901-12-07,1901,Sheffield United,Liverpool,2-1,2,1,1,1,3,1,H
1901-12-07,1901,Stoke City,Notts County,3-0,3,0,1,1,3,3,H
1901-12-14,1901,Aston Villa,Grimsby Town,4-1,4,1,1,1,5,3,H
1901-12-14,1901,Bolton Wanderers,Stoke City,2-1,2,1,1,1,3,1,H
1901-12-14,1901,Liverpool,Nottingham Forest,0-2,0,2,1,1,2,-2,A
1901-12-14,1901,Manchester City,Blackburn Rovers,1-1,1,1,1,1,2,0,D
1901-12-14,1901,Newcastle United,Sheffield United,1-1,1,1,1,1,2,0,D
1901-12-14,1901,Notts County,Everton,0-2,0,2,1,1,2,-2,A
1901-12-14,1901,Sheffield Wednesday,Sunderland,1-1,1,1,1,1,2,0,D
1901-12-14,1901,Wolverhampton Wanderers,Bury,1-0,1,0,1,1,1,1,H
1901-12-21,1901,Birmingham City,Sheffield Wednesday,1-1,1,1,1,1,2,0,D
1901-12-21,1901,Blackburn Rovers,Wolverhampton Wanderers,2-0,2,0,1,1,2,2,H
1901-12-21,1901,Everton,Bolton Wanderers,1-0,1,0,1,1,1,1,H
1901-12-21,1901,Sunderland,Notts County,2-1,2,1,1,1,3,1,H
1901-12-25,1901,Blackburn Rovers,Grimsby Town,2-0,2,0,1,1,2,2,H
1901-12-25,1901,Derby County,Wolverhampton Wanderers,3-1,3,1,1,1,4,2,H
1901-12-25,1901,Everton,Aston Villa,2-3,2,3,1,1,5,-1,A
1901-12-26,1901,Aston Villa,Birmingham City,1-0,1,0,1,1,1,1,H
1901-12-26,1901,Derby County,Newcastle United,1-0,1,0,1,1,1,1,H
1901-12-26,1901,Liverpool,Sunderland,0-1,0,1,1,1,1,-1,A
1901-12-26,1901,Nottingham Forest,Notts County,1-0,1,0,1,1,1,1,H
1901-12-26,1901,Sheffield Wednesday,Manchester City,2-1,2,1,1,1,3,1,H
1901-12-26,1901,Stoke City,Sheffield United,3-2,3,2,1,1,5,1,H
1901-12-26,1901,Wolverhampton Wanderers,Everton,2-1,2,1,1,1,3,1,H
1901-12-28,1901,Aston Villa,Nottingham Forest,3-0,3,0,1,1,3,3,H
1901-12-28,1901,Bolton Wanderers,Sunderland,0-0,0,0,1,1,0,0,D
1901-12-28,1901,Grimsby Town,Sheffield United,0-1,0,1,1,1,1,-1,A
1901-12-28,1901,Liverpool,Blackburn Rovers,1-0,1,0,1,1,1,1,H
1901-12-28,1901,Newcastle United,Bury,1-1,1,1,1,1,2,0,D
1901-12-28,1901,Notts County,Birmingham City,6-1,6,1,1,1,7,5,H
1901-12-28,1901,Wolverhampton Wanderers,Stoke City,4-1,4,1,1,1,5,3,H
1902-01-01,1901,Blackburn Rovers,Nottingham Forest,1-0,1,0,1,1,1,1,H
1902-01-01,1901,Bolton Wanderers,Manchester City,3-3,3,3,1,1,6,0,D
1902-01-01,1901,Bury,Grimsby Town,1-1,1,1,1,1,2,0,D
1902-01-01,1901,Sheffield United,Aston Villa,6-0,6,0,1,1,6,6,H
1902-01-01,1901,Sunderland,Derby County,1-0,1,0,1,1,1,1,H
1902-01-02,1901,Bolton Wanderers,Nottingham Forest,3-0,3,0,1,1,3,3,H
1902-01-04,1901,Aston Villa,Bury,2-0,2,0,1,1,2,2,H
1902-01-04,1901,Bolton Wanderers,Birmingham City,4-0,4,0,1,1,4,4,H
1902-01-04,1901,Grimsby Town,Sheffield Wednesday,3-1,3,1,1,1,4,2,H
1902-01-04,1901,Liverpool,Stoke City,7-0,7,0,1,1,7,7,H
1902-01-04,1901,Manchester City,Sunderland,0-3,0,3,1,1,3,-3,A
1902-01-04,1901,Newcastle United,Blackburn Rovers,0-3,0,3,1,1,3,-3,A
1902-01-04,1901,Notts County,Derby County,3-2,3,2,1,1,5,1,H
1902-01-04,1901,Sheffield United,Nottingham Forest,2-2,2,2,1,1,4,0,D
1902-01-11,1901,Birmingham City,Manchester City,1-0,1,0,1,1,1,1,H
1902-01-11,1901,Blackburn Rovers,Aston Villa,4-0,4,0,1,1,4,4,H
1902-01-11,1901,Bury,Sheffield United,1-2,1,2,1,1,3,-1,A
1902-01-11,1901,Derby County,Bolton Wanderers,1-2,1,2,1,1,3,-1,A
1902-01-11,1901,Everton,Liverpool,4-0,4,0,1,1,4,4,H
1902-01-11,1901,Nottingham Forest,Grimsby Town,0-1,0,1,1,1,1,-1,A
1902-01-11,1901,Sheffield Wednesday,Notts County,4-0,4,0,1,1,4,4,H
1902-01-11,1901,Stoke City,Newcastle United,0-0,0,0,1,1,0,0,D
1902-01-11,1901,Sunderland,Wolverhampton Wanderers,2-0,2,0,1,1,2,2,H
1902-01-13,1901,Stoke City,Manchester City,3-0,3,0,1,1,3,3,H
1902-01-18,1901,Aston Villa,Stoke City,0-0,0,0,1,1,0,0,D
1902-01-18,1901,Bolton Wanderers,Sheffield Wednesday,3-1,3,1,1,1,4,2,H
1902-01-18,1901,Grimsby Town,Notts County,1-0,1,0,1,1,1,1,H
1902-01-18,1901,Manchester City,Derby County,0-0,0,0,1,1,0,0,D
1902-01-18,1901,Newcastle United,Everton,1-1,1,1,1,1,2,0,D
1902-01-18,1901,Nottingham Forest,Bury,2-1,2,1,1,1,3,1,H
1902-01-18,1901,Sheffield United,Blackburn Rovers,4-1,4,1,1,1,5,3,H
1902-01-18,1901,Wolverhampton Wanderers,Birmingham City,2-1,2,1,1,1,3,1,H
1902-02-01,1901,Aston Villa,Sunderland,0-1,0,1,1,1,1,-1,A
1902-02-01,1901,Bury,Liverpool,0-0,0,0,1,1,0,0,D
1902-02-01,1901,Grimsby Town,Bolton Wanderers,4-1,4,1,1,1,5,3,H
1902-02-01,1901,Manchester City,Notts County,1-0,1,0,1,1,1,1,H
1902-02-01,1901,Newcastle United,Birmingham City,2-0,2,0,1,1,2,2,H
1902-02-01,1901,Nottingham Forest,Stoke City,2-0,2,0,1,1,2,2,H
1902-02-01,1901,Sheffield United,Everton,0-0,0,0,1,1,0,0,D
1902-02-01,1901,Wolverhampton Wanderers,Sheffield Wednesday,1-0,1,0,1,1,1,1,H
1902-02-11,1901,Sheffield United,Grimsby Town,2-2,2,2,1,1,4,0,D
1902-02-15,1901,Aston Villa,Derby County,3-2,3,2,1,1,5,1,H
1902-02-15,1901,Blackburn Rovers,Stoke City,6-1,6,1,1,1,7,5,H
1902-02-15,1901,Bury,Everton,1-0,1,0,1,1,1,1,H
1902-02-15,1901,Grimsby Town,Manchester City,3-2,3,2,1,1,5,1,H
1902-02-15,1901,Liverpool,Notts County,0-1,0,1,1,1,1,-1,A
1902-02-15,1901,Newcastle United,Sheffield Wednesday,2-1,2,1,1,1,3,1,H
1902-02-15,1901,Nottingham Forest,Sunderland,2-1,2,1,1,1,3,1,H
1902-02-15,1901,Sheffield United,Birmingham City,1-4,1,4,1,1,5,-3,A
1902-02-15,1901,Wolverhampton Wanderers,Bolton Wanderers,1-2,1,2,1,1,3,-1,A
1902-02-17,1901,Birmingham City,Stoke City,1-1,1,1,1,1,2,0,D
1902-02-17,1901,Manchester City,Aston Villa,1-0,1,0,1,1,1,1,H
1902-02-22,1901,Birmingham City,Grimsby Town,6-0,6,0,1,1,6,6,H
1902-02-22,1901,Bolton Wanderers,Liverpool,1-0,1,0,1,1,1,1,H
1902-02-22,1901,Everton,Blackburn Rovers,0-2,0,2,1,1,2,-2,A
1902-02-22,1901,Manchester City,Wolverhampton Wanderers,3-0,3,0,1,1,3,3,H
1902-02-22,1901,Sheffield Wednesday,Aston Villa,1-0,1,0,1,1,1,1,H
1902-03-01,1901,Blackburn Rovers,Sunderland,0-1,0,1,1,1,1,-1,A
1902-03-01,1901,Bury,Birmingham City,2-0,2,0,1,1,2,2,H
1902-03-01,1901,Grimsby Town,Wolverhampton Wanderers,3-0,3,0,1,1,3,3,H
1902-03-01,1901,Liverpool,Manchester City,4-0,4,0,1,1,4,4,H
1902-03-01,1901,Newcastle United,Bolton Wanderers,4-1,4,1,1,1,5,3,H
1902-03-01,1901,Nottingham Forest,Derby County,3-1,3,1,1,1,4,2,H
1902-03-01,1901,Sheffield United,Sheffield Wednesday,3-0,3,0,1,1,3,3,H
1902-03-01,1901,Stoke City,Everton,1-2,1,2,1,1,3,-1,A
1902-03-08,1901,Birmingham City,Blackburn Rovers,2-0,2,0,1,1,2,2,H
1902-03-08,1901,Bolton Wanderers,Aston Villa,2-2,2,2,1,1,4,0,D
1902-03-08,1901,Derby County,Bury,1-0,1,0,1,1,1,1,H
1902-03-08,1901,Everton,Grimsby Town,0-1,0,1,1,1,1,-1,A
1902-03-08,1901,Manchester City,Newcastle United,2-0,2,0,1,1,2,2,H
1902-03-08,1901,Notts County,Sheffield United,4-0,4,0,1,1,4,4,H
1902-03-08,1901,Sheffield Wednesday,Nottingham Forest,0-2,0,2,1,1,2,-2,A
1902-03-08,1901,Sunderland,Stoke City,2-0,2,0,1,1,2,2,H
1902-03-08,1901,Wolverhampton Wanderers,Liverpool,3-1,3,1,1,1,4,2,H
1902-03-10,1901,Wolverhampton Wanderers,Newcastle United,3-0,3,0,1,1,3,3,H
1902-03-15,1901,Bury,Sheffield Wednesday,2-0,2,0,1,1,2,2,H
1902-03-15,1901,Everton,Sunderland,2-0,2,0,1,1,2,2,H
1902-03-15,1901,Grimsby Town,Liverpool,1-1,1,1,1,1,2,0,D
1902-03-15,1901,Newcastle United,Wolverhampton Wanderers,3-1,3,1,1,1,4,2,H
1902-03-15,1901,Stoke City,Birmingham City,1-0,1,0,1,1,1,1,H
1902-03-17,1901,Manchester City,Everton,2-0,2,0,1,1,2,2,H
1902-03-17,1901,Sheffield Wednesday,Derby County,2-0,2,0,1,1,2,2,H
1902-03-19,1901,Nottingham Forest,Newcastle United,0-2,0,2,1,1,2,-2,A
1902-03-22,1901,Birmingham City,Everton,0-1,0,1,1,1,1,-1,A
1902-03-22,1901,Derby County,Stoke City,1-0,1,0,1,1,1,1,H
1902-03-22,1901,Liverpool,Newcastle United,0-1,0,1,1,1,1,-1,A
1902-03-22,1901,Manchester City,Sheffield United,4-0,4,0,1,1,4,4,H
1902-03-22,1901,Notts County,Bury,2-1,2,1,1,1,3,1,H
1902-03-22,1901,Sheffield Wednesday,Blackburn Rovers,0-1,0,1,1,1,1,-1,A
1902-03-22,1901,Sunderland,Grimsby Town,3-1,3,1,1,1,4,2,H
1902-03-22,1901,Wolverhampton Wanderers,Aston Villa,0-2,0,2,1,1,2,-2,A
1902-03-28,1901,Bolton Wanderers,Sheffield United,1-0,1,0,1,1,1,1,H
1902-03-28,1901,Bury,Blackburn Rovers,2-0,2,0,1,1,2,2,H
1902-03-28,1901,Grimsby Town,Newcastle United,3-0,3,0,1,1,3,3,H
1902-03-28,1901,Manchester City,Sheffield Wednesday,0-3,0,3,1,1,3,-3,A
1902-03-28,1901,Notts County,Wolverhampton Wanderers,5-3,5,3,1,1,8,2,H
1902-03-29,1901,Aston Villa,Liverpool,0-1,0,1,1,1,1,-1,A
1902-03-29,1901,Blackburn Rovers,Notts County,4-2,4,2,1,1,6,2,H
1902-03-29,1901,Bury,Bolton Wanderers,2-2,2,2,1,1,4,0,D
1902-03-29,1901,Everton,Derby County,2-0,2,0,1,1,2,2,H
1902-03-29,1901,Nottingham Forest,Manchester City,3-1,3,1,1,1,4,2,H
1902-03-29,1901,Sheffield United,Wolverhampton Wanderers,0-0,0,0,1,1,0,0,D
1902-03-29,1901,Stoke City,Sheffield Wednesday,1-2,1,2,1,1,3,-1,A
1902-03-29,1901,Sunderland,Birmingham City,1-1,1,1,1,1,2,0,D
1902-03-31,1901,Aston Villa,Manchester City,2-2,2,2,1,1,4,0,D
1902-03-31,1901,Derby County,Birmingham City,0-0,0,0,1,1,0,0,D
1902-03-31,1901,Everton,Nottingham Forest,1-0,1,0,1,1,1,1,H
1902-03-31,1901,Notts County,Bolton Wanderers,2-1,2,1,1,1,3,1,H
1902-03-31,1901,Sunderland,Newcastle United,0-0,0,0,1,1,0,0,D
1902-03-31,1901,Wolverhampton Wanderers,Blackburn Rovers,3-1,3,1,1,1,4,2,H
1902-04-01,1901,Derby County,Grimsby Town,2-0,2,0,1,1,2,2,H
1902-04-01,1901,Nottingham Forest,Aston Villa,1-1,1,1,1,1,2,0,D
1902-04-01,1901,Sheffield Wednesday,Liverpool,1-1,1,1,1,1,2,0,D
1902-04-05,1901,Birmingham City,Nottingham Forest,1-1,1,1,1,1,2,0,D
1902-04-05,1901,Bolton Wanderers,Blackburn Rovers,4-0,4,0,1,1,4,4,H
1902-04-05,1901,Derby County,Sunderland,1-0,1,0,1,1,1,1,H
1902-04-05,1901,Liverpool,Sheffield United,1-0,1,0,1,1,1,1,H
1902-04-05,1901,Manchester City,Bury,2-0,2,0,1,1,2,2,H
1902-04-05,1901,Newcastle United,Aston Villa,2-1,2,1,1,1,3,1,H
1902-04-05,1901,Notts County,Stoke City,1-1,1,1,1,1,2,0,D
1902-04-05,1901,Sheffield Wednesday,Everton,1-1,1,1,1,1,2,0,D
1902-04-07,1901,Sheffield United,Bolton Wanderers,2-0,2,0,1,1,2,2,H
1902-04-12,1901,Birmingham City,Derby County,5-1,5,1,1,1,6,4,H
1902-04-12,1901,Blackburn Rovers,Manchester City,1-4,1,4,1,1,5,-3,A
1902-04-12,1901,Bury,Wolverhampton Wanderers,2-1,2,1,1,1,3,1,H
1902-04-12,1901,Everton,Notts County,0-1,0,1,1,1,1,-1,A
1902-04-12,1901,Grimsby Town,Aston Villa,4-1,4,1,1,1,5,3,H
1902-04-12,1901,Nottingham Forest,Liverpool,1-1,1,1,1,1,2,0,D
1902-04-12,1901,Sheffield United,Newcastle United,1-0,1,0,1,1,1,1,H
1902-04-12,1901,Stoke City,Bolton Wanderers,4-0,4,0,1,1,4,4,H
1902-04-12,1901,Sunderland,Sheffield Wednesday,1-2,1,2,1,1,3,-1,A
1902-04-14,1901,Liverpool,Derby County,0-2,0,2,1,1,2,-2,A
1902-04-14,1901,Stoke City,Grimsby Town,2-0,2,0,1,1,2,2,H
1902-04-16,1901,Sunderland,Bury,3-0,3,0,1,1,3,3,H
1902-04-19,1901,Blackburn Rovers,Derby County,3-1,3,1,1,1,4,2,H
1902-04-19,1901,Bolton Wanderers,Everton,1-3,1,3,1,1,4,-2,A
1902-04-19,1901,Liverpool,Bury,1-0,1,0,1,1,1,1,H
1902-04-19,1901,Manchester City,Stoke City,2-2,2,2,1,1,4,0,D
1902-04-19,1901,Newcastle United,Nottingham Forest,3-0,3,0,1,1,3,3,H
1902-04-19,1901,Notts County,Sunderland,2-0,2,0,1,1,2,2,H
1902-04-19,1901,Sheffield Wednesday,Birmingham City,1-2,1,2,1,1,3,-1,A
1902-04-21,1901,Liverpool,Grimsby Town,2-2,2,2,1,1,4,0,D
1902-04-26,1901,Birmingham City,Notts County,0-0,0,0,1,1,0,0,D
1902-04-26,1901,Blackburn Rovers,Liverpool,1-1,1,1,1,1,2,0,D
1902-04-26,1901,Bury,Newcastle United,4-0,4,0,1,1,4,4,H
1902-04-26,1901,Derby County,Sheffield Wednesday,2-2,2,2,1,1,4,0,D
1902-04-26,1901,Sunderland,Bolton Wanderers,2-1,2,1,1,1,3,1,H
1902-04-28,1901,Derby County,Sheffield United,3-1,3,1,1,1,4,2,H
1902-09-01,1902,Blackburn Rovers,Middlesbrough,0-1,0,1,1,1,1,-1,A
1902-09-01,1902,Sheffield United,Sheffield Wednesday,2-3,2,3,1,1,5,-1,A
1902-09-01,1902,Sunderland,Nottingham Forest,0-1,0,1,1,1,1,-1,A
1902-09-01,1902,West Bromwich Albion,Everton,2-1,2,1,1,1,3,1,H
1902-09-01,1902,Wolverhampton Wanderers,Derby County,3-0,3,0,1,1,3,3,H
1902-09-06,1902,Aston Villa,Derby County,0-0,0,0,1,1,0,0,D
1902-09-06,1902,Bolton Wanderers,Sheffield Wednesday,0-2,0,2,1,1,2,-2,A
1902-09-06,1902,Liverpool,Blackburn Rovers,5-2,5,2,1,1,7,3,H
1902-09-06,1902,Middlesbrough,Everton,1-0,1,0,1,1,1,1,H
1902-09-06,1902,Newcastle United,Stoke City,5-0,5,0,1,1,5,5,H
1902-09-06,1902,Notts County,West Bromwich Albion,3-1,3,1,1,1,4,2,H
1902-09-06,1902,Sheffield United,Bury,1-0,1,0,1,1,1,1,H
1902-09-06,1902,Wolverhampton Wanderers,Sunderland,3-3,3,3,1,1,6,0,D
1902-09-09,1902,Grimsby Town,Nottingham Forest,0-1,0,1,1,1,1,-1,A
1902-09-13,1902,Blackburn Rovers,Sheffield United,2-0,2,0,1,1,2,2,H
1902-09-13,1902,Bury,Grimsby Town,2-1,2,1,1,1,3,1,H
1902-09-13,1902,Derby County,Notts County,4-1,4,1,1,1,5,3,H
1902-09-13,1902,Everton,Newcastle United,0-1,0,1,1,1,1,-1,A
1902-09-13,1902,Nottingham Forest,Aston Villa,2-0,2,0,1,1,2,2,H
1902-09-13,1902,Sheffield Wednesday,Middlesbrough,2-0,2,0,1,1,2,2,H
1902-09-13,1902,Stoke City,Wolverhampton Wanderers,3-0,3,0,1,1,3,3,H
1902-09-13,1902,Sunderland,Liverpool,2-1,2,1,1,1,3,1,H
1902-09-13,1902,West Bromwich Albion,Bolton Wanderers,2-1,2,1,1,1,3,1,H
1902-09-15,1902,Stoke City,Notts County,0-2,0,2,1,1,2,-2,A
1902-09-20,1902,Aston Villa,Bury,2-2,2,2,1,1,4,0,D
1902-09-20,1902,Bolton Wanderers,Notts County,0-1,0,1,1,1,1,-1,A
1902-09-20,1902,Grimsby Town,Blackburn Rovers,4-1,4,1,1,1,5,3,H
1902-09-20,1902,Liverpool,Stoke City,1-1,1,1,1,1,2,0,D
1902-09-20,1902,Middlesbrough,West Bromwich Albion,1-1,1,1,1,1,2,0,D
1902-09-20,1902,Newcastle United,Sheffield Wednesday,3-0,3,0,1,1,3,3,H
1902-09-20,1902,Nottingham Forest,Derby County,2-3,2,3,1,1,5,-1,A
1902-09-20,1902,Sheffield United,Sunderland,1-0,1,0,1,1,1,1,H
1902-09-20,1902,Wolverhampton Wanderers,Everton,1-1,1,1,1,1,2,0,D
1902-09-27,1902,Blackburn Rovers,Aston Villa,0-2,0,2,1,1,2,-2,A
1902-09-27,1902,Bury,Nottingham Forest,3-1,3,1,1,1,4,2,H
1902-09-27,1902,Derby County,Bolton Wanderers,5-0,5,0,1,1,5,5,H
1902-09-27,1902,Everton,Liverpool,3-1,3,1,1,1,4,2,H
1902-09-27,1902,Notts County,Middlesbrough,2-0,2,0,1,1,2,2,H
1902-09-27,1902,Sheffield Wednesday,Wolverhampton Wanderers,1-1,1,1,1,1,2,0,D
1902-09-27,1902,Stoke City,Sheffield United,0-1,0,1,1,1,1,-1,A
1902-09-27,1902,Sunderland,Grimsby Town,5-1,5,1,1,1,6,4,H
1902-09-27,1902,West Bromwich Albion,Newcastle United,6-1,6,1,1,1,7,5,H
1902-10-02,1902,Nottingham Forest,Everton,2-2,2,2,1,1,4,0,D
1902-10-03,1902,Notts County,Sheffield Wednesday,0-3,0,3,1,1,3,-3,A
1902-10-04,1902,Aston Villa,Sunderland,0-1,0,1,1,1,1,-1,A
1902-10-04,1902,Bury,Derby County,1-0,1,0,1,1,1,1,H
1902-10-04,1902,Grimsby Town,Stoke City,2-2,2,2,1,1,4,0,D
1902-10-04,1902,Liverpool,Sheffield Wednesday,4-2,4,2,1,1,6,2,H
1902-10-04,1902,Middlesbrough,Bolton Wanderers,4-3,4,3,1,1,7,1,H
1902-10-04,1902,Newcastle United,Notts County,6-1,6,1,1,1,7,5,H
1902-10-04,1902,Nottingham Forest,Blackburn Rovers,2-0,2,0,1,1,2,2,H
1902-10-04,1902,Sheffield United,Everton,0-2,0,2,1,1,2,-2,A
1902-10-04,1902,Wolverhampton Wanderers,West Bromwich Albion,1-2,1,2,1,1,3,-1,A
1902-10-11,1902,Blackburn Rovers,Bury,0-3,0,3,1,1,3,-3,A
1902-10-11,1902,Bolton Wanderers,Newcastle United,0-2,0,2,1,1,2,-2,A
1902-10-11,1902,Derby County,Middlesbrough,3-2,3,2,1,1,5,1,H
1902-10-11,1902,Everton,Grimsby Town,4-2,4,2,1,1,6,2,H
1902-10-11,1902,Notts County,Wolverhampton Wanderers,0-0,0,0,1,1,0,0,D
1902-10-11,1902,Sheffield Wednesday,Sheffield United,0-1,0,1,1,1,1,-1,A
1902-10-11,1902,Stoke City,Aston Villa,1-0,1,0,1,1,1,1,H
1902-10-11,1902,West Bromwich Albion,Liverpool,1-2,1,2,1,1,3,-1,A
1902-10-13,1902,Sheffield United,Nottingham Forest,2-0,2,0,1,1,2,2,H
1902-10-18,1902,Aston Villa,Everton,2-1,2,1,1,1,3,1,H
1902-10-18,1902,Blackburn Rovers,Derby County,2-4,2,4,1,1,6,-2,A
1902-10-18,1902,Bury,Sunderland,3-1,3,1,1,1,4,2,H
1902-10-18,1902,Grimsby Town,Sheffield Wednesday,0-1,0,1,1,1,1,-1,A
1902-10-18,1902,Liverpool,Notts County,0-2,0,2,1,1,2,-2,A
1902-10-18,1902,Newcastle United,Middlesbrough,0-1,0,1,1,1,1,-1,A
1902-10-18,1902,Nottingham Forest,Stoke City,1-3,1,3,1,1,4,-2,A
1902-10-18,1902,Sheffield United,West Bromwich Albion,1-2,1,2,1,1,3,-1,A
1902-10-18,1902,Wolverhampton Wanderers,Bolton Wanderers,3-1,3,1,1,1,4,2,H
1902-10-25,1902,Bolton Wanderers,Liverpool,1-1,1,1,1,1,2,0,D
1902-10-25,1902,Derby County,Newcastle United,0-0,0,0,1,1,0,0,D
1902-10-25,1902,Everton,Nottingham Forest,1-1,1,1,1,1,2,0,D
1902-10-25,1902,Middlesbrough,Wolverhampton Wanderers,2-0,2,0,1,1,2,2,H
1902-10-25,1902,Notts County,Sheffield United,1-1,1,1,1,1,2,0,D
1902-10-25,1902,Stoke City,Bury,1-0,1,0,1,1,1,1,H
1902-10-25,1902,Sunderland,Blackburn Rovers,2-2,2,2,1,1,4,0,D
1902-10-25,1902,West Bromwich Albion,Grimsby Town,1-0,1,0,1,1,1,1,H
1902-11-01,1902,Aston Villa,West Bromwich Albion,0-3,0,3,1,1,3,-3,A
1902-11-01,1902,Blackburn Rovers,Stoke City,1-1,1,1,1,1,2,0,D
1902-11-01,1902,Bolton Wanderers,Everton,1-3,1,3,1,1,4,-2,A
1902-11-01,1902,Derby County,Sunderland,5-2,5,2,1,1,7,3,H
1902-11-01,1902,Grimsby Town,Notts County,1-1,1,1,1,1,2,0,D
1902-11-01,1902,Liverpool,Middlesbrough,5-0,5,0,1,1,5,5,H
1902-11-01,1902,Nottingham Forest,Sheffield Wednesday,1-4,1,4,1,1,5,-3,A
1902-11-01,1902,Wolverhampton Wanderers,Newcastle United,3-0,3,0,1,1,3,3,H
1902-11-08,1902,Blackburn Rovers,Everton,3-2,3,2,1,1,5,1,H
1902-11-08,1902,Derby County,Wolverhampton Wanderers,3-1,3,1,1,1,4,2,H
1902-11-08,1902,Grimsby Town,Bolton Wanderers,1-1,1,1,1,1,2,0,D
1902-11-08,1902,Middlesbrough,Sheffield United,0-2,0,2,1,1,2,-2,A
1902-11-08,1902,Newcastle United,Liverpool,1-2,1,2,1,1,3,-1,A
1902-11-08,1902,Notts County,Aston Villa,2-1,2,1,1,1,3,1,H
1902-11-08,1902,Sheffield Wednesday,Bury,2-0,2,0,1,1,2,2,H
1902-11-08,1902,Stoke City,Sunderland,1-1,1,1,1,1,2,0,D
1902-11-08,1902,West Bromwich Albion,Nottingham Forest,2-0,2,0,1,1,2,2,H
1902-11-15,1902,Aston Villa,Bolton Wanderers,4-2,4,2,1,1,6,2,H
1902-11-15,1902,Blackburn Rovers,Sheffield Wednesday,2-1,2,1,1,1,3,1,H
1902-11-15,1902,Bury,West Bromwich Albion,1-2,1,2,1,1,3,-1,A
1902-11-15,1902,Grimsby Town,Middlesbrough,2-2,2,2,1,1,4,0,D
1902-11-15,1902,Liverpool,Wolverhampton Wanderers,4-1,4,1,1,1,5,3,H
1902-11-15,1902,Nottingham Forest,Notts County,0-0,0,0,1,1,0,0,D
1902-11-15,1902,Sheffield United,Newcastle United,2-1,2,1,1,1,3,1,H
1902-11-15,1902,Stoke City,Derby County,2-0,2,0,1,1,2,2,H
1902-11-15,1902,Sunderland,Everton,2-1,2,1,1,1,3,1,H
1902-11-22,1902,Bolton Wanderers,Nottingham Forest,1-1,1,1,1,1,2,0,D
1902-11-22,1902,Derby County,Liverpool,2-1,2,1,1,1,3,1,H
1902-11-22,1902,Everton,Stoke City,0-1,0,1,1,1,1,-1,A
1902-11-22,1902,Middlesbrough,Aston Villa,1-2,1,2,1,1,3,-1,A
1902-11-22,1902,Newcastle United,Grimsby Town,1-0,1,0,1,1,1,1,H
1902-11-22,1902,Notts County,Bury,1-0,1,0,1,1,1,1,H
1902-11-22,1902,Sheffield Wednesday,Sunderland,1-0,1,0,1,1,1,1,H
1902-11-22,1902,West Bromwich Albion,Blackburn Rovers,5-3,5,3,1,1,8,2,H
1902-11-22,1902,Wolverhampton Wanderers,Sheffield United,1-3,1,3,1,1,4,-2,A
1902-11-29,1902,Aston Villa,Newcastle United,7-0,7,0,1,1,7,7,H
1902-11-29,1902,Blackburn Rovers,Notts County,1-2,1,2,1,1,3,-1,A
1902-11-29,1902,Bury,Bolton Wanderers,3-0,3,0,1,1,3,3,H
1902-11-29,1902,Everton,Derby County,2-1,2,1,1,1,3,1,H
1902-11-29,1902,Grimsby Town,Wolverhampton Wanderers,1-2,1,2,1,1,3,-1,A
1902-11-29,1902,Nottingham Forest,Middlesbrough,1-0,1,0,1,1,1,1,H
1902-11-29,1902,Sheffield United,Liverpool,2-0,2,0,1,1,2,2,H
1902-11-29,1902,Stoke City,Sheffield Wednesday,4-0,4,0,1,1,4,4,H
1902-11-29,1902,Sunderland,West Bromwich Albion,0-0,0,0,1,1,0,0,D
1902-12-06,1902,Bolton Wanderers,Blackburn Rovers,1-2,1,2,1,1,3,-1,A
1902-12-06,1902,Derby County,Sheffield United,1-0,1,0,1,1,1,1,H
1902-12-06,1902,Liverpool,Grimsby Town,9-2,9,2,1,1,11,7,H
1902-12-06,1902,Middlesbrough,Bury,1-1,1,1,1,1,2,0,D
1902-12-06,1902,Newcastle United,Nottingham Forest,0-2,0,2,1,1,2,-2,A
1902-12-06,1902,Notts County,Sunderland,0-0,0,0,1,1,0,0,D
1902-12-06,1902,Sheffield Wednesday,Everton,4-1,4,1,1,1,5,3,H
1902-12-06,1902,West Bromwich Albion,Stoke City,2-1,2,1,1,1,3,1,H
1902-12-06,1902,Wolverhampton Wanderers,Aston Villa,2-1,2,1,1,1,3,1,H
1902-12-13,1902,Aston Villa,Liverpool,1-2,1,2,1,1,3,-1,A
1902-12-13,1902,Bury,Newcastle United,1-0,1,0,1,1,1,1,H
1902-12-13,1902,Everton,West Bromwich Albion,3-1,3,1,1,1,4,2,H
1902-12-13,1902,Grimsby Town,Sheffield United,1-2,1,2,1,1,3,-1,A
1902-12-13,1902,Nottingham Forest,Wolverhampton Wanderers,2-0,2,0,1,1,2,2,H
1902-12-13,1902,Sheffield Wednesday,Derby County,0-1,0,1,1,1,1,-1,A
1902-12-13,1902,Sunderland,Bolton Wanderers,3-1,3,1,1,1,4,2,H
1902-12-20,1902,Bolton Wanderers,Stoke City,2-3,2,3,1,1,5,-1,A
1902-12-20,1902,Grimsby Town,Derby County,4-1,4,1,1,1,5,3,H
1902-12-20,1902,Liverpool,Nottingham Forest,2-1,2,1,1,1,3,1,H
1902-12-20,1902,Middlesbrough,Sunderland,0-1,0,1,1,1,1,-1,A
1902-12-20,1902,Newcastle United,Blackburn Rovers,1-0,1,0,1,1,1,1,H
1902-12-20,1902,Notts County,Everton,2-0,2,0,1,1,2,2,H
1902-12-20,1902,Sheffield United,Aston Villa,2-4,2,4,1,1,6,-2,A
1902-12-20,1902,West Bromwich Albion,Sheffield Wednesday,2-3,2,3,1,1,5,-1,A
1902-12-20,1902,Wolverhampton Wanderers,Bury,3-2,3,2,1,1,5,1,H
1902-12-25,1902,Blackburn Rovers,Sunderland,0-2,0,2,1,1,2,-2,A
1902-12-25,1902,Bury,Stoke City,2-1,2,1,1,1,3,1,H
1902-12-25,1902,Grimsby Town,Everton,0-0,0,0,1,1,0,0,D
1902-12-25,1902,Liverpool,Bolton Wanderers,5-1,5,1,1,1,6,4,H
1902-12-26,1902,Aston Villa,Sheffield Wednesday,1-0,1,0,1,1,1,1,H
1902-12-26,1902,Notts County,Nottingham Forest,1-1,1,1,1,1,2,0,D
1902-12-26,1902,Sheffield United,Bolton Wanderers,7-1,7,1,1,1,8,6,H
1902-12-26,1902,Stoke City,Blackburn Rovers,0-2,0,2,1,1,2,-2,A
1902-12-26,1902,Wolverhampton Wanderers,Middlesbrough,2-0,2,0,1,1,2,2,H
1902-12-27,1902,Aston Villa,Grimsby Town,2-2,2,2,1,1,4,0,D
1902-12-27,1902,Bury,Liverpool,3-1,3,1,1,1,4,2,H
1902-12-27,1902,Derby County,West Bromwich Albion,1-0,1,0,1,1,1,1,H
1902-12-27,1902,Everton,Bolton Wanderers,3-1,3,1,1,1,4,2,H
1902-12-27,1902,Nottingham Forest,Sheffield United,2-2,2,2,1,1,4,0,D
1902-12-27,1902,Sheffield Wednesday,Notts County,2-0,2,0,1,1,2,2,H
1902-12-27,1902,Stoke City,Middlesbrough,0-2,0,2,1,1,2,-2,A
1902-12-27,1902,Sunderland,Newcastle United,0-0,0,0,1,1,0,0,D
1902-12-27,1902,Wolverhampton Wanderers,Blackburn Rovers,2-0,2,0,1,1,2,2,H
1903-01-01,1902,Blackburn Rovers,Wolverhampton Wanderers,1-0,1,0,1,1,1,1,H
1903-01-01,1902,Bury,Everton,4-2,4,2,1,1,6,2,H
1903-01-01,1902,Liverpool,West Bromwich Albion,0-2,0,2,1,1,2,-2,A
1903-01-01,1902,Sheffield Wednesday,Aston Villa,4-0,4,0,1,1,4,4,H
1903-01-01,1902,Sunderland,Derby County,2-0,2,0,1,1,2,2,H
1903-01-02,1902,Bolton Wanderers,Grimsby Town,0-1,0,1,1,1,1,-1,A
1903-01-03,1902,Blackburn Rovers,Liverpool,3-1,3,1,1,1,4,2,H
1903-01-03,1902,Bury,Sheffield United,3-1,3,1,1,1,4,2,H
1903-01-03,1902,Derby County,Aston Villa,2-0,2,0,1,1,2,2,H
1903-01-03,1902,Everton,Middlesbrough,3-0,3,0,1,1,3,3,H
1903-01-03,1902,Nottingham Forest,Grimsby Town,2-1,2,1,1,1,3,1,H
1903-01-03,1902,Sheffield Wednesday,Bolton Wanderers,3-0,3,0,1,1,3,3,H
1903-01-03,1902,Stoke City,Newcastle United,5-0,5,0,1,1,5,5,H
1903-01-03,1902,Sunderland,Wolverhampton Wanderers,3-0,3,0,1,1,3,3,H
1903-01-03,1902,West Bromwich Albion,Notts County,3-2,3,2,1,1,5,1,H
1903-01-10,1902,Aston Villa,Nottingham Forest,3-1,3,1,1,1,4,2,H
1903-01-10,1902,Bolton Wanderers,West Bromwich Albion,0-1,0,1,1,1,1,-1,A
1903-01-10,1902,Grimsby Town,Bury,2-1,2,1,1,1,3,1,H
1903-01-10,1902,Middlesbrough,Sheffield Wednesday,2-1,2,1,1,1,3,1,H
1903-01-10,1902,Notts County,Derby County,2-1,2,1,1,1,3,1,H
1903-01-10,1902,Sheffield United,Blackburn Rovers,2-1,2,1,1,1,3,1,H
1903-01-10,1902,Wolverhampton Wanderers,Stoke City,1-0,1,0,1,1,1,1,H
1903-01-17,1902,Blackburn Rovers,Grimsby Town,2-0,2,0,1,1,2,2,H
1903-01-17,1902,Bury,Aston Villa,0-1,0,1,1,1,1,-1,A
1903-01-17,1902,Derby County,Nottingham Forest,0-1,0,1,1,1,1,-1,A
1903-01-17,1902,Everton,Wolverhampton Wanderers,2-1,2,1,1,1,3,1,H
1903-01-17,1902,Notts County,Bolton Wanderers,1-3,1,3,1,1,4,-2,A
1903-01-17,1902,Sheffield Wednesday,Newcastle United,3-0,3,0,1,1,3,3,H
1903-01-17,1902,Stoke City,Liverpool,1-0,1,0,1,1,1,1,H
1903-01-17,1902,Sunderland,Sheffield United,0-0,0,0,1,1,0,0,D
1903-01-17,1902,West Bromwich Albion,Middlesbrough,1-0,1,0,1,1,1,1,H
1903-01-24,1902,Aston Villa,Blackburn Rovers,5-0,5,0,1,1,5,5,H
1903-01-24,1902,Bolton Wanderers,Derby County,2-0,2,0,1,1,2,2,H
1903-01-24,1902,Grimsby Town,Sunderland,2-4,2,4,1,1,6,-2,A
1903-01-24,1902,Middlesbrough,Notts County,2-1,2,1,1,1,3,1,H
1903-01-24,1902,Newcastle United,West Bromwich Albion,1-0,1,0,1,1,1,1,H
1903-01-24,1902,Nottingham Forest,Bury,3-0,3,0,1,1,3,3,H
1903-01-24,1902,Sheffield United,Stoke City,1-3,1,3,1,1,4,-2,A
1903-01-24,1902,Wolverhampton Wanderers,Sheffield Wednesday,2-1,2,1,1,1,3,1,H
1903-01-31,1902,Blackburn Rovers,Nottingham Forest,2-2,2,2,1,1,4,0,D
1903-01-31,1902,Bolton Wanderers,Middlesbrough,2-1,2,1,1,1,3,1,H
1903-01-31,1902,Derby County,Bury,2-0,2,0,1,1,2,2,H
1903-01-31,1902,Everton,Sheffield United,1-0,1,0,1,1,1,1,H
1903-01-31,1902,Notts County,Newcastle United,2-2,2,2,1,1,4,0,D
1903-01-31,1902,Sheffield Wednesday,Liverpool,3-1,3,1,1,1,4,2,H
1903-01-31,1902,Stoke City,Grimsby Town,1-1,1,1,1,1,2,0,D
1903-01-31,1902,Sunderland,Aston Villa,1-0,1,0,1,1,1,1,H
1903-01-31,1902,West Bromwich Albion,Wolverhampton Wanderers,2-2,2,2,1,1,4,0,D
1903-02-14,1902,Bolton Wanderers,Wolverhampton Wanderers,4-1,4,1,1,1,5,3,H
1903-02-14,1902,Derby County,Blackburn Rovers,1-0,1,0,1,1,1,1,H
1903-02-14,1902,Everton,Aston Villa,0-1,0,1,1,1,1,-1,A
1903-02-14,1902,Middlesbrough,Newcastle United,1-0,1,0,1,1,1,1,H
1903-02-14,1902,Notts County,Liverpool,1-2,1,2,1,1,3,-1,A
1903-02-14,1902,Sheffield Wednesday,Grimsby Town,1-1,1,1,1,1,2,0,D
1903-02-14,1902,Stoke City,Nottingham Forest,3-2,3,2,1,1,5,1,H
1903-02-14,1902,Sunderland,Bury,3-1,3,1,1,1,4,2,H
1903-02-14,1902,West Bromwich Albion,Sheffield United,3-3,3,3,1,1,6,0,D
1903-02-28,1902,Bolton Wanderers,Sheffield United,1-0,1,0,1,1,1,1,H
1903-02-28,1902,Everton,Bury,3-0,3,0,1,1,3,3,H
1903-02-28,1902,Middlesbrough,Liverpool,0-2,0,2,1,1,2,-2,A
1903-02-28,1902,Newcastle United,Wolverhampton Wanderers,2-4,2,4,1,1,6,-2,A
1903-02-28,1902,Notts County,Grimsby Town,0-1,0,1,1,1,1,-1,A
1903-02-28,1902,Sheffield Wednesday,Nottingham Forest,1-0,1,0,1,1,1,1,H
1903-02-28,1902,West Bromwich Albion,Aston Villa,1-2,1,2,1,1,3,-1,A
1903-03-07,1902,Liverpool,Newcastle United,3-0,3,0,1,1,3,3,H
1903-03-07,1902,Nottingham Forest,West Bromwich Albion,3-1,3,1,1,1,4,2,H
1903-03-07,1902,Sheffield United,Middlesbrough,1-3,1,3,1,1,4,-2,A
1903-03-14,1902,Bolton Wanderers,Aston Villa,0-1,0,1,1,1,1,-1,A
1903-03-14,1902,Derby County,Stoke City,2-0,2,0,1,1,2,2,H
1903-03-14,1902,Everton,Sunderland,0-3,0,3,1,1,3,-3,A
1903-03-14,1902,Middlesbrough,Grimsby Town,2-0,2,0,1,1,2,2,H
1903-03-14,1902,Newcastle United,Sheffield United,0-0,0,0,1,1,0,0,D
1903-03-14,1902,Sheffield Wednesday,Blackburn Rovers,0-0,0,0,1,1,0,0,D
1903-03-21,1902,Blackburn Rovers,West Bromwich Albion,1-0,1,0,1,1,1,1,H
1903-03-21,1902,Grimsby Town,Newcastle United,1-0,1,0,1,1,1,1,H
1903-03-21,1902,Nottingham Forest,Bolton Wanderers,1-2,1,2,1,1,3,-1,A
1903-03-21,1902,Sheffield United,Wolverhampton Wanderers,3-0,3,0,1,1,3,3,H
1903-03-21,1902,Stoke City,Everton,2-0,2,0,1,1,2,2,H
1903-03-21,1902,Sunderland,Sheffield Wednesday,0-1,0,1,1,1,1,-1,A
1903-03-23,1902,Liverpool,Derby County,3-1,3,1,1,1,4,2,H
1903-03-26,1902,Bury,Notts County,3-1,3,1,1,1,4,2,H
1903-03-28,1902,Bolton Wanderers,Bury,1-0,1,0,1,1,1,1,H
1903-03-28,1902,Derby County,Everton,0-1,0,1,1,1,1,-1,A
1903-03-28,1902,Liverpool,Sheffield United,2-4,2,4,1,1,6,-2,A
1903-03-28,1902,Middlesbrough,Nottingham Forest,2-0,2,0,1,1,2,2,H
1903-03-28,1902,Newcastle United,Aston Villa,2-0,2,0,1,1,2,2,H
1903-03-28,1902,Notts County,Blackburn Rovers,4-0,4,0,1,1,4,4,H
1903-03-28,1902,Sheffield Wednesday,Stoke City,1-0,1,0,1,1,1,1,H
1903-03-28,1902,West Bromwich Albion,Sunderland,0-3,0,3,1,1,3,-3,A
1903-03-28,1902,Wolverhampton Wanderers,Grimsby Town,3-0,3,0,1,1,3,3,H
1903-03-30,1902,Liverpool,Sunderland,1-1,1,1,1,1,2,0,D
1903-03-30,1902,Sheffield United,Derby County,3-2,3,2,1,1,5,1,H
1903-04-01,1902,Newcastle United,Everton,3-0,3,0,1,1,3,3,H
1903-04-04,1902,Aston Villa,Wolverhampton Wanderers,3-1,3,1,1,1,4,2,H
1903-04-04,1902,Blackburn Rovers,Bolton Wanderers,4-2,4,2,1,1,6,2,H
1903-04-04,1902,Bury,Middlesbrough,3-1,3,1,1,1,4,2,H
1903-04-04,1902,Everton,Sheffield Wednesday,1-1,1,1,1,1,2,0,D
1903-04-04,1902,Grimsby Town,Liverpool,3-1,3,1,1,1,4,2,H
1903-04-04,1902,Nottingham Forest,Newcastle United,3-2,3,2,1,1,5,1,H
1903-04-04,1902,Stoke City,West Bromwich Albion,3-0,3,0,1,1,3,3,H
1903-04-04,1902,Sunderland,Notts County,2-1,2,1,1,1,3,1,H
1903-04-06,1902,Bury,Sheffield Wednesday,4-0,4,0,1,1,4,4,H
1903-04-10,1902,Bury,Blackburn Rovers,1-1,1,1,1,1,2,0,D
1903-04-10,1902,Grimsby Town,West Bromwich Albion,4-0,4,0,1,1,4,4,H
1903-04-10,1902,Liverpool,Everton,0-0,0,0,1,1,0,0,D
1903-04-10,1902,Newcastle United,Derby County,2-1,2,1,1,1,3,1,H
1903-04-10,1902,Sheffield United,Notts County,3-0,3,0,1,1,3,3,H
1903-04-10,1902,Sunderland,Stoke City,0-0,0,0,1,1,0,0,D
1903-04-11,1902,Bolton Wanderers,Sunderland,2-0,2,0,1,1,2,2,H
1903-04-11,1902,Derby County,Sheffield Wednesday,1-0,1,0,1,1,1,1,H
1903-04-11,1902,Liverpool,Aston Villa,2-1,2,1,1,1,3,1,H
1903-04-11,1902,Middlesbrough,Blackburn Rovers,4-0,4,0,1,1,4,4,H
1903-04-11,1902,Newcastle United,Bury,1-0,1,0,1,1,1,1,H
1903-04-11,1902,Notts County,Stoke City,3-0,3,0,1,1,3,3,H
1903-04-11,1902,Sheffield United,Grimsby Town,3-0,3,0,1,1,3,3,H
1903-04-11,1902,Wolverhampton Wanderers,Nottingham Forest,2-1,2,1,1,1,3,1,H
1903-04-13,1902,Aston Villa,Stoke City,2-0,2,0,1,1,2,2,H
1903-04-13,1902,Everton,Blackburn Rovers,0-3,0,3,1,1,3,-3,A
1903-04-13,1902,Middlesbrough,Derby County,3-1,3,1,1,1,4,2,H
1903-04-13,1902,Newcastle United,Bolton Wanderers,2-0,2,0,1,1,2,2,H
1903-04-13,1902,Nottingham Forest,Sunderland,5-2,5,2,1,1,7,3,H
1903-04-13,1902,Wolverhampton Wanderers,Notts County,2-0,2,0,1,1,2,2,H
1903-04-15,1902,Aston Villa,Notts County,2-1,2,1,1,1,3,1,H
1903-04-18,1902,Aston Villa,Sheffield United,4-2,4,2,1,1,6,2,H
1903-04-18,1902,Blackburn Rovers,Newcastle United,3-1,3,1,1,1,4,2,H
1903-04-18,1902,Everton,Notts County,2-0,2,0,1,1,2,2,H
1903-04-18,1902,Nottingham Forest,Liverpool,1-0,1,0,1,1,1,1,H
1903-04-18,1902,Sheffield Wednesday,West Bromwich Albion,3-1,3,1,1,1,4,2,H
1903-04-18,1902,Stoke City,Bolton Wanderers,2-0,2,0,1,1,2,2,H
1903-04-18,1902,Sunderland,Middlesbrough,2-1,2,1,1,1,3,1,H
1903-04-20,1902,West Bromwich Albion,Bury,1-3,1,3,1,1,4,-2,A
1903-04-22,1902,Bury,Wolverhampton Wanderers,4-0,4,0,1,1,4,4,H
1903-04-22,1902,Derby County,Grimsby Town,2-2,2,2,1,1,4,0,D
1903-04-25,1902,Grimsby Town,Aston Villa,0-2,0,2,1,1,2,-2,A
1903-04-25,1902,Liverpool,Bury,2-0,2,0,1,1,2,2,H
1903-04-25,1902,Middlesbrough,Stoke City,1-1,1,1,1,1,2,0,D
1903-04-25,1902,Newcastle United,Sunderland,1-0,1,0,1,1,1,1,H
1903-04-25,1902,West Bromwich Albion,Derby County,3-0,3,0,1,1,3,3,H
1903-04-27,1902,Aston Villa,Middlesbrough,5-0,5,0,1,1,5,5,H
1903-04-27,1902,Wolverhampton Wanderers,Liverpool,0-2,0,2,1,1,2,-2,A
1903-09-01,1903,Derby County,Birmingham City,4-1,4,1,1,1,5,3,H
1903-09-01,1903,Everton,Blackburn Rovers,3-1,3,1,1,1,4,2,H
1903-09-01,1903,Stoke City,Bury,4-1,4,1,1,1,5,3,H
1903-09-01,1903,Sunderland,Notts County,4-1,4,1,1,1,5,3,H
1903-09-02,1903,Newcastle United,Aston Villa,1-1,1,1,1,1,2,0,D
1903-09-02,1903,West Bromwich Albion,Sheffield Wednesday,0-1,0,1,1,1,1,-1,A
1903-09-05,1903,Birmingham City,Sheffield United,1-3,1,3,1,1,4,-2,A
1903-09-05,1903,Blackburn Rovers,Bury,2-2,2,2,1,1,4,0,D
1903-09-05,1903,Derby County,Wolverhampton Wanderers,2-1,2,1,1,1,3,1,H
1903-09-05,1903,Everton,Notts County,3-1,3,1,1,1,4,2,H
1903-09-05,1903,Nottingham Forest,Liverpool,2-1,2,1,1,1,3,1,H
1903-09-05,1903,Sheffield Wednesday,Middlesbrough,4-1,4,1,1,1,5,3,H
1903-09-05,1903,Stoke City,Manchester City,1-2,1,2,1,1,3,-1,A
1903-09-05,1903,Sunderland,Aston Villa,6-1,6,1,1,1,7,5,H
1903-09-05,1903,West Bromwich Albion,Newcastle United,1-2,1,2,1,1,3,-1,A
1903-09-07,1903,Birmingham City,Nottingham Forest,3-3,3,3,1,1,6,0,D
1903-09-12,1903,Aston Villa,West Bromwich Albion,3-1,3,1,1,1,4,2,H
1903-09-12,1903,Bury,Nottingham Forest,2-2,2,2,1,1,4,0,D
1903-09-12,1903,Liverpool,Sheffield Wednesday,1-3,1,3,1,1,4,-2,A
1903-09-12,1903,Manchester City,Derby County,2-1,2,1,1,1,3,1,H
1903-09-12,1903,Middlesbrough,Sunderland,2-3,2,3,1,1,5,-1,A
1903-09-12,1903,Newcastle United,Birmingham City,3-1,3,1,1,1,4,2,H
1903-09-12,1903,Notts County,Stoke City,1-0,1,0,1,1,1,1,H
1903-09-12,1903,Sheffield United,Everton,2-1,2,1,1,1,3,1,H
1903-09-12,1903,Wolverhampton Wanderers,Blackburn Rovers,1-0,1,0,1,1,1,1,H
1903-09-19,1903,Birmingham City,Aston Villa,2-2,2,2,1,1,4,0,D
1903-09-19,1903,Derby County,Notts County,0-1,0,1,1,1,1,-1,A
1903-09-19,1903,Everton,Newcastle United,4-1,4,1,1,1,5,3,H
1903-09-19,1903,Manchester City,Wolverhampton Wanderers,4-1,4,1,1,1,5,3,H
1903-09-19,1903,Nottingham Forest,Blackburn Rovers,0-1,0,1,1,1,1,-1,A
1903-09-19,1903,Sheffield Wednesday,Bury,1-1,1,1,1,1,2,0,D
1903-09-19,1903,Stoke City,Sheffield United,3-4,3,4,1,1,7,-1,A
1903-09-19,1903,Sunderland,Liverpool,2-1,2,1,1,1,3,1,H
1903-09-19,1903,West Bromwich Albion,Middlesbrough,0-0,0,0,1,1,0,0,D
1903-09-26,1903,Aston Villa,Everton,3-1,3,1,1,1,4,2,H
1903-09-26,1903,Blackburn Rovers,Sheffield Wednesday,0-0,0,0,1,1,0,0,D
1903-09-26,1903,Bury,Sunderland,3-1,3,1,1,1,4,2,H
1903-09-26,1903,Liverpool,West Bromwich Albion,1-3,1,3,1,1,4,-2,A
1903-09-26,1903,Middlesbrough,Birmingham City,3-1,3,1,1,1,4,2,H
1903-09-26,1903,Newcastle United,Stoke City,1-0,1,0,1,1,1,1,H
1903-09-26,1903,Notts County,Manchester City,0-3,0,3,1,1,3,-3,A
1903-09-26,1903,Sheffield United,Derby County,3-2,3,2,1,1,5,1,H
1903-09-26,1903,Wolverhampton Wanderers,Nottingham Forest,3-2,3,2,1,1,5,1,H
1903-10-01,1903,Notts County,Liverpool,4-2,4,2,1,1,6,2,H
1903-10-03,1903,Birmingham City,Liverpool,1-2,1,2,1,1,3,-1,A
1903-10-03,1903,Derby County,Newcastle United,1-3,1,3,1,1,4,-2,A
1903-10-03,1903,Everton,Middlesbrough,2-0,2,0,1,1,2,2,H
1903-10-03,1903,Manchester City,Sheffield United,0-1,0,1,1,1,1,-1,A
1903-10-03,1903,Notts County,Wolverhampton Wanderers,0-2,0,2,1,1,2,-2,A
1903-10-03,1903,Sheffield Wednesday,Nottingham Forest,2-1,2,1,1,1,3,1,H
1903-10-03,1903,Stoke City,Aston Villa,2-0,2,0,1,1,2,2,H
1903-10-03,1903,Sunderland,Blackburn Rovers,2-0,2,0,1,1,2,2,H
1903-10-03,1903,West Bromwich Albion,Bury,3-2,3,2,1,1,5,1,H
1903-10-10,1903,Aston Villa,Derby County,3-0,3,0,1,1,3,3,H
1903-10-10,1903,Blackburn Rovers,West Bromwich Albion,2-0,2,0,1,1,2,2,H
1903-10-10,1903,Bury,Birmingham City,1-0,1,0,1,1,1,1,H
1903-10-10,1903,Liverpool,Everton,2-2,2,2,1,1,4,0,D
1903-10-10,1903,Middlesbrough,Stoke City,2-0,2,0,1,1,2,2,H
1903-10-10,1903,Newcastle United,Manchester City,1-0,1,0,1,1,1,1,H
1903-10-10,1903,Nottingham Forest,Sunderland,3-0,3,0,1,1,3,3,H
1903-10-10,1903,Sheffield United,Notts County,3-1,3,1,1,1,4,2,H
1903-10-10,1903,Wolverhampton Wanderers,Sheffield Wednesday,2-1,2,1,1,1,3,1,H
1903-10-17,1903,Birmingham City,Blackburn Rovers,2-1,2,1,1,1,3,1,H
1903-10-17,1903,Derby County,Middlesbrough,2-2,2,2,1,1,4,0,D
1903-10-17,1903,Everton,Bury,2-1,2,1,1,1,3,1,H
1903-10-17,1903,Manchester City,Aston Villa,1-0,1,0,1,1,1,1,H
1903-10-17,1903,Notts County,Newcastle United,3-2,3,2,1,1,5,1,H
1903-10-17,1903,Sheffield United,Wolverhampton Wanderers,7-2,7,2,1,1,9,5,H
1903-10-17,1903,Stoke City,Liverpool,5-2,5,2,1,1,7,3,H
1903-10-17,1903,Sunderland,Sheffield Wednesday,0-1,0,1,1,1,1,-1,A
1903-10-17,1903,West Bromwich Albion,Nottingham Forest,1-1,1,1,1,1,2,0,D
1903-10-24,1903,Aston Villa,Notts County,4-0,4,0,1,1,4,4,H
1903-10-24,1903,Blackburn Rovers,Everton,0-2,0,2,1,1,2,-2,A
1903-10-24,1903,Bury,Stoke City,2-2,2,2,1,1,4,0,D
1903-10-24,1903,Liverpool,Derby County,3-1,3,1,1,1,4,2,H
1903-10-24,1903,Middlesbrough,Manchester City,6-0,6,0,1,1,6,6,H
1903-10-24,1903,Newcastle United,Sheffield United,0-1,0,1,1,1,1,-1,A
1903-10-24,1903,Nottingham Forest,Birmingham City,0-1,0,1,1,1,1,-1,A
1903-10-24,1903,Sheffield Wednesday,West Bromwich Albion,1-0,1,0,1,1,1,1,H
1903-10-24,1903,Wolverhampton Wanderers,Sunderland,2-1,2,1,1,1,3,1,H
1903-10-31,1903,Birmingham City,Sheffield Wednesday,0-0,0,0,1,1,0,0,D
1903-10-31,1903,Derby County,Bury,2-2,2,2,1,1,4,0,D
1903-10-31,1903,Everton,Nottingham Forest,0-2,0,2,1,1,2,-2,A
1903-10-31,1903,Manchester City,Liverpool,3-2,3,2,1,1,5,1,H
1903-10-31,1903,Newcastle United,Wolverhampton Wanderers,3-0,3,0,1,1,3,3,H
1903-10-31,1903,Notts County,Middlesbrough,3-2,3,2,1,1,5,1,H
1903-10-31,1903,Sheffield United,Aston Villa,1-2,1,2,1,1,3,-1,A
1903-10-31,1903,Stoke City,Blackburn Rovers,6-2,6,2,1,1,8,4,H
1903-10-31,1903,West Bromwich Albion,Sunderland,1-1,1,1,1,1,2,0,D
1903-11-07,1903,Aston Villa,Newcastle United,3-1,3,1,1,1,4,2,H
1903-11-07,1903,Blackburn Rovers,Derby County,2-1,2,1,1,1,3,1,H
1903-11-07,1903,Bury,Manchester City,1-3,1,3,1,1,4,-2,A
1903-11-07,1903,Liverpool,Notts County,2-1,2,1,1,1,3,1,H
1903-11-07,1903,Middlesbrough,Sheffield United,4-1,4,1,1,1,5,3,H
1903-11-07,1903,Sheffield Wednesday,Everton,1-0,1,0,1,1,1,1,H
1903-11-07,1903,Sunderland,Birmingham City,3-1,3,1,1,1,4,2,H
1903-11-07,1903,Wolverhampton Wanderers,West Bromwich Albion,1-0,1,0,1,1,1,1,H
1903-11-14,1903,Aston Villa,Wolverhampton Wanderers,2-0,2,0,1,1,2,2,H
1903-11-14,1903,Birmingham City,West Bromwich Albion,0-1,0,1,1,1,1,-1,A
1903-11-14,1903,Derby County,Nottingham Forest,2-6,2,6,1,1,8,-4,A
1903-11-14,1903,Everton,Sunderland,0-1,0,1,1,1,1,-1,A
1903-11-14,1903,Manchester City,Blackburn Rovers,1-0,1,0,1,1,1,1,H
1903-11-14,1903,Newcastle United,Middlesbrough,2-1,2,1,1,1,3,1,H
1903-11-14,1903,Notts County,Bury,0-0,0,0,1,1,0,0,D
1903-11-14,1903,Sheffield United,Liverpool,2-1,2,1,1,1,3,1,H
1903-11-14,1903,Stoke City,Sheffield Wednesday,3-1,3,1,1,1,4,2,H
1903-11-21,1903,Blackburn Rovers,Notts County,3-0,3,0,1,1,3,3,H
1903-11-21,1903,Bury,Sheffield United,0-1,0,1,1,1,1,-1,A
1903-11-21,1903,Liverpool,Newcastle United,1-0,1,0,1,1,1,1,H
1903-11-21,1903,Middlesbrough,Aston Villa,2-1,2,1,1,1,3,1,H
1903-11-21,1903,Nottingham Forest,Manchester City,0-3,0,3,1,1,3,-3,A
1903-11-21,1903,Sheffield Wednesday,Derby County,1-0,1,0,1,1,1,1,H
1903-11-21,1903,Sunderland,Stoke City,3-0,3,0,1,1,3,3,H
1903-11-21,1903,West Bromwich Albion,Everton,0-0,0,0,1,1,0,0,D
1903-11-21,1903,Wolverhampton Wanderers,Birmingham City,1-0,1,0,1,1,1,1,H
1903-11-25,1903,Nottingham Forest,Stoke City,4-2,4,2,1,1,6,2,H
1903-11-28,1903,Aston Villa,Liverpool,2-1,2,1,1,1,3,1,H
1903-11-28,1903,Derby County,Sunderland,7-2,7,2,1,1,9,5,H
1903-11-28,1903,Everton,Birmingham City,5-1,5,1,1,1,6,4,H
1903-11-28,1903,Manchester City,Sheffield Wednesday,1-1,1,1,1,1,2,0,D
1903-11-28,1903,Middlesbrough,Wolverhampton Wanderers,1-2,1,2,1,1,3,-1,A
1903-11-28,1903,Newcastle United,Bury,3-2,3,2,1,1,5,1,H
1903-11-28,1903,Notts County,Nottingham Forest,1-3,1,3,1,1,4,-2,A
1903-11-28,1903,Sheffield United,Blackburn Rovers,2-2,2,2,1,1,4,0,D
1903-11-28,1903,Stoke City,West Bromwich Albion,5-0,5,0,1,1,5,5,H
1903-12-05,1903,Birmingham City,Stoke City,1-0,1,0,1,1,1,1,H
1903-12-05,1903,Blackburn Rovers,Newcastle United,4-0,4,0,1,1,4,4,H
1903-12-05,1903,Bury,Aston Villa,2-2,2,2,1,1,4,0,D
1903-12-05,1903,Nottingham Forest,Sheffield United,1-1,1,1,1,1,2,0,D
1903-12-05,1903,Sunderland,Manchester City,1-1,1,1,1,1,2,0,D
1903-12-05,1903,Wolverhampton Wanderers,Everton,2-2,2,2,1,1,4,0,D
1903-12-12,1903,Aston Villa,Blackburn Rovers,2-3,2,3,1,1,5,-1,A
1903-12-12,1903,Liverpool,Wolverhampton Wanderers,1-2,1,2,1,1,3,-1,A
1903-12-12,1903,Manchester City,West Bromwich Albion,6-3,6,3,1,1,9,3,H
1903-12-12,1903,Middlesbrough,Bury,1-0,1,0,1,1,1,1,H
1903-12-12,1903,Newcastle United,Nottingham Forest,3-1,3,1,1,1,4,2,H
1903-12-12,1903,Notts County,Sunderland,2-1,2,1,1,1,3,1,H
1903-12-12,1903,Sheffield United,Sheffield Wednesday,1-1,1,1,1,1,2,0,D
1903-12-12,1903,Stoke City,Everton,2-3,2,3,1,1,5,-1,A
1903-12-14,1903,West Bromwich Albion,Derby County,0-0,0,0,1,1,0,0,D
1903-12-19,1903,Birmingham City,Manchester City,0-3,0,3,1,1,3,-3,A
1903-12-19,1903,Blackburn Rovers,Middlesbrough,1-1,1,1,1,1,2,0,D
1903-12-19,1903,Bury,Liverpool,2-2,2,2,1,1,4,0,D
1903-12-19,1903,Everton,Derby County,0-1,0,1,1,1,1,-1,A
1903-12-19,1903,Nottingham Forest,Aston Villa,3-7,3,7,1,1,10,-4,A
1903-12-19,1903,Sheffield Wednesday,Newcastle United,1-1,1,1,1,1,2,0,D
1903-12-19,1903,Stoke City,Wolverhampton Wanderers,5-1,5,1,1,1,6,4,H
1903-12-19,1903,Sunderland,Sheffield United,2-1,2,1,1,1,3,1,H
1903-12-19,1903,West Bromwich Albion,Notts County,0-0,0,0,1,1,0,0,D
1903-12-25,1903,Blackburn Rovers,Stoke City,2-0,2,0,1,1,2,2,H
1903-12-25,1903,Derby County,Liverpool,2-0,2,0,1,1,2,2,H
1903-12-25,1903,Nottingham Forest,Notts County,0-1,0,1,1,1,1,-1,A
1903-12-25,1903,Sheffield United,Newcastle United,2-2,2,2,1,1,4,0,D
1903-12-26,1903,Aston Villa,Sheffield Wednesday,2-1,2,1,1,1,3,1,H
1903-12-26,1903,Derby County,Stoke City,5-0,5,0,1,1,5,5,H
1903-12-26,1903,Liverpool,Blackburn Rovers,1-2,1,2,1,1,3,-1,A
1903-12-26,1903,Manchester City,Everton,1-3,1,3,1,1,4,-2,A
1903-12-26,1903,Middlesbrough,Nottingham Forest,1-1,1,1,1,1,2,0,D
1903-12-26,1903,Newcastle United,Sunderland,1-3,1,3,1,1,4,-2,A
1903-12-26,1903,Notts County,Birmingham City,2-0,2,0,1,1,2,2,H
1903-12-26,1903,Sheffield United,West Bromwich Albion,4-0,4,0,1,1,4,4,H
1903-12-26,1903,Wolverhampton Wanderers,Bury,0-0,0,0,1,1,0,0,D
1903-12-28,1903,Derby County,Aston Villa,2-2,2,2,1,1,4,0,D
1903-12-28,1903,Sheffield United,Manchester City,5-3,5,3,1,1,8,2,H
1903-12-28,1903,Stoke City,Middlesbrough,0-0,0,0,1,1,0,0,D
1903-12-28,1903,West Bromwich Albion,Blackburn Rovers,2-1,2,1,1,1,3,1,H
1903-12-28,1903,Wolverhampton Wanderers,Liverpool,4-2,4,2,1,1,6,2,H
1904-01-01,1903,Blackburn Rovers,Nottingham Forest,3-1,3,1,1,1,4,2,H
1904-01-01,1903,Bury,Notts County,3-0,3,0,1,1,3,3,H
1904-01-01,1903,Manchester City,Middlesbrough,1-1,1,1,1,1,2,0,D
1904-01-01,1903,Sheffield Wednesday,Wolverhampton Wanderers,4-0,4,0,1,1,4,4,H
1904-01-01,1903,Sunderland,Newcastle United,1-1,1,1,1,1,2,0,D
1904-01-02,1903,Aston Villa,Sunderland,2-0,2,0,1,1,2,2,H
1904-01-02,1903,Bury,Blackburn Rovers,3-0,3,0,1,1,3,3,H
1904-01-02,1903,Liverpool,Nottingham Forest,0-0,0,0,1,1,0,0,D
1904-01-02,1903,Manchester City,Stoke City,2-2,2,2,1,1,4,0,D
1904-01-02,1903,Middlesbrough,Sheffield Wednesday,0-1,0,1,1,1,1,-1,A
1904-01-02,1903,Newcastle United,West Bromwich Albion,1-0,1,0,1,1,1,1,H
1904-01-02,1903,Notts County,Everton,0-3,0,3,1,1,3,-3,A
1904-01-02,1903,Sheffield United,Birmingham City,1-1,1,1,1,1,2,0,D
1904-01-02,1903,Wolverhampton Wanderers,Derby County,2-2,2,2,1,1,4,0,D
1904-01-09,1903,Birmingham City,Newcastle United,3-0,3,0,1,1,3,3,H
1904-01-09,1903,Blackburn Rovers,Wolverhampton Wanderers,1-1,1,1,1,1,2,0,D
1904-01-09,1903,Derby County,Manchester City,2-3,2,3,1,1,5,-1,A
1904-01-09,1903,Everton,Sheffield United,2-0,2,0,1,1,2,2,H
1904-01-09,1903,Nottingham Forest,Bury,2-2,2,2,1,1,4,0,D
1904-01-09,1903,Sheffield Wednesday,Liverpool,2-1,2,1,1,1,3,1,H
1904-01-09,1903,Stoke City,Notts County,0-2,0,2,1,1,2,-2,A
1904-01-09,1903,Sunderland,Middlesbrough,3-1,3,1,1,1,4,2,H
1904-01-09,1903,West Bromwich Albion,Aston Villa,1-3,1,3,1,1,4,-2,A
1904-01-16,1903,Aston Villa,Birmingham City,1-1,1,1,1,1,2,0,D
1904-01-16,1903,Bury,Sheffield Wednesday,1-0,1,0,1,1,1,1,H
1904-01-16,1903,Liverpool,Sunderland,2-1,2,1,1,1,3,1,H
1904-01-16,1903,Middlesbrough,West Bromwich Albion,2-2,2,2,1,1,4,0,D
1904-01-16,1903,Newcastle United,Everton,1-0,1,0,1,1,1,1,H
1904-01-16,1903,Notts County,Derby County,2-2,2,2,1,1,4,0,D
1904-01-16,1903,Sheffield United,Stoke City,1-1,1,1,1,1,2,0,D
1904-01-23,1903,Birmingham City,Middlesbrough,2-2,2,2,1,1,4,0,D
1904-01-23,1903,Derby County,Sheffield United,3-5,3,5,1,1,8,-2,A
1904-01-23,1903,Everton,Aston Villa,1-0,1,0,1,1,1,1,H
1904-01-23,1903,Manchester City,Notts County,3-0,3,0,1,1,3,3,H
1904-01-23,1903,Nottingham Forest,Wolverhampton Wanderers,5-0,5,0,1,1,5,5,H
1904-01-23,1903,Sheffield Wednesday,Blackburn Rovers,3-1,3,1,1,1,4,2,H
1904-01-23,1903,Stoke City,Newcastle United,2-3,2,3,1,1,5,-1,A
1904-01-23,1903,Sunderland,Bury,6-0,6,0,1,1,6,6,H
1904-01-23,1903,West Bromwich Albion,Liverpool,2-2,2,2,1,1,4,0,D
1904-01-30,1903,Aston Villa,Stoke City,3-1,3,1,1,1,4,2,H
1904-01-30,1903,Blackburn Rovers,Sunderland,1-3,1,3,1,1,4,-2,A
1904-01-30,1903,Bury,West Bromwich Albion,2-1,2,1,1,1,3,1,H
1904-01-30,1903,Liverpool,Birmingham City,0-2,0,2,1,1,2,-2,A
1904-01-30,1903,Middlesbrough,Everton,3-0,3,0,1,1,3,3,H
1904-01-30,1903,Newcastle United,Derby County,0-0,0,0,1,1,0,0,D
1904-01-30,1903,Nottingham Forest,Sheffield Wednesday,0-1,0,1,1,1,1,-1,A
1904-01-30,1903,Wolverhampton Wanderers,Notts County,1-1,1,1,1,1,2,0,D
1904-02-13,1903,Aston Villa,Manchester City,0-1,0,1,1,1,1,-1,A
1904-02-13,1903,Blackburn Rovers,Birmingham City,1-1,1,1,1,1,2,0,D
1904-02-13,1903,Bury,Everton,0-0,0,0,1,1,0,0,D
1904-02-13,1903,Liverpool,Stoke City,0-0,0,0,1,1,0,0,D
1904-02-13,1903,Middlesbrough,Derby County,0-0,0,0,1,1,0,0,D
1904-02-13,1903,Newcastle United,Notts County,4-1,4,1,1,1,5,3,H
1904-02-13,1903,Sheffield Wednesday,Sunderland,0-0,0,0,1,1,0,0,D
1904-02-13,1903,Wolverhampton Wanderers,Sheffield United,1-0,1,0,1,1,1,1,H
1904-02-20,1903,Notts County,West Bromwich Albion,2-3,2,3,1,1,5,-1,A
1904-02-22,1903,Liverpool,Middlesbrough,1-0,1,0,1,1,1,1,H
1904-02-22,1903,Sheffield Wednesday,Notts County,2-0,2,0,1,1,2,2,H
1904-02-27,1903,Aston Villa,Sheffield United,6-1,6,1,1,1,7,5,H
1904-02-27,1903,Bury,Derby County,2-2,2,2,1,1,4,0,D
1904-02-27,1903,Liverpool,Manchester City,2-2,2,2,1,1,4,0,D
1904-02-27,1903,Middlesbrough,Notts County,1-0,1,0,1,1,1,1,H
1904-02-27,1903,Nottingham Forest,Everton,0-4,0,4,1,1,4,-4,A
1904-02-27,1903,Sheffield Wednesday,Birmingham City,3-2,3,2,1,1,5,1,H
1904-02-27,1903,Sunderland,West Bromwich Albion,1-1,1,1,1,1,2,0,D
1904-02-27,1903,Wolverhampton Wanderers,Newcastle United,3-2,3,2,1,1,5,1,H
1904-03-05,1903,Birmingham City,Sunderland,2-1,2,1,1,1,3,1,H
1904-03-05,1903,Stoke City,Nottingham Forest,2-3,2,3,1,1,5,-1,A
1904-03-05,1903,West Bromwich Albion,Wolverhampton Wanderers,1-2,1,2,1,1,3,-1,A
1904-03-12,1903,Blackburn Rovers,Manchester City,2-5,2,5,1,1,7,-3,A
1904-03-12,1903,Liverpool,Sheffield United,3-0,3,0,1,1,3,3,H
1904-03-12,1903,Middlesbrough,Newcastle United,1-3,1,3,1,1,4,-2,A
1904-03-12,1903,Nottingham Forest,Derby County,5-1,5,1,1,1,6,4,H
1904-03-12,1903,Sheffield Wednesday,Stoke City,1-0,1,0,1,1,1,1,H
1904-03-12,1903,Sunderland,Everton,2-0,2,0,1,1,2,2,H
1904-03-12,1903,West Bromwich Albion,Birmingham City,0-1,0,1,1,1,1,-1,A
1904-03-12,1903,Wolverhampton Wanderers,Aston Villa,3-2,3,2,1,1,5,1,H
1904-03-19,1903,Aston Villa,Middlesbrough,2-1,2,1,1,1,3,1,H
1904-03-19,1903,Birmingham City,Wolverhampton Wanderers,3-0,3,0,1,1,3,3,H
1904-03-19,1903,Newcastle United,Liverpool,1-1,1,1,1,1,2,0,D
1904-03-19,1903,Notts County,Blackburn Rovers,4-2,4,2,1,1,6,2,H
1904-03-19,1903,Sheffield United,Bury,0-0,0,0,1,1,0,0,D
1904-03-19,1903,Stoke City,Sunderland,3-1,3,1,1,1,4,2,H
1904-03-21,1903,Wolverhampton Wanderers,Manchester City,1-6,1,6,1,1,7,-5,A
1904-03-26,1903,Birmingham City,Everton,1-1,1,1,1,1,2,0,D
1904-03-26,1903,Blackburn Rovers,Sheffield United,3-0,3,0,1,1,3,3,H
1904-03-26,1903,Bury,Newcastle United,0-3,0,3,1,1,3,-3,A
1904-03-26,1903,Liverpool,Aston Villa,1-1,1,1,1,1,2,0,D
1904-03-26,1903,Sheffield Wednesday,Manchester City,1-0,1,0,1,1,1,1,H
1904-03-26,1903,Sunderland,Derby County,0-3,0,3,1,1,3,-3,A
1904-03-26,1903,West Bromwich Albion,Stoke City,3-0,3,0,1,1,3,3,H
1904-03-26,1903,Wolverhampton Wanderers,Middlesbrough,2-2,2,2,1,1,4,0,D
1904-03-28,1903,Sheffield United,Middlesbrough,3-0,3,0,1,1,3,3,H
1904-03-30,1903,Nottingham Forest,West Bromwich Albion,2-0,2,0,1,1,2,2,H
1904-04-01,1903,Everton,Liverpool,5-2,5,2,1,1,7,3,H
1904-04-01,1903,Manchester City,Newcastle United,1-3,1,3,1,1,4,-2,A
1904-04-01,1903,Notts County,Aston Villa,0-0,0,0,1,1,0,0,D
1904-04-01,1903,Sunderland,Wolverhampton Wanderers,2-1,2,1,1,1,3,1,H
1904-04-02,1903,Aston Villa,Bury,0-2,0,2,1,1,2,-2,A
1904-04-02,1903,Derby County,West Bromwich Albion,4-2,4,2,1,1,6,2,H
1904-04-02,1903,Everton,Wolverhampton Wanderers,2-0,2,0,1,1,2,2,H
1904-04-02,1903,Manchester City,Sunderland,2-1,2,1,1,1,3,1,H
1904-04-02,1903,Middlesbrough,Liverpool,1-0,1,0,1,1,1,1,H
1904-04-02,1903,Newcastle United,Blackburn Rovers,2-1,2,1,1,1,3,1,H
1904-04-02,1903,Notts County,Sheffield Wednesday,1-0,1,0,1,1,1,1,H
1904-04-02,1903,Sheffield United,Nottingham Forest,2-0,2,0,1,1,2,2,H
1904-04-02,1903,Stoke City,Birmingham City,1-0,1,0,1,1,1,1,H
1904-04-04,1903,Birmingham City,Bury,1-0,1,0,1,1,1,1,H
1904-04-04,1903,Everton,Sheffield Wednesday,2-0,2,0,1,1,2,2,H
1904-04-04,1903,Notts County,Sheffield United,2-1,2,1,1,1,3,1,H
1904-04-04,1903,Sunderland,Nottingham Forest,3-1,3,1,1,1,4,2,H
1904-04-04,1903,Wolverhampton Wanderers,Stoke City,0-0,0,0,1,1,0,0,D
1904-04-09,1903,Birmingham City,Derby County,1-0,1,0,1,1,1,1,H
1904-04-09,1903,Blackburn Rovers,Aston Villa,0-3,0,3,1,1,3,-3,A
1904-04-09,1903,Bury,Middlesbrough,1-1,1,1,1,1,2,0,D
1904-04-09,1903,Everton,Stoke City,0-1,0,1,1,1,1,-1,A
1904-04-09,1903,Nottingham Forest,Newcastle United,1-0,1,0,1,1,1,1,H
1904-04-09,1903,Sheffield Wednesday,Sheffield United,3-0,3,0,1,1,3,3,H
1904-04-09,1903,West Bromwich Albion,Manchester City,2-1,2,1,1,1,3,1,H
1904-04-11,1903,Derby County,Blackburn Rovers,3-0,3,0,1,1,3,3,H
1904-04-11,1903,Manchester City,Bury,3-0,3,0,1,1,3,3,H
1904-04-13,1903,Manchester City,Nottingham Forest,0-0,0,0,1,1,0,0,D
1904-04-16,1903,Aston Villa,Nottingham Forest,3-1,3,1,1,1,4,2,H
1904-04-16,1903,Derby County,Everton,0-1,0,1,1,1,1,-1,A
1904-04-16,1903,Liverpool,Bury,3-0,3,0,1,1,3,3,H
1904-04-16,1903,Manchester City,Birmingham City,4-0,4,0,1,1,4,4,H
1904-04-16,1903,Middlesbrough,Blackburn Rovers,0-2,0,2,1,1,2,-2,A
1904-04-16,1903,Newcastle United,Sheffield Wednesday,4-0,4,0,1,1,4,4,H
1904-04-16,1903,Sheffield United,Sunderland,1-2,1,2,1,1,3,-1,A
1904-04-18,1903,Everton,West Bromwich Albion,4-0,4,0,1,1,4,4,H
1904-04-23,1903,Birmingham City,Notts County,2-0,2,0,1,1,2,2,H
1904-04-23,1903,Blackburn Rovers,Liverpool,2-3,2,3,1,1,5,-1,A
1904-04-23,1903,Bury,Wolverhampton Wanderers,0-0,0,0,1,1,0,0,D
1904-04-23,1903,Nottingham Forest,Middlesbrough,1-1,1,1,1,1,2,0,D
1904-04-23,1903,Sheffield Wednesday,Aston Villa,4-2,4,2,1,1,6,2,H
1904-04-23,1903,Stoke City,Derby County,1-1,1,1,1,1,2,0,D
1904-04-23,1903,West Bromwich Albion,Sheffield United,2-2,2,2,1,1,4,0,D
1904-04-25,1903,Everton,Manchester City,1-0,1,0,1,1,1,1,H
1904-04-30,1903,Derby County,Sheffield Wednesday,0-2,0,2,1,1,2,-2,A
1904-09-01,1904,Aston Villa,Preston North End,1-2,1,2,1,1,3,-1,A
1904-09-01,1904,Stoke City,Derby County,1-2,1,2,1,1,3,-1,A
1904-09-03,1904,Aston Villa,Stoke City,3-0,3,0,1,1,3,3,H
1904-09-03,1904,Bury,Blackburn Rovers,0-2,0,2,1,1,2,-2,A
1904-09-03,1904,Manchester City,Birmingham City,2-1,2,1,1,1,3,1,H
1904-09-03,1904,Middlesbrough,Sheffield Wednesday,1-3,1,3,1,1,4,-2,A
1904-09-03,1904,Newcastle United,Arsenal,3-0,3,0,1,1,3,3,H
1904-09-03,1904,Notts County,Everton,1-2,1,2,1,1,3,-1,A
1904-09-03,1904,Preston North End,Sunderland,3-1,3,1,1,1,4,2,H
1904-09-03,1904,Sheffield United,Derby County,3-1,3,1,1,1,4,2,H
1904-09-03,1904,Wolverhampton Wanderers,Nottingham Forest,3-2,3,2,1,1,5,1,H
1904-09-05,1904,Sunderland,Notts County,5-0,5,0,1,1,5,5,H
1904-09-05,1904,Wolverhampton Wanderers,Sheffield United,4-2,4,2,1,1,6,2,H
1904-09-10,1904,Arsenal,Preston North End,0-0,0,0,1,1,0,0,D
1904-09-10,1904,Birmingham City,Notts County,1-2,1,2,1,1,3,-1,A
1904-09-10,1904,Blackburn Rovers,Aston Villa,4-0,4,0,1,1,4,4,H
1904-09-10,1904,Derby County,Newcastle United,1-1,1,1,1,1,2,0,D
1904-09-10,1904,Everton,Sheffield United,2-0,2,0,1,1,2,2,H
1904-09-10,1904,Nottingham Forest,Bury,5-1,5,1,1,1,6,4,H
1904-09-10,1904,Sheffield Wednesday,Wolverhampton Wanderers,4-0,4,0,1,1,4,4,H
1904-09-10,1904,Stoke City,Manchester City,1-0,1,0,1,1,1,1,H
1904-09-10,1904,Sunderland,Middlesbrough,1-1,1,1,1,1,2,0,D
1904-09-12,1904,Aston Villa,Everton,1-0,1,0,1,1,1,1,H
1904-09-17,1904,Aston Villa,Nottingham Forest,2-0,2,0,1,1,2,2,H
1904-09-17,1904,Blackburn Rovers,Stoke City,4-0,4,0,1,1,4,4,H
1904-09-17,1904,Bury,Sheffield Wednesday,1-4,1,4,1,1,5,-3,A
1904-09-17,1904,Middlesbrough,Arsenal,1-0,1,0,1,1,1,1,H
1904-09-17,1904,Newcastle United,Everton,3-2,3,2,1,1,5,1,H
1904-09-17,1904,Notts County,Manchester City,1-1,1,1,1,1,2,0,D
1904-09-17,1904,Preston North End,Derby County,2-0,2,0,1,1,2,2,H
1904-09-17,1904,Sheffield United,Birmingham City,2-1,2,1,1,1,3,1,H
1904-09-17,1904,Wolverhampton Wanderers,Sunderland,1-0,1,0,1,1,1,1,H
1904-09-24,1904,Arsenal,Wolverhampton Wanderers,2-0,2,0,1,1,2,2,H
1904-09-24,1904,Birmingham City,Newcastle United,2-1,2,1,1,1,3,1,H
1904-09-24,1904,Derby County,Middlesbrough,4-2,4,2,1,1,6,2,H
1904-09-24,1904,Everton,Preston North End,1-0,1,0,1,1,1,1,H
1904-09-24,1904,Manchester City,Sheffield United,1-1,1,1,1,1,2,0,D
1904-09-24,1904,Nottingham Forest,Blackburn Rovers,5-2,5,2,1,1,7,3,H
1904-09-24,1904,Sheffield Wednesday,Aston Villa,3-2,3,2,1,1,5,1,H
1904-09-24,1904,Stoke City,Notts County,0-2,0,2,1,1,2,-2,A
1904-09-24,1904,Sunderland,Bury,2-1,2,1,1,1,3,1,H
1904-10-01,1904,Aston Villa,Sunderland,2-2,2,2,1,1,4,0,D
1904-10-01,1904,Blackburn Rovers,Sheffield Wednesday,0-1,0,1,1,1,1,-1,A
1904-10-01,1904,Bury,Arsenal,1-1,1,1,1,1,2,0,D
1904-10-01,1904,Middlesbrough,Everton,1-0,1,0,1,1,1,1,H
1904-10-01,1904,Newcastle United,Manchester City,2-0,2,0,1,1,2,2,H
1904-10-01,1904,Nottingham Forest,Stoke City,0-1,0,1,1,1,1,-1,A
1904-10-01,1904,Preston North End,Birmingham City,2-2,2,2,1,1,4,0,D
1904-10-01,1904,Sheffield United,Notts County,2-1,2,1,1,1,3,1,H
1904-10-01,1904,Wolverhampton Wanderers,Derby County,2-0,2,0,1,1,2,2,H
1904-10-06,1904,Nottingham Forest,Preston North End,0-1,0,1,1,1,1,-1,A
1904-10-08,1904,Arsenal,Aston Villa,1-0,1,0,1,1,1,1,H
1904-10-08,1904,Birmingham City,Middlesbrough,2-1,2,1,1,1,3,1,H
1904-10-08,1904,Derby County,Bury,3-2,3,2,1,1,5,1,H
1904-10-08,1904,Everton,Wolverhampton Wanderers,2-1,2,1,1,1,3,1,H
1904-10-08,1904,Manchester City,Preston North End,6-1,6,1,1,1,7,5,H
1904-10-08,1904,Notts County,Newcastle United,0-3,0,3,1,1,3,-3,A
1904-10-08,1904,Sheffield Wednesday,Nottingham Forest,2-0,2,0,1,1,2,2,H
1904-10-08,1904,Stoke City,Sheffield United,2-1,2,1,1,1,3,1,H
1904-10-08,1904,Sunderland,Blackburn Rovers,2-1,2,1,1,1,3,1,H
1904-10-15,1904,Aston Villa,Derby County,0-2,0,2,1,1,2,-2,A
1904-10-15,1904,Blackburn Rovers,Arsenal,1-1,1,1,1,1,2,0,D
1904-10-15,1904,Bury,Everton,1-2,1,2,1,1,3,-1,A
1904-10-15,1904,Middlesbrough,Manchester City,0-1,0,1,1,1,1,-1,A
1904-10-15,1904,Newcastle United,Sheffield United,1-1,1,1,1,1,2,0,D
1904-10-15,1904,Nottingham Forest,Sunderland,2-3,2,3,1,1,5,-1,A
1904-10-15,1904,Preston North End,Notts County,3-1,3,1,1,1,4,2,H
1904-10-15,1904,Sheffield Wednesday,Stoke City,3-0,3,0,1,1,3,3,H
1904-10-15,1904,Wolverhampton Wanderers,Birmingham City,0-1,0,1,1,1,1,-1,A
1904-10-22,1904,Arsenal,Nottingham Forest,0-3,0,3,1,1,3,-3,A
1904-10-22,1904,Birmingham City,Bury,5-0,5,0,1,1,5,5,H
1904-10-22,1904,Derby County,Blackburn Rovers,1-1,1,1,1,1,2,0,D
1904-10-22,1904,Everton,Aston Villa,3-2,3,2,1,1,5,1,H
1904-10-22,1904,Notts County,Middlesbrough,0-0,0,0,1,1,0,0,D
1904-10-22,1904,Sheffield United,Preston North End,1-0,1,0,1,1,1,1,H
1904-10-22,1904,Stoke City,Newcastle United,1-0,1,0,1,1,1,1,H
1904-10-22,1904,Sunderland,Sheffield Wednesday,3-0,3,0,1,1,3,3,H
1904-10-29,1904,Aston Villa,Birmingham City,2-1,2,1,1,1,3,1,H
1904-10-29,1904,Blackburn Rovers,Everton,1-0,1,0,1,1,1,1,H
1904-10-29,1904,Bury,Manchester City,2-4,2,4,1,1,6,-2,A
1904-10-29,1904,Middlesbrough,Sheffield United,0-1,0,1,1,1,1,-1,A
1904-10-29,1904,Nottingham Forest,Derby County,0-1,0,1,1,1,1,-1,A
1904-10-29,1904,Preston North End,Newcastle United,1-0,1,0,1,1,1,1,H
1904-10-29,1904,Sheffield Wednesday,Arsenal,0-3,0,3,1,1,3,-3,A
1904-10-29,1904,Sunderland,Stoke City,3-1,3,1,1,1,4,2,H
1904-10-29,1904,Wolverhampton Wanderers,Notts County,3-1,3,1,1,1,4,2,H
1904-11-05,1904,Arsenal,Sunderland,0-0,0,0,1,1,0,0,D
1904-11-05,1904,Birmingham City,Blackburn Rovers,2-0,2,0,1,1,2,2,H
1904-11-05,1904,Derby County,Sheffield Wednesday,1-0,1,0,1,1,1,1,H
1904-11-05,1904,Everton,Nottingham Forest,5-1,5,1,1,1,6,4,H
1904-11-05,1904,Newcastle United,Middlesbrough,3-0,3,0,1,1,3,3,H
1904-11-05,1904,Notts County,Bury,0-1,0,1,1,1,1,-1,A
1904-11-05,1904,Sheffield United,Wolverhampton Wanderers,4-2,4,2,1,1,6,2,H
1904-11-05,1904,Stoke City,Preston North End,1-1,1,1,1,1,2,0,D
1904-11-09,1904,Manchester City,Aston Villa,2-1,2,1,1,1,3,1,H
1904-11-12,1904,Arsenal,Stoke City,2-1,2,1,1,1,3,1,H
1904-11-12,1904,Aston Villa,Notts County,4-2,4,2,1,1,6,2,H
1904-11-12,1904,Blackburn Rovers,Manchester City,3-1,3,1,1,1,4,2,H
1904-11-12,1904,Bury,Sheffield United,7-1,7,1,1,1,8,6,H
1904-11-12,1904,Middlesbrough,Preston North End,1-1,1,1,1,1,2,0,D
1904-11-12,1904,Nottingham Forest,Birmingham City,0-2,0,2,1,1,2,-2,A
1904-11-12,1904,Sheffield Wednesday,Everton,5-5,5,5,1,1,10,0,D
1904-11-12,1904,Sunderland,Derby County,3-0,3,0,1,1,3,3,H
1904-11-12,1904,Wolverhampton Wanderers,Newcastle United,1-3,1,3,1,1,4,-2,A
1904-11-14,1904,Manchester City,Wolverhampton Wanderers,5-1,5,1,1,1,6,4,H
1904-11-19,1904,Birmingham City,Sheffield Wednesday,2-1,2,1,1,1,3,1,H
1904-11-19,1904,Derby County,Arsenal,0-0,0,0,1,1,0,0,D
1904-11-19,1904,Everton,Sunderland,0-1,0,1,1,1,1,-1,A
1904-11-19,1904,Manchester City,Nottingham Forest,1-1,1,1,1,1,2,0,D
1904-11-19,1904,Newcastle United,Bury,3-1,3,1,1,1,4,2,H
1904-11-19,1904,Notts County,Blackburn Rovers,2-1,2,1,1,1,3,1,H
1904-11-19,1904,Preston North End,Wolverhampton Wanderers,2-2,2,2,1,1,4,0,D
1904-11-19,1904,Sheffield United,Aston Villa,0-3,0,3,1,1,3,-3,A
1904-11-19,1904,Stoke City,Middlesbrough,3-1,3,1,1,1,4,2,H
1904-11-26,1904,Aston Villa,Newcastle United,0-1,0,1,1,1,1,-1,A
1904-11-26,1904,Blackburn Rovers,Sheffield United,2-4,2,4,1,1,6,-2,A
1904-11-26,1904,Bury,Preston North End,0-1,0,1,1,1,1,-1,A
1904-11-26,1904,Derby County,Stoke City,3-0,3,0,1,1,3,3,H
1904-11-26,1904,Nottingham Forest,Notts County,2-1,2,1,1,1,3,1,H
1904-11-26,1904,Sheffield Wednesday,Manchester City,2-1,2,1,1,1,3,1,H
1904-11-26,1904,Sunderland,Birmingham City,1-4,1,4,1,1,5,-3,A
1904-11-26,1904,Wolverhampton Wanderers,Middlesbrough,5-3,5,3,1,1,8,2,H
1904-12-03,1904,Birmingham City,Arsenal,2-1,2,1,1,1,3,1,H
1904-12-03,1904,Everton,Derby County,0-0,0,0,1,1,0,0,D
1904-12-03,1904,Manchester City,Sunderland,5-2,5,2,1,1,7,3,H
1904-12-03,1904,Middlesbrough,Bury,2-2,2,2,1,1,4,0,D
1904-12-03,1904,Newcastle United,Blackburn Rovers,1-0,1,0,1,1,1,1,H
1904-12-03,1904,Notts County,Sheffield Wednesday,2-2,2,2,1,1,4,0,D
1904-12-03,1904,Preston North End,Aston Villa,2-3,2,3,1,1,5,-1,A
1904-12-03,1904,Sheffield United,Nottingham Forest,4-0,4,0,1,1,4,4,H
1904-12-03,1904,Stoke City,Wolverhampton Wanderers,2-1,2,1,1,1,3,1,H
1904-12-10,1904,Arsenal,Manchester City,1-0,1,0,1,1,1,1,H
1904-12-10,1904,Aston Villa,Middlesbrough,0-0,0,0,1,1,0,0,D
1904-12-10,1904,Blackburn Rovers,Preston North End,1-1,1,1,1,1,2,0,D
1904-12-10,1904,Bury,Wolverhampton Wanderers,3-1,3,1,1,1,4,2,H
1904-12-10,1904,Derby County,Birmingham City,3-0,3,0,1,1,3,3,H
1904-12-10,1904,Everton,Stoke City,4-1,4,1,1,1,5,3,H
1904-12-10,1904,Nottingham Forest,Newcastle United,1-3,1,3,1,1,4,-2,A
1904-12-10,1904,Sheffield Wednesday,Sheffield United,1-3,1,3,1,1,4,-2,A
1904-12-17,1904,Birmingham City,Everton,1-2,1,2,1,1,3,-1,A
1904-12-17,1904,Bury,Stoke City,3-1,3,1,1,1,4,2,H
1904-12-17,1904,Manchester City,Derby County,6-0,6,0,1,1,6,6,H
1904-12-17,1904,Middlesbrough,Blackburn Rovers,2-1,2,1,1,1,3,1,H
1904-12-17,1904,Newcastle United,Sheffield Wednesday,6-2,6,2,1,1,8,4,H
1904-12-17,1904,Notts County,Arsenal,1-5,1,5,1,1,6,-4,A
1904-12-17,1904,Preston North End,Nottingham Forest,0-1,0,1,1,1,1,-1,A
1904-12-17,1904,Sheffield United,Sunderland,1-0,1,0,1,1,1,1,H
1904-12-17,1904,Wolverhampton Wanderers,Aston Villa,1-1,1,1,1,1,2,0,D
1904-12-24,1904,Arsenal,Sheffield United,1-0,1,0,1,1,1,1,H
1904-12-24,1904,Aston Villa,Bury,2-0,2,0,1,1,2,2,H
1904-12-24,1904,Blackburn Rovers,Wolverhampton Wanderers,3-0,3,0,1,1,3,3,H
1904-12-24,1904,Derby County,Notts County,1-1,1,1,1,1,2,0,D
1904-12-24,1904,Everton,Manchester City,0-0,0,0,1,1,0,0,D
1904-12-24,1904,Nottingham Forest,Middlesbrough,1-1,1,1,1,1,2,0,D
1904-12-24,1904,Sunderland,Newcastle United,3-1,3,1,1,1,4,2,H
1904-12-26,1904,Aston Villa,Arsenal,3-1,3,1,1,1,4,2,H
1904-12-26,1904,Blackburn Rovers,Sunderland,2-1,2,1,1,1,3,1,H
1904-12-26,1904,Bury,Derby County,2-0,2,0,1,1,2,2,H
1904-12-26,1904,Middlesbrough,Birmingham City,0-1,0,1,1,1,1,-1,A
1904-12-26,1904,Nottingham Forest,Sheffield Wednesday,2-1,2,1,1,1,3,1,H
1904-12-26,1904,Preston North End,Manchester City,0-1,0,1,1,1,1,-1,A
1904-12-26,1904,Sheffield United,Stoke City,5-2,5,2,1,1,7,3,H
1904-12-26,1904,Wolverhampton Wanderers,Everton,0-3,0,3,1,1,3,-3,A
1904-12-27,1904,Derby County,Everton,1-2,1,2,1,1,3,-1,A
1904-12-27,1904,Nottingham Forest,Arsenal,0-3,0,3,1,1,3,-3,A
1904-12-27,1904,Sheffield Wednesday,Sunderland,1-1,1,1,1,1,2,0,D
1904-12-28,1904,Sheffield United,Arsenal,4-0,4,0,1,1,4,4,H
1904-12-31,1904,Arsenal,Newcastle United,0-2,0,2,1,1,2,-2,A
1904-12-31,1904,Birmingham City,Manchester City,3-1,3,1,1,1,4,2,H
1904-12-31,1904,Blackburn Rovers,Bury,0-2,0,2,1,1,2,-2,A
1904-12-31,1904,Derby County,Sheffield United,2-3,2,3,1,1,5,-1,A
1904-12-31,1904,Everton,Notts County,5-1,5,1,1,1,6,4,H
1904-12-31,1904,Nottingham Forest,Wolverhampton Wanderers,2-2,2,2,1,1,4,0,D
1904-12-31,1904,Sheffield Wednesday,Middlesbrough,5-0,5,0,1,1,5,5,H
1904-12-31,1904,Stoke City,Aston Villa,1-4,1,4,1,1,5,-3,A
1904-12-31,1904,Sunderland,Preston North End,3-2,3,2,1,1,5,1,H
1905-01-02,1904,Blackburn Rovers,Derby County,3-1,3,1,1,1,4,2,H
1905-01-02,1904,Bury,Birmingham City,1-1,1,1,1,1,2,0,D
1905-01-02,1904,Newcastle United,Notts County,1-0,1,0,1,1,1,1,H
1905-01-02,1904,Sheffield Wednesday,Preston North End,2-0,2,0,1,1,2,2,H
1905-01-02,1904,Sunderland,Nottingham Forest,1-0,1,0,1,1,1,1,H
1905-01-07,1904,Aston Villa,Blackburn Rovers,3-0,3,0,1,1,3,3,H
1905-01-07,1904,Bury,Nottingham Forest,5-1,5,1,1,1,6,4,H
1905-01-07,1904,Manchester City,Stoke City,1-0,1,0,1,1,1,1,H
1905-01-07,1904,Middlesbrough,Sunderland,1-3,1,3,1,1,4,-2,A
1905-01-07,1904,Newcastle United,Derby County,2-0,2,0,1,1,2,2,H
1905-01-07,1904,Notts County,Birmingham City,0-0,0,0,1,1,0,0,D
1905-01-07,1904,Preston North End,Arsenal,3-0,3,0,1,1,3,3,H
1905-01-07,1904,Sheffield United,Everton,1-0,1,0,1,1,1,1,H
1905-01-07,1904,Wolverhampton Wanderers,Sheffield Wednesday,1-0,1,0,1,1,1,1,H
1905-01-14,1904,Arsenal,Middlesbrough,1-1,1,1,1,1,2,0,D
1905-01-14,1904,Birmingham City,Sheffield United,2-0,2,0,1,1,2,2,H
1905-01-14,1904,Derby County,Preston North End,3-1,3,1,1,1,4,2,H
1905-01-14,1904,Everton,Newcastle United,2-1,2,1,1,1,3,1,H
1905-01-14,1904,Manchester City,Notts County,2-1,2,1,1,1,3,1,H
1905-01-14,1904,Nottingham Forest,Aston Villa,1-1,1,1,1,1,2,0,D
1905-01-14,1904,Sheffield Wednesday,Bury,4-0,4,0,1,1,4,4,H
1905-01-14,1904,Stoke City,Blackburn Rovers,4-0,4,0,1,1,4,4,H
1905-01-14,1904,Sunderland,Wolverhampton Wanderers,3-0,3,0,1,1,3,3,H
1905-01-21,1904,Aston Villa,Sheffield Wednesday,0-2,0,2,1,1,2,-2,A
1905-01-21,1904,Blackburn Rovers,Nottingham Forest,0-0,0,0,1,1,0,0,D
1905-01-21,1904,Bury,Sunderland,1-0,1,0,1,1,1,1,H
1905-01-21,1904,Middlesbrough,Derby County,2-0,2,0,1,1,2,2,H
1905-01-21,1904,Newcastle United,Birmingham City,0-1,0,1,1,1,1,-1,A
1905-01-21,1904,Notts County,Stoke City,0-0,0,0,1,1,0,0,D
1905-01-21,1904,Preston North End,Everton,1-1,1,1,1,1,2,0,D
1905-01-21,1904,Sheffield United,Manchester City,0-3,0,3,1,1,3,-3,A
1905-01-21,1904,Wolverhampton Wanderers,Arsenal,4-1,4,1,1,1,5,3,H
1905-01-28,1904,Arsenal,Bury,2-1,2,1,1,1,3,1,H
1905-01-28,1904,Birmingham City,Preston North End,2-0,2,0,1,1,2,2,H
1905-01-28,1904,Derby County,Wolverhampton Wanderers,2-1,2,1,1,1,3,1,H
1905-01-28,1904,Everton,Middlesbrough,1-0,1,0,1,1,1,1,H
1905-01-28,1904,Manchester City,Newcastle United,3-2,3,2,1,1,5,1,H
1905-01-28,1904,Notts County,Sheffield United,1-5,1,5,1,1,6,-4,A
1905-01-28,1904,Sheffield Wednesday,Blackburn Rovers,1-2,1,2,1,1,3,-1,A
1905-01-28,1904,Stoke City,Nottingham Forest,0-0,0,0,1,1,0,0,D
1905-01-28,1904,Sunderland,Aston Villa,2-3,2,3,1,1,5,-1,A
1905-02-11,1904,Arsenal,Blackburn Rovers,2-0,2,0,1,1,2,2,H
1905-02-11,1904,Birmingham City,Wolverhampton Wanderers,4-1,4,1,1,1,5,3,H
1905-02-11,1904,Derby County,Aston Villa,0-2,0,2,1,1,2,-2,A
1905-02-11,1904,Everton,Bury,2-0,2,0,1,1,2,2,H
1905-02-11,1904,Manchester City,Middlesbrough,3-2,3,2,1,1,5,1,H
1905-02-11,1904,Notts County,Preston North End,1-3,1,3,1,1,4,-2,A
1905-02-11,1904,Sheffield United,Newcastle United,1-3,1,3,1,1,4,-2,A
1905-02-11,1904,Stoke City,Sheffield Wednesday,2-1,2,1,1,1,3,1,H
1905-02-18,1904,Notts County,Derby County,0-0,0,0,1,1,0,0,D
1905-02-25,1904,Arsenal,Sheffield Wednesday,3-0,3,0,1,1,3,3,H
1905-02-25,1904,Birmingham City,Aston Villa,0-3,0,3,1,1,3,-3,A
1905-02-25,1904,Derby County,Nottingham Forest,3-2,3,2,1,1,5,1,H
1905-02-25,1904,Everton,Blackburn Rovers,1-0,1,0,1,1,1,1,H
1905-02-25,1904,Manchester City,Bury,3-2,3,2,1,1,5,1,H
1905-02-25,1904,Newcastle United,Preston North End,1-0,1,0,1,1,1,1,H
1905-02-25,1904,Notts County,Wolverhampton Wanderers,3-4,3,4,1,1,7,-1,A
1905-02-25,1904,Sheffield United,Middlesbrough,0-1,0,1,1,1,1,-1,A
1905-02-25,1904,Stoke City,Sunderland,1-3,1,3,1,1,4,-2,A
1905-03-04,1904,Blackburn Rovers,Birmingham City,1-4,1,4,1,1,5,-3,A
1905-03-04,1904,Derby County,Manchester City,0-1,0,1,1,1,1,-1,A
1905-03-04,1904,Middlesbrough,Nottingham Forest,0-0,0,0,1,1,0,0,D
1905-03-04,1904,Sunderland,Arsenal,1-1,1,1,1,1,2,0,D
1905-03-11,1904,Birmingham City,Nottingham Forest,1-2,1,2,1,1,3,-1,A
1905-03-11,1904,Derby County,Sunderland,1-0,1,0,1,1,1,1,H
1905-03-11,1904,Everton,Sheffield Wednesday,5-2,5,2,1,1,7,3,H
1905-03-11,1904,Manchester City,Blackburn Rovers,2-1,2,1,1,1,3,1,H
1905-03-11,1904,Newcastle United,Wolverhampton Wanderers,3-0,3,0,1,1,3,3,H
1905-03-11,1904,Notts County,Aston Villa,1-2,1,2,1,1,3,-1,A
1905-03-11,1904,Preston North End,Middlesbrough,2-0,2,0,1,1,2,2,H
1905-03-11,1904,Sheffield United,Bury,4-0,4,0,1,1,4,4,H
1905-03-11,1904,Stoke City,Arsenal,2-0,2,0,1,1,2,2,H
1905-03-18,1904,Arsenal,Derby County,0-0,0,0,1,1,0,0,D
1905-03-18,1904,Aston Villa,Sheffield United,3-0,3,0,1,1,3,3,H
1905-03-18,1904,Blackburn Rovers,Notts County,1-0,1,0,1,1,1,1,H
1905-03-18,1904,Bury,Newcastle United,2-4,2,4,1,1,6,-2,A
1905-03-18,1904,Middlesbrough,Stoke City,2-1,2,1,1,1,3,1,H
1905-03-18,1904,Nottingham Forest,Manchester City,2-1,2,1,1,1,3,1,H
1905-03-18,1904,Sheffield Wednesday,Birmingham City,3-1,3,1,1,1,4,2,H
1905-03-18,1904,Sunderland,Everton,2-3,2,3,1,1,5,-1,A
1905-03-18,1904,Wolverhampton Wanderers,Preston North End,0-0,0,0,1,1,0,0,D
1905-03-25,1904,Birmingham City,Sunderland,1-1,1,1,1,1,2,0,D
1905-03-25,1904,Middlesbrough,Wolverhampton Wanderers,3-1,3,1,1,1,4,2,H
1905-03-25,1904,Notts County,Nottingham Forest,1-2,1,2,1,1,3,-1,A
1905-03-25,1904,Preston North End,Bury,0-0,0,0,1,1,0,0,D
1905-03-25,1904,Sheffield United,Blackburn Rovers,3-1,3,1,1,1,4,2,H
1905-04-01,1904,Arsenal,Birmingham City,1-1,1,1,1,1,2,0,D
1905-04-01,1904,Blackburn Rovers,Newcastle United,2-0,2,0,1,1,2,2,H
1905-04-01,1904,Bury,Middlesbrough,1-0,1,0,1,1,1,1,H
1905-04-01,1904,Nottingham Forest,Sheffield United,1-2,1,2,1,1,3,-1,A
1905-04-01,1904,Sheffield Wednesday,Notts County,1-0,1,0,1,1,1,1,H
1905-04-01,1904,Sunderland,Manchester City,0-0,0,0,1,1,0,0,D
1905-04-01,1904,Wolverhampton Wanderers,Stoke City,1-3,1,3,1,1,4,-2,A
1905-04-03,1904,Sheffield Wednesday,Derby County,1-1,1,1,1,1,2,0,D
1905-04-05,1904,Everton,Arsenal,1-0,1,0,1,1,1,1,H
1905-04-05,1904,Newcastle United,Aston Villa,2-0,2,0,1,1,2,2,H
1905-04-08,1904,Birmingham City,Derby County,2-0,2,0,1,1,2,2,H
1905-04-08,1904,Manchester City,Arsenal,1-0,1,0,1,1,1,1,H
1905-04-08,1904,Middlesbrough,Aston Villa,3-1,3,1,1,1,4,2,H
1905-04-08,1904,Newcastle United,Nottingham Forest,5-1,5,1,1,1,6,4,H
1905-04-08,1904,Notts County,Sunderland,2-2,2,2,1,1,4,0,D
1905-04-08,1904,Preston North End,Blackburn Rovers,0-0,0,0,1,1,0,0,D
1905-04-08,1904,Sheffield United,Sheffield Wednesday,4-2,4,2,1,1,6,2,H
1905-04-08,1904,Stoke City,Everton,2-2,2,2,1,1,4,0,D
1905-04-08,1904,Wolverhampton Wanderers,Bury,2-0,2,0,1,1,2,2,H
1905-04-10,1904,Preston North End,Stoke City,2-1,2,1,1,1,3,1,H
1905-04-15,1904,Arsenal,Notts County,1-2,1,2,1,1,3,-1,A
1905-04-15,1904,Blackburn Rovers,Middlesbrough,0-2,0,2,1,1,2,-2,A
1905-04-15,1904,Everton,Birmingham City,2-1,2,1,1,1,3,1,H
1905-04-15,1904,Manchester City,Sheffield Wednesday,1-1,1,1,1,1,2,0,D
1905-04-15,1904,Stoke City,Bury,2-0,2,0,1,1,2,2,H
1905-04-21,1904,Bury,Notts County,2-0,2,0,1,1,2,2,H
1905-04-21,1904,Manchester City,Everton,2-0,2,0,1,1,2,2,H
1905-04-21,1904,Newcastle United,Stoke City,4-1,4,1,1,1,5,3,H
1905-04-21,1904,Preston North End,Sheffield United,4-0,4,0,1,1,4,4,H
1905-04-22,1904,Arsenal,Everton,2-1,2,1,1,1,3,1,H
1905-04-22,1904,Birmingham City,Stoke City,0-1,0,1,1,1,1,-1,A
1905-04-22,1904,Bury,Aston Villa,2-3,2,3,1,1,5,-1,A
1905-04-22,1904,Newcastle United,Sunderland,1-3,1,3,1,1,4,-2,A
1905-04-22,1904,Preston North End,Sheffield Wednesday,1-0,1,0,1,1,1,1,H
1905-04-22,1904,Wolverhampton Wanderers,Blackburn Rovers,2-0,2,0,1,1,2,2,H
1905-04-24,1904,Middlesbrough,Notts County,2-5,2,5,1,1,7,-3,A
1905-04-24,1904,Nottingham Forest,Everton,0-2,0,2,1,1,2,-2,A
1905-04-24,1904,Sunderland,Sheffield United,2-1,2,1,1,1,3,1,H
1905-04-24,1904,Wolverhampton Wanderers,Manchester City,0-3,0,3,1,1,3,-3,A
1905-04-26,1904,Sheffield Wednesday,Newcastle United,1-3,1,3,1,1,4,-2,A
1905-04-27,1904,Aston Villa,Wolverhampton Wanderers,3-0,3,0,1,1,3,3,H
1905-04-29,1904,Aston Villa,Manchester City,3-2,3,2,1,1,5,1,H
1905-04-29,1904,Middlesbrough,Newcastle United,0-3,0,3,1,1,3,-3,A
1905-04-29,1904,Stoke City,Birmingham City,1-0,1,0,1,1,1,1,H
1905-09-02,1905,Arsenal,Liverpool,3-1,3,1,1,1,4,2,H
1905-09-02,1905,Birmingham City,Preston North End,1-1,1,1,1,1,2,0,D
1905-09-02,1905,Blackburn Rovers,Aston Villa,1-1,1,1,1,1,2,0,D
1905-09-02,1905,Bolton Wanderers,Sheffield United,1-2,1,2,1,1,3,-1,A
1905-09-02,1905,Derby County,Bury,3-1,3,1,1,1,4,2,H
1905-09-02,1905,Everton,Middlesbrough,4-1,4,1,1,1,5,3,H
1905-09-02,1905,Nottingham Forest,Wolverhampton Wanderers,3-1,3,1,1,1,4,2,H
1905-09-02,1905,Sheffield Wednesday,Manchester City,1-0,1,0,1,1,1,1,H
1905-09-02,1905,Stoke City,Notts County,3-0,3,0,1,1,3,3,H
1905-09-02,1905,Sunderland,Newcastle United,3-2,3,2,1,1,5,1,H
1905-09-04,1905,Preston North End,Nottingham Forest,3-1,3,1,1,1,4,2,H
1905-09-04,1905,Stoke City,Blackburn Rovers,3-0,3,0,1,1,3,3,H
1905-09-04,1905,Wolverhampton Wanderers,Sheffield Wednesday,0-0,0,0,1,1,0,0,D
1905-09-06,1905,Newcastle United,Manchester City,2-2,2,2,1,1,4,0,D
1905-09-09,1905,Aston Villa,Sunderland,2-1,2,1,1,1,3,1,H
1905-09-09,1905,Bury,Sheffield Wednesday,2-2,2,2,1,1,4,0,D
1905-09-09,1905,Liverpool,Blackburn Rovers,1-3,1,3,1,1,4,-2,A
1905-09-09,1905,Manchester City,Nottingham Forest,5-0,5,0,1,1,5,5,H
1905-09-09,1905,Middlesbrough,Derby County,0-1,0,1,1,1,1,-1,A
1905-09-09,1905,Newcastle United,Birmingham City,2-2,2,2,1,1,4,0,D
1905-09-09,1905,Notts County,Bolton Wanderers,3-3,3,3,1,1,6,0,D
1905-09-09,1905,Preston North End,Everton,1-1,1,1,1,1,2,0,D
1905-09-09,1905,Sheffield United,Arsenal,3-1,3,1,1,1,4,2,H
1905-09-09,1905,Wolverhampton Wanderers,Stoke City,1-2,1,2,1,1,3,-1,A
1905-09-11,1905,Aston Villa,Liverpool,5-0,5,0,1,1,5,5,H
1905-09-11,1905,Wolverhampton Wanderers,Bury,2-2,2,2,1,1,4,0,D
1905-09-13,1905,Newcastle United,Sheffield Wednesday,0-3,0,3,1,1,3,-3,A
1905-09-16,1905,Arsenal,Notts County,1-1,1,1,1,1,2,0,D
1905-09-16,1905,Birmingham City,Aston Villa,2-0,2,0,1,1,2,2,H
1905-09-16,1905,Blackburn Rovers,Sheffield United,2-1,2,1,1,1,3,1,H
1905-09-16,1905,Bolton Wanderers,Stoke City,1-2,1,2,1,1,3,-1,A
1905-09-16,1905,Derby County,Preston North End,3-0,3,0,1,1,3,3,H
1905-09-16,1905,Everton,Newcastle United,1-2,1,2,1,1,3,-1,A
1905-09-16,1905,Manchester City,Wolverhampton Wanderers,4-0,4,0,1,1,4,4,H
1905-09-16,1905,Nottingham Forest,Bury,3-2,3,2,1,1,5,1,H
1905-09-16,1905,Sheffield Wednesday,Middlesbrough,3-0,3,0,1,1,3,3,H
1905-09-16,1905,Sunderland,Liverpool,1-2,1,2,1,1,3,-1,A
1905-09-18,1905,Arsenal,Preston North End,2-2,2,2,1,1,4,0,D
1905-09-23,1905,Aston Villa,Everton,4-0,4,0,1,1,4,4,H
1905-09-23,1905,Bury,Manchester City,2-4,2,4,1,1,6,-2,A
1905-09-23,1905,Liverpool,Birmingham City,2-0,2,0,1,1,2,2,H
1905-09-23,1905,Middlesbrough,Nottingham Forest,2-0,2,0,1,1,2,2,H
1905-09-23,1905,Newcastle United,Derby County,0-1,0,1,1,1,1,-1,A
1905-09-23,1905,Notts County,Blackburn Rovers,1-1,1,1,1,1,2,0,D
1905-09-23,1905,Preston North End,Sheffield Wednesday,0-1,0,1,1,1,1,-1,A
1905-09-23,1905,Sheffield United,Sunderland,4-1,4,1,1,1,5,3,H
1905-09-23,1905,Stoke City,Arsenal,2-1,2,1,1,1,3,1,H
1905-09-23,1905,Wolverhampton Wanderers,Bolton Wanderers,2-0,2,0,1,1,2,2,H
1905-09-30,1905,Arsenal,Bolton Wanderers,0-0,0,0,1,1,0,0,D
1905-09-30,1905,Birmingham City,Sheffield United,2-0,2,0,1,1,2,2,H
1905-09-30,1905,Blackburn Rovers,Stoke City,3-0,3,0,1,1,3,3,H
1905-09-30,1905,Bury,Wolverhampton Wanderers,0-1,0,1,1,1,1,-1,A
1905-09-30,1905,Derby County,Aston Villa,1-0,1,0,1,1,1,1,H
1905-09-30,1905,Everton,Liverpool,4-2,4,2,1,1,6,2,H
1905-09-30,1905,Manchester City,Middlesbrough,4-0,4,0,1,1,4,4,H
1905-09-30,1905,Nottingham Forest,Preston North End,1-0,1,0,1,1,1,1,H
1905-09-30,1905,Sheffield Wednesday,Newcastle United,1-1,1,1,1,1,2,0,D
1905-09-30,1905,Sunderland,Notts County,1-3,1,3,1,1,4,-2,A
1905-10-05,1905,Notts County,Wolverhampton Wanderers,5-2,5,2,1,1,7,3,H
1905-10-07,1905,Aston Villa,Sheffield Wednesday,3-0,3,0,1,1,3,3,H
1905-10-07,1905,Bolton Wanderers,Blackburn Rovers,1-0,1,0,1,1,1,1,H
1905-10-07,1905,Liverpool,Derby County,4-1,4,1,1,1,5,3,H
1905-10-07,1905,Middlesbrough,Bury,5-1,5,1,1,1,6,4,H
1905-10-07,1905,Newcastle United,Nottingham Forest,3-2,3,2,1,1,5,1,H
1905-10-07,1905,Notts County,Birmingham City,0-0,0,0,1,1,0,0,D
1905-10-07,1905,Preston North End,Manchester City,2-0,2,0,1,1,2,2,H
1905-10-07,1905,Sheffield United,Everton,3-2,3,2,1,1,5,1,H
1905-10-07,1905,Stoke City,Sunderland,1-0,1,0,1,1,1,1,H
1905-10-07,1905,Wolverhampton Wanderers,Arsenal,0-2,0,2,1,1,2,-2,A
1905-10-14,1905,Birmingham City,Stoke City,2-0,2,0,1,1,2,2,H
1905-10-14,1905,Blackburn Rovers,Arsenal,2-0,2,0,1,1,2,2,H
1905-10-14,1905,Bury,Preston North End,1-1,1,1,1,1,2,0,D
1905-10-14,1905,Derby County,Sheffield United,1-0,1,0,1,1,1,1,H
1905-10-14,1905,Everton,Notts County,6-2,6,2,1,1,8,4,H
1905-10-14,1905,Middlesbrough,Wolverhampton Wanderers,3-1,3,1,1,1,4,2,H
1905-10-14,1905,Nottingham Forest,Aston Villa,2-2,2,2,1,1,4,0,D
1905-10-14,1905,Sheffield Wednesday,Liverpool,3-2,3,2,1,1,5,1,H
1905-10-14,1905,Sunderland,Bolton Wanderers,3-3,3,3,1,1,6,0,D
1905-10-21,1905,Arsenal,Sunderland,2-0,2,0,1,1,2,2,H
1905-10-21,1905,Aston Villa,Manchester City,2-1,2,1,1,1,3,1,H
1905-10-21,1905,Bolton Wanderers,Birmingham City,0-1,0,1,1,1,1,-1,A
1905-10-21,1905,Liverpool,Nottingham Forest,4-1,4,1,1,1,5,3,H
1905-10-21,1905,Newcastle United,Bury,3-1,3,1,1,1,4,2,H
1905-10-21,1905,Notts County,Derby County,1-0,1,0,1,1,1,1,H
1905-10-21,1905,Preston North End,Middlesbrough,2-1,2,1,1,1,3,1,H
1905-10-21,1905,Sheffield United,Sheffield Wednesday,0-2,0,2,1,1,2,-2,A
1905-10-21,1905,Stoke City,Everton,2-2,2,2,1,1,4,0,D
1905-10-21,1905,Wolverhampton Wanderers,Blackburn Rovers,2-1,2,1,1,1,3,1,H
1905-10-28,1905,Birmingham City,Arsenal,2-1,2,1,1,1,3,1,H
1905-10-28,1905,Bury,Aston Villa,0-1,0,1,1,1,1,-1,A
1905-10-28,1905,Derby County,Stoke City,1-0,1,0,1,1,1,1,H
1905-10-28,1905,Everton,Bolton Wanderers,3-1,3,1,1,1,4,2,H
1905-10-28,1905,Manchester City,Liverpool,0-1,0,1,1,1,1,-1,A
1905-10-28,1905,Newcastle United,Middlesbrough,4-1,4,1,1,1,5,3,H
1905-10-28,1905,Nottingham Forest,Sheffield United,4-1,4,1,1,1,5,3,H
1905-10-28,1905,Preston North End,Wolverhampton Wanderers,3-2,3,2,1,1,5,1,H
1905-10-28,1905,Sheffield Wednesday,Notts County,3-1,3,1,1,1,4,2,H
1905-10-28,1905,Sunderland,Blackburn Rovers,3-0,3,0,1,1,3,3,H
1905-11-04,1905,Arsenal,Everton,1-2,1,2,1,1,3,-1,A
1905-11-04,1905,Aston Villa,Middlesbrough,4-1,4,1,1,1,5,3,H
1905-11-04,1905,Blackburn Rovers,Birmingham City,5-1,5,1,1,1,6,4,H
1905-11-04,1905,Bolton Wanderers,Derby County,5-0,5,0,1,1,5,5,H
1905-11-04,1905,Liverpool,Bury,3-1,3,1,1,1,4,2,H
1905-11-04,1905,Newcastle United,Preston North End,1-0,1,0,1,1,1,1,H
1905-11-04,1905,Notts County,Nottingham Forest,1-1,1,1,1,1,2,0,D
1905-11-04,1905,Sheffield United,Manchester City,1-3,1,3,1,1,4,-2,A
1905-11-04,1905,Stoke City,Sheffield Wednesday,4-0,4,0,1,1,4,4,H
1905-11-04,1905,Wolverhampton Wanderers,Sunderland,5-2,5,2,1,1,7,3,H
1905-11-11,1905,Birmingham City,Sunderland,3-0,3,0,1,1,3,3,H
1905-11-11,1905,Bury,Sheffield United,2-5,2,5,1,1,7,-3,A
1905-11-11,1905,Derby County,Arsenal,5-1,5,1,1,1,6,4,H
1905-11-11,1905,Everton,Blackburn Rovers,3-2,3,2,1,1,5,1,H
1905-11-11,1905,Manchester City,Notts County,5-1,5,1,1,1,6,4,H
1905-11-11,1905,Middlesbrough,Liverpool,1-5,1,5,1,1,6,-4,A
1905-11-11,1905,Newcastle United,Wolverhampton Wanderers,8-0,8,0,1,1,8,8,H
1905-11-11,1905,Nottingham Forest,Stoke City,3-1,3,1,1,1,4,2,H
1905-11-11,1905,Preston North End,Aston Villa,2-0,2,0,1,1,2,2,H
1905-11-11,1905,Sheffield Wednesday,Bolton Wanderers,1-2,1,2,1,1,3,-1,A
1905-11-13,1905,Stoke City,Aston Villa,0-1,0,1,1,1,1,-1,A
1905-11-18,1905,Arsenal,Sheffield Wednesday,0-2,0,2,1,1,2,-2,A
1905-11-18,1905,Aston Villa,Newcastle United,0-3,0,3,1,1,3,-3,A
1905-11-18,1905,Blackburn Rovers,Derby County,3-0,3,0,1,1,3,3,H
1905-11-18,1905,Bolton Wanderers,Nottingham Forest,6-0,6,0,1,1,6,6,H
1905-11-18,1905,Liverpool,Preston North End,1-1,1,1,1,1,2,0,D
1905-11-18,1905,Notts County,Bury,2-2,2,2,1,1,4,0,D
1905-11-18,1905,Sheffield United,Middlesbrough,1-0,1,0,1,1,1,1,H
1905-11-18,1905,Stoke City,Manchester City,0-0,0,0,1,1,0,0,D
1905-11-18,1905,Sunderland,Everton,2-1,2,1,1,1,3,1,H
1905-11-18,1905,Wolverhampton Wanderers,Birmingham City,0-0,0,0,1,1,0,0,D
1905-11-25,1905,Aston Villa,Wolverhampton Wanderers,6-0,6,0,1,1,6,6,H
1905-11-25,1905,Bury,Stoke City,3-0,3,0,1,1,3,3,H
1905-11-25,1905,Derby County,Sunderland,1-0,1,0,1,1,1,1,H
1905-11-25,1905,Everton,Birmingham City,1-2,1,2,1,1,3,-1,A
1905-11-25,1905,Manchester City,Bolton Wanderers,3-1,3,1,1,1,4,2,H
1905-11-25,1905,Middlesbrough,Notts County,4-1,4,1,1,1,5,3,H
1905-11-25,1905,Newcastle United,Liverpool,2-3,2,3,1,1,5,-1,A
1905-11-25,1905,Nottingham Forest,Arsenal,3-1,3,1,1,1,4,2,H
1905-11-25,1905,Preston North End,Sheffield United,1-1,1,1,1,1,2,0,D
1905-11-25,1905,Sheffield Wednesday,Blackburn Rovers,0-1,0,1,1,1,1,-1,A
1905-12-02,1905,Arsenal,Manchester City,2-0,2,0,1,1,2,2,H
1905-12-02,1905,Birmingham City,Derby County,3-1,3,1,1,1,4,2,H
1905-12-02,1905,Blackburn Rovers,Nottingham Forest,1-1,1,1,1,1,2,0,D
1905-12-02,1905,Bolton Wanderers,Bury,4-0,4,0,1,1,4,4,H
1905-12-02,1905,Liverpool,Aston Villa,3-0,3,0,1,1,3,3,H
1905-12-02,1905,Notts County,Preston North End,2-2,2,2,1,1,4,0,D
1905-12-02,1905,Sheffield United,Newcastle United,2-0,2,0,1,1,2,2,H
1905-12-02,1905,Stoke City,Middlesbrough,1-1,1,1,1,1,2,0,D
1905-12-02,1905,Sunderland,Sheffield Wednesday,2-0,2,0,1,1,2,2,H
1905-12-02,1905,Wolverhampton Wanderers,Everton,2-5,2,5,1,1,7,-3,A
1905-12-09,1905,Aston Villa,Sheffield United,4-1,4,1,1,1,5,3,H
1905-12-09,1905,Bury,Arsenal,2-0,2,0,1,1,2,2,H
1905-12-09,1905,Derby County,Everton,0-0,0,0,1,1,0,0,D
1905-12-09,1905,Liverpool,Wolverhampton Wanderers,4-0,4,0,1,1,4,4,H
1905-12-09,1905,Manchester City,Blackburn Rovers,1-1,1,1,1,1,2,0,D
1905-12-09,1905,Middlesbrough,Bolton Wanderers,4-4,4,4,1,1,8,0,D
1905-12-09,1905,Newcastle United,Notts County,3-1,3,1,1,1,4,2,H
1905-12-09,1905,Nottingham Forest,Sunderland,1-2,1,2,1,1,3,-1,A
1905-12-09,1905,Preston North End,Stoke City,2-0,2,0,1,1,2,2,H
1905-12-09,1905,Sheffield Wednesday,Birmingham City,4-2,4,2,1,1,6,2,H
1905-12-16,1905,Arsenal,Middlesbrough,2-2,2,2,1,1,4,0,D
1905-12-16,1905,Birmingham City,Nottingham Forest,5-0,5,0,1,1,5,5,H
1905-12-16,1905,Blackburn Rovers,Bury,3-0,3,0,1,1,3,3,H
1905-12-16,1905,Bolton Wanderers,Preston North End,1-2,1,2,1,1,3,-1,A
1905-12-16,1905,Derby County,Wolverhampton Wanderers,2-0,2,0,1,1,2,2,H
1905-12-16,1905,Everton,Sheffield Wednesday,2-0,2,0,1,1,2,2,H
1905-12-16,1905,Notts County,Aston Villa,2-1,2,1,1,1,3,1,H
1905-12-16,1905,Sheffield United,Liverpool,1-2,1,2,1,1,3,-1,A
1905-12-16,1905,Stoke City,Newcastle United,1-0,1,0,1,1,1,1,H
1905-12-16,1905,Sunderland,Manchester City,2-0,2,0,1,1,2,2,H
1905-12-23,1905,Aston Villa,Stoke City,3-0,3,0,1,1,3,3,H
1905-12-23,1905,Bury,Sunderland,3-1,3,1,1,1,4,2,H
1905-12-23,1905,Liverpool,Notts County,2-0,2,0,1,1,2,2,H
1905-12-23,1905,Manchester City,Birmingham City,4-1,4,1,1,1,5,3,H
1905-12-23,1905,Middlesbrough,Blackburn Rovers,1-1,1,1,1,1,2,0,D
1905-12-23,1905,Newcastle United,Bolton Wanderers,2-1,2,1,1,1,3,1,H
1905-12-23,1905,Nottingham Forest,Everton,4-3,4,3,1,1,7,1,H
1905-12-23,1905,Preston North End,Arsenal,2-2,2,2,1,1,4,0,D
1905-12-23,1905,Sheffield Wednesday,Derby County,1-0,1,0,1,1,1,1,H
1905-12-23,1905,Wolverhampton Wanderers,Sheffield United,1-1,1,1,1,1,2,0,D
1905-12-25,1905,Arsenal,Newcastle United,4-3,4,3,1,1,7,1,H
1905-12-25,1905,Bury,Everton,3-2,3,2,1,1,5,1,H
1905-12-25,1905,Derby County,Manchester City,1-2,1,2,1,1,3,-1,A
1905-12-25,1905,Liverpool,Bolton Wanderers,2-2,2,2,1,1,4,0,D
1905-12-25,1905,Middlesbrough,Birmingham City,1-0,1,0,1,1,1,1,H
1905-12-25,1905,Nottingham Forest,Notts County,1-2,1,2,1,1,3,-1,A
1905-12-25,1905,Preston North End,Sunderland,1-1,1,1,1,1,2,0,D
1905-12-25,1905,Sheffield United,Stoke City,1-1,1,1,1,1,2,0,D
1905-12-26,1905,Aston Villa,Bolton Wanderers,1-1,1,1,1,1,2,0,D
1905-12-26,1905,Birmingham City,Middlesbrough,7-0,7,0,1,1,7,7,H
1905-12-26,1905,Derby County,Nottingham Forest,2-2,2,2,1,1,4,0,D
1905-12-26,1905,Everton,Bury,1-2,1,2,1,1,3,-1,A
1905-12-26,1905,Manchester City,Newcastle United,1-4,1,4,1,1,5,-3,A
1905-12-26,1905,Notts County,Sheffield United,2-3,2,3,1,1,5,-1,A
1905-12-26,1905,Sheffield Wednesday,Wolverhampton Wanderers,5-1,5,1,1,1,6,4,H
1905-12-26,1905,Stoke City,Liverpool,2-1,2,1,1,1,3,1,H
1905-12-27,1905,Aston Villa,Arsenal,2-1,2,1,1,1,3,1,H
1905-12-27,1905,Notts County,Sunderland,4-1,4,1,1,1,5,3,H
1905-12-27,1905,Sheffield Wednesday,Nottingham Forest,1-0,1,0,1,1,1,1,H
1905-12-28,1905,Sheffield United,Birmingham City,3-0,3,0,1,1,3,3,H
1905-12-30,1905,Aston Villa,Blackburn Rovers,0-1,0,1,1,1,1,-1,A
1905-12-30,1905,Bury,Derby County,0-2,0,2,1,1,2,-2,A
1905-12-30,1905,Liverpool,Arsenal,3-0,3,0,1,1,3,3,H
1905-12-30,1905,Manchester City,Sheffield Wednesday,2-1,2,1,1,1,3,1,H
1905-12-30,1905,Middlesbrough,Everton,0-0,0,0,1,1,0,0,D
1905-12-30,1905,Newcastle United,Sunderland,1-1,1,1,1,1,2,0,D
1905-12-30,1905,Notts County,Stoke City,1-1,1,1,1,1,2,0,D
1905-12-30,1905,Preston North End,Birmingham City,3-0,3,0,1,1,3,3,H
1905-12-30,1905,Sheffield United,Bolton Wanderers,5-2,5,2,1,1,7,3,H
1905-12-30,1905,Wolverhampton Wanderers,Nottingham Forest,2-1,2,1,1,1,3,1,H
1906-01-01,1905,Blackburn Rovers,Newcastle United,1-0,1,0,1,1,1,1,H
1906-01-01,1905,Bolton Wanderers,Arsenal,6-1,6,1,1,1,7,5,H
1906-01-01,1905,Bury,Birmingham City,1-0,1,0,1,1,1,1,H
1906-01-01,1905,Liverpool,Stoke City,3-1,3,1,1,1,4,2,H
1906-01-01,1905,Manchester City,Everton,1-0,1,0,1,1,1,1,H
1906-01-01,1905,Sheffield United,Notts County,1-0,1,0,1,1,1,1,H
1906-01-01,1905,Sunderland,Middlesbrough,2-1,2,1,1,1,3,1,H
1906-01-02,1905,Bolton Wanderers,Aston Villa,4-1,4,1,1,1,5,3,H
1906-01-06,1905,Arsenal,Sheffield United,5-1,5,1,1,1,6,4,H
1906-01-06,1905,Birmingham City,Newcastle United,0-1,0,1,1,1,1,-1,A
1906-01-06,1905,Blackburn Rovers,Liverpool,0-0,0,0,1,1,0,0,D
1906-01-06,1905,Derby County,Middlesbrough,1-1,1,1,1,1,2,0,D
1906-01-06,1905,Everton,Preston North End,1-0,1,0,1,1,1,1,H
1906-01-06,1905,Nottingham Forest,Manchester City,0-1,0,1,1,1,1,-1,A
1906-01-06,1905,Sheffield Wednesday,Bury,1-1,1,1,1,1,2,0,D
1906-01-06,1905,Stoke City,Wolverhampton Wanderers,4-0,4,0,1,1,4,4,H
1906-01-20,1905,Aston Villa,Birmingham City,1-3,1,3,1,1,4,-2,A
1906-01-20,1905,Bury,Nottingham Forest,2-1,2,1,1,1,3,1,H
1906-01-20,1905,Liverpool,Sunderland,2-0,2,0,1,1,2,2,H
1906-01-20,1905,Middlesbrough,Sheffield Wednesday,2-2,2,2,1,1,4,0,D
1906-01-20,1905,Newcastle United,Everton,4-2,4,2,1,1,6,2,H
1906-01-20,1905,Notts County,Arsenal,1-0,1,0,1,1,1,1,H
1906-01-20,1905,Preston North End,Derby County,3-1,3,1,1,1,4,2,H
1906-01-20,1905,Sheffield United,Blackburn Rovers,0-2,0,2,1,1,2,-2,A
1906-01-20,1905,Stoke City,Bolton Wanderers,1-2,1,2,1,1,3,-1,A
1906-01-20,1905,Wolverhampton Wanderers,Manchester City,2-3,2,3,1,1,5,-1,A
1906-01-27,1905,Arsenal,Stoke City,1-2,1,2,1,1,3,-1,A
1906-01-27,1905,Birmingham City,Liverpool,1-0,1,0,1,1,1,1,H
1906-01-27,1905,Blackburn Rovers,Notts County,1-3,1,3,1,1,4,-2,A
1906-01-27,1905,Bolton Wanderers,Wolverhampton Wanderers,3-2,3,2,1,1,5,1,H
1906-01-27,1905,Derby County,Newcastle United,2-1,2,1,1,1,3,1,H
1906-01-27,1905,Everton,Aston Villa,4-2,4,2,1,1,6,2,H
1906-01-27,1905,Manchester City,Bury,5-2,5,2,1,1,7,3,H
1906-01-27,1905,Nottingham Forest,Middlesbrough,2-1,2,1,1,1,3,1,H
1906-01-27,1905,Sheffield Wednesday,Preston North End,1-1,1,1,1,1,2,0,D
1906-01-27,1905,Sunderland,Sheffield United,2-0,2,0,1,1,2,2,H
1906-02-03,1905,Bolton Wanderers,Notts County,2-0,2,0,1,1,2,2,H
1906-02-03,1905,Preston North End,Blackburn Rovers,2-1,2,1,1,1,3,1,H
1906-02-10,1905,Arsenal,Wolverhampton Wanderers,2-1,2,1,1,1,3,1,H
1906-02-10,1905,Birmingham City,Notts County,4-2,4,2,1,1,6,2,H
1906-02-10,1905,Bury,Middlesbrough,1-1,1,1,1,1,2,0,D
1906-02-10,1905,Derby County,Liverpool,0-3,0,3,1,1,3,-3,A
1906-02-10,1905,Everton,Sheffield United,3-2,3,2,1,1,5,1,H
1906-02-10,1905,Manchester City,Preston North End,0-0,0,0,1,1,0,0,D
1906-02-10,1905,Nottingham Forest,Newcastle United,2-1,2,1,1,1,3,1,H
1906-02-10,1905,Sheffield Wednesday,Aston Villa,2-2,2,2,1,1,4,0,D
1906-02-10,1905,Sunderland,Stoke City,1-0,1,0,1,1,1,1,H
1906-02-17,1905,Arsenal,Blackburn Rovers,3-2,3,2,1,1,5,1,H
1906-02-17,1905,Aston Villa,Nottingham Forest,3-1,3,1,1,1,4,2,H
1906-02-17,1905,Bolton Wanderers,Sunderland,6-2,6,2,1,1,8,4,H
1906-02-17,1905,Liverpool,Sheffield Wednesday,2-1,2,1,1,1,3,1,H
1906-02-17,1905,Notts County,Everton,0-0,0,0,1,1,0,0,D
1906-02-17,1905,Preston North End,Bury,1-0,1,0,1,1,1,1,H
1906-02-17,1905,Sheffield United,Derby County,1-0,1,0,1,1,1,1,H
1906-02-17,1905,Stoke City,Birmingham City,2-2,2,2,1,1,4,0,D
1906-02-17,1905,Wolverhampton Wanderers,Middlesbrough,0-0,0,0,1,1,0,0,D
1906-02-24,1905,Blackburn Rovers,Wolverhampton Wanderers,3-1,3,1,1,1,4,2,H
1906-02-24,1905,Derby County,Notts County,1-1,1,1,1,1,2,0,D
1906-02-28,1905,Sunderland,Aston Villa,2-0,2,0,1,1,2,2,H
1906-03-03,1905,Arsenal,Birmingham City,5-0,5,0,1,1,5,5,H
1906-03-03,1905,Aston Villa,Bury,3-3,3,3,1,1,6,0,D
1906-03-03,1905,Blackburn Rovers,Sunderland,0-3,0,3,1,1,3,-3,A
1906-03-03,1905,Bolton Wanderers,Everton,3-2,3,2,1,1,5,1,H
1906-03-03,1905,Liverpool,Manchester City,0-1,0,1,1,1,1,-1,A
1906-03-03,1905,Middlesbrough,Newcastle United,1-0,1,0,1,1,1,1,H
1906-03-03,1905,Notts County,Sheffield Wednesday,1-3,1,3,1,1,4,-2,A
1906-03-03,1905,Sheffield United,Nottingham Forest,1-4,1,4,1,1,5,-3,A
1906-03-03,1905,Stoke City,Derby County,2-2,2,2,1,1,4,0,D
1906-03-03,1905,Wolverhampton Wanderers,Preston North End,2-3,2,3,1,1,5,-1,A
1906-03-10,1905,Derby County,Bolton Wanderers,0-1,0,1,1,1,1,-1,A
1906-03-10,1905,Manchester City,Sheffield United,1-2,1,2,1,1,3,-1,A
1906-03-10,1905,Middlesbrough,Aston Villa,1-2,1,2,1,1,3,-1,A
1906-03-10,1905,Sunderland,Wolverhampton Wanderers,7-2,7,2,1,1,9,5,H
1906-03-14,1905,Manchester City,Aston Villa,1-4,1,4,1,1,5,-3,A
1906-03-14,1905,Middlesbrough,Preston North End,1-2,1,2,1,1,3,-1,A
1906-03-14,1905,Nottingham Forest,Liverpool,1-2,1,2,1,1,3,-1,A
1906-03-17,1905,Arsenal,Derby County,1-0,1,0,1,1,1,1,H
1906-03-17,1905,Aston Villa,Preston North End,0-1,0,1,1,1,1,-1,A
1906-03-17,1905,Blackburn Rovers,Everton,1-2,1,2,1,1,3,-1,A
1906-03-17,1905,Bolton Wanderers,Sheffield Wednesday,1-0,1,0,1,1,1,1,H
1906-03-17,1905,Liverpool,Middlesbrough,6-1,6,1,1,1,7,5,H
1906-03-17,1905,Notts County,Manchester City,3-0,3,0,1,1,3,3,H
1906-03-17,1905,Sheffield United,Bury,1-1,1,1,1,1,2,0,D
1906-03-17,1905,Stoke City,Nottingham Forest,4-0,4,0,1,1,4,4,H
1906-03-17,1905,Sunderland,Birmingham City,3-1,3,1,1,1,4,2,H
1906-03-17,1905,Wolverhampton Wanderers,Newcastle United,0-2,0,2,1,1,2,-2,A
1906-03-19,1905,Sheffield United,Wolverhampton Wanderers,4-1,4,1,1,1,5,3,H
1906-03-21,1905,Everton,Arsenal,0-1,0,1,1,1,1,-1,A
1906-03-21,1905,Notts County,Liverpool,3-0,3,0,1,1,3,3,H
1906-03-24,1905,Birmingham City,Wolverhampton Wanderers,3-3,3,3,1,1,6,0,D
1906-03-24,1905,Bury,Notts County,0-0,0,0,1,1,0,0,D
1906-03-24,1905,Derby County,Blackburn Rovers,1-2,1,2,1,1,3,-1,A
1906-03-24,1905,Everton,Sunderland,3-1,3,1,1,1,4,2,H
1906-03-24,1905,Manchester City,Stoke City,2-0,2,0,1,1,2,2,H
1906-03-24,1905,Middlesbrough,Sheffield United,0-1,0,1,1,1,1,-1,A
1906-03-24,1905,Newcastle United,Aston Villa,3-1,3,1,1,1,4,2,H
1906-03-24,1905,Nottingham Forest,Bolton Wanderers,4-0,4,0,1,1,4,4,H
1906-03-24,1905,Preston North End,Liverpool,1-2,1,2,1,1,3,-1,A
1906-03-24,1905,Sheffield Wednesday,Arsenal,4-2,4,2,1,1,6,2,H
1906-03-26,1905,Birmingham City,Bolton Wanderers,2-5,2,5,1,1,7,-3,A
1906-03-26,1905,Stoke City,Bury,4-2,4,2,1,1,6,2,H
1906-03-31,1905,Blackburn Rovers,Sheffield Wednesday,1-0,1,0,1,1,1,1,H
1906-03-31,1905,Bolton Wanderers,Manchester City,1-3,1,3,1,1,4,-2,A
1906-03-31,1905,Notts County,Middlesbrough,1-1,1,1,1,1,2,0,D
1906-03-31,1905,Sheffield United,Preston North End,0-0,0,0,1,1,0,0,D
1906-03-31,1905,Sunderland,Derby County,2-0,2,0,1,1,2,2,H
1906-03-31,1905,Wolverhampton Wanderers,Aston Villa,4-1,4,1,1,1,5,3,H
1906-04-02,1905,Arsenal,Nottingham Forest,3-1,3,1,1,1,4,2,H
1906-04-02,1905,Blackburn Rovers,Bolton Wanderers,4-1,4,1,1,1,5,3,H
1906-04-02,1905,Bury,Liverpool,0-0,0,0,1,1,0,0,D
1906-04-03,1905,Everton,Stoke City,0-3,0,3,1,1,3,-3,A
1906-04-04,1905,Newcastle United,Sheffield United,2-1,2,1,1,1,3,1,H
1906-04-07,1905,Bury,Bolton Wanderers,2-1,2,1,1,1,3,1,H
1906-04-07,1905,Derby County,Birmingham City,0-0,0,0,1,1,0,0,D
1906-04-07,1905,Everton,Wolverhampton Wanderers,2-2,2,2,1,1,4,0,D
1906-04-07,1905,Manchester City,Arsenal,1-2,1,2,1,1,3,-1,A
1906-04-07,1905,Middlesbrough,Stoke City,5-0,5,0,1,1,5,5,H
1906-04-07,1905,Nottingham Forest,Blackburn Rovers,1-2,1,2,1,1,3,-1,A
1906-04-07,1905,Preston North End,Notts County,4-1,4,1,1,1,5,3,H
1906-04-07,1905,Sheffield Wednesday,Sunderland,3-3,3,3,1,1,6,0,D
1906-04-09,1905,Birmingham City,Everton,1-0,1,0,1,1,1,1,H
1906-04-09,1905,Liverpool,Newcastle United,3-0,3,0,1,1,3,3,H
1906-04-09,1905,Sheffield Wednesday,Stoke City,2-0,2,0,1,1,2,2,H
1906-04-13,1905,Arsenal,Aston Villa,2-1,2,1,1,1,3,1,H
1906-04-13,1905,Blackburn Rovers,Preston North End,1-2,1,2,1,1,3,-1,A
1906-04-13,1905,Bury,Newcastle United,1-4,1,4,1,1,5,-3,A
1906-04-13,1905,Liverpool,Everton,1-1,1,1,1,1,2,0,D
1906-04-13,1905,Manchester City,Derby County,1-2,1,2,1,1,3,-1,A
1906-04-13,1905,Middlesbrough,Sunderland,2-1,2,1,1,1,3,1,H
1906-04-14,1905,Arsenal,Bury,4-0,4,0,1,1,4,4,H
1906-04-14,1905,Birmingham City,Sheffield Wednesday,5-1,5,1,1,1,6,4,H
1906-04-14,1905,Blackburn Rovers,Manchester City,1-1,1,1,1,1,2,0,D
1906-04-14,1905,Bolton Wanderers,Middlesbrough,2-1,2,1,1,1,3,1,H
1906-04-14,1905,Everton,Derby County,2-1,2,1,1,1,3,1,H
1906-04-14,1905,Notts County,Newcastle United,1-0,1,0,1,1,1,1,H
1906-04-14,1905,Sheffield United,Aston Villa,1-1,1,1,1,1,2,0,D
1906-04-14,1905,Stoke City,Preston North End,3-0,3,0,1,1,3,3,H
1906-04-14,1905,Sunderland,Nottingham Forest,0-1,0,1,1,1,1,-1,A
1906-04-14,1905,Wolverhampton Wanderers,Liverpool,0-2,0,2,1,1,2,-2,A
1906-04-16,1905,Aston Villa,Derby County,6-0,6,0,1,1,6,6,H
1906-04-16,1905,Birmingham City,Bury,0-3,0,3,1,1,3,-3,A
1906-04-16,1905,Bolton Wanderers,Liverpool,3-2,3,2,1,1,5,1,H
1906-04-16,1905,Everton,Manchester City,0-3,0,3,1,1,3,-3,A
1906-04-16,1905,Newcastle United,Arsenal,1-1,1,1,1,1,2,0,D
1906-04-16,1905,Nottingham Forest,Sheffield Wednesday,3-4,3,4,1,1,7,-1,A
1906-04-16,1905,Stoke City,Sheffield United,2-1,2,1,1,1,3,1,H
1906-04-16,1905,Sunderland,Preston North End,2-0,2,0,1,1,2,2,H
1906-04-16,1905,Wolverhampton Wanderers,Notts County,6-1,6,1,1,1,7,5,H
1906-04-17,1905,Middlesbrough,Manchester City,6-1,6,1,1,1,7,5,H
1906-04-17,1905,Nottingham Forest,Derby County,0-0,0,0,1,1,0,0,D
1906-04-18,1905,Sheffield Wednesday,Sheffield United,1-0,1,0,1,1,1,1,H
1906-04-21,1905,Aston Villa,Notts County,2-1,2,1,1,1,3,1,H
1906-04-21,1905,Bury,Blackburn Rovers,5-0,5,0,1,1,5,5,H
1906-04-21,1905,Liverpool,Sheffield United,3-1,3,1,1,1,4,2,H
1906-04-21,1905,Manchester City,Sunderland,5-1,5,1,1,1,6,4,H
1906-04-21,1905,Middlesbrough,Arsenal,2-0,2,0,1,1,2,2,H
1906-04-21,1905,Nottingham Forest,Birmingham City,2-1,2,1,1,1,3,1,H
1906-04-21,1905,Preston North End,Bolton Wanderers,3-0,3,0,1,1,3,3,H
1906-04-21,1905,Wolverhampton Wanderers,Derby County,7-0,7,0,1,1,7,7,H
1906-04-23,1905,Birmingham City,Blackburn Rovers,3-0,3,0,1,1,3,3,H
1906-04-23,1905,Sheffield Wednesday,Everton,3-1,3,1,1,1,4,2,H
1906-04-24,1905,Newcastle United,Stoke City,5-0,5,0,1,1,5,5,H
1906-04-25,1905,Sunderland,Arsenal,2-2,2,2,1,1,4,0,D
1906-04-26,1905,Preston North End,Newcastle United,0-0,0,0,1,1,0,0,D
1906-04-28,1905,Birmingham City,Manchester City,3-2,3,2,1,1,5,1,H
1906-04-28,1905,Blackburn Rovers,Middlesbrough,1-1,1,1,1,1,2,0,D
1906-04-28,1905,Bolton Wanderers,Newcastle United,1-1,1,1,1,1,2,0,D
1906-04-28,1905,Derby County,Sheffield Wednesday,2-1,2,1,1,1,3,1,H
1906-04-28,1905,Everton,Nottingham Forest,4-1,4,1,1,1,5,3,H
1906-04-28,1905,Sunderland,Bury,0-3,0,3,1,1,3,-3,A
1906-04-30,1905,Newcastle United,Blackburn Rovers,3-0,3,0,1,1,3,3,H
1906-09-01,1906,Aston Villa,Blackburn Rovers,4-2,4,2,1,1,6,2,H
1906-09-01,1906,Bristol City,Manchester United,1-2,1,2,1,1,3,-1,A
1906-09-01,1906,Bury,Sheffield Wednesday,0-0,0,0,1,1,0,0,D
1906-09-01,1906,Liverpool,Stoke City,1-0,1,0,1,1,1,1,H
1906-09-01,1906,Manchester City,Arsenal,1-4,1,4,1,1,5,-3,A
1906-09-01,1906,Middlesbrough,Everton,2-2,2,2,1,1,4,0,D
1906-09-01,1906,Newcastle United,Sunderland,4-2,4,2,1,1,6,2,H
1906-09-01,1906,Notts County,Bolton Wanderers,0-0,0,0,1,1,0,0,D
1906-09-01,1906,Preston North End,Birmingham City,2-0,2,0,1,1,2,2,H
1906-09-01,1906,Sheffield United,Derby County,2-0,2,0,1,1,2,2,H
1906-09-03,1906,Birmingham City,Bristol City,2-2,2,2,1,1,4,0,D
1906-09-03,1906,Bury,Arsenal,4-1,4,1,1,1,5,3,H
1906-09-03,1906,Derby County,Manchester United,2-2,2,2,1,1,4,0,D
1906-09-03,1906,Everton,Manchester City,9-1,9,1,1,1,10,8,H
1906-09-03,1906,Sheffield Wednesday,Newcastle United,2-2,2,2,1,1,4,0,D
1906-09-03,1906,Stoke City,Aston Villa,0-2,0,2,1,1,2,-2,A
1906-09-08,1906,Arsenal,Middlesbrough,2-0,2,0,1,1,2,2,H
1906-09-08,1906,Birmingham City,Newcastle United,2-4,2,4,1,1,6,-2,A
1906-09-08,1906,Blackburn Rovers,Liverpool,1-1,1,1,1,1,2,0,D
1906-09-08,1906,Bolton Wanderers,Sheffield United,6-1,6,1,1,1,7,5,H
1906-09-08,1906,Derby County,Bury,2-1,2,1,1,1,3,1,H
1906-09-08,1906,Everton,Preston North End,1-0,1,0,1,1,1,1,H
1906-09-08,1906,Manchester United,Notts County,0-0,0,0,1,1,0,0,D
1906-09-08,1906,Sheffield Wednesday,Manchester City,3-1,3,1,1,1,4,2,H
1906-09-08,1906,Stoke City,Bristol City,0-3,0,3,1,1,3,-3,A
1906-09-08,1906,Sunderland,Aston Villa,2-1,2,1,1,1,3,1,H
1906-09-10,1906,Aston Villa,Stoke City,1-0,1,0,1,1,1,1,H
1906-09-10,1906,Liverpool,Bury,2-2,2,2,1,1,4,0,D
1906-09-15,1906,Aston Villa,Birmingham City,4-1,4,1,1,1,5,3,H
1906-09-15,1906,Bolton Wanderers,Derby County,1-0,1,0,1,1,1,1,H
1906-09-15,1906,Bristol City,Blackburn Rovers,3-0,3,0,1,1,3,3,H
1906-09-15,1906,Liverpool,Sunderland,1-2,1,2,1,1,3,-1,A
1906-09-15,1906,Manchester City,Bury,2-2,2,2,1,1,4,0,D
1906-09-15,1906,Middlesbrough,Sheffield Wednesday,1-3,1,3,1,1,4,-2,A
1906-09-15,1906,Newcastle United,Everton,1-0,1,0,1,1,1,1,H
1906-09-15,1906,Notts County,Stoke City,2-2,2,2,1,1,4,0,D
1906-09-15,1906,Preston North End,Arsenal,0-3,0,3,1,1,3,-3,A
1906-09-15,1906,Sheffield United,Manchester United,0-2,0,2,1,1,2,-2,A
1906-09-17,1906,Everton,Notts County,2-2,2,2,1,1,4,0,D
1906-09-22,1906,Arsenal,Newcastle United,2-0,2,0,1,1,2,2,H
1906-09-22,1906,Birmingham City,Liverpool,2-1,2,1,1,1,3,1,H
1906-09-22,1906,Blackburn Rovers,Notts County,0-2,0,2,1,1,2,-2,A
1906-09-22,1906,Bury,Middlesbrough,1-1,1,1,1,1,2,0,D
1906-09-22,1906,Derby County,Manchester City,2-2,2,2,1,1,4,0,D
1906-09-22,1906,Everton,Aston Villa,1-2,1,2,1,1,3,-1,A
1906-09-22,1906,Manchester United,Bolton Wanderers,1-2,1,2,1,1,3,-1,A
1906-09-22,1906,Sheffield Wednesday,Preston North End,2-1,2,1,1,1,3,1,H
1906-09-22,1906,Stoke City,Sheffield United,1-1,1,1,1,1,2,0,D
1906-09-22,1906,Sunderland,Bristol City,3-3,3,3,1,1,6,0,D
1906-09-29,1906,Aston Villa,Arsenal,2-2,2,2,1,1,4,0,D
1906-09-29,1906,Bolton Wanderers,Stoke City,1-1,1,1,1,1,2,0,D
1906-09-29,1906,Bristol City,Birmingham City,0-0,0,0,1,1,0,0,D
1906-09-29,1906,Liverpool,Everton,1-2,1,2,1,1,3,-1,A
1906-09-29,1906,Manchester United,Derby County,1-1,1,1,1,1,2,0,D
1906-09-29,1906,Middlesbrough,Manchester City,2-3,2,3,1,1,5,-1,A
1906-09-29,1906,Newcastle United,Sheffield Wednesday,5-1,5,1,1,1,6,4,H
1906-09-29,1906,Notts County,Sunderland,0-0,0,0,1,1,0,0,D
1906-09-29,1906,Preston North End,Bury,3-2,3,2,1,1,5,1,H
1906-09-29,1906,Sheffield United,Blackburn Rovers,3-0,3,0,1,1,3,3,H
1906-10-06,1906,Arsenal,Liverpool,2-1,2,1,1,1,3,1,H
1906-10-06,1906,Birmingham City,Notts County,2-0,2,0,1,1,2,2,H
1906-10-06,1906,Blackburn Rovers,Bolton Wanderers,2-3,2,3,1,1,5,-1,A
1906-10-06,1906,Bury,Newcastle United,3-2,3,2,1,1,5,1,H
1906-10-06,1906,Derby County,Middlesbrough,1-0,1,0,1,1,1,1,H
1906-10-06,1906,Everton,Bristol City,2-0,2,0,1,1,2,2,H
1906-10-06,1906,Manchester City,Preston North End,1-1,1,1,1,1,2,0,D
1906-10-06,1906,Sheffield Wednesday,Aston Villa,2-1,2,1,1,1,3,1,H
1906-10-06,1906,Stoke City,Manchester United,1-2,1,2,1,1,3,-1,A
1906-10-06,1906,Sunderland,Sheffield United,1-2,1,2,1,1,3,-1,A
1906-10-13,1906,Aston Villa,Bury,3-1,3,1,1,1,4,2,H
1906-10-13,1906,Bolton Wanderers,Sunderland,1-0,1,0,1,1,1,1,H
1906-10-13,1906,Bristol City,Arsenal,1-3,1,3,1,1,4,-2,A
1906-10-13,1906,Liverpool,Sheffield Wednesday,1-2,1,2,1,1,3,-1,A
1906-10-13,1906,Manchester United,Blackburn Rovers,1-1,1,1,1,1,2,0,D
1906-10-13,1906,Newcastle United,Manchester City,2-0,2,0,1,1,2,2,H
1906-10-13,1906,Notts County,Everton,0-1,0,1,1,1,1,-1,A
1906-10-13,1906,Preston North End,Middlesbrough,4-2,4,2,1,1,6,2,H
1906-10-13,1906,Sheffield United,Birmingham City,2-0,2,0,1,1,2,2,H
1906-10-13,1906,Stoke City,Derby County,2-1,2,1,1,1,3,1,H
1906-10-20,1906,Arsenal,Notts County,1-0,1,0,1,1,1,1,H
1906-10-20,1906,Birmingham City,Bolton Wanderers,4-2,4,2,1,1,6,2,H
1906-10-20,1906,Blackburn Rovers,Stoke City,3-1,3,1,1,1,4,2,H
1906-10-20,1906,Bury,Liverpool,1-3,1,3,1,1,4,-2,A
1906-10-20,1906,Derby County,Preston North End,3-0,3,0,1,1,3,3,H
1906-10-20,1906,Everton,Sheffield United,4-2,4,2,1,1,6,2,H
1906-10-20,1906,Manchester City,Aston Villa,4-2,4,2,1,1,6,2,H
1906-10-20,1906,Middlesbrough,Newcastle United,0-3,0,3,1,1,3,-3,A
1906-10-20,1906,Sheffield Wednesday,Bristol City,3-0,3,0,1,1,3,3,H
1906-10-20,1906,Sunderland,Manchester United,4-1,4,1,1,1,5,3,H
1906-10-27,1906,Aston Villa,Middlesbrough,2-3,2,3,1,1,5,-1,A
1906-10-27,1906,Blackburn Rovers,Derby County,5-1,5,1,1,1,6,4,H
1906-10-27,1906,Bolton Wanderers,Everton,1-3,1,3,1,1,4,-2,A
1906-10-27,1906,Bristol City,Bury,2-0,2,0,1,1,2,2,H
1906-10-27,1906,Liverpool,Manchester City,5-4,5,4,1,1,9,1,H
1906-10-27,1906,Manchester United,Birmingham City,2-1,2,1,1,1,3,1,H
1906-10-27,1906,Newcastle United,Preston North End,2-1,2,1,1,1,3,1,H
1906-10-27,1906,Notts County,Sheffield Wednesday,2-2,2,2,1,1,4,0,D
1906-10-27,1906,Sheffield United,Arsenal,4-2,4,2,1,1,6,2,H
1906-10-27,1906,Stoke City,Sunderland,2-2,2,2,1,1,4,0,D
1906-11-03,1906,Arsenal,Bolton Wanderers,2-2,2,2,1,1,4,0,D
1906-11-03,1906,Birmingham City,Stoke City,2-1,2,1,1,1,3,1,H
1906-11-03,1906,Bury,Notts County,3-0,3,0,1,1,3,3,H
1906-11-03,1906,Derby County,Newcastle United,0-0,0,0,1,1,0,0,D
1906-11-03,1906,Everton,Manchester United,3-0,3,0,1,1,3,3,H
1906-11-03,1906,Manchester City,Bristol City,0-1,0,1,1,1,1,-1,A
1906-11-03,1906,Middlesbrough,Liverpool,0-1,0,1,1,1,1,-1,A
1906-11-03,1906,Preston North End,Aston Villa,2-0,2,0,1,1,2,2,H
1906-11-03,1906,Sheffield Wednesday,Sheffield United,2-2,2,2,1,1,4,0,D
1906-11-03,1906,Sunderland,Blackburn Rovers,1-0,1,0,1,1,1,1,H
1906-11-10,1906,Aston Villa,Newcastle United,0-0,0,0,1,1,0,0,D
1906-11-10,1906,Blackburn Rovers,Birmingham City,1-0,1,0,1,1,1,1,H
1906-11-10,1906,Bolton Wanderers,Sheffield Wednesday,0-0,0,0,1,1,0,0,D
1906-11-10,1906,Bristol City,Middlesbrough,3-0,3,0,1,1,3,3,H
1906-11-10,1906,Liverpool,Preston North End,6-1,6,1,1,1,7,5,H
1906-11-10,1906,Manchester United,Arsenal,1-0,1,0,1,1,1,1,H
1906-11-10,1906,Notts County,Manchester City,0-0,0,0,1,1,0,0,D
1906-11-10,1906,Sheffield United,Bury,3-0,3,0,1,1,3,3,H
1906-11-10,1906,Stoke City,Everton,2-0,2,0,1,1,2,2,H
1906-11-10,1906,Sunderland,Derby County,0-2,0,2,1,1,2,-2,A
1906-11-12,1906,Stoke City,Blackburn Rovers,1-1,1,1,1,1,2,0,D
1906-11-17,1906,Arsenal,Stoke City,2-1,2,1,1,1,3,1,H
1906-11-17,1906,Birmingham City,Sunderland,2-0,2,0,1,1,2,2,H
1906-11-17,1906,Bury,Bolton Wanderers,2-3,2,3,1,1,5,-1,A
1906-11-17,1906,Derby County,Aston Villa,0-1,0,1,1,1,1,-1,A
1906-11-17,1906,Everton,Blackburn Rovers,2-0,2,0,1,1,2,2,H
1906-11-17,1906,Manchester City,Sheffield United,0-2,0,2,1,1,2,-2,A
1906-11-17,1906,Middlesbrough,Notts County,2-0,2,0,1,1,2,2,H
1906-11-17,1906,Newcastle United,Liverpool,2-0,2,0,1,1,2,2,H
1906-11-17,1906,Preston North End,Bristol City,3-1,3,1,1,1,4,2,H
1906-11-17,1906,Sheffield Wednesday,Manchester United,5-2,5,2,1,1,7,3,H
1906-11-24,1906,Birmingham City,Derby County,2-1,2,1,1,1,3,1,H
1906-11-24,1906,Blackburn Rovers,Arsenal,2-3,2,3,1,1,5,-1,A
1906-11-24,1906,Bolton Wanderers,Manchester City,1-1,1,1,1,1,2,0,D
1906-11-24,1906,Bristol City,Newcastle United,2-1,2,1,1,1,3,1,H
1906-11-24,1906,Liverpool,Aston Villa,5-2,5,2,1,1,7,3,H
1906-11-24,1906,Manchester United,Bury,2-4,2,4,1,1,6,-2,A
1906-11-24,1906,Notts County,Preston North End,0-0,0,0,1,1,0,0,D
1906-11-24,1906,Sheffield United,Middlesbrough,1-1,1,1,1,1,2,0,D
1906-11-24,1906,Stoke City,Sheffield Wednesday,1-1,1,1,1,1,2,0,D
1906-11-24,1906,Sunderland,Everton,1-0,1,0,1,1,1,1,H
1906-12-01,1906,Arsenal,Sunderland,0-1,0,1,1,1,1,-1,A
1906-12-01,1906,Aston Villa,Bristol City,3-2,3,2,1,1,5,1,H
1906-12-01,1906,Bury,Stoke City,2-0,2,0,1,1,2,2,H
1906-12-01,1906,Derby County,Liverpool,0-1,0,1,1,1,1,-1,A
1906-12-01,1906,Everton,Birmingham City,3-0,3,0,1,1,3,3,H
1906-12-01,1906,Manchester City,Manchester United,3-0,3,0,1,1,3,3,H
1906-12-01,1906,Middlesbrough,Bolton Wanderers,0-0,0,0,1,1,0,0,D
1906-12-01,1906,Newcastle United,Notts County,4-3,4,3,1,1,7,1,H
1906-12-01,1906,Preston North End,Sheffield United,2-1,2,1,1,1,3,1,H
1906-12-01,1906,Sheffield Wednesday,Blackburn Rovers,3-1,3,1,1,1,4,2,H
1906-12-08,1906,Birmingham City,Arsenal,5-1,5,1,1,1,6,4,H
1906-12-08,1906,Blackburn Rovers,Bury,4-1,4,1,1,1,5,3,H
1906-12-08,1906,Bristol City,Liverpool,3-1,3,1,1,1,4,2,H
1906-12-08,1906,Everton,Derby County,2-0,2,0,1,1,2,2,H
1906-12-08,1906,Manchester United,Middlesbrough,3-1,3,1,1,1,4,2,H
1906-12-08,1906,Notts County,Aston Villa,1-1,1,1,1,1,2,0,D
1906-12-08,1906,Preston North End,Bolton Wanderers,3-1,3,1,1,1,4,2,H
1906-12-08,1906,Sheffield United,Newcastle United,0-0,0,0,1,1,0,0,D
1906-12-08,1906,Stoke City,Manchester City,3-0,3,0,1,1,3,3,H
1906-12-08,1906,Sunderland,Sheffield Wednesday,1-1,1,1,1,1,2,0,D
1906-12-15,1906,Arsenal,Everton,3-1,3,1,1,1,4,2,H
1906-12-15,1906,Aston Villa,Sheffield United,5-1,5,1,1,1,6,4,H
1906-12-15,1906,Bristol City,Derby County,3-0,3,0,1,1,3,3,H
1906-12-15,1906,Bury,Sunderland,2-3,2,3,1,1,5,-1,A
1906-12-15,1906,Liverpool,Notts County,5-1,5,1,1,1,6,4,H
1906-12-15,1906,Manchester City,Blackburn Rovers,0-0,0,0,1,1,0,0,D
1906-12-15,1906,Middlesbrough,Stoke City,5-0,5,0,1,1,5,5,H
1906-12-15,1906,Newcastle United,Bolton Wanderers,4-0,4,0,1,1,4,4,H
1906-12-15,1906,Preston North End,Manchester United,2-0,2,0,1,1,2,2,H
1906-12-15,1906,Sheffield Wednesday,Birmingham City,0-1,0,1,1,1,1,-1,A
1906-12-22,1906,Birmingham City,Bury,3-1,3,1,1,1,4,2,H
1906-12-22,1906,Blackburn Rovers,Middlesbrough,4-1,4,1,1,1,5,3,H
1906-12-22,1906,Bolton Wanderers,Aston Villa,1-2,1,2,1,1,3,-1,A
1906-12-22,1906,Derby County,Arsenal,0-0,0,0,1,1,0,0,D
1906-12-22,1906,Everton,Sheffield Wednesday,2-0,2,0,1,1,2,2,H
1906-12-22,1906,Manchester United,Newcastle United,1-3,1,3,1,1,4,-2,A
1906-12-22,1906,Notts County,Bristol City,2-3,2,3,1,1,5,-1,A
1906-12-22,1906,Sheffield United,Liverpool,1-0,1,0,1,1,1,1,H
1906-12-22,1906,Stoke City,Preston North End,0-2,0,2,1,1,2,-2,A
1906-12-22,1906,Sunderland,Manchester City,1-1,1,1,1,1,2,0,D
1906-12-24,1906,Aston Villa,Preston North End,3-0,3,0,1,1,3,3,H
1906-12-24,1906,Bristol City,Sheffield United,3-3,3,3,1,1,6,0,D
1906-12-24,1906,Derby County,Notts County,3-0,3,0,1,1,3,3,H
1906-12-24,1906,Stoke City,Bolton Wanderers,3-0,3,0,1,1,3,3,H
1906-12-25,1906,Blackburn Rovers,Newcastle United,4-0,4,0,1,1,4,4,H
1906-12-25,1906,Bury,Everton,1-2,1,2,1,1,3,-1,A
1906-12-25,1906,Manchester City,Birmingham City,1-0,1,0,1,1,1,1,H
1906-12-25,1906,Manchester United,Liverpool,0-0,0,0,1,1,0,0,D
1906-12-25,1906,Middlesbrough,Sunderland,2-1,2,1,1,1,3,1,H
1906-12-25,1906,Sheffield Wednesday,Derby County,1-1,1,1,1,1,2,0,D
1906-12-26,1906,Arsenal,Bury,3-1,3,1,1,1,4,2,H
1906-12-26,1906,Aston Villa,Manchester United,2-0,2,0,1,1,2,2,H
1906-12-26,1906,Birmingham City,Middlesbrough,0-0,0,0,1,1,0,0,D
1906-12-26,1906,Liverpool,Bolton Wanderers,0-2,0,2,1,1,2,-2,A
1906-12-26,1906,Manchester City,Everton,3-1,3,1,1,1,4,2,H
1906-12-26,1906,Preston North End,Blackburn Rovers,1-0,1,0,1,1,1,1,H
1906-12-26,1906,Sheffield United,Notts County,2-1,2,1,1,1,3,1,H
1906-12-26,1906,Stoke City,Newcastle United,1-2,1,2,1,1,3,-1,A
1906-12-29,1906,Arsenal,Manchester City,4-1,4,1,1,1,5,3,H
1906-12-29,1906,Birmingham City,Preston North End,3-0,3,0,1,1,3,3,H
1906-12-29,1906,Blackburn Rovers,Aston Villa,2-1,2,1,1,1,3,1,H
1906-12-29,1906,Bolton Wanderers,Notts County,0-0,0,0,1,1,0,0,D
1906-12-29,1906,Derby County,Sheffield United,3-0,3,0,1,1,3,3,H
1906-12-29,1906,Everton,Middlesbrough,5-1,5,1,1,1,6,4,H
1906-12-29,1906,Manchester United,Bristol City,0-0,0,0,1,1,0,0,D
1906-12-29,1906,Sheffield Wednesday,Bury,1-2,1,2,1,1,3,-1,A
1906-12-31,1906,Sheffield United,Bristol City,1-1,1,1,1,1,2,0,D
1907-01-01,1906,Blackburn Rovers,Preston North End,1-1,1,1,1,1,2,0,D
1907-01-01,1906,Bolton Wanderers,Liverpool,3-0,3,0,1,1,3,3,H
1907-01-01,1906,Everton,Bury,1-0,1,0,1,1,1,1,H
1907-01-01,1906,Manchester United,Aston Villa,1-0,1,0,1,1,1,1,H
1907-01-01,1906,Middlesbrough,Birmingham City,1-0,1,0,1,1,1,1,H
1907-01-01,1906,Newcastle United,Derby County,2-0,2,0,1,1,2,2,H
1907-01-01,1906,Sheffield Wednesday,Arsenal,1-1,1,1,1,1,2,0,D
1907-01-02,1906,Bolton Wanderers,Preston North End,3-0,3,0,1,1,3,3,H
1907-01-02,1906,Manchester City,Middlesbrough,3-1,3,1,1,1,4,2,H
1907-01-05,1906,Aston Villa,Sunderland,2-2,2,2,1,1,4,0,D
1907-01-05,1906,Bristol City,Stoke City,4-0,4,0,1,1,4,4,H
1907-01-05,1906,Bury,Derby County,1-0,1,0,1,1,1,1,H
1907-01-05,1906,Liverpool,Blackburn Rovers,0-2,0,2,1,1,2,-2,A
1907-01-05,1906,Manchester City,Sheffield Wednesday,0-1,0,1,1,1,1,-1,A
1907-01-05,1906,Middlesbrough,Arsenal,5-3,5,3,1,1,8,2,H
1907-01-05,1906,Newcastle United,Birmingham City,2-0,2,0,1,1,2,2,H
1907-01-05,1906,Notts County,Manchester United,3-0,3,0,1,1,3,3,H
1907-01-05,1906,Preston North End,Everton,1-1,1,1,1,1,2,0,D
1907-01-05,1906,Sheffield United,Bolton Wanderers,2-1,2,1,1,1,3,1,H
1907-01-19,1906,Arsenal,Preston North End,1-0,1,0,1,1,1,1,H
1907-01-19,1906,Birmingham City,Aston Villa,3-2,3,2,1,1,5,1,H
1907-01-19,1906,Blackburn Rovers,Bristol City,0-1,0,1,1,1,1,-1,A
1907-01-19,1906,Bury,Manchester City,3-1,3,1,1,1,4,2,H
1907-01-19,1906,Derby County,Bolton Wanderers,0-1,0,1,1,1,1,-1,A
1907-01-19,1906,Everton,Newcastle United,3-0,3,0,1,1,3,3,H
1907-01-19,1906,Manchester United,Sheffield United,2-0,2,0,1,1,2,2,H
1907-01-19,1906,Sheffield Wednesday,Middlesbrough,0-2,0,2,1,1,2,-2,A
1907-01-19,1906,Stoke City,Notts County,1-1,1,1,1,1,2,0,D
1907-01-19,1906,Sunderland,Liverpool,5-5,5,5,1,1,10,0,D
1907-01-26,1906,Aston Villa,Everton,2-1,2,1,1,1,3,1,H
1907-01-26,1906,Bolton Wanderers,Manchester United,0-1,0,1,1,1,1,-1,A
1907-01-26,1906,Bristol City,Sunderland,1-1,1,1,1,1,2,0,D
1907-01-26,1906,Liverpool,Birmingham City,2-0,2,0,1,1,2,2,H
1907-01-26,1906,Manchester City,Derby County,2-2,2,2,1,1,4,0,D
1907-01-26,1906,Middlesbrough,Bury,3-1,3,1,1,1,4,2,H
1907-01-26,1906,Newcastle United,Arsenal,1-0,1,0,1,1,1,1,H
1907-01-26,1906,Notts County,Blackburn Rovers,1-2,1,2,1,1,3,-1,A
1907-01-26,1906,Preston North End,Sheffield Wednesday,1-0,1,0,1,1,1,1,H
1907-01-26,1906,Sheffield United,Stoke City,2-0,2,0,1,1,2,2,H
1907-02-02,1906,Newcastle United,Manchester United,5-0,5,0,1,1,5,5,H
1907-02-02,1906,Sheffield United,Preston North End,3-1,3,1,1,1,4,2,H
1907-02-09,1906,Aston Villa,Sheffield Wednesday,8-1,8,1,1,1,9,7,H
1907-02-09,1906,Bolton Wanderers,Blackburn Rovers,5-2,5,2,1,1,7,3,H
1907-02-09,1906,Bristol City,Everton,2-1,2,1,1,1,3,1,H
1907-02-09,1906,Liverpool,Arsenal,4-0,4,0,1,1,4,4,H
1907-02-09,1906,Manchester United,Stoke City,4-1,4,1,1,1,5,3,H
1907-02-09,1906,Middlesbrough,Derby County,4-1,4,1,1,1,5,3,H
1907-02-09,1906,Newcastle United,Bury,3-2,3,2,1,1,5,1,H
1907-02-09,1906,Notts County,Birmingham City,2-2,2,2,1,1,4,0,D
1907-02-09,1906,Preston North End,Manchester City,1-3,1,3,1,1,4,-2,A
1907-02-09,1906,Sheffield United,Sunderland,3-2,3,2,1,1,5,1,H
1907-02-13,1906,Sunderland,Preston North End,1-0,1,0,1,1,1,1,H
1907-02-16,1906,Arsenal,Bristol City,1-2,1,2,1,1,3,-1,A
1907-02-16,1906,Birmingham City,Sheffield United,0-0,0,0,1,1,0,0,D
1907-02-16,1906,Blackburn Rovers,Manchester United,2-4,2,4,1,1,6,-2,A
1907-02-16,1906,Bury,Aston Villa,0-3,0,3,1,1,3,-3,A
1907-02-16,1906,Derby County,Stoke City,2-1,2,1,1,1,3,1,H
1907-02-16,1906,Manchester City,Newcastle United,1-1,1,1,1,1,2,0,D
1907-02-16,1906,Middlesbrough,Preston North End,2-1,2,1,1,1,3,1,H
1907-02-16,1906,Sheffield Wednesday,Liverpool,2-3,2,3,1,1,5,-1,A
1907-02-16,1906,Sunderland,Bolton Wanderers,1-2,1,2,1,1,3,-1,A
1907-02-23,1906,Aston Villa,Manchester City,4-1,4,1,1,1,5,3,H
1907-02-23,1906,Manchester United,Preston North End,3-0,3,0,1,1,3,3,H
1907-02-23,1906,Newcastle United,Middlesbrough,4-0,4,0,1,1,4,4,H
1907-03-02,1906,Arsenal,Sheffield United,0-1,0,1,1,1,1,-1,A
1907-03-02,1906,Birmingham City,Manchester United,1-1,1,1,1,1,2,0,D
1907-03-02,1906,Bury,Bristol City,1-1,1,1,1,1,2,0,D
1907-03-02,1906,Derby County,Blackburn Rovers,2-3,2,3,1,1,5,-1,A
1907-03-02,1906,Everton,Bolton Wanderers,1-0,1,0,1,1,1,1,H
1907-03-02,1906,Manchester City,Liverpool,1-0,1,0,1,1,1,1,H
1907-03-02,1906,Middlesbrough,Aston Villa,1-0,1,0,1,1,1,1,H
1907-03-02,1906,Preston North End,Newcastle United,2-2,2,2,1,1,4,0,D
1907-03-02,1906,Sheffield Wednesday,Notts County,1-3,1,3,1,1,4,-2,A
1907-03-02,1906,Sunderland,Stoke City,3-1,3,1,1,1,4,2,H
1907-03-04,1906,Sheffield United,Everton,4-1,4,1,1,1,5,3,H
1907-03-09,1906,Blackburn Rovers,Sunderland,2-1,2,1,1,1,3,1,H
1907-03-09,1906,Bolton Wanderers,Bury,1-0,1,0,1,1,1,1,H
1907-03-09,1906,Bristol City,Manchester City,2-0,2,0,1,1,2,2,H
1907-03-09,1906,Preston North End,Derby County,1-0,1,0,1,1,1,1,H
1907-03-09,1906,Stoke City,Birmingham City,3-0,3,0,1,1,3,3,H
1907-03-11,1906,Bolton Wanderers,Birmingham City,2-3,2,3,1,1,5,-1,A
1907-03-11,1906,Stoke City,Liverpool,1-1,1,1,1,1,2,0,D
1907-03-13,1906,Notts County,Bury,1-2,1,2,1,1,3,-1,A
1907-03-16,1906,Arsenal,Manchester United,4-0,4,0,1,1,4,4,H
1907-03-16,1906,Birmingham City,Blackburn Rovers,2-0,2,0,1,1,2,2,H
1907-03-16,1906,Bury,Sheffield United,2-1,2,1,1,1,3,1,H
1907-03-16,1906,Derby County,Sunderland,1-1,1,1,1,1,2,0,D
1907-03-16,1906,Everton,Stoke City,3-0,3,0,1,1,3,3,H
1907-03-16,1906,Manchester City,Notts County,2-1,2,1,1,1,3,1,H
1907-03-16,1906,Middlesbrough,Bristol City,1-0,1,0,1,1,1,1,H
1907-03-16,1906,Newcastle United,Aston Villa,3-2,3,2,1,1,5,1,H
1907-03-16,1906,Preston North End,Liverpool,3-1,3,1,1,1,4,2,H
1907-03-16,1906,Sheffield Wednesday,Bolton Wanderers,2-0,2,0,1,1,2,2,H
1907-03-20,1906,Sunderland,Newcastle United,2-0,2,0,1,1,2,2,H
1907-03-23,1906,Aston Villa,Derby County,2-0,2,0,1,1,2,2,H
1907-03-23,1906,Bristol City,Preston North End,1-0,1,0,1,1,1,1,H
1907-03-23,1906,Liverpool,Newcastle United,4-1,4,1,1,1,5,3,H
1907-03-23,1906,Sheffield United,Manchester City,1-4,1,4,1,1,5,-3,A
1907-03-23,1906,Sunderland,Birmingham City,4-1,4,1,1,1,5,3,H
1907-03-25,1906,Manchester United,Sunderland,2-0,2,0,1,1,2,2,H
1907-03-27,1906,Bolton Wanderers,Arsenal,3-0,3,0,1,1,3,3,H
1907-03-29,1906,Arsenal,Sheffield Wednesday,1-0,1,0,1,1,1,1,H
1907-03-29,1906,Birmingham City,Manchester City,4-0,4,0,1,1,4,4,H
1907-03-29,1906,Blackburn Rovers,Sheffield United,1-1,1,1,1,1,2,0,D
1907-03-29,1906,Bolton Wanderers,Bristol City,1-2,1,2,1,1,3,-1,A
1907-03-29,1906,Everton,Liverpool,0-0,0,0,1,1,0,0,D
1907-03-29,1906,Newcastle United,Stoke City,1-0,1,0,1,1,1,1,H
1907-03-29,1906,Notts County,Derby County,4-0,4,0,1,1,4,4,H
1907-03-29,1906,Preston North End,Sunderland,2-0,2,0,1,1,2,2,H
1907-03-30,1906,Arsenal,Blackburn Rovers,2-0,2,0,1,1,2,2,H
1907-03-30,1906,Aston Villa,Liverpool,4-0,4,0,1,1,4,4,H
1907-03-30,1906,Bury,Manchester United,1-2,1,2,1,1,3,-1,A
1907-03-30,1906,Derby County,Birmingham City,1-1,1,1,1,1,2,0,D
1907-03-30,1906,Everton,Sunderland,4-1,4,1,1,1,5,3,H
1907-03-30,1906,Manchester City,Bolton Wanderers,1-1,1,1,1,1,2,0,D
1907-03-30,1906,Middlesbrough,Sheffield United,0-1,0,1,1,1,1,-1,A
1907-03-30,1906,Newcastle United,Bristol City,3-0,3,0,1,1,3,3,H
1907-03-30,1906,Preston North End,Notts County,0-0,0,0,1,1,0,0,D
1907-03-30,1906,Sheffield Wednesday,Stoke City,0-1,0,1,1,1,1,-1,A
1907-04-01,1906,Arsenal,Aston Villa,3-1,3,1,1,1,4,2,H
1907-04-01,1906,Bury,Preston North End,2-0,2,0,1,1,2,2,H
1907-04-01,1906,Derby County,Sheffield Wednesday,1-0,1,0,1,1,1,1,H
1907-04-01,1906,Liverpool,Manchester United,0-1,0,1,1,1,1,-1,A
1907-04-01,1906,Newcastle United,Blackburn Rovers,3-1,3,1,1,1,4,2,H
1907-04-01,1906,Notts County,Sheffield United,4-0,4,0,1,1,4,4,H
1907-04-01,1906,Sunderland,Middlesbrough,4-2,4,2,1,1,6,2,H
1907-04-02,1906,Bristol City,Bolton Wanderers,1-2,1,2,1,1,3,-1,A
1907-04-04,1906,Sheffield United,Sheffield Wednesday,2-1,2,1,1,1,3,1,H
1907-04-06,1906,Birmingham City,Everton,1-0,1,0,1,1,1,1,H
1907-04-06,1906,Blackburn Rovers,Sheffield Wednesday,0-2,0,2,1,1,2,-2,A
1907-04-06,1906,Bolton Wanderers,Middlesbrough,1-0,1,0,1,1,1,1,H
1907-04-06,1906,Bristol City,Aston Villa,2-4,2,4,1,1,6,-2,A
1907-04-06,1906,Liverpool,Derby County,2-0,2,0,1,1,2,2,H
1907-04-06,1906,Manchester United,Manchester City,1-1,1,1,1,1,2,0,D
1907-04-06,1906,Notts County,Newcastle United,1-0,1,0,1,1,1,1,H
1907-04-06,1906,Stoke City,Bury,3-1,3,1,1,1,4,2,H
1907-04-06,1906,Sunderland,Arsenal,2-3,2,3,1,1,5,-1,A
1907-04-08,1906,Blackburn Rovers,Everton,2-1,2,1,1,1,3,1,H
1907-04-10,1906,Everton,Arsenal,2-1,2,1,1,1,3,1,H
1907-04-10,1906,Manchester United,Sheffield Wednesday,5-0,5,0,1,1,5,5,H
1907-04-10,1906,Notts County,Middlesbrough,2-2,2,2,1,1,4,0,D
1907-04-13,1906,Arsenal,Birmingham City,2-1,2,1,1,1,3,1,H
1907-04-13,1906,Aston Villa,Notts County,0-0,0,0,1,1,0,0,D
1907-04-13,1906,Bury,Blackburn Rovers,0-0,0,0,1,1,0,0,D
1907-04-13,1906,Derby County,Everton,5-2,5,2,1,1,7,3,H
1907-04-13,1906,Liverpool,Bristol City,2-4,2,4,1,1,6,-2,A
1907-04-13,1906,Manchester City,Stoke City,2-2,2,2,1,1,4,0,D
1907-04-13,1906,Middlesbrough,Manchester United,2-0,2,0,1,1,2,2,H
1907-04-13,1906,Newcastle United,Sheffield United,0-0,0,0,1,1,0,0,D
1907-04-13,1906,Sheffield Wednesday,Sunderland,2-1,2,1,1,1,3,1,H
1907-04-15,1906,Stoke City,Arsenal,2-0,2,0,1,1,2,2,H
1907-04-17,1906,Liverpool,Middlesbrough,2-4,2,4,1,1,6,-2,A
1907-04-17,1906,Notts County,Arsenal,4-1,4,1,1,1,5,3,H
1907-04-20,1906,Blackburn Rovers,Manchester City,4-0,4,0,1,1,4,4,H
1907-04-20,1906,Bolton Wanderers,Newcastle United,4-2,4,2,1,1,6,2,H
1907-04-20,1906,Derby County,Bristol City,1-3,1,3,1,1,4,-2,A
1907-04-20,1906,Notts County,Liverpool,2-0,2,0,1,1,2,2,H
1907-04-20,1906,Sheffield United,Aston Villa,0-0,0,0,1,1,0,0,D
1907-04-20,1906,Stoke City,Middlesbrough,0-2,0,2,1,1,2,-2,A
1907-04-20,1906,Sunderland,Bury,3-5,3,5,1,1,8,-2,A
1907-04-22,1906,Manchester United,Everton,3-0,3,0,1,1,3,3,H
1907-04-24,1906,Bristol City,Sheffield Wednesday,2-0,2,0,1,1,2,2,H
1907-04-24,1906,Sunderland,Notts County,3-1,3,1,1,1,4,2,H
1907-04-25,1906,Birmingham City,Sheffield Wednesday,1-1,1,1,1,1,2,0,D
1907-04-27,1906,Arsenal,Derby County,3-2,3,2,1,1,5,1,H
1907-04-27,1906,Aston Villa,Bolton Wanderers,0-2,0,2,1,1,2,-2,A
1907-04-27,1906,Bristol City,Notts County,1-0,1,0,1,1,1,1,H
1907-04-27,1906,Bury,Birmingham City,1-0,1,0,1,1,1,1,H
1907-04-27,1906,Liverpool,Sheffield United,2-2,2,2,1,1,4,0,D
1907-04-27,1906,Manchester City,Sunderland,2-3,2,3,1,1,5,-1,A
1907-04-27,1906,Middlesbrough,Blackburn Rovers,0-1,0,1,1,1,1,-1,A
1907-04-27,1906,Preston North End,Stoke City,2-2,2,2,1,1,4,0,D
1907-04-27,1906,Sheffield Wednesday,Everton,1-1,1,1,1,1,2,0,D
1907-09-02,1907,Arsenal,Notts County,1-1,1,1,1,1,2,0,D
1907-09-02,1907,Aston Villa,Manchester United,1-4,1,4,1,1,5,-3,A
1907-09-02,1907,Blackburn Rovers,Bury,1-0,1,0,1,1,1,1,H
1907-09-02,1907,Bristol City,Everton,3-2,3,2,1,1,5,1,H
1907-09-02,1907,Nottingham Forest,Liverpool,3-1,3,1,1,1,4,2,H
1907-09-02,1907,Preston North End,Sheffield Wednesday,1-1,1,1,1,1,2,0,D
1907-09-02,1907,Sunderland,Manchester City,2-5,2,5,1,1,7,-3,A
1907-09-04,1907,Middlesbrough,Birmingham City,1-0,1,0,1,1,1,1,H
1907-09-04,1907,Newcastle United,Notts County,1-1,1,1,1,1,2,0,D
1907-09-07,1907,Arsenal,Bristol City,0-4,0,4,1,1,4,-4,A
1907-09-07,1907,Birmingham City,Preston North End,2-0,2,0,1,1,2,2,H
1907-09-07,1907,Blackburn Rovers,Aston Villa,2-0,2,0,1,1,2,2,H
1907-09-07,1907,Bolton Wanderers,Bury,3-6,3,6,1,1,9,-3,A
1907-09-07,1907,Chelsea,Sheffield United,2-4,2,4,1,1,6,-2,A
1907-09-07,1907,Everton,Manchester City,3-3,3,3,1,1,6,0,D
1907-09-07,1907,Manchester United,Liverpool,4-0,4,0,1,1,4,4,H
1907-09-07,1907,Nottingham Forest,Middlesbrough,0-3,0,3,1,1,3,-3,A
1907-09-07,1907,Sheffield Wednesday,Newcastle United,3-1,3,1,1,1,4,2,H
1907-09-07,1907,Sunderland,Notts County,4-3,4,3,1,1,7,1,H
1907-09-09,1907,Aston Villa,Sunderland,1-0,1,0,1,1,1,1,H
1907-09-09,1907,Bury,Arsenal,3-2,3,2,1,1,5,1,H
1907-09-09,1907,Everton,Preston North End,2-1,2,1,1,1,3,1,H
1907-09-09,1907,Manchester United,Middlesbrough,2-1,2,1,1,1,3,1,H
1907-09-14,1907,Aston Villa,Bolton Wanderers,2-0,2,0,1,1,2,2,H
1907-09-14,1907,Bristol City,Sheffield Wednesday,0-2,0,2,1,1,2,-2,A
1907-09-14,1907,Bury,Birmingham City,1-0,1,0,1,1,1,1,H
1907-09-14,1907,Liverpool,Blackburn Rovers,2-0,2,0,1,1,2,2,H
1907-09-14,1907,Manchester City,Sunderland,0-0,0,0,1,1,0,0,D
1907-09-14,1907,Middlesbrough,Manchester United,2-1,2,1,1,1,3,1,H
1907-09-14,1907,Newcastle United,Chelsea,1-0,1,0,1,1,1,1,H
1907-09-14,1907,Notts County,Arsenal,2-0,2,0,1,1,2,2,H
1907-09-14,1907,Preston North End,Everton,2-2,2,2,1,1,4,0,D
1907-09-14,1907,Sheffield United,Nottingham Forest,2-2,2,2,1,1,4,0,D
1907-09-16,1907,Birmingham City,Bury,0-1,0,1,1,1,1,-1,A
1907-09-16,1907,Sheffield United,Liverpool,0-0,0,0,1,1,0,0,D
1907-09-21,1907,Arsenal,Manchester City,2-1,2,1,1,1,3,1,H
1907-09-21,1907,Birmingham City,Aston Villa,2-3,2,3,1,1,5,-1,A
1907-09-21,1907,Blackburn Rovers,Middlesbrough,2-0,2,0,1,1,2,2,H
1907-09-21,1907,Bolton Wanderers,Liverpool,0-4,0,4,1,1,4,-4,A
1907-09-21,1907,Bristol City,Newcastle United,1-1,1,1,1,1,2,0,D
1907-09-21,1907,Everton,Bury,6-1,6,1,1,1,7,5,H
1907-09-21,1907,Manchester United,Sheffield United,2-1,2,1,1,1,3,1,H
1907-09-21,1907,Nottingham Forest,Chelsea,6-0,6,0,1,1,6,6,H
1907-09-21,1907,Sheffield Wednesday,Notts County,2-0,2,0,1,1,2,2,H
1907-09-21,1907,Sunderland,Preston North End,4-1,4,1,1,1,5,3,H
1907-09-23,1907,Chelsea,Newcastle United,2-0,2,0,1,1,2,2,H
1907-09-23,1907,Sheffield Wednesday,Bristol City,5-3,5,3,1,1,8,2,H
1907-09-28,1907,Aston Villa,Everton,0-2,0,2,1,1,2,-2,A
1907-09-28,1907,Bury,Sunderland,2-1,2,1,1,1,3,1,H
1907-09-28,1907,Chelsea,Manchester United,1-4,1,4,1,1,5,-3,A
1907-09-28,1907,Liverpool,Birmingham City,3-4,3,4,1,1,7,-1,A
1907-09-28,1907,Manchester City,Sheffield Wednesday,3-2,3,2,1,1,5,1,H
1907-09-28,1907,Middlesbrough,Bolton Wanderers,0-1,0,1,1,1,1,-1,A
1907-09-28,1907,Newcastle United,Nottingham Forest,3-0,3,0,1,1,3,3,H
1907-09-28,1907,Notts County,Bristol City,3-1,3,1,1,1,4,2,H
1907-09-28,1907,Preston North End,Arsenal,3-0,3,0,1,1,3,3,H
1907-09-28,1907,Sheffield United,Blackburn Rovers,4-2,4,2,1,1,6,2,H
1907-10-03,1907,Notts County,Bury,2-1,2,1,1,1,3,1,H
1907-10-05,1907,Arsenal,Bury,0-0,0,0,1,1,0,0,D
1907-10-05,1907,Birmingham City,Middlesbrough,1-4,1,4,1,1,5,-3,A
1907-10-05,1907,Blackburn Rovers,Chelsea,2-0,2,0,1,1,2,2,H
1907-10-05,1907,Bolton Wanderers,Sheffield United,1-1,1,1,1,1,2,0,D
1907-10-05,1907,Bristol City,Manchester City,2-1,2,1,1,1,3,1,H
1907-10-05,1907,Everton,Liverpool,2-4,2,4,1,1,6,-2,A
1907-10-05,1907,Manchester United,Nottingham Forest,4-0,4,0,1,1,4,4,H
1907-10-05,1907,Notts County,Newcastle United,0-1,0,1,1,1,1,-1,A
1907-10-05,1907,Sheffield Wednesday,Preston North End,1-0,1,0,1,1,1,1,H
1907-10-05,1907,Sunderland,Aston Villa,3-0,3,0,1,1,3,3,H
1907-10-12,1907,Aston Villa,Arsenal,0-1,0,1,1,1,1,-1,A
1907-10-12,1907,Bury,Sheffield Wednesday,0-2,0,2,1,1,2,-2,A
1907-10-12,1907,Chelsea,Bolton Wanderers,1-3,1,3,1,1,4,-2,A
1907-10-12,1907,Liverpool,Sunderland,1-0,1,0,1,1,1,1,H
1907-10-12,1907,Manchester City,Notts County,2-1,2,1,1,1,3,1,H
1907-10-12,1907,Middlesbrough,Everton,0-2,0,2,1,1,2,-2,A
1907-10-12,1907,Newcastle United,Manchester United,1-6,1,6,1,1,7,-5,A
1907-10-12,1907,Nottingham Forest,Blackburn Rovers,3-2,3,2,1,1,5,1,H
1907-10-12,1907,Preston North End,Bristol City,3-0,3,0,1,1,3,3,H
1907-10-12,1907,Sheffield United,Birmingham City,1-0,1,0,1,1,1,1,H
1907-10-19,1907,Arsenal,Liverpool,2-1,2,1,1,1,3,1,H
1907-10-19,1907,Birmingham City,Chelsea,1-1,1,1,1,1,2,0,D
1907-10-19,1907,Blackburn Rovers,Manchester United,1-5,1,5,1,1,6,-4,A
1907-10-19,1907,Bolton Wanderers,Nottingham Forest,1-0,1,0,1,1,1,1,H
1907-10-19,1907,Bristol City,Bury,1-1,1,1,1,1,2,0,D
1907-10-19,1907,Everton,Sheffield United,2-1,2,1,1,1,3,1,H
1907-10-19,1907,Manchester City,Newcastle United,1-0,1,0,1,1,1,1,H
1907-10-19,1907,Notts County,Preston North End,0-1,0,1,1,1,1,-1,A
1907-10-19,1907,Sheffield Wednesday,Aston Villa,2-3,2,3,1,1,5,-1,A
1907-10-19,1907,Sunderland,Middlesbrough,0-0,0,0,1,1,0,0,D
1907-10-26,1907,Aston Villa,Bristol City,4-4,4,4,1,1,8,0,D
1907-10-26,1907,Bury,Notts County,0-0,0,0,1,1,0,0,D
1907-10-26,1907,Chelsea,Everton,2-1,2,1,1,1,3,1,H
1907-10-26,1907,Liverpool,Sheffield Wednesday,3-0,3,0,1,1,3,3,H
1907-10-26,1907,Manchester United,Bolton Wanderers,2-1,2,1,1,1,3,1,H
1907-10-26,1907,Middlesbrough,Arsenal,0-0,0,0,1,1,0,0,D
1907-10-26,1907,Newcastle United,Blackburn Rovers,3-0,3,0,1,1,3,3,H
1907-10-26,1907,Nottingham Forest,Birmingham City,1-1,1,1,1,1,2,0,D
1907-10-26,1907,Preston North End,Manchester City,2-4,2,4,1,1,6,-2,A
1907-10-26,1907,Sheffield United,Sunderland,5-3,5,3,1,1,8,2,H
1907-11-02,1907,Arsenal,Sheffield United,5-1,5,1,1,1,6,4,H
1907-11-02,1907,Birmingham City,Manchester United,3-4,3,4,1,1,7,-1,A
1907-11-02,1907,Bolton Wanderers,Blackburn Rovers,3-1,3,1,1,1,4,2,H
1907-11-02,1907,Bristol City,Liverpool,2-0,2,0,1,1,2,2,H
1907-11-02,1907,Everton,Nottingham Forest,1-0,1,0,1,1,1,1,H
1907-11-02,1907,Manchester City,Bury,2-2,2,2,1,1,4,0,D
1907-11-02,1907,Notts County,Aston Villa,0-3,0,3,1,1,3,-3,A
1907-11-02,1907,Preston North End,Newcastle United,2-0,2,0,1,1,2,2,H
1907-11-02,1907,Sheffield Wednesday,Middlesbrough,3-2,3,2,1,1,5,1,H
1907-11-02,1907,Sunderland,Chelsea,3-0,3,0,1,1,3,3,H
1907-11-09,1907,Aston Villa,Manchester City,2-2,2,2,1,1,4,0,D
1907-11-09,1907,Blackburn Rovers,Birmingham City,1-0,1,0,1,1,1,1,H
1907-11-09,1907,Bury,Preston North End,5-1,5,1,1,1,6,4,H
1907-11-09,1907,Chelsea,Arsenal,2-1,2,1,1,1,3,1,H
1907-11-09,1907,Liverpool,Notts County,6-0,6,0,1,1,6,6,H
1907-11-09,1907,Manchester United,Everton,4-3,4,3,1,1,7,1,H
1907-11-09,1907,Middlesbrough,Bristol City,0-2,0,2,1,1,2,-2,A
1907-11-09,1907,Newcastle United,Bolton Wanderers,3-0,3,0,1,1,3,3,H
1907-11-09,1907,Nottingham Forest,Sunderland,4-1,4,1,1,1,5,3,H
1907-11-09,1907,Sheffield United,Sheffield Wednesday,1-3,1,3,1,1,4,-2,A
1907-11-16,1907,Arsenal,Nottingham Forest,3-1,3,1,1,1,4,2,H
1907-11-16,1907,Birmingham City,Bolton Wanderers,2-1,2,1,1,1,3,1,H
1907-11-16,1907,Bristol City,Sheffield United,3-2,3,2,1,1,5,1,H
1907-11-16,1907,Bury,Newcastle United,1-2,1,2,1,1,3,-1,A
1907-11-16,1907,Everton,Blackburn Rovers,4-1,4,1,1,1,5,3,H
1907-11-16,1907,Manchester City,Liverpool,1-1,1,1,1,1,2,0,D
1907-11-16,1907,Notts County,Middlesbrough,2-0,2,0,1,1,2,2,H
1907-11-16,1907,Preston North End,Aston Villa,3-0,3,0,1,1,3,3,H
1907-11-16,1907,Sheffield Wednesday,Chelsea,3-1,3,1,1,1,4,2,H
1907-11-16,1907,Sunderland,Manchester United,1-2,1,2,1,1,3,-1,A
1907-11-23,1907,Aston Villa,Bury,2-2,2,2,1,1,4,0,D
1907-11-23,1907,Blackburn Rovers,Sunderland,4-2,4,2,1,1,6,2,H
1907-11-23,1907,Bolton Wanderers,Everton,3-0,3,0,1,1,3,3,H
1907-11-23,1907,Chelsea,Bristol City,4-1,4,1,1,1,5,3,H
1907-11-23,1907,Liverpool,Preston North End,1-2,1,2,1,1,3,-1,A
1907-11-23,1907,Manchester United,Arsenal,4-2,4,2,1,1,6,2,H
1907-11-23,1907,Middlesbrough,Manchester City,2-0,2,0,1,1,2,2,H
1907-11-23,1907,Newcastle United,Birmingham City,8-0,8,0,1,1,8,8,H
1907-11-23,1907,Nottingham Forest,Sheffield Wednesday,2-2,2,2,1,1,4,0,D
1907-11-23,1907,Sheffield United,Notts County,0-1,0,1,1,1,1,-1,A
1907-11-30,1907,Arsenal,Blackburn Rovers,2-0,2,0,1,1,2,2,H
1907-11-30,1907,Aston Villa,Newcastle United,3-3,3,3,1,1,6,0,D
1907-11-30,1907,Bristol City,Nottingham Forest,3-0,3,0,1,1,3,3,H
1907-11-30,1907,Notts County,Chelsea,2-0,2,0,1,1,2,2,H
1907-11-30,1907,Preston North End,Middlesbrough,1-1,1,1,1,1,2,0,D
1907-11-30,1907,Sheffield Wednesday,Manchester United,2-0,2,0,1,1,2,2,H
1907-11-30,1907,Sunderland,Bolton Wanderers,1-2,1,2,1,1,3,-1,A
1907-12-02,1907,Chelsea,Blackburn Rovers,1-0,1,0,1,1,1,1,H
1907-12-07,1907,Birmingham City,Sunderland,0-2,0,2,1,1,2,-2,A
1907-12-07,1907,Blackburn Rovers,Sheffield Wednesday,2-0,2,0,1,1,2,2,H
1907-12-07,1907,Bolton Wanderers,Arsenal,3-1,3,1,1,1,4,2,H
1907-12-07,1907,Chelsea,Manchester City,2-2,2,2,1,1,4,0,D
1907-12-07,1907,Liverpool,Aston Villa,5-0,5,0,1,1,5,5,H
1907-12-07,1907,Manchester United,Bristol City,2-1,2,1,1,1,3,1,H
1907-12-07,1907,Middlesbrough,Bury,0-2,0,2,1,1,2,-2,A
1907-12-07,1907,Newcastle United,Everton,2-1,2,1,1,1,3,1,H
1907-12-07,1907,Nottingham Forest,Notts County,2-0,2,0,1,1,2,2,H
1907-12-07,1907,Sheffield United,Preston North End,2-0,2,0,1,1,2,2,H
1907-12-14,1907,Arsenal,Birmingham City,1-1,1,1,1,1,2,0,D
1907-12-14,1907,Aston Villa,Middlesbrough,6-0,6,0,1,1,6,6,H
1907-12-14,1907,Bristol City,Blackburn Rovers,2-2,2,2,1,1,4,0,D
1907-12-14,1907,Bury,Sheffield United,3-2,3,2,1,1,5,1,H
1907-12-14,1907,Liverpool,Newcastle United,1-5,1,5,1,1,6,-4,A
1907-12-14,1907,Manchester City,Nottingham Forest,4-2,4,2,1,1,6,2,H
1907-12-14,1907,Notts County,Manchester United,1-1,1,1,1,1,2,0,D
1907-12-14,1907,Preston North End,Chelsea,2-4,2,4,1,1,6,-2,A
1907-12-14,1907,Sheffield Wednesday,Bolton Wanderers,5-2,5,2,1,1,7,3,H
1907-12-14,1907,Sunderland,Everton,1-2,1,2,1,1,3,-1,A
1907-12-21,1907,Birmingham City,Sheffield Wednesday,2-1,2,1,1,1,3,1,H
1907-12-21,1907,Blackburn Rovers,Notts County,1-1,1,1,1,1,2,0,D
1907-12-21,1907,Bolton Wanderers,Bristol City,1-2,1,2,1,1,3,-1,A
1907-12-21,1907,Chelsea,Bury,3-4,3,4,1,1,7,-1,A
1907-12-21,1907,Everton,Arsenal,1-1,1,1,1,1,2,0,D
1907-12-21,1907,Manchester United,Manchester City,3-1,3,1,1,1,4,2,H
1907-12-21,1907,Middlesbrough,Liverpool,3-1,3,1,1,1,4,2,H
1907-12-21,1907,Nottingham Forest,Preston North End,2-2,2,2,1,1,4,0,D
1907-12-21,1907,Sheffield United,Aston Villa,1-1,1,1,1,1,2,0,D
1907-12-21,1907,Sunderland,Newcastle United,2-4,2,4,1,1,6,-2,A
1907-12-25,1907,Arsenal,Newcastle United,2-2,2,2,1,1,4,0,D
1907-12-25,1907,Aston Villa,Nottingham Forest,4-0,4,0,1,1,4,4,H
1907-12-25,1907,Birmingham City,Manchester City,2-1,2,1,1,1,3,1,H
1907-12-25,1907,Liverpool,Chelsea,1-4,1,4,1,1,5,-3,A
1907-12-25,1907,Manchester United,Bury,2-1,2,1,1,1,3,1,H
1907-12-25,1907,Notts County,Everton,2-1,2,1,1,1,3,1,H
1907-12-25,1907,Preston North End,Bolton Wanderers,2-0,2,0,1,1,2,2,H
1907-12-25,1907,Sheffield United,Middlesbrough,0-0,0,0,1,1,0,0,D
1907-12-25,1907,Sunderland,Bristol City,3-3,3,3,1,1,6,0,D
1907-12-26,1907,Birmingham City,Notts County,0-0,0,0,1,1,0,0,D
1907-12-26,1907,Chelsea,Middlesbrough,1-0,1,0,1,1,1,1,H
1907-12-26,1907,Everton,Bristol City,0-0,0,0,1,1,0,0,D
1907-12-26,1907,Manchester City,Bolton Wanderers,1-0,1,0,1,1,1,1,H
1907-12-26,1907,Newcastle United,Sheffield United,2-3,2,3,1,1,5,-1,A
1907-12-26,1907,Nottingham Forest,Aston Villa,2-2,2,2,1,1,4,0,D
1907-12-26,1907,Preston North End,Blackburn Rovers,1-1,1,1,1,1,2,0,D
1907-12-26,1907,Sheffield Wednesday,Sunderland,2-3,2,3,1,1,5,-1,A
1907-12-27,1907,Notts County,Birmingham City,0-0,0,0,1,1,0,0,D
1907-12-28,1907,Arsenal,Sunderland,4-0,4,0,1,1,4,4,H
1907-12-28,1907,Aston Villa,Chelsea,0-0,0,0,1,1,0,0,D
1907-12-28,1907,Bristol City,Birmingham City,0-0,0,0,1,1,0,0,D
1907-12-28,1907,Bury,Nottingham Forest,0-0,0,0,1,1,0,0,D
1907-12-28,1907,Liverpool,Sheffield United,3-0,3,0,1,1,3,3,H
1907-12-28,1907,Manchester City,Blackburn Rovers,2-0,2,0,1,1,2,2,H
1907-12-28,1907,Newcastle United,Middlesbrough,1-1,1,1,1,1,2,0,D
1907-12-28,1907,Notts County,Bolton Wanderers,0-1,0,1,1,1,1,-1,A
1907-12-28,1907,Preston North End,Manchester United,0-0,0,0,1,1,0,0,D
1907-12-28,1907,Sheffield Wednesday,Everton,1-2,1,2,1,1,3,-1,A
1907-12-30,1907,Sheffield United,Bolton Wanderers,1-0,1,0,1,1,1,1,H
1907-12-31,1907,Sheffield Wednesday,Arsenal,6-0,6,0,1,1,6,6,H
1908-01-01,1907,Blackburn Rovers,Preston North End,1-1,1,1,1,1,2,0,D
1908-01-01,1907,Bolton Wanderers,Manchester City,2-0,2,0,1,1,2,2,H
1908-01-01,1907,Bury,Manchester United,0-1,0,1,1,1,1,-1,A
1908-01-01,1907,Liverpool,Nottingham Forest,0-0,0,0,1,1,0,0,D
1908-01-01,1907,Middlesbrough,Chelsea,3-1,3,1,1,1,4,2,H
1908-01-01,1907,Sheffield United,Newcastle United,1-1,1,1,1,1,2,0,D
1908-01-01,1907,Sunderland,Arsenal,5-2,5,2,1,1,7,3,H
1908-01-02,1907,Bolton Wanderers,Preston North End,2-0,2,0,1,1,2,2,H
1908-01-04,1907,Aston Villa,Blackburn Rovers,1-1,1,1,1,1,2,0,D
1908-01-04,1907,Bristol City,Arsenal,1-2,1,2,1,1,3,-1,A
1908-01-04,1907,Bury,Bolton Wanderers,2-2,2,2,1,1,4,0,D
1908-01-04,1907,Manchester City,Everton,4-2,4,2,1,1,6,2,H
1908-01-04,1907,Middlesbrough,Nottingham Forest,1-1,1,1,1,1,2,0,D
1908-01-04,1907,Newcastle United,Sheffield Wednesday,2-1,2,1,1,1,3,1,H
1908-01-04,1907,Notts County,Sunderland,4-0,4,0,1,1,4,4,H
1908-01-04,1907,Preston North End,Birmingham City,1-1,1,1,1,1,2,0,D
1908-01-04,1907,Sheffield United,Chelsea,0-3,0,3,1,1,3,-3,A
1908-01-18,1907,Aston Villa,Birmingham City,2-3,2,3,1,1,5,-1,A
1908-01-18,1907,Bury,Everton,3-0,3,0,1,1,3,3,H
1908-01-18,1907,Chelsea,Nottingham Forest,0-4,0,4,1,1,4,-4,A
1908-01-18,1907,Liverpool,Bolton Wanderers,1-0,1,0,1,1,1,1,H
1908-01-18,1907,Manchester City,Arsenal,4-0,4,0,1,1,4,4,H
1908-01-18,1907,Middlesbrough,Blackburn Rovers,3-0,3,0,1,1,3,3,H
1908-01-18,1907,Newcastle United,Bristol City,2-0,2,0,1,1,2,2,H
1908-01-18,1907,Notts County,Sheffield Wednesday,1-2,1,2,1,1,3,-1,A
1908-01-18,1907,Preston North End,Sunderland,3-2,3,2,1,1,5,1,H
1908-01-18,1907,Sheffield United,Manchester United,2-0,2,0,1,1,2,2,H
1908-01-25,1907,Arsenal,Preston North End,1-1,1,1,1,1,2,0,D
1908-01-25,1907,Birmingham City,Liverpool,1-1,1,1,1,1,2,0,D
1908-01-25,1907,Blackburn Rovers,Sheffield United,3-3,3,3,1,1,6,0,D
1908-01-25,1907,Bolton Wanderers,Middlesbrough,1-1,1,1,1,1,2,0,D
1908-01-25,1907,Bristol City,Notts County,2-1,2,1,1,1,3,1,H
1908-01-25,1907,Everton,Aston Villa,1-0,1,0,1,1,1,1,H
1908-01-25,1907,Manchester United,Chelsea,1-0,1,0,1,1,1,1,H
1908-01-25,1907,Nottingham Forest,Newcastle United,0-0,0,0,1,1,0,0,D
1908-01-25,1907,Sheffield Wednesday,Manchester City,5-1,5,1,1,1,6,4,H
1908-01-25,1907,Sunderland,Bury,6-2,6,2,1,1,8,4,H
1908-02-01,1907,Middlesbrough,Sheffield United,2-0,2,0,1,1,2,2,H
1908-02-08,1907,Arsenal,Aston Villa,0-1,0,1,1,1,1,-1,A
1908-02-08,1907,Birmingham City,Sheffield United,0-0,0,0,1,1,0,0,D
1908-02-08,1907,Blackburn Rovers,Nottingham Forest,3-3,3,3,1,1,6,0,D
1908-02-08,1907,Bolton Wanderers,Chelsea,1-2,1,2,1,1,3,-1,A
1908-02-08,1907,Bristol City,Preston North End,1-3,1,3,1,1,4,-2,A
1908-02-08,1907,Everton,Middlesbrough,2-1,2,1,1,1,3,1,H
1908-02-08,1907,Manchester United,Newcastle United,1-1,1,1,1,1,2,0,D
1908-02-08,1907,Notts County,Manchester City,1-0,1,0,1,1,1,1,H
1908-02-08,1907,Sheffield Wednesday,Bury,2-0,2,0,1,1,2,2,H
1908-02-08,1907,Sunderland,Liverpool,1-0,1,0,1,1,1,1,H
1908-02-15,1907,Aston Villa,Sheffield Wednesday,5-0,5,0,1,1,5,5,H
1908-02-15,1907,Bury,Bristol City,1-1,1,1,1,1,2,0,D
1908-02-15,1907,Chelsea,Birmingham City,2-2,2,2,1,1,4,0,D
1908-02-15,1907,Liverpool,Arsenal,4-1,4,1,1,1,5,3,H
1908-02-15,1907,Manchester United,Blackburn Rovers,1-2,1,2,1,1,3,-1,A
1908-02-15,1907,Middlesbrough,Sunderland,3-1,3,1,1,1,4,2,H
1908-02-15,1907,Newcastle United,Manchester City,1-1,1,1,1,1,2,0,D
1908-02-15,1907,Nottingham Forest,Bolton Wanderers,1-0,1,0,1,1,1,1,H
1908-02-15,1907,Preston North End,Notts County,1-0,1,0,1,1,1,1,H
1908-02-15,1907,Sheffield United,Everton,2-0,2,0,1,1,2,2,H
1908-02-22,1907,Arsenal,Middlesbrough,4-1,4,1,1,1,5,3,H
1908-02-22,1907,Sunderland,Sheffield United,4-1,4,1,1,1,5,3,H
1908-02-29,1907,Blackburn Rovers,Bolton Wanderers,3-2,3,2,1,1,5,1,H
1908-02-29,1907,Bury,Manchester City,0-0,0,0,1,1,0,0,D
1908-02-29,1907,Chelsea,Sunderland,2-1,2,1,1,1,3,1,H
1908-02-29,1907,Liverpool,Bristol City,3-1,3,1,1,1,4,2,H
1908-02-29,1907,Manchester United,Birmingham City,1-0,1,0,1,1,1,1,H
1908-02-29,1907,Nottingham Forest,Everton,5-2,5,2,1,1,7,3,H
1908-02-29,1907,Sheffield United,Arsenal,2-2,2,2,1,1,4,0,D
1908-03-02,1907,Aston Villa,Notts County,5-1,5,1,1,1,6,4,H
1908-03-07,1907,Arsenal,Chelsea,0-0,0,0,1,1,0,0,D
1908-03-07,1907,Birmingham City,Blackburn Rovers,1-1,1,1,1,1,2,0,D
1908-03-07,1907,Bristol City,Middlesbrough,0-1,0,1,1,1,1,-1,A
1908-03-07,1907,Manchester City,Aston Villa,3-2,3,2,1,1,5,1,H
1908-03-07,1907,Notts County,Liverpool,2-2,2,2,1,1,4,0,D
1908-03-07,1907,Preston North End,Bury,3-1,3,1,1,1,4,2,H
1908-03-07,1907,Sheffield Wednesday,Sheffield United,2-0,2,0,1,1,2,2,H
1908-03-07,1907,Sunderland,Nottingham Forest,7-2,7,2,1,1,9,5,H
1908-03-09,1907,Sheffield Wednesday,Liverpool,1-2,1,2,1,1,3,-1,A
1908-03-11,1907,Bristol City,Aston Villa,2-2,2,2,1,1,4,0,D
1908-03-11,1907,Manchester City,Sheffield United,0-2,0,2,1,1,2,-2,A
1908-03-11,1907,Newcastle United,Preston North End,0-0,0,0,1,1,0,0,D
1908-03-14,1907,Aston Villa,Preston North End,3-0,3,0,1,1,3,3,H
1908-03-14,1907,Blackburn Rovers,Everton,2-0,2,0,1,1,2,2,H
1908-03-14,1907,Bolton Wanderers,Birmingham City,1-0,1,0,1,1,1,1,H
1908-03-14,1907,Chelsea,Sheffield Wednesday,3-1,3,1,1,1,4,2,H
1908-03-14,1907,Liverpool,Manchester City,0-1,0,1,1,1,1,-1,A
1908-03-14,1907,Manchester United,Sunderland,3-0,3,0,1,1,3,3,H
1908-03-14,1907,Middlesbrough,Notts County,3-1,3,1,1,1,4,2,H
1908-03-14,1907,Newcastle United,Bury,3-0,3,0,1,1,3,3,H
1908-03-14,1907,Nottingham Forest,Arsenal,1-0,1,0,1,1,1,1,H
1908-03-14,1907,Sheffield United,Bristol City,2-0,2,0,1,1,2,2,H
1908-03-18,1907,Everton,Birmingham City,4-1,4,1,1,1,5,3,H
1908-03-21,1907,Arsenal,Manchester United,1-0,1,0,1,1,1,1,H
1908-03-21,1907,Birmingham City,Newcastle United,1-1,1,1,1,1,2,0,D
1908-03-21,1907,Bristol City,Chelsea,0-0,0,0,1,1,0,0,D
1908-03-21,1907,Bury,Aston Villa,2-1,2,1,1,1,3,1,H
1908-03-21,1907,Everton,Bolton Wanderers,2-1,2,1,1,1,3,1,H
1908-03-21,1907,Manchester City,Middlesbrough,2-1,2,1,1,1,3,1,H
1908-03-21,1907,Notts County,Sheffield United,0-3,0,3,1,1,3,-3,A
1908-03-21,1907,Preston North End,Liverpool,3-0,3,0,1,1,3,3,H
1908-03-21,1907,Sheffield Wednesday,Nottingham Forest,2-1,2,1,1,1,3,1,H
1908-03-21,1907,Sunderland,Blackburn Rovers,4-0,4,0,1,1,4,4,H
1908-03-23,1907,Blackburn Rovers,Newcastle United,1-1,1,1,1,1,2,0,D
1908-03-25,1907,Liverpool,Manchester United,7-4,7,4,1,1,11,3,H
1908-03-28,1907,Birmingham City,Everton,2-1,2,1,1,1,3,1,H
1908-03-28,1907,Blackburn Rovers,Arsenal,1-1,1,1,1,1,2,0,D
1908-03-28,1907,Bolton Wanderers,Sunderland,2-3,2,3,1,1,5,-1,A
1908-03-28,1907,Bury,Liverpool,3-1,3,1,1,1,4,2,H
1908-03-28,1907,Manchester United,Sheffield Wednesday,4-1,4,1,1,1,5,3,H
1908-03-28,1907,Middlesbrough,Preston North End,1-0,1,0,1,1,1,1,H
1908-03-28,1907,Nottingham Forest,Bristol City,3-1,3,1,1,1,4,2,H
1908-03-28,1907,Sheffield United,Manchester City,1-2,1,2,1,1,3,-1,A
1908-03-30,1907,Birmingham City,Nottingham Forest,1-0,1,0,1,1,1,1,H
1908-04-01,1907,Bolton Wanderers,Newcastle United,4-0,4,0,1,1,4,4,H
1908-04-01,1907,Everton,Chelsea,0-3,0,3,1,1,3,-3,A
1908-04-04,1907,Arsenal,Bolton Wanderers,1-1,1,1,1,1,2,0,D
1908-04-04,1907,Aston Villa,Liverpool,5-1,5,1,1,1,6,4,H
1908-04-04,1907,Bristol City,Manchester United,1-1,1,1,1,1,2,0,D
1908-04-04,1907,Bury,Middlesbrough,1-4,1,4,1,1,5,-3,A
1908-04-04,1907,Everton,Newcastle United,2-0,2,0,1,1,2,2,H
1908-04-04,1907,Manchester City,Chelsea,0-3,0,3,1,1,3,-3,A
1908-04-04,1907,Notts County,Nottingham Forest,2-0,2,0,1,1,2,2,H
1908-04-04,1907,Preston North End,Sheffield United,0-0,0,0,1,1,0,0,D
1908-04-04,1907,Sheffield Wednesday,Blackburn Rovers,2-0,2,0,1,1,2,2,H
1908-04-04,1907,Sunderland,Birmingham City,1-0,1,0,1,1,1,1,H
1908-04-06,1907,Blackburn Rovers,Liverpool,1-3,1,3,1,1,4,-2,A
1908-04-06,1907,Manchester City,Preston North End,5-0,5,0,1,1,5,5,H
1908-04-08,1907,Everton,Manchester United,1-3,1,3,1,1,4,-2,A
1908-04-08,1907,Middlesbrough,Sheffield Wednesday,6-1,6,1,1,1,7,5,H
1908-04-08,1907,Newcastle United,Aston Villa,2-5,2,5,1,1,7,-3,A
1908-04-11,1907,Birmingham City,Arsenal,1-2,1,2,1,1,3,-1,A
1908-04-11,1907,Blackburn Rovers,Bristol City,4-1,4,1,1,1,5,3,H
1908-04-11,1907,Bolton Wanderers,Sheffield Wednesday,2-1,2,1,1,1,3,1,H
1908-04-11,1907,Chelsea,Preston North End,0-0,0,0,1,1,0,0,D
1908-04-11,1907,Everton,Sunderland,0-3,0,3,1,1,3,-3,A
1908-04-11,1907,Manchester United,Notts County,0-1,0,1,1,1,1,-1,A
1908-04-11,1907,Middlesbrough,Aston Villa,0-1,0,1,1,1,1,-1,A
1908-04-11,1907,Newcastle United,Liverpool,3-1,3,1,1,1,4,2,H
1908-04-11,1907,Nottingham Forest,Manchester City,3-1,3,1,1,1,4,2,H
1908-04-11,1907,Sheffield United,Bury,0-2,0,2,1,1,2,-2,A
1908-04-17,1907,Bolton Wanderers,Aston Villa,3-1,3,1,1,1,4,2,H
1908-04-17,1907,Bury,Blackburn Rovers,1-1,1,1,1,1,2,0,D
1908-04-17,1907,Liverpool,Everton,0-0,0,0,1,1,0,0,D
1908-04-17,1907,Manchester City,Birmingham City,2-1,2,1,1,1,3,1,H
1908-04-17,1907,Newcastle United,Arsenal,2-1,2,1,1,1,3,1,H
1908-04-17,1907,Nottingham Forest,Manchester United,2-0,2,0,1,1,2,2,H
1908-04-17,1907,Sunderland,Sheffield Wednesday,1-2,1,2,1,1,3,-1,A
1908-04-18,1907,Arsenal,Everton,2-1,2,1,1,1,3,1,H
1908-04-18,1907,Aston Villa,Sheffield United,1-0,1,0,1,1,1,1,H
1908-04-18,1907,Bristol City,Bolton Wanderers,2-0,2,0,1,1,2,2,H
1908-04-18,1907,Bury,Chelsea,1-1,1,1,1,1,2,0,D
1908-04-18,1907,Liverpool,Middlesbrough,0-1,0,1,1,1,1,-1,A
1908-04-18,1907,Manchester City,Manchester United,0-0,0,0,1,1,0,0,D
1908-04-18,1907,Newcastle United,Sunderland,1-3,1,3,1,1,4,-2,A
1908-04-18,1907,Notts County,Blackburn Rovers,0-2,0,2,1,1,2,-2,A
1908-04-18,1907,Preston North End,Nottingham Forest,0-1,0,1,1,1,1,-1,A
1908-04-18,1907,Sheffield Wednesday,Birmingham City,1-4,1,4,1,1,5,-3,A
1908-04-20,1907,Arsenal,Sheffield Wednesday,1-1,1,1,1,1,2,0,D
1908-04-20,1907,Bristol City,Sunderland,3-0,3,0,1,1,3,3,H
1908-04-20,1907,Chelsea,Liverpool,0-2,0,2,1,1,2,-2,A
1908-04-20,1907,Everton,Notts County,1-0,1,0,1,1,1,1,H
1908-04-20,1907,Manchester United,Aston Villa,1-2,1,2,1,1,3,-1,A
1908-04-20,1907,Middlesbrough,Newcastle United,2-1,2,1,1,1,3,1,H
1908-04-20,1907,Nottingham Forest,Sheffield United,1-1,1,1,1,1,2,0,D
1908-04-21,1907,Manchester City,Bristol City,0-0,0,0,1,1,0,0,D
1908-04-22,1907,Bolton Wanderers,Manchester United,2-2,2,2,1,1,4,0,D
1908-04-25,1907,Birmingham City,Bristol City,0-4,0,4,1,1,4,-4,A
1908-04-25,1907,Blackburn Rovers,Manchester City,0-0,0,0,1,1,0,0,D
1908-04-25,1907,Bolton Wanderers,Notts County,0-1,0,1,1,1,1,-1,A
1908-04-25,1907,Chelsea,Aston Villa,1-3,1,3,1,1,4,-2,A
1908-04-25,1907,Everton,Sheffield Wednesday,0-0,0,0,1,1,0,0,D
1908-04-25,1907,Manchester United,Preston North End,2-1,2,1,1,1,3,1,H
1908-04-25,1907,Nottingham Forest,Bury,1-2,1,2,1,1,3,-1,A
1908-04-27,1907,Liverpool,Bury,2-1,2,1,1,1,3,1,H
1908-04-29,1907,Chelsea,Notts County,1-2,1,2,1,1,3,-1,A
1908-09-01,1908,Blackburn Rovers,Bristol City,1-1,1,1,1,1,2,0,D
1908-09-01,1908,Bury,Sheffield United,1-2,1,2,1,1,3,-1,A
1908-09-01,1908,Chelsea,Preston North End,0-0,0,0,1,1,0,0,D
1908-09-01,1908,Leicester City,Sheffield Wednesday,1-1,1,1,1,1,2,0,D
1908-09-01,1908,Liverpool,Aston Villa,3-2,3,2,1,1,5,1,H
1908-09-01,1908,Manchester City,Sunderland,1-0,1,0,1,1,1,1,H
1908-09-02,1908,Arsenal,Everton,0-4,0,4,1,1,4,-4,A
1908-09-02,1908,Newcastle United,Bradford City,1-0,1,0,1,1,1,1,H
1908-09-05,1908,Aston Villa,Sheffield Wednesday,1-1,1,1,1,1,2,0,D
1908-09-05,1908,Bristol City,Everton,0-2,0,2,1,1,2,-2,A
1908-09-05,1908,Bury,Sunderland,4-2,4,2,1,1,6,2,H
1908-09-05,1908,Liverpool,Chelsea,2-1,2,1,1,1,3,1,H
1908-09-05,1908,Manchester City,Blackburn Rovers,3-3,3,3,1,1,6,0,D
1908-09-05,1908,Middlesbrough,Bradford City,1-0,1,0,1,1,1,1,H
1908-09-05,1908,Newcastle United,Leicester City,2-0,2,0,1,1,2,2,H
1908-09-05,1908,Notts County,Arsenal,2-1,2,1,1,1,3,1,H
1908-09-05,1908,Preston North End,Manchester United,0-3,0,3,1,1,3,-3,A
1908-09-05,1908,Sheffield United,Nottingham Forest,1-2,1,2,1,1,3,-1,A
1908-09-07,1908,Everton,Arsenal,0-3,0,3,1,1,3,-3,A
1908-09-07,1908,Manchester United,Bury,2-1,2,1,1,1,3,1,H
1908-09-07,1908,Preston North End,Chelsea,6-0,6,0,1,1,6,6,H
1908-09-09,1908,Middlesbrough,Sunderland,0-3,0,3,1,1,3,-3,A
1908-09-09,1908,Newcastle United,Bristol City,2-1,2,1,1,1,3,1,H
1908-09-12,1908,Arsenal,Newcastle United,1-2,1,2,1,1,3,-1,A
1908-09-12,1908,Blackburn Rovers,Liverpool,1-0,1,0,1,1,1,1,H
1908-09-12,1908,Bradford City,Manchester City,0-0,0,0,1,1,0,0,D
1908-09-12,1908,Chelsea,Bury,4-1,4,1,1,1,5,3,H
1908-09-12,1908,Everton,Preston North End,0-1,0,1,1,1,1,-1,A
1908-09-12,1908,Leicester City,Bristol City,1-1,1,1,1,1,2,0,D
1908-09-12,1908,Manchester United,Middlesbrough,6-3,6,3,1,1,9,3,H
1908-09-12,1908,Nottingham Forest,Aston Villa,1-2,1,2,1,1,3,-1,A
1908-09-12,1908,Sheffield Wednesday,Notts County,2-0,2,0,1,1,2,2,H
1908-09-12,1908,Sunderland,Sheffield United,3-1,3,1,1,1,4,2,H
1908-09-14,1908,Sheffield United,Liverpool,0-2,0,2,1,1,2,-2,A
1908-09-19,1908,Aston Villa,Sunderland,2-0,2,0,1,1,2,2,H
1908-09-19,1908,Bristol City,Arsenal,2-1,2,1,1,1,3,1,H
1908-09-19,1908,Bury,Blackburn Rovers,1-1,1,1,1,1,2,0,D
1908-09-19,1908,Liverpool,Bradford City,4-0,4,0,1,1,4,4,H
1908-09-19,1908,Manchester City,Manchester United,1-2,1,2,1,1,3,-1,A
1908-09-19,1908,Middlesbrough,Everton,2-3,2,3,1,1,5,-1,A
1908-09-19,1908,Newcastle United,Notts County,1-0,1,0,1,1,1,1,H
1908-09-19,1908,Nottingham Forest,Sheffield Wednesday,1-2,1,2,1,1,3,-1,A
1908-09-19,1908,Preston North End,Leicester City,0-1,0,1,1,1,1,-1,A
1908-09-19,1908,Sheffield United,Chelsea,1-3,1,3,1,1,4,-2,A
1908-09-21,1908,Chelsea,Nottingham Forest,2-1,2,1,1,1,3,1,H
1908-09-26,1908,Arsenal,Preston North End,1-0,1,0,1,1,1,1,H
1908-09-26,1908,Blackburn Rovers,Sheffield United,0-1,0,1,1,1,1,-1,A
1908-09-26,1908,Bradford City,Bury,4-1,4,1,1,1,5,3,H
1908-09-26,1908,Chelsea,Aston Villa,0-2,0,2,1,1,2,-2,A
1908-09-26,1908,Everton,Manchester City,6-3,6,3,1,1,9,3,H
1908-09-26,1908,Leicester City,Middlesbrough,1-1,1,1,1,1,2,0,D
1908-09-26,1908,Manchester United,Liverpool,3-2,3,2,1,1,5,1,H
1908-09-26,1908,Notts County,Bristol City,0-1,0,1,1,1,1,-1,A
1908-09-26,1908,Sheffield Wednesday,Newcastle United,2-0,2,0,1,1,2,2,H
1908-09-26,1908,Sunderland,Nottingham Forest,2-1,2,1,1,1,3,1,H
1908-10-01,1908,Nottingham Forest,Liverpool,5-1,5,1,1,1,6,4,H
1908-10-03,1908,Aston Villa,Blackburn Rovers,1-1,1,1,1,1,2,0,D
1908-10-03,1908,Bristol City,Newcastle United,3-3,3,3,1,1,6,0,D
1908-10-03,1908,Bury,Manchester United,2-2,2,2,1,1,4,0,D
1908-10-03,1908,Liverpool,Everton,0-1,0,1,1,1,1,-1,A
1908-10-03,1908,Manchester City,Leicester City,5-2,5,2,1,1,7,3,H
1908-10-03,1908,Middlesbrough,Arsenal,1-1,1,1,1,1,2,0,D
1908-10-03,1908,Nottingham Forest,Chelsea,2-1,2,1,1,1,3,1,H
1908-10-03,1908,Preston North End,Notts County,0-0,0,0,1,1,0,0,D
1908-10-03,1908,Sheffield United,Bradford City,3-0,3,0,1,1,3,3,H
1908-10-03,1908,Sunderland,Sheffield Wednesday,4-2,4,2,1,1,6,2,H
1908-10-10,1908,Arsenal,Manchester City,3-0,3,0,1,1,3,3,H
1908-10-10,1908,Blackburn Rovers,Nottingham Forest,0-3,0,3,1,1,3,-3,A
1908-10-10,1908,Bradford City,Aston Villa,1-1,1,1,1,1,2,0,D
1908-10-10,1908,Chelsea,Sunderland,2-0,2,0,1,1,2,2,H
1908-10-10,1908,Everton,Bury,4-0,4,0,1,1,4,4,H
1908-10-10,1908,Leicester City,Liverpool,3-2,3,2,1,1,5,1,H
1908-10-10,1908,Manchester United,Sheffield United,2-1,2,1,1,1,3,1,H
1908-10-10,1908,Newcastle United,Preston North End,2-0,2,0,1,1,2,2,H
1908-10-10,1908,Notts County,Middlesbrough,3-2,3,2,1,1,5,1,H
1908-10-10,1908,Sheffield Wednesday,Bristol City,2-0,2,0,1,1,2,2,H
1908-10-17,1908,Aston Villa,Manchester United,3-1,3,1,1,1,4,2,H
1908-10-17,1908,Bury,Leicester City,2-2,2,2,1,1,4,0,D
1908-10-17,1908,Chelsea,Sheffield Wednesday,2-2,2,2,1,1,4,0,D
1908-10-17,1908,Liverpool,Arsenal,2-2,2,2,1,1,4,0,D
1908-10-17,1908,Manchester City,Notts County,1-0,1,0,1,1,1,1,H
1908-10-17,1908,Middlesbrough,Newcastle United,0-0,0,0,1,1,0,0,D
1908-10-17,1908,Nottingham Forest,Bradford City,2-1,2,1,1,1,3,1,H
1908-10-17,1908,Preston North End,Bristol City,2-1,2,1,1,1,3,1,H
1908-10-17,1908,Sheffield United,Everton,1-5,1,5,1,1,6,-4,A
1908-10-17,1908,Sunderland,Blackburn Rovers,0-1,0,1,1,1,1,-1,A
1908-10-24,1908,Arsenal,Bury,4-0,4,0,1,1,4,4,H
1908-10-24,1908,Blackburn Rovers,Chelsea,2-0,2,0,1,1,2,2,H
1908-10-24,1908,Bradford City,Sunderland,0-2,0,2,1,1,2,-2,A
1908-10-24,1908,Bristol City,Middlesbrough,1-1,1,1,1,1,2,0,D
1908-10-24,1908,Everton,Aston Villa,3-1,3,1,1,1,4,2,H
1908-10-24,1908,Leicester City,Sheffield United,1-1,1,1,1,1,2,0,D
1908-10-24,1908,Manchester United,Nottingham Forest,2-2,2,2,1,1,4,0,D
1908-10-24,1908,Newcastle United,Manchester City,2-0,2,0,1,1,2,2,H
1908-10-24,1908,Notts County,Liverpool,1-2,1,2,1,1,3,-1,A
1908-10-24,1908,Sheffield Wednesday,Preston North End,1-0,1,0,1,1,1,1,H
1908-10-31,1908,Aston Villa,Leicester City,1-1,1,1,1,1,2,0,D
1908-10-31,1908,Blackburn Rovers,Sheffield Wednesday,2-2,2,2,1,1,4,0,D
1908-10-31,1908,Bury,Notts County,3-1,3,1,1,1,4,2,H
1908-10-31,1908,Chelsea,Bradford City,1-1,1,1,1,1,2,0,D
1908-10-31,1908,Liverpool,Newcastle United,2-1,2,1,1,1,3,1,H
1908-10-31,1908,Manchester City,Bristol City,5-1,5,1,1,1,6,4,H
1908-10-31,1908,Middlesbrough,Preston North End,4-2,4,2,1,1,6,2,H
1908-10-31,1908,Nottingham Forest,Everton,1-2,1,2,1,1,3,-1,A
1908-10-31,1908,Sheffield United,Arsenal,1-1,1,1,1,1,2,0,D
1908-10-31,1908,Sunderland,Manchester United,6-1,6,1,1,1,7,5,H
1908-11-07,1908,Arsenal,Aston Villa,0-1,0,1,1,1,1,-1,A
1908-11-07,1908,Bradford City,Blackburn Rovers,0-2,0,2,1,1,2,-2,A
1908-11-07,1908,Bristol City,Liverpool,1-0,1,0,1,1,1,1,H
1908-11-07,1908,Everton,Sunderland,4-0,4,0,1,1,4,4,H
1908-11-07,1908,Leicester City,Nottingham Forest,0-3,0,3,1,1,3,-3,A
1908-11-07,1908,Manchester United,Chelsea,0-1,0,1,1,1,1,-1,A
1908-11-07,1908,Newcastle United,Bury,3-1,3,1,1,1,4,2,H
1908-11-07,1908,Notts County,Sheffield United,3-1,3,1,1,1,4,2,H
1908-11-07,1908,Preston North End,Manchester City,3-0,3,0,1,1,3,3,H
1908-11-07,1908,Sheffield Wednesday,Middlesbrough,3-2,3,2,1,1,5,1,H
1908-11-14,1908,Aston Villa,Notts County,1-1,1,1,1,1,2,0,D
1908-11-14,1908,Blackburn Rovers,Manchester United,1-3,1,3,1,1,4,-2,A
1908-11-14,1908,Bradford City,Sheffield Wednesday,0-0,0,0,1,1,0,0,D
1908-11-14,1908,Bury,Bristol City,1-2,1,2,1,1,3,-1,A
1908-11-14,1908,Chelsea,Everton,3-3,3,3,1,1,6,0,D
1908-11-14,1908,Liverpool,Preston North End,2-1,2,1,1,1,3,1,H
1908-11-14,1908,Manchester City,Middlesbrough,0-0,0,0,1,1,0,0,D
1908-11-14,1908,Nottingham Forest,Arsenal,0-1,0,1,1,1,1,-1,A
1908-11-14,1908,Sheffield United,Newcastle United,1-1,1,1,1,1,2,0,D
1908-11-14,1908,Sunderland,Leicester City,3-1,3,1,1,1,4,2,H
1908-11-21,1908,Arsenal,Sunderland,0-4,0,4,1,1,4,-4,A
1908-11-21,1908,Bristol City,Sheffield United,1-1,1,1,1,1,2,0,D
1908-11-21,1908,Everton,Blackburn Rovers,4-4,4,4,1,1,8,0,D
1908-11-21,1908,Leicester City,Chelsea,5-2,5,2,1,1,7,3,H
1908-11-21,1908,Manchester United,Bradford City,2-0,2,0,1,1,2,2,H
1908-11-21,1908,Middlesbrough,Liverpool,1-0,1,0,1,1,1,1,H
1908-11-21,1908,Newcastle United,Aston Villa,0-2,0,2,1,1,2,-2,A
1908-11-21,1908,Notts County,Nottingham Forest,3-0,3,0,1,1,3,3,H
1908-11-21,1908,Preston North End,Bury,0-2,0,2,1,1,2,-2,A
1908-11-21,1908,Sheffield Wednesday,Manchester City,3-1,3,1,1,1,4,2,H
1908-11-28,1908,Aston Villa,Bristol City,1-1,1,1,1,1,2,0,D
1908-11-28,1908,Blackburn Rovers,Leicester City,3-0,3,0,1,1,3,3,H
1908-11-28,1908,Bradford City,Everton,1-1,1,1,1,1,2,0,D
1908-11-28,1908,Bury,Middlesbrough,2-1,2,1,1,1,3,1,H
1908-11-28,1908,Chelsea,Arsenal,1-2,1,2,1,1,3,-1,A
1908-11-28,1908,Liverpool,Manchester City,1-3,1,3,1,1,4,-2,A
1908-11-28,1908,Manchester United,Sheffield Wednesday,3-1,3,1,1,1,4,2,H
1908-11-28,1908,Nottingham Forest,Newcastle United,0-4,0,4,1,1,4,-4,A
1908-11-28,1908,Sheffield United,Preston North End,2-1,2,1,1,1,3,1,H
1908-11-28,1908,Sunderland,Notts County,0-1,0,1,1,1,1,-1,A
1908-12-05,1908,Arsenal,Blackburn Rovers,0-1,0,1,1,1,1,-1,A
1908-12-05,1908,Bristol City,Nottingham Forest,2-1,2,1,1,1,3,1,H
1908-12-05,1908,Everton,Manchester United,3-2,3,2,1,1,5,1,H
1908-12-05,1908,Leicester City,Bradford City,1-4,1,4,1,1,5,-3,A
1908-12-05,1908,Manchester City,Bury,6-1,6,1,1,1,7,5,H
1908-12-05,1908,Middlesbrough,Sheffield United,1-2,1,2,1,1,3,-1,A
1908-12-05,1908,Newcastle United,Sunderland,1-9,1,9,1,1,10,-8,A
1908-12-05,1908,Notts County,Chelsea,3-0,3,0,1,1,3,3,H
1908-12-05,1908,Preston North End,Aston Villa,3-2,3,2,1,1,5,1,H
1908-12-05,1908,Sheffield Wednesday,Liverpool,2-3,2,3,1,1,5,-1,A
1908-12-12,1908,Aston Villa,Middlesbrough,0-3,0,3,1,1,3,-3,A
1908-12-12,1908,Blackburn Rovers,Notts County,0-2,0,2,1,1,2,-2,A
1908-12-12,1908,Bradford City,Arsenal,4-1,4,1,1,1,5,3,H
1908-12-12,1908,Bury,Liverpool,2-1,2,1,1,1,3,1,H
1908-12-12,1908,Chelsea,Newcastle United,1-2,1,2,1,1,3,-1,A
1908-12-12,1908,Everton,Sheffield Wednesday,1-0,1,0,1,1,1,1,H
1908-12-12,1908,Manchester United,Leicester City,4-2,4,2,1,1,6,2,H
1908-12-12,1908,Nottingham Forest,Preston North End,1-1,1,1,1,1,2,0,D
1908-12-12,1908,Sheffield United,Manchester City,4-0,4,0,1,1,4,4,H
1908-12-12,1908,Sunderland,Bristol City,0-2,0,2,1,1,2,-2,A
1908-12-19,1908,Arsenal,Manchester United,0-1,0,1,1,1,1,-1,A
1908-12-19,1908,Bristol City,Chelsea,1-0,1,0,1,1,1,1,H
1908-12-19,1908,Leicester City,Everton,0-2,0,2,1,1,2,-2,A
1908-12-19,1908,Liverpool,Sheffield United,2-1,2,1,1,1,3,1,H
1908-12-19,1908,Manchester City,Aston Villa,2-0,2,0,1,1,2,2,H
1908-12-19,1908,Middlesbrough,Nottingham Forest,4-0,4,0,1,1,4,4,H
1908-12-19,1908,Newcastle United,Blackburn Rovers,2-0,2,0,1,1,2,2,H
1908-12-19,1908,Notts County,Bradford City,1-1,1,1,1,1,2,0,D
1908-12-19,1908,Preston North End,Sunderland,1-0,1,0,1,1,1,1,H
1908-12-19,1908,Sheffield Wednesday,Bury,4-3,4,3,1,1,7,1,H
1908-12-25,1908,Aston Villa,Liverpool,1-1,1,1,1,1,2,0,D
1908-12-25,1908,Blackburn Rovers,Middlesbrough,0-0,0,0,1,1,0,0,D
1908-12-25,1908,Bradford City,Bristol City,0-1,0,1,1,1,1,-1,A
1908-12-25,1908,Bury,Nottingham Forest,3-2,3,2,1,1,5,1,H
1908-12-25,1908,Everton,Notts County,0-1,0,1,1,1,1,-1,A
1908-12-25,1908,Leicester City,Arsenal,1-1,1,1,1,1,2,0,D
1908-12-25,1908,Manchester City,Chelsea,1-2,1,2,1,1,3,-1,A
1908-12-25,1908,Newcastle United,Manchester United,2-1,2,1,1,1,3,1,H
1908-12-25,1908,Sheffield Wednesday,Sheffield United,1-0,1,0,1,1,1,1,H
1908-12-26,1908,Arsenal,Leicester City,2-1,2,1,1,1,3,1,H
1908-12-26,1908,Aston Villa,Bury,3-0,3,0,1,1,3,3,H
1908-12-26,1908,Bristol City,Bradford City,0-1,0,1,1,1,1,-1,A
1908-12-26,1908,Chelsea,Manchester City,1-2,1,2,1,1,3,-1,A
1908-12-26,1908,Liverpool,Nottingham Forest,1-1,1,1,1,1,2,0,D
1908-12-26,1908,Manchester United,Newcastle United,1-0,1,0,1,1,1,1,H
1908-12-26,1908,Notts County,Everton,0-0,0,0,1,1,0,0,D
1908-12-26,1908,Preston North End,Blackburn Rovers,2-0,2,0,1,1,2,2,H
1908-12-26,1908,Sheffield United,Sheffield Wednesday,2-1,2,1,1,1,3,1,H
1908-12-26,1908,Sunderland,Middlesbrough,2-0,2,0,1,1,2,2,H
1908-12-28,1908,Nottingham Forest,Manchester City,0-2,0,2,1,1,2,-2,A
1908-12-28,1908,Sheffield Wednesday,Arsenal,6-2,6,2,1,1,8,4,H
1909-01-01,1908,Blackburn Rovers,Preston North End,1-1,1,1,1,1,2,0,D
1909-01-01,1908,Bury,Aston Villa,1-2,1,2,1,1,3,-1,A
1909-01-01,1908,Everton,Newcastle United,0-1,0,1,1,1,1,-1,A
1909-01-01,1908,Manchester United,Notts County,4-3,4,3,1,1,7,1,H
1909-01-01,1908,Middlesbrough,Chelsea,1-4,1,4,1,1,5,-3,A
1909-01-01,1908,Sheffield Wednesday,Leicester City,3-1,3,1,1,1,4,2,H
1909-01-01,1908,Sunderland,Liverpool,1-4,1,4,1,1,5,-3,A
1909-01-02,1908,Arsenal,Notts County,1-0,1,0,1,1,1,1,H
1909-01-02,1908,Blackburn Rovers,Manchester City,3-2,3,2,1,1,5,1,H
1909-01-02,1908,Bradford City,Middlesbrough,0-2,0,2,1,1,2,-2,A
1909-01-02,1908,Chelsea,Liverpool,3-0,3,0,1,1,3,3,H
1909-01-02,1908,Everton,Bristol City,5-2,5,2,1,1,7,3,H
1909-01-02,1908,Leicester City,Newcastle United,0-4,0,4,1,1,4,-4,A
1909-01-02,1908,Manchester United,Preston North End,0-2,0,2,1,1,2,-2,A
1909-01-02,1908,Nottingham Forest,Sheffield United,0-2,0,2,1,1,2,-2,A
1909-01-02,1908,Sheffield Wednesday,Aston Villa,4-2,4,2,1,1,6,2,H
1909-01-02,1908,Sunderland,Bury,3-1,3,1,1,1,4,2,H
1909-01-09,1908,Aston Villa,Nottingham Forest,1-2,1,2,1,1,3,-1,A
1909-01-09,1908,Bristol City,Leicester City,1-1,1,1,1,1,2,0,D
1909-01-09,1908,Liverpool,Blackburn Rovers,1-1,1,1,1,1,2,0,D
1909-01-09,1908,Manchester City,Bradford City,4-3,4,3,1,1,7,1,H
1909-01-09,1908,Middlesbrough,Manchester United,5-0,5,0,1,1,5,5,H
1909-01-09,1908,Newcastle United,Arsenal,3-1,3,1,1,1,4,2,H
1909-01-09,1908,Notts County,Sheffield Wednesday,1-0,1,0,1,1,1,1,H
1909-01-09,1908,Preston North End,Everton,3-3,3,3,1,1,6,0,D
1909-01-09,1908,Sheffield United,Sunderland,0-2,0,2,1,1,2,-2,A
1909-01-23,1908,Arsenal,Bristol City,1-1,1,1,1,1,2,0,D
1909-01-23,1908,Blackburn Rovers,Bury,0-1,0,1,1,1,1,-1,A
1909-01-23,1908,Bradford City,Liverpool,0-2,0,2,1,1,2,-2,A
1909-01-23,1908,Chelsea,Sheffield United,1-1,1,1,1,1,2,0,D
1909-01-23,1908,Everton,Middlesbrough,1-1,1,1,1,1,2,0,D
1909-01-23,1908,Leicester City,Preston North End,0-0,0,0,1,1,0,0,D
1909-01-23,1908,Manchester United,Manchester City,3-1,3,1,1,1,4,2,H
1909-01-23,1908,Notts County,Newcastle United,0-4,0,4,1,1,4,-4,A
1909-01-23,1908,Sheffield Wednesday,Nottingham Forest,3-0,3,0,1,1,3,3,H
1909-01-23,1908,Sunderland,Aston Villa,4-3,4,3,1,1,7,1,H
1909-01-30,1908,Aston Villa,Chelsea,0-0,0,0,1,1,0,0,D
1909-01-30,1908,Bristol City,Notts County,1-0,1,0,1,1,1,1,H
1909-01-30,1908,Bury,Bradford City,2-1,2,1,1,1,3,1,H
1909-01-30,1908,Liverpool,Manchester United,3-1,3,1,1,1,4,2,H
1909-01-30,1908,Manchester City,Everton,4-0,4,0,1,1,4,4,H
1909-01-30,1908,Middlesbrough,Leicester City,6-2,6,2,1,1,8,4,H
1909-01-30,1908,Newcastle United,Sheffield Wednesday,1-0,1,0,1,1,1,1,H
1909-01-30,1908,Nottingham Forest,Sunderland,4-0,4,0,1,1,4,4,H
1909-01-30,1908,Preston North End,Arsenal,0-0,0,0,1,1,0,0,D
1909-01-30,1908,Sheffield United,Blackburn Rovers,0-0,0,0,1,1,0,0,D
1909-02-06,1908,Sheffield United,Aston Villa,3-1,3,1,1,1,4,2,H
1909-02-13,1908,Aston Villa,Bradford City,1-3,1,3,1,1,4,-2,A
1909-02-13,1908,Bristol City,Sheffield Wednesday,1-1,1,1,1,1,2,0,D
1909-02-13,1908,Bury,Everton,2-2,2,2,1,1,4,0,D
1909-02-13,1908,Liverpool,Leicester City,4-1,4,1,1,1,5,3,H
1909-02-13,1908,Manchester City,Arsenal,2-2,2,2,1,1,4,0,D
1909-02-13,1908,Middlesbrough,Notts County,1-2,1,2,1,1,3,-1,A
1909-02-13,1908,Nottingham Forest,Blackburn Rovers,2-1,2,1,1,1,3,1,H
1909-02-13,1908,Preston North End,Newcastle United,0-1,0,1,1,1,1,-1,A
1909-02-13,1908,Sheffield United,Manchester United,0-0,0,0,1,1,0,0,D
1909-02-13,1908,Sunderland,Chelsea,1-2,1,2,1,1,3,-1,A
1909-02-15,1908,Blackburn Rovers,Aston Villa,3-1,3,1,1,1,4,2,H
1909-02-20,1908,Arsenal,Liverpool,5-0,5,0,1,1,5,5,H
1909-02-20,1908,Everton,Sheffield United,5-1,5,1,1,1,6,4,H
1909-02-20,1908,Leicester City,Bury,2-5,2,5,1,1,7,-3,A
1909-02-20,1908,Notts County,Manchester City,5-1,5,1,1,1,6,4,H
1909-02-27,1908,Aston Villa,Everton,3-1,3,1,1,1,4,2,H
1909-02-27,1908,Bury,Arsenal,1-1,1,1,1,1,2,0,D
1909-02-27,1908,Chelsea,Blackburn Rovers,1-1,1,1,1,1,2,0,D
1909-02-27,1908,Liverpool,Notts County,1-1,1,1,1,1,2,0,D
1909-02-27,1908,Manchester City,Newcastle United,0-2,0,2,1,1,2,-2,A
1909-02-27,1908,Middlesbrough,Bristol City,4-0,4,0,1,1,4,4,H
1909-02-27,1908,Nottingham Forest,Manchester United,2-0,2,0,1,1,2,2,H
1909-02-27,1908,Preston North End,Sheffield Wednesday,4-1,4,1,1,1,5,3,H
1909-02-27,1908,Sheffield United,Leicester City,2-1,2,1,1,1,3,1,H
1909-02-27,1908,Sunderland,Bradford City,2-1,2,1,1,1,3,1,H
1909-03-01,1908,Sheffield United,Bury,2-2,2,2,1,1,4,0,D
1909-03-06,1908,Preston North End,Middlesbrough,1-1,1,1,1,1,2,0,D
1909-03-10,1908,Notts County,Preston North End,1-0,1,0,1,1,1,1,H
1909-03-11,1908,Leicester City,Manchester City,3-1,3,1,1,1,4,2,H
1909-03-13,1908,Aston Villa,Arsenal,2-1,2,1,1,1,3,1,H
1909-03-13,1908,Blackburn Rovers,Bradford City,1-1,1,1,1,1,2,0,D
1909-03-13,1908,Bury,Newcastle United,1-1,1,1,1,1,2,0,D
1909-03-13,1908,Chelsea,Manchester United,1-1,1,1,1,1,2,0,D
1909-03-13,1908,Liverpool,Bristol City,1-2,1,2,1,1,3,-1,A
1909-03-13,1908,Manchester City,Preston North End,4-1,4,1,1,1,5,3,H
1909-03-13,1908,Middlesbrough,Sheffield Wednesday,2-1,2,1,1,1,3,1,H
1909-03-13,1908,Sheffield United,Notts County,3-2,3,2,1,1,5,1,H
1909-03-13,1908,Sunderland,Everton,2-0,2,0,1,1,2,2,H
1909-03-15,1908,Manchester United,Sunderland,2-2,2,2,1,1,4,0,D
1909-03-17,1908,Arsenal,Middlesbrough,1-1,1,1,1,1,2,0,D
1909-03-17,1908,Bristol City,Preston North End,2-3,2,3,1,1,5,-1,A
1909-03-20,1908,Arsenal,Nottingham Forest,1-2,1,2,1,1,3,-1,A
1909-03-20,1908,Bristol City,Bury,4-2,4,2,1,1,6,2,H
1909-03-20,1908,Everton,Chelsea,3-2,3,2,1,1,5,1,H
1909-03-20,1908,Leicester City,Sunderland,4-3,4,3,1,1,7,1,H
1909-03-20,1908,Manchester United,Blackburn Rovers,0-3,0,3,1,1,3,-3,A
1909-03-20,1908,Middlesbrough,Manchester City,3-0,3,0,1,1,3,3,H
1909-03-20,1908,Newcastle United,Sheffield United,4-0,4,0,1,1,4,4,H
1909-03-20,1908,Notts County,Aston Villa,1-1,1,1,1,1,2,0,D
1909-03-20,1908,Preston North End,Liverpool,2-0,2,0,1,1,2,2,H
1909-03-20,1908,Sheffield Wednesday,Bradford City,0-2,0,2,1,1,2,-2,A
1909-03-22,1908,Blackburn Rovers,Sunderland,8-1,8,1,1,1,9,7,H
1909-03-22,1908,Sheffield Wednesday,Chelsea,5-1,5,1,1,1,6,4,H
1909-03-23,1908,Bradford City,Newcastle United,1-2,1,2,1,1,3,-1,A
1909-03-24,1908,Everton,Nottingham Forest,3-3,3,3,1,1,6,0,D
1909-03-24,1908,Notts County,Bury,3-2,3,2,1,1,5,1,H
1909-03-27,1908,Blackburn Rovers,Everton,0-0,0,0,1,1,0,0,D
1909-03-27,1908,Bradford City,Sheffield United,3-1,3,1,1,1,4,2,H
1909-03-27,1908,Bury,Preston North End,0-1,0,1,1,1,1,-1,A
1909-03-27,1908,Leicester City,Aston Villa,4-2,4,2,1,1,6,2,H
1909-03-27,1908,Liverpool,Middlesbrough,1-2,1,2,1,1,3,-1,A
1909-03-27,1908,Manchester City,Sheffield Wednesday,4-0,4,0,1,1,4,4,H
1909-03-27,1908,Nottingham Forest,Notts County,1-0,1,0,1,1,1,1,H
1909-03-27,1908,Sunderland,Arsenal,1-0,1,0,1,1,1,1,H
1909-03-29,1908,Sheffield Wednesday,Sunderland,2-5,2,5,1,1,7,-3,A
1909-03-30,1908,Bradford City,Nottingham Forest,1-1,1,1,1,1,2,0,D
1909-03-31,1908,Bury,Chelsea,2-1,2,1,1,1,3,1,H
1909-03-31,1908,Manchester United,Aston Villa,0-2,0,2,1,1,2,-2,A
1909-03-31,1908,Newcastle United,Middlesbrough,1-0,1,0,1,1,1,1,H
1909-04-01,1908,Arsenal,Sheffield United,1-0,1,0,1,1,1,1,H
1909-04-03,1908,Arsenal,Chelsea,0-0,0,0,1,1,0,0,D
1909-04-03,1908,Bristol City,Aston Villa,0-0,0,0,1,1,0,0,D
1909-04-03,1908,Everton,Bradford City,0-1,0,1,1,1,1,-1,A
1909-04-03,1908,Leicester City,Blackburn Rovers,2-4,2,4,1,1,6,-2,A
1909-04-03,1908,Manchester City,Liverpool,4-0,4,0,1,1,4,4,H
1909-04-03,1908,Middlesbrough,Bury,0-1,0,1,1,1,1,-1,A
1909-04-03,1908,Newcastle United,Nottingham Forest,1-1,1,1,1,1,2,0,D
1909-04-03,1908,Notts County,Sunderland,0-0,0,0,1,1,0,0,D
1909-04-03,1908,Preston North End,Sheffield United,1-1,1,1,1,1,2,0,D
1909-04-03,1908,Sheffield Wednesday,Manchester United,2-0,2,0,1,1,2,2,H
1909-04-05,1908,Sheffield United,Bristol City,3-1,3,1,1,1,4,2,H
1909-04-09,1908,Aston Villa,Sheffield United,3-0,3,0,1,1,3,3,H
1909-04-09,1908,Chelsea,Middlesbrough,3-0,3,0,1,1,3,3,H
1909-04-09,1908,Everton,Liverpool,5-0,5,0,1,1,5,5,H
1909-04-09,1908,Manchester United,Bristol City,0-1,0,1,1,1,1,-1,A
1909-04-09,1908,Notts County,Leicester City,2-3,2,3,1,1,5,-1,A
1909-04-09,1908,Preston North End,Bradford City,0-0,0,0,1,1,0,0,D
1909-04-09,1908,Sunderland,Manchester City,2-0,2,0,1,1,2,2,H
1909-04-10,1908,Aston Villa,Preston North End,2-4,2,4,1,1,6,-2,A
1909-04-10,1908,Blackburn Rovers,Arsenal,1-3,1,3,1,1,4,-2,A
1909-04-10,1908,Bradford City,Leicester City,4-1,4,1,1,1,5,3,H
1909-04-10,1908,Bury,Manchester City,1-0,1,0,1,1,1,1,H
1909-04-10,1908,Chelsea,Notts County,3-2,3,2,1,1,5,1,H
1909-04-10,1908,Liverpool,Sheffield Wednesday,1-2,1,2,1,1,3,-1,A
1909-04-10,1908,Manchester United,Everton,2-2,2,2,1,1,4,0,D
1909-04-10,1908,Nottingham Forest,Bristol City,1-1,1,1,1,1,2,0,D
1909-04-10,1908,Sheffield United,Middlesbrough,2-0,2,0,1,1,2,2,H
1909-04-10,1908,Sunderland,Newcastle United,3-1,3,1,1,1,4,2,H
1909-04-12,1908,Arsenal,Sheffield Wednesday,2-0,2,0,1,1,2,2,H
1909-04-12,1908,Bradford City,Preston North End,2-0,2,0,1,1,2,2,H
1909-04-12,1908,Bristol City,Manchester United,0-0,0,0,1,1,0,0,D
1909-04-12,1908,Leicester City,Notts County,0-2,0,2,1,1,2,-2,A
1909-04-12,1908,Liverpool,Sunderland,3-0,3,0,1,1,3,3,H
1909-04-12,1908,Middlesbrough,Blackburn Rovers,1-0,1,0,1,1,1,1,H
1909-04-12,1908,Newcastle United,Everton,3-0,3,0,1,1,3,3,H
1909-04-12,1908,Nottingham Forest,Bury,0-2,0,2,1,1,2,-2,A
1909-04-13,1908,Bristol City,Blackburn Rovers,1-4,1,4,1,1,5,-3,A
1909-04-13,1908,Manchester City,Nottingham Forest,2-1,2,1,1,1,3,1,H
1909-04-13,1908,Notts County,Manchester United,0-1,0,1,1,1,1,-1,A
1909-04-17,1908,Arsenal,Bradford City,1-0,1,0,1,1,1,1,H
1909-04-17,1908,Bristol City,Sunderland,2-4,2,4,1,1,6,-2,A
1909-04-17,1908,Leicester City,Manchester United,3-2,3,2,1,1,5,1,H
1909-04-17,1908,Liverpool,Bury,2-2,2,2,1,1,4,0,D
1909-04-17,1908,Manchester City,Sheffield United,1-3,1,3,1,1,4,-2,A
1909-04-17,1908,Middlesbrough,Aston Villa,1-0,1,0,1,1,1,1,H
1909-04-17,1908,Newcastle United,Chelsea,1-3,1,3,1,1,4,-2,A
1909-04-17,1908,Notts County,Blackburn Rovers,2-3,2,3,1,1,5,-1,A
1909-04-17,1908,Preston North End,Nottingham Forest,1-1,1,1,1,1,2,0,D
1909-04-17,1908,Sheffield Wednesday,Everton,2-0,2,0,1,1,2,2,H
1909-04-19,1908,Sheffield Wednesday,Blackburn Rovers,1-2,1,2,1,1,3,-1,A
1909-04-20,1908,Bradford City,Chelsea,3-0,3,0,1,1,3,3,H
1909-04-21,1908,Nottingham Forest,Leicester City,12-0,12,0,1,1,12,12,H
1909-04-24,1908,Aston Villa,Manchester City,2-1,2,1,1,1,3,1,H
1909-04-24,1908,Blackburn Rovers,Newcastle United,2-4,2,4,1,1,6,-2,A
1909-04-24,1908,Bradford City,Notts County,2-2,2,2,1,1,4,0,D
1909-04-24,1908,Bury,Sheffield Wednesday,4-2,4,2,1,1,6,2,H
1909-04-24,1908,Everton,Leicester City,4-2,4,2,1,1,6,2,H
1909-04-24,1908,Nottingham Forest,Middlesbrough,4-1,4,1,1,1,5,3,H
1909-04-24,1908,Sunderland,Preston North End,2-1,2,1,1,1,3,1,H
1909-04-26,1908,Aston Villa,Newcastle United,3-0,3,0,1,1,3,3,H
1909-04-26,1908,Chelsea,Bristol City,3-1,3,1,1,1,4,2,H
1909-04-27,1908,Manchester United,Arsenal,1-4,1,4,1,1,5,-3,A
1909-04-28,1908,Bristol City,Manchester City,1-0,1,0,1,1,1,1,H
1909-04-29,1908,Bradford City,Manchester United,1-0,1,0,1,1,1,1,H
1909-04-29,1908,Chelsea,Leicester City,1-0,1,0,1,1,1,1,H
1909-04-30,1908,Newcastle United,Liverpool,0-1,0,1,1,1,1,-1,A
1909-09-01,1909,Aston Villa,Arsenal,5-1,5,1,1,1,6,4,H
1909-09-01,1909,Chelsea,Notts County,2-2,2,2,1,1,4,0,D
1909-09-01,1909,Everton,Sheffield Wednesday,1-1,1,1,1,1,2,0,D
1909-09-01,1909,Manchester United,Bradford City,1-0,1,0,1,1,1,1,H
1909-09-01,1909,Middlesbrough,Sheffield United,0-2,0,2,1,1,2,-2,A
1909-09-01,1909,Newcastle United,Bolton Wanderers,1-0,1,0,1,1,1,1,H
1909-09-01,1909,Preston North End,Nottingham Forest,0-1,0,1,1,1,1,-1,A
1909-09-01,1909,Sunderland,Tottenham Hotspur,3-1,3,1,1,1,4,2,H
1909-09-04,1909,Arsenal,Sheffield United,0-0,0,0,1,1,0,0,D
1909-09-04,1909,Blackburn Rovers,Newcastle United,2-0,2,0,1,1,2,2,H
1909-09-04,1909,Bolton Wanderers,Aston Villa,1-2,1,2,1,1,3,-1,A
1909-09-04,1909,Bradford City,Bristol City,3-1,3,1,1,1,4,2,H
1909-09-04,1909,Chelsea,Liverpool,2-1,2,1,1,1,3,1,H
1909-09-04,1909,Everton,Tottenham Hotspur,4-2,4,2,1,1,6,2,H
1909-09-04,1909,Manchester United,Bury,2-0,2,0,1,1,2,2,H
1909-09-04,1909,Nottingham Forest,Notts County,2-1,2,1,1,1,3,1,H
1909-09-04,1909,Sheffield Wednesday,Middlesbrough,1-5,1,5,1,1,6,-4,A
1909-09-04,1909,Sunderland,Preston North End,2-1,2,1,1,1,3,1,H
1909-09-06,1909,Bolton Wanderers,Liverpool,1-2,1,2,1,1,3,-1,A
1909-09-06,1909,Everton,Newcastle United,1-4,1,4,1,1,5,-3,A
1909-09-06,1909,Manchester United,Notts County,2-1,2,1,1,1,3,1,H
1909-09-07,1909,Bolton Wanderers,Newcastle United,0-4,0,4,1,1,4,-4,A
1909-09-08,1909,Bristol City,Bury,1-1,1,1,1,1,2,0,D
1909-09-11,1909,Aston Villa,Chelsea,4-1,4,1,1,1,5,3,H
1909-09-11,1909,Bristol City,Sheffield Wednesday,1-1,1,1,1,1,2,0,D
1909-09-11,1909,Bury,Bradford City,3-4,3,4,1,1,7,-1,A
1909-09-11,1909,Liverpool,Blackburn Rovers,3-1,3,1,1,1,4,2,H
1909-09-11,1909,Middlesbrough,Arsenal,5-2,5,2,1,1,7,3,H
1909-09-11,1909,Newcastle United,Nottingham Forest,1-2,1,2,1,1,3,-1,A
1909-09-11,1909,Notts County,Sunderland,1-1,1,1,1,1,2,0,D
1909-09-11,1909,Preston North End,Everton,0-1,0,1,1,1,1,-1,A
1909-09-11,1909,Sheffield United,Bolton Wanderers,2-2,2,2,1,1,4,0,D
1909-09-11,1909,Tottenham Hotspur,Manchester United,2-2,2,2,1,1,4,0,D
1909-09-13,1909,Blackburn Rovers,Bristol City,5-2,5,2,1,1,7,3,H
1909-09-18,1909,Blackburn Rovers,Aston Villa,3-2,3,2,1,1,5,1,H
1909-09-18,1909,Bolton Wanderers,Arsenal,3-0,3,0,1,1,3,3,H
1909-09-18,1909,Bradford City,Tottenham Hotspur,5-1,5,1,1,1,6,4,H
1909-09-18,1909,Bristol City,Middlesbrough,4-1,4,1,1,1,5,3,H
1909-09-18,1909,Chelsea,Sheffield United,2-2,2,2,1,1,4,0,D
1909-09-18,1909,Everton,Notts County,2-0,2,0,1,1,2,2,H
1909-09-18,1909,Manchester United,Preston North End,1-1,1,1,1,1,2,0,D
1909-09-18,1909,Nottingham Forest,Liverpool,1-4,1,4,1,1,5,-3,A
1909-09-18,1909,Sheffield Wednesday,Bury,1-4,1,4,1,1,5,-3,A
1909-09-18,1909,Sunderland,Newcastle United,0-2,0,2,1,1,2,-2,A
1909-09-20,1909,Sheffield Wednesday,Everton,1-3,1,3,1,1,4,-2,A
1909-09-25,1909,Arsenal,Chelsea,3-2,3,2,1,1,5,1,H
1909-09-25,1909,Aston Villa,Nottingham Forest,0-0,0,0,1,1,0,0,D
1909-09-25,1909,Bury,Bristol City,1-2,1,2,1,1,3,-1,A
1909-09-25,1909,Liverpool,Sunderland,1-4,1,4,1,1,5,-3,A
1909-09-25,1909,Middlesbrough,Bolton Wanderers,1-2,1,2,1,1,3,-1,A
1909-09-25,1909,Newcastle United,Everton,1-2,1,2,1,1,3,-1,A
1909-09-25,1909,Notts County,Manchester United,3-2,3,2,1,1,5,1,H
1909-09-25,1909,Preston North End,Bradford City,2-2,2,2,1,1,4,0,D
1909-09-25,1909,Sheffield United,Blackburn Rovers,3-0,3,0,1,1,3,3,H
1909-09-25,1909,Tottenham Hotspur,Sheffield Wednesday,3-0,3,0,1,1,3,3,H
1909-10-02,1909,Blackburn Rovers,Arsenal,7-0,7,0,1,1,7,7,H
1909-10-02,1909,Bradford City,Notts County,2-1,2,1,1,1,3,1,H
1909-10-02,1909,Bristol City,Tottenham Hotspur,0-0,0,0,1,1,0,0,D
1909-10-02,1909,Bury,Middlesbrough,2-1,2,1,1,1,3,1,H
1909-10-02,1909,Chelsea,Bolton Wanderers,3-2,3,2,1,1,5,1,H
1909-10-02,1909,Everton,Liverpool,2-3,2,3,1,1,5,-1,A
1909-10-02,1909,Manchester United,Newcastle United,1-1,1,1,1,1,2,0,D
1909-10-02,1909,Nottingham Forest,Sheffield United,2-3,2,3,1,1,5,-1,A
1909-10-02,1909,Sheffield Wednesday,Preston North End,4-1,4,1,1,1,5,3,H
1909-10-02,1909,Sunderland,Aston Villa,1-1,1,1,1,1,2,0,D
1909-10-07,1909,Notts County,Arsenal,5-1,5,1,1,1,6,4,H
1909-10-09,1909,Arsenal,Nottingham Forest,0-1,0,1,1,1,1,-1,A
1909-10-09,1909,Aston Villa,Everton,3-1,3,1,1,1,4,2,H
1909-10-09,1909,Bolton Wanderers,Blackburn Rovers,1-2,1,2,1,1,3,-1,A
1909-10-09,1909,Liverpool,Manchester United,3-2,3,2,1,1,5,1,H
1909-10-09,1909,Middlesbrough,Chelsea,0-1,0,1,1,1,1,-1,A
1909-10-09,1909,Newcastle United,Bradford City,1-0,1,0,1,1,1,1,H
1909-10-09,1909,Notts County,Sheffield Wednesday,0-0,0,0,1,1,0,0,D
1909-10-09,1909,Preston North End,Bristol City,3-0,3,0,1,1,3,3,H
1909-10-09,1909,Sheffield United,Sunderland,3-0,3,0,1,1,3,3,H
1909-10-09,1909,Tottenham Hotspur,Bury,1-0,1,0,1,1,1,1,H
1909-10-16,1909,Blackburn Rovers,Chelsea,1-0,1,0,1,1,1,1,H
1909-10-16,1909,Bradford City,Liverpool,1-2,1,2,1,1,3,-1,A
1909-10-16,1909,Bristol City,Notts County,3-1,3,1,1,1,4,2,H
1909-10-16,1909,Bury,Preston North End,3-1,3,1,1,1,4,2,H
1909-10-16,1909,Everton,Sheffield United,1-2,1,2,1,1,3,-1,A
1909-10-16,1909,Manchester United,Aston Villa,2-0,2,0,1,1,2,2,H
1909-10-16,1909,Nottingham Forest,Bolton Wanderers,2-0,2,0,1,1,2,2,H
1909-10-16,1909,Sheffield Wednesday,Newcastle United,3-1,3,1,1,1,4,2,H
1909-10-16,1909,Sunderland,Arsenal,6-2,6,2,1,1,8,4,H
1909-10-16,1909,Tottenham Hotspur,Middlesbrough,1-3,1,3,1,1,4,-2,A
1909-10-18,1909,Sheffield United,Notts County,2-2,2,2,1,1,4,0,D
1909-10-23,1909,Arsenal,Everton,1-0,1,0,1,1,1,1,H
1909-10-23,1909,Aston Villa,Bradford City,3-1,3,1,1,1,4,2,H
1909-10-23,1909,Bolton Wanderers,Sunderland,2-1,2,1,1,1,3,1,H
1909-10-23,1909,Chelsea,Nottingham Forest,0-1,0,1,1,1,1,-1,A
1909-10-23,1909,Liverpool,Sheffield Wednesday,3-1,3,1,1,1,4,2,H
1909-10-23,1909,Middlesbrough,Blackburn Rovers,1-3,1,3,1,1,4,-2,A
1909-10-23,1909,Newcastle United,Bristol City,3-1,3,1,1,1,4,2,H
1909-10-23,1909,Notts County,Bury,3-1,3,1,1,1,4,2,H
1909-10-23,1909,Sheffield United,Manchester United,0-1,0,1,1,1,1,-1,A
1909-10-27,1909,Chelsea,Preston North End,2-0,2,0,1,1,2,2,H
1909-10-30,1909,Bradford City,Sheffield United,2-0,2,0,1,1,2,2,H
1909-10-30,1909,Bristol City,Liverpool,0-1,0,1,1,1,1,-1,A
1909-10-30,1909,Bury,Newcastle United,1-2,1,2,1,1,3,-1,A
1909-10-30,1909,Everton,Bolton Wanderers,3-1,3,1,1,1,4,2,H
1909-10-30,1909,Manchester United,Arsenal,1-0,1,0,1,1,1,1,H
1909-10-30,1909,Nottingham Forest,Blackburn Rovers,0-4,0,4,1,1,4,-4,A
1909-10-30,1909,Preston North End,Middlesbrough,1-0,1,0,1,1,1,1,H
1909-10-30,1909,Sheffield Wednesday,Aston Villa,3-2,3,2,1,1,5,1,H
1909-10-30,1909,Sunderland,Chelsea,4-0,4,0,1,1,4,4,H
1909-10-30,1909,Tottenham Hotspur,Notts County,1-3,1,3,1,1,4,-2,A
1909-11-03,1909,Nottingham Forest,Bury,3-3,3,3,1,1,6,0,D
1909-11-06,1909,Arsenal,Bradford City,0-1,0,1,1,1,1,-1,A
1909-11-06,1909,Aston Villa,Bristol City,1-0,1,0,1,1,1,1,H
1909-11-06,1909,Blackburn Rovers,Sunderland,0-0,0,0,1,1,0,0,D
1909-11-06,1909,Bolton Wanderers,Manchester United,2-3,2,3,1,1,5,-1,A
1909-11-06,1909,Chelsea,Everton,0-1,0,1,1,1,1,-1,A
1909-11-06,1909,Liverpool,Bury,2-2,2,2,1,1,4,0,D
1909-11-06,1909,Middlesbrough,Nottingham Forest,2-1,2,1,1,1,3,1,H
1909-11-06,1909,Newcastle United,Tottenham Hotspur,1-0,1,0,1,1,1,1,H
1909-11-06,1909,Notts County,Preston North End,3-1,3,1,1,1,4,2,H
1909-11-06,1909,Sheffield United,Sheffield Wednesday,3-3,3,3,1,1,6,0,D
1909-11-13,1909,Bradford City,Bolton Wanderers,1-0,1,0,1,1,1,1,H
1909-11-13,1909,Bristol City,Sheffield United,0-2,0,2,1,1,2,-2,A
1909-11-13,1909,Bury,Aston Villa,0-2,0,2,1,1,2,-2,A
1909-11-13,1909,Everton,Blackburn Rovers,0-2,0,2,1,1,2,-2,A
1909-11-13,1909,Manchester United,Chelsea,2-0,2,0,1,1,2,2,H
1909-11-13,1909,Notts County,Middlesbrough,2-1,2,1,1,1,3,1,H
1909-11-13,1909,Preston North End,Newcastle United,4-0,4,0,1,1,4,4,H
1909-11-13,1909,Sheffield Wednesday,Arsenal,1-1,1,1,1,1,2,0,D
1909-11-13,1909,Sunderland,Nottingham Forest,2-1,2,1,1,1,3,1,H
1909-11-13,1909,Tottenham Hotspur,Liverpool,1-0,1,0,1,1,1,1,H
1909-11-20,1909,Arsenal,Bristol City,2-2,2,2,1,1,4,0,D
1909-11-20,1909,Aston Villa,Tottenham Hotspur,3-2,3,2,1,1,5,1,H
1909-11-20,1909,Blackburn Rovers,Manchester United,3-2,3,2,1,1,5,1,H
1909-11-20,1909,Chelsea,Bradford City,0-3,0,3,1,1,3,-3,A
1909-11-20,1909,Liverpool,Preston North End,2-0,2,0,1,1,2,2,H
1909-11-20,1909,Middlesbrough,Sunderland,3-2,3,2,1,1,5,1,H
1909-11-20,1909,Newcastle United,Notts County,1-3,1,3,1,1,4,-2,A
1909-11-20,1909,Nottingham Forest,Everton,1-0,1,0,1,1,1,1,H
1909-11-20,1909,Sheffield United,Bury,2-0,2,0,1,1,2,2,H
1909-11-22,1909,Preston North End,Tottenham Hotspur,4-1,4,1,1,1,5,3,H
1909-11-27,1909,Bradford City,Blackburn Rovers,2-0,2,0,1,1,2,2,H
1909-11-27,1909,Bristol City,Bolton Wanderers,1-0,1,0,1,1,1,1,H
1909-11-27,1909,Bury,Arsenal,1-2,1,2,1,1,3,-1,A
1909-11-27,1909,Everton,Sunderland,2-1,2,1,1,1,3,1,H
1909-11-27,1909,Manchester United,Nottingham Forest,2-6,2,6,1,1,8,-4,A
1909-11-27,1909,Newcastle United,Middlesbrough,2-0,2,0,1,1,2,2,H
1909-11-27,1909,Notts County,Liverpool,3-1,3,1,1,1,4,2,H
1909-11-27,1909,Preston North End,Aston Villa,1-0,1,0,1,1,1,1,H
1909-11-27,1909,Sheffield Wednesday,Chelsea,4-1,4,1,1,1,5,3,H
1909-11-27,1909,Tottenham Hotspur,Sheffield United,2-1,2,1,1,1,3,1,H
1909-12-04,1909,Arsenal,Tottenham Hotspur,1-0,1,0,1,1,1,1,H
1909-12-04,1909,Aston Villa,Notts County,1-1,1,1,1,1,2,0,D
1909-12-04,1909,Blackburn Rovers,Sheffield Wednesday,0-0,0,0,1,1,0,0,D
1909-12-04,1909,Bolton Wanderers,Bury,1-3,1,3,1,1,4,-2,A
1909-12-04,1909,Chelsea,Bristol City,4-1,4,1,1,1,5,3,H
1909-12-04,1909,Liverpool,Newcastle United,6-5,6,5,1,1,11,1,H
1909-12-04,1909,Middlesbrough,Everton,1-1,1,1,1,1,2,0,D
1909-12-04,1909,Nottingham Forest,Bradford City,1-1,1,1,1,1,2,0,D
1909-12-04,1909,Sheffield United,Preston North End,5-1,5,1,1,1,6,4,H
1909-12-04,1909,Sunderland,Manchester United,3-0,3,0,1,1,3,3,H
1909-12-11,1909,Bradford City,Sunderland,3-1,3,1,1,1,4,2,H
1909-12-11,1909,Bristol City,Blackburn Rovers,2-2,2,2,1,1,4,0,D
1909-12-11,1909,Bury,Chelsea,4-2,4,2,1,1,6,2,H
1909-12-11,1909,Liverpool,Middlesbrough,0-0,0,0,1,1,0,0,D
1909-12-11,1909,Newcastle United,Aston Villa,1-0,1,0,1,1,1,1,H
1909-12-11,1909,Notts County,Sheffield United,1-2,1,2,1,1,3,-1,A
1909-12-11,1909,Preston North End,Arsenal,3-4,3,4,1,1,7,-1,A
1909-12-11,1909,Sheffield Wednesday,Nottingham Forest,4-3,4,3,1,1,7,1,H
1909-12-11,1909,Tottenham Hotspur,Bolton Wanderers,1-1,1,1,1,1,2,0,D
1909-12-18,1909,Arsenal,Notts County,1-2,1,2,1,1,3,-1,A
1909-12-18,1909,Aston Villa,Liverpool,3-1,3,1,1,1,4,2,H
1909-12-18,1909,Blackburn Rovers,Bury,5-1,5,1,1,1,6,4,H
1909-12-18,1909,Bolton Wanderers,Preston North End,3-1,3,1,1,1,4,2,H
1909-12-18,1909,Chelsea,Tottenham Hotspur,2-1,2,1,1,1,3,1,H
1909-12-18,1909,Everton,Bradford City,1-1,1,1,1,1,2,0,D
1909-12-18,1909,Middlesbrough,Manchester United,1-2,1,2,1,1,3,-1,A
1909-12-18,1909,Nottingham Forest,Bristol City,0-0,0,0,1,1,0,0,D
1909-12-18,1909,Sheffield United,Newcastle United,4-0,4,0,1,1,4,4,H
1909-12-18,1909,Sunderland,Sheffield Wednesday,2-0,2,0,1,1,2,2,H
1909-12-25,1909,Arsenal,Newcastle United,0-3,0,3,1,1,3,-3,A
1909-12-25,1909,Blackburn Rovers,Preston North End,2-2,2,2,1,1,4,0,D
1909-12-25,1909,Bristol City,Everton,3-1,3,1,1,1,4,2,H
1909-12-25,1909,Bury,Sunderland,0-1,0,1,1,1,1,-1,A
1909-12-25,1909,Liverpool,Bolton Wanderers,3-0,3,0,1,1,3,3,H
1909-12-25,1909,Manchester United,Sheffield Wednesday,0-3,0,3,1,1,3,-3,A
1909-12-25,1909,Middlesbrough,Bradford City,3-7,3,7,1,1,10,-4,A
1909-12-25,1909,Notts County,Chelsea,2-1,2,1,1,1,3,1,H
1909-12-25,1909,Sheffield United,Aston Villa,0-1,0,1,1,1,1,-1,A
1909-12-25,1909,Tottenham Hotspur,Nottingham Forest,2-2,2,2,1,1,4,0,D
1909-12-27,1909,Arsenal,Liverpool,1-1,1,1,1,1,2,0,D
1909-12-27,1909,Aston Villa,Sheffield United,2-1,2,1,1,1,3,1,H
1909-12-27,1909,Bradford City,Middlesbrough,4-1,4,1,1,1,5,3,H
1909-12-27,1909,Chelsea,Newcastle United,2-1,2,1,1,1,3,1,H
1909-12-27,1909,Everton,Bristol City,1-0,1,0,1,1,1,1,H
1909-12-27,1909,Nottingham Forest,Tottenham Hotspur,2-2,2,2,1,1,4,0,D
1909-12-27,1909,Preston North End,Blackburn Rovers,3-2,3,2,1,1,5,1,H
1909-12-27,1909,Sheffield Wednesday,Manchester United,4-1,4,1,1,1,5,3,H
1909-12-27,1909,Sunderland,Bury,2-3,2,3,1,1,5,-1,A
1909-12-28,1909,Bristol City,Sunderland,2-3,2,3,1,1,5,-1,A
1909-12-28,1909,Notts County,Blackburn Rovers,2-2,2,2,1,1,4,0,D
1909-12-28,1909,Sheffield United,Liverpool,4-2,4,2,1,1,6,2,H
1910-01-01,1909,Blackburn Rovers,Tottenham Hotspur,2-0,2,0,1,1,2,2,H
1910-01-01,1909,Bolton Wanderers,Notts County,3-4,3,4,1,1,7,-1,A
1910-01-01,1909,Bradford City,Manchester United,0-2,0,2,1,1,2,-2,A
1910-01-01,1909,Bury,Everton,2-2,2,2,1,1,4,0,D
1910-01-01,1909,Liverpool,Arsenal,5-1,5,1,1,1,6,4,H
1910-01-01,1909,Newcastle United,Chelsea,1-0,1,0,1,1,1,1,H
1910-01-01,1909,Nottingham Forest,Aston Villa,1-4,1,4,1,1,5,-3,A
1910-01-01,1909,Sheffield United,Middlesbrough,2-0,2,0,1,1,2,2,H
1910-01-01,1909,Sunderland,Bristol City,4-0,4,0,1,1,4,4,H
1910-01-03,1909,Bolton Wanderers,Sheffield Wednesday,0-2,0,2,1,1,2,-2,A
1910-01-03,1909,Bury,Nottingham Forest,4-1,4,1,1,1,5,3,H
1910-01-03,1909,Newcastle United,Preston North End,5-2,5,2,1,1,7,3,H
1910-01-08,1909,Aston Villa,Bolton Wanderers,3-1,3,1,1,1,4,2,H
1910-01-08,1909,Bristol City,Bradford City,2-0,2,0,1,1,2,2,H
1910-01-08,1909,Bury,Manchester United,1-1,1,1,1,1,2,0,D
1910-01-08,1909,Liverpool,Chelsea,5-1,5,1,1,1,6,4,H
1910-01-08,1909,Middlesbrough,Sheffield Wednesday,4-0,4,0,1,1,4,4,H
1910-01-08,1909,Newcastle United,Blackburn Rovers,4-1,4,1,1,1,5,3,H
1910-01-08,1909,Notts County,Nottingham Forest,4-1,4,1,1,1,5,3,H
1910-01-08,1909,Preston North End,Sunderland,1-0,1,0,1,1,1,1,H
1910-01-08,1909,Sheffield United,Arsenal,2-0,2,0,1,1,2,2,H
1910-01-08,1909,Tottenham Hotspur,Everton,3-0,3,0,1,1,3,3,H
1910-01-10,1909,Preston North End,Chelsea,2-0,2,0,1,1,2,2,H
1910-01-22,1909,Arsenal,Middlesbrough,3-0,3,0,1,1,3,3,H
1910-01-22,1909,Blackburn Rovers,Liverpool,1-1,1,1,1,1,2,0,D
1910-01-22,1909,Bolton Wanderers,Sheffield United,1-0,1,0,1,1,1,1,H
1910-01-22,1909,Bradford City,Bury,0-0,0,0,1,1,0,0,D
1910-01-22,1909,Chelsea,Aston Villa,0-0,0,0,1,1,0,0,D
1910-01-22,1909,Everton,Preston North End,2-1,2,1,1,1,3,1,H
1910-01-22,1909,Manchester United,Tottenham Hotspur,5-0,5,0,1,1,5,5,H
1910-01-22,1909,Nottingham Forest,Newcastle United,0-1,0,1,1,1,1,-1,A
1910-01-22,1909,Sheffield Wednesday,Bristol City,2-0,2,0,1,1,2,2,H
1910-01-22,1909,Sunderland,Notts County,0-3,0,3,1,1,3,-3,A
1910-01-29,1909,Arsenal,Bolton Wanderers,2-0,2,0,1,1,2,2,H
1910-01-29,1909,Aston Villa,Blackburn Rovers,4-3,4,3,1,1,7,1,H
1910-01-29,1909,Tottenham Hotspur,Bradford City,0-0,0,0,1,1,0,0,D
1910-02-05,1909,Bolton Wanderers,Middlesbrough,1-1,1,1,1,1,2,0,D
1910-02-05,1909,Preston North End,Manchester United,1-0,1,0,1,1,1,1,H
1910-02-12,1909,Arsenal,Blackburn Rovers,0-1,0,1,1,1,1,-1,A
1910-02-12,1909,Aston Villa,Sunderland,3-2,3,2,1,1,5,1,H
1910-02-12,1909,Bolton Wanderers,Chelsea,5-2,5,2,1,1,7,3,H
1910-02-12,1909,Liverpool,Everton,0-1,0,1,1,1,1,-1,A
1910-02-12,1909,Middlesbrough,Bury,0-5,0,5,1,1,5,-5,A
1910-02-12,1909,Newcastle United,Manchester United,3-4,3,4,1,1,7,-1,A
1910-02-12,1909,Notts County,Bradford City,3-2,3,2,1,1,5,1,H
1910-02-12,1909,Preston North End,Sheffield Wednesday,1-0,1,0,1,1,1,1,H
1910-02-12,1909,Sheffield United,Nottingham Forest,1-4,1,4,1,1,5,-3,A
1910-02-12,1909,Tottenham Hotspur,Bristol City,3-2,3,2,1,1,5,1,H
1910-02-19,1909,Bolton Wanderers,Bradford City,1-1,1,1,1,1,2,0,D
1910-02-19,1909,Bristol City,Preston North End,2-0,2,0,1,1,2,2,H
1910-02-19,1909,Chelsea,Middlesbrough,2-1,2,1,1,1,3,1,H
1910-02-19,1909,Manchester United,Liverpool,3-4,3,4,1,1,7,-1,A
1910-02-19,1909,Sheffield Wednesday,Notts County,0-0,0,0,1,1,0,0,D
1910-02-26,1909,Arsenal,Sunderland,1-2,1,2,1,1,3,-1,A
1910-02-26,1909,Aston Villa,Manchester United,7-1,7,1,1,1,8,6,H
1910-02-26,1909,Bolton Wanderers,Nottingham Forest,2-1,2,1,1,1,3,1,H
1910-02-26,1909,Chelsea,Blackburn Rovers,3-1,3,1,1,1,4,2,H
1910-02-26,1909,Liverpool,Bradford City,1-0,1,0,1,1,1,1,H
1910-02-26,1909,Middlesbrough,Tottenham Hotspur,4-3,4,3,1,1,7,1,H
1910-02-26,1909,Newcastle United,Sheffield Wednesday,3-1,3,1,1,1,4,2,H
1910-02-26,1909,Notts County,Bristol City,0-2,0,2,1,1,2,-2,A
1910-02-26,1909,Preston North End,Bury,2-1,2,1,1,1,3,1,H
1910-02-26,1909,Sheffield United,Everton,3-0,3,0,1,1,3,3,H
1910-03-02,1909,Nottingham Forest,Arsenal,1-1,1,1,1,1,2,0,D
1910-03-05,1909,Blackburn Rovers,Middlesbrough,1-1,1,1,1,1,2,0,D
1910-03-05,1909,Bradford City,Aston Villa,1-2,1,2,1,1,3,-1,A
1910-03-05,1909,Bury,Notts County,1-1,1,1,1,1,2,0,D
1910-03-05,1909,Manchester United,Sheffield United,1-0,1,0,1,1,1,1,H
1910-03-05,1909,Nottingham Forest,Chelsea,0-0,0,0,1,1,0,0,D
1910-03-05,1909,Sheffield Wednesday,Liverpool,3-0,3,0,1,1,3,3,H
1910-03-05,1909,Sunderland,Bolton Wanderers,3-0,3,0,1,1,3,3,H
1910-03-05,1909,Tottenham Hotspur,Preston North End,2-1,2,1,1,1,3,1,H
1910-03-07,1909,Everton,Arsenal,1-0,1,0,1,1,1,1,H
1910-03-07,1909,Sheffield United,Chelsea,0-0,0,0,1,1,0,0,D
1910-03-09,1909,Bradford City,Newcastle United,3-3,3,3,1,1,6,0,D
1910-03-09,1909,Bury,Sheffield Wednesday,3-2,3,2,1,1,5,1,H
1910-03-12,1909,Arsenal,Manchester United,0-0,0,0,1,1,0,0,D
1910-03-12,1909,Aston Villa,Sheffield Wednesday,5-0,5,0,1,1,5,5,H
1910-03-12,1909,Blackburn Rovers,Nottingham Forest,2-2,2,2,1,1,4,0,D
1910-03-12,1909,Bolton Wanderers,Everton,0-1,0,1,1,1,1,-1,A
1910-03-12,1909,Chelsea,Sunderland,1-4,1,4,1,1,5,-3,A
1910-03-12,1909,Liverpool,Bristol City,0-1,0,1,1,1,1,-1,A
1910-03-12,1909,Middlesbrough,Preston North End,1-0,1,0,1,1,1,1,H
1910-03-12,1909,Newcastle United,Bury,2-2,2,2,1,1,4,0,D
1910-03-12,1909,Notts County,Tottenham Hotspur,3-0,3,0,1,1,3,3,H
1910-03-12,1909,Sheffield United,Bradford City,1-2,1,2,1,1,3,-1,A
1910-03-14,1909,Everton,Aston Villa,0-0,0,0,1,1,0,0,D
1910-03-14,1909,Sheffield Wednesday,Tottenham Hotspur,1-1,1,1,1,1,2,0,D
1910-03-16,1909,Sunderland,Sheffield United,1-0,1,0,1,1,1,1,H
1910-03-19,1909,Bradford City,Arsenal,0-1,0,1,1,1,1,-1,A
1910-03-19,1909,Bristol City,Aston Villa,0-0,0,0,1,1,0,0,D
1910-03-19,1909,Bury,Liverpool,1-2,1,2,1,1,3,-1,A
1910-03-19,1909,Everton,Chelsea,2-2,2,2,1,1,4,0,D
1910-03-19,1909,Manchester United,Bolton Wanderers,5-0,5,0,1,1,5,5,H
1910-03-19,1909,Nottingham Forest,Middlesbrough,0-1,0,1,1,1,1,-1,A
1910-03-19,1909,Preston North End,Notts County,4-0,4,0,1,1,4,4,H
1910-03-19,1909,Sheffield Wednesday,Sheffield United,1-3,1,3,1,1,4,-2,A
1910-03-19,1909,Sunderland,Blackburn Rovers,0-0,0,0,1,1,0,0,D
1910-03-19,1909,Tottenham Hotspur,Newcastle United,0-4,0,4,1,1,4,-4,A
1910-03-25,1909,Aston Villa,Middlesbrough,4-2,4,2,1,1,6,2,H
1910-03-25,1909,Blackburn Rovers,Notts County,2-0,2,0,1,1,2,2,H
1910-03-25,1909,Bradford City,Sheffield Wednesday,2-0,2,0,1,1,2,2,H
1910-03-25,1909,Liverpool,Sheffield United,0-0,0,0,1,1,0,0,D
1910-03-25,1909,Manchester United,Bristol City,2-1,2,1,1,1,3,1,H
1910-03-25,1909,Newcastle United,Arsenal,1-1,1,1,1,1,2,0,D
1910-03-25,1909,Nottingham Forest,Preston North End,0-0,0,0,1,1,0,0,D
1910-03-25,1909,Tottenham Hotspur,Sunderland,5-1,5,1,1,1,6,4,H
1910-03-26,1909,Arsenal,Sheffield Wednesday,0-1,0,1,1,1,1,-1,A
1910-03-26,1909,Aston Villa,Bury,4-1,4,1,1,1,5,3,H
1910-03-26,1909,Blackburn Rovers,Bolton Wanderers,4-2,4,2,1,1,6,2,H
1910-03-26,1909,Chelsea,Manchester United,1-1,1,1,1,1,2,0,D
1910-03-26,1909,Liverpool,Tottenham Hotspur,2-0,2,0,1,1,2,2,H
1910-03-26,1909,Middlesbrough,Notts County,2-0,2,0,1,1,2,2,H
1910-03-26,1909,Nottingham Forest,Sunderland,1-3,1,3,1,1,4,-2,A
1910-03-26,1909,Sheffield United,Bristol City,4-0,4,0,1,1,4,4,H
1910-03-28,1909,Bristol City,Manchester United,2-1,2,1,1,1,3,1,H
1910-03-28,1909,Chelsea,Arsenal,0-1,0,1,1,1,1,-1,A
1910-03-28,1909,Everton,Bury,3-0,3,0,1,1,3,3,H
1910-03-28,1909,Middlesbrough,Aston Villa,3-2,3,2,1,1,5,1,H
1910-03-28,1909,Notts County,Bolton Wanderers,0-0,0,0,1,1,0,0,D
1910-03-28,1909,Sheffield Wednesday,Bradford City,2-1,2,1,1,1,3,1,H
1910-03-28,1909,Sunderland,Liverpool,2-1,2,1,1,1,3,1,H
1910-03-29,1909,Bradford City,Preston North End,2-0,2,0,1,1,2,2,H
1910-03-29,1909,Tottenham Hotspur,Blackburn Rovers,4-0,4,0,1,1,4,4,H
1910-04-02,1909,Bradford City,Chelsea,4-1,4,1,1,1,5,3,H
1910-04-02,1909,Bristol City,Arsenal,0-1,0,1,1,1,1,-1,A
1910-04-02,1909,Bury,Sheffield United,2-0,2,0,1,1,2,2,H
1910-04-02,1909,Everton,Nottingham Forest,0-4,0,4,1,1,4,-4,A
1910-04-02,1909,Manchester United,Blackburn Rovers,2-0,2,0,1,1,2,2,H
1910-04-02,1909,Notts County,Newcastle United,2-2,2,2,1,1,4,0,D
1910-04-02,1909,Preston North End,Liverpool,2-0,2,0,1,1,2,2,H
1910-04-02,1909,Sheffield Wednesday,Bolton Wanderers,0-0,0,0,1,1,0,0,D
1910-04-02,1909,Sunderland,Middlesbrough,2-2,2,2,1,1,4,0,D
1910-04-02,1909,Tottenham Hotspur,Aston Villa,1-1,1,1,1,1,2,0,D
1910-04-06,1909,Manchester United,Everton,3-2,3,2,1,1,5,1,H
1910-04-09,1909,Arsenal,Bury,0-0,0,0,1,1,0,0,D
1910-04-09,1909,Aston Villa,Preston North End,3-0,3,0,1,1,3,3,H
1910-04-09,1909,Blackburn Rovers,Bradford City,2-0,2,0,1,1,2,2,H
1910-04-09,1909,Bolton Wanderers,Bristol City,4-2,4,2,1,1,6,2,H
1910-04-09,1909,Chelsea,Sheffield Wednesday,4-1,4,1,1,1,5,3,H
1910-04-09,1909,Liverpool,Notts County,2-1,2,1,1,1,3,1,H
1910-04-09,1909,Middlesbrough,Newcastle United,1-1,1,1,1,1,2,0,D
1910-04-09,1909,Nottingham Forest,Manchester United,2-0,2,0,1,1,2,2,H
1910-04-09,1909,Sheffield United,Tottenham Hotspur,1-1,1,1,1,1,2,0,D
1910-04-09,1909,Sunderland,Everton,0-1,0,1,1,1,1,-1,A
1910-04-11,1909,Arsenal,Aston Villa,1-0,1,0,1,1,1,1,H
1910-04-11,1909,Blackburn Rovers,Everton,2-1,2,1,1,1,3,1,H
1910-04-13,1909,Newcastle United,Sunderland,1-0,1,0,1,1,1,1,H
1910-04-13,1909,Notts County,Everton,2-3,2,3,1,1,5,-1,A
1910-04-16,1909,Bradford City,Nottingham Forest,1-1,1,1,1,1,2,0,D
1910-04-16,1909,Bristol City,Chelsea,1-0,1,0,1,1,1,1,H
1910-04-16,1909,Bury,Bolton Wanderers,1-2,1,2,1,1,3,-1,A
1910-04-16,1909,Everton,Middlesbrough,1-1,1,1,1,1,2,0,D
1910-04-16,1909,Manchester United,Sunderland,2-0,2,0,1,1,2,2,H
1910-04-16,1909,Newcastle United,Liverpool,1-3,1,3,1,1,4,-2,A
1910-04-16,1909,Notts County,Aston Villa,2-3,2,3,1,1,5,-1,A
1910-04-16,1909,Preston North End,Sheffield United,1-1,1,1,1,1,2,0,D
1910-04-16,1909,Sheffield Wednesday,Blackburn Rovers,2-1,2,1,1,1,3,1,H
1910-04-16,1909,Tottenham Hotspur,Arsenal,1-1,1,1,1,1,2,0,D
1910-04-20,1909,Bury,Tottenham Hotspur,3-1,3,1,1,1,4,2,H
1910-04-20,1909,Liverpool,Nottingham Forest,7-3,7,3,1,1,10,4,H
1910-04-20,1909,Middlesbrough,Bristol City,0-0,0,0,1,1,0,0,D
1910-04-23,1909,Arsenal,Preston North End,1-3,1,3,1,1,4,-2,A
1910-04-23,1909,Blackburn Rovers,Sheffield United,3-1,3,1,1,1,4,2,H
1910-04-23,1909,Bolton Wanderers,Tottenham Hotspur,0-2,0,2,1,1,2,-2,A
1910-04-23,1909,Chelsea,Bury,2-0,2,0,1,1,2,2,H
1910-04-23,1909,Everton,Manchester United,3-3,3,3,1,1,6,0,D
1910-04-23,1909,Middlesbrough,Liverpool,2-2,2,2,1,1,4,0,D
1910-04-23,1909,Nottingham Forest,Sheffield Wednesday,0-6,0,6,1,1,6,-6,A
1910-04-23,1909,Sunderland,Bradford City,3-0,3,0,1,1,3,3,H
1910-04-25,1909,Bristol City,Newcastle United,0-3,0,3,1,1,3,-3,A
1910-04-27,1909,Aston Villa,Newcastle United,4-0,4,0,1,1,4,4,H
1910-04-30,1909,Bradford City,Everton,2-0,2,0,1,1,2,2,H
1910-04-30,1909,Bristol City,Nottingham Forest,4-0,4,0,1,1,4,4,H
1910-04-30,1909,Bury,Blackburn Rovers,2-1,2,1,1,1,3,1,H
1910-04-30,1909,Liverpool,Aston Villa,2-0,2,0,1,1,2,2,H
1910-04-30,1909,Manchester United,Middlesbrough,4-1,4,1,1,1,5,3,H
1910-04-30,1909,Newcastle United,Sheffield United,0-0,0,0,1,1,0,0,D
1910-04-30,1909,Preston North End,Bolton Wanderers,1-0,1,0,1,1,1,1,H
1910-04-30,1909,Sheffield Wednesday,Sunderland,1-0,1,0,1,1,1,1,H
1910-04-30,1909,Tottenham Hotspur,Chelsea,2-1,2,1,1,1,3,1,H
1910-09-01,1910,Arsenal,Manchester United,1-2,1,2,1,1,3,-1,A
1910-09-01,1910,Blackburn Rovers,Notts County,1-1,1,1,1,1,2,0,D
1910-09-01,1910,Everton,Tottenham Hotspur,2-0,2,0,1,1,2,2,H
1910-09-01,1910,Manchester City,Bury,5-1,5,1,1,1,6,4,H
1910-09-01,1910,Preston North End,Nottingham Forest,0-2,0,2,1,1,2,-2,A
1910-09-01,1910,Sunderland,Newcastle United,2-1,2,1,1,1,3,1,H
1910-09-03,1910,Aston Villa,Oldham Athletic,1-1,1,1,1,1,2,0,D
1910-09-03,1910,Bury,Arsenal,1-1,1,1,1,1,2,0,D
1910-09-03,1910,Liverpool,Bradford City,1-2,1,2,1,1,3,-1,A
1910-09-03,1910,Manchester United,Blackburn Rovers,3-2,3,2,1,1,5,1,H
1910-09-03,1910,Middlesbrough,Everton,1-0,1,0,1,1,1,1,H
1910-09-03,1910,Newcastle United,Bristol City,0-1,0,1,1,1,1,-1,A
1910-09-03,1910,Notts County,Nottingham Forest,1-1,1,1,1,1,2,0,D
1910-09-03,1910,Preston North End,Manchester City,1-1,1,1,1,1,2,0,D
1910-09-03,1910,Sheffield United,Sunderland,1-2,1,2,1,1,3,-1,A
1910-09-03,1910,Tottenham Hotspur,Sheffield Wednesday,3-1,3,1,1,1,4,2,H
1910-09-10,1910,Arsenal,Sheffield United,0-0,0,0,1,1,0,0,D
1910-09-10,1910,Blackburn Rovers,Liverpool,1-2,1,2,1,1,3,-1,A
1910-09-10,1910,Bradford City,Bury,2-2,2,2,1,1,4,0,D
1910-09-10,1910,Bristol City,Tottenham Hotspur,0-2,0,2,1,1,2,-2,A
1910-09-10,1910,Everton,Preston North End,2-0,2,0,1,1,2,2,H
1910-09-10,1910,Manchester City,Notts County,0-1,0,1,1,1,1,-1,A
1910-09-10,1910,Nottingham Forest,Manchester United,2-1,2,1,1,1,3,1,H
1910-09-10,1910,Oldham Athletic,Newcastle United,0-2,0,2,1,1,2,-2,A
1910-09-10,1910,Sheffield Wednesday,Middlesbrough,1-1,1,1,1,1,2,0,D
1910-09-10,1910,Sunderland,Aston Villa,3-2,3,2,1,1,5,1,H
1910-09-17,1910,Aston Villa,Arsenal,3-0,3,0,1,1,3,3,H
1910-09-17,1910,Bury,Blackburn Rovers,2-2,2,2,1,1,4,0,D
1910-09-17,1910,Liverpool,Nottingham Forest,2-3,2,3,1,1,5,-1,A
1910-09-17,1910,Manchester United,Manchester City,2-1,2,1,1,1,3,1,H
1910-09-17,1910,Middlesbrough,Bristol City,3-0,3,0,1,1,3,3,H
1910-09-17,1910,Notts County,Everton,0-0,0,0,1,1,0,0,D
1910-09-17,1910,Preston North End,Sheffield Wednesday,1-3,1,3,1,1,4,-2,A
1910-09-17,1910,Sheffield United,Bradford City,0-1,0,1,1,1,1,-1,A
1910-09-17,1910,Sunderland,Oldham Athletic,2-1,2,1,1,1,3,1,H
1910-09-17,1910,Tottenham Hotspur,Newcastle United,1-2,1,2,1,1,3,-1,A
1910-09-19,1910,Sheffield United,Liverpool,2-0,2,0,1,1,2,2,H
1910-09-24,1910,Arsenal,Sunderland,0-0,0,0,1,1,0,0,D
1910-09-24,1910,Blackburn Rovers,Sheffield United,1-2,1,2,1,1,3,-1,A
1910-09-24,1910,Bradford City,Aston Villa,1-2,1,2,1,1,3,-1,A
1910-09-24,1910,Bristol City,Preston North End,0-0,0,0,1,1,0,0,D
1910-09-24,1910,Everton,Manchester United,0-1,0,1,1,1,1,-1,A
1910-09-24,1910,Manchester City,Liverpool,1-2,1,2,1,1,3,-1,A
1910-09-24,1910,Newcastle United,Middlesbrough,0-0,0,0,1,1,0,0,D
1910-09-24,1910,Nottingham Forest,Bury,1-2,1,2,1,1,3,-1,A
1910-09-24,1910,Oldham Athletic,Tottenham Hotspur,2-0,2,0,1,1,2,2,H
1910-09-24,1910,Sheffield Wednesday,Notts County,1-3,1,3,1,1,4,-2,A
1910-10-01,1910,Arsenal,Oldham Athletic,0-0,0,0,1,1,0,0,D
1910-10-01,1910,Aston Villa,Blackburn Rovers,2-2,2,2,1,1,4,0,D
1910-10-01,1910,Bury,Manchester City,5-2,5,2,1,1,7,3,H
1910-10-01,1910,Liverpool,Everton,0-2,0,2,1,1,2,-2,A
1910-10-01,1910,Manchester United,Sheffield Wednesday,3-2,3,2,1,1,5,1,H
1910-10-01,1910,Middlesbrough,Tottenham Hotspur,2-0,2,0,1,1,2,2,H
1910-10-01,1910,Notts County,Bristol City,2-0,2,0,1,1,2,2,H
1910-10-01,1910,Preston North End,Newcastle United,2-1,2,1,1,1,3,1,H
1910-10-01,1910,Sheffield United,Nottingham Forest,0-1,0,1,1,1,1,-1,A
1910-10-01,1910,Sunderland,Bradford City,1-1,1,1,1,1,2,0,D
1910-10-06,1910,Nottingham Forest,Preston North End,1-3,1,3,1,1,4,-2,A
1910-10-08,1910,Blackburn Rovers,Sunderland,0-1,0,1,1,1,1,-1,A
1910-10-08,1910,Bradford City,Arsenal,3-0,3,0,1,1,3,3,H
1910-10-08,1910,Bristol City,Manchester United,0-1,0,1,1,1,1,-1,A
1910-10-08,1910,Everton,Bury,2-1,2,1,1,1,3,1,H
1910-10-08,1910,Manchester City,Sheffield United,0-4,0,4,1,1,4,-4,A
1910-10-08,1910,Newcastle United,Notts County,2-0,2,0,1,1,2,2,H
1910-10-08,1910,Nottingham Forest,Aston Villa,3-1,3,1,1,1,4,2,H
1910-10-08,1910,Oldham Athletic,Middlesbrough,1-1,1,1,1,1,2,0,D
1910-10-08,1910,Sheffield Wednesday,Liverpool,1-0,1,0,1,1,1,1,H
1910-10-08,1910,Tottenham Hotspur,Preston North End,1-1,1,1,1,1,2,0,D
1910-10-15,1910,Arsenal,Blackburn Rovers,4-1,4,1,1,1,5,3,H
1910-10-15,1910,Aston Villa,Manchester City,2-1,2,1,1,1,3,1,H
1910-10-15,1910,Bradford City,Oldham Athletic,1-2,1,2,1,1,3,-1,A
1910-10-15,1910,Bury,Sheffield Wednesday,1-1,1,1,1,1,2,0,D
1910-10-15,1910,Liverpool,Bristol City,4-0,4,0,1,1,4,4,H
1910-10-15,1910,Manchester United,Newcastle United,2-0,2,0,1,1,2,2,H
1910-10-15,1910,Notts County,Tottenham Hotspur,1-0,1,0,1,1,1,1,H
1910-10-15,1910,Preston North End,Middlesbrough,1-1,1,1,1,1,2,0,D
1910-10-15,1910,Sheffield United,Everton,0-1,0,1,1,1,1,-1,A
1910-10-15,1910,Sunderland,Nottingham Forest,2-2,2,2,1,1,4,0,D
1910-10-22,1910,Blackburn Rovers,Bradford City,3-0,3,0,1,1,3,3,H
1910-10-22,1910,Bristol City,Bury,2-0,2,0,1,1,2,2,H
1910-10-22,1910,Everton,Aston Villa,0-1,0,1,1,1,1,-1,A
1910-10-22,1910,Manchester City,Sunderland,3-3,3,3,1,1,6,0,D
1910-10-22,1910,Middlesbrough,Notts County,4-1,4,1,1,1,5,3,H
1910-10-22,1910,Newcastle United,Liverpool,6-1,6,1,1,1,7,5,H
1910-10-22,1910,Nottingham Forest,Arsenal,2-3,2,3,1,1,5,-1,A
1910-10-22,1910,Oldham Athletic,Preston North End,2-1,2,1,1,1,3,1,H
1910-10-22,1910,Sheffield Wednesday,Sheffield United,2-0,2,0,1,1,2,2,H
1910-10-22,1910,Tottenham Hotspur,Manchester United,2-2,2,2,1,1,4,0,D
1910-10-29,1910,Arsenal,Manchester City,0-1,0,1,1,1,1,-1,A
1910-10-29,1910,Aston Villa,Sheffield Wednesday,2-1,2,1,1,1,3,1,H
1910-10-29,1910,Blackburn Rovers,Oldham Athletic,1-0,1,0,1,1,1,1,H
1910-10-29,1910,Bradford City,Nottingham Forest,2-1,2,1,1,1,3,1,H
1910-10-29,1910,Bury,Newcastle United,1-1,1,1,1,1,2,0,D
1910-10-29,1910,Liverpool,Tottenham Hotspur,1-2,1,2,1,1,3,-1,A
1910-10-29,1910,Manchester United,Middlesbrough,1-2,1,2,1,1,3,-1,A
1910-10-29,1910,Notts County,Preston North End,3-3,3,3,1,1,6,0,D
1910-10-29,1910,Sheffield United,Bristol City,0-4,0,4,1,1,4,-4,A
1910-10-29,1910,Sunderland,Everton,4-0,4,0,1,1,4,4,H
1910-11-05,1910,Bristol City,Aston Villa,1-2,1,2,1,1,3,-1,A
1910-11-05,1910,Everton,Arsenal,2-0,2,0,1,1,2,2,H
1910-11-05,1910,Manchester City,Bradford City,1-3,1,3,1,1,4,-2,A
1910-11-05,1910,Middlesbrough,Liverpool,2-2,2,2,1,1,4,0,D
1910-11-05,1910,Newcastle United,Sheffield United,1-1,1,1,1,1,2,0,D
1910-11-05,1910,Nottingham Forest,Blackburn Rovers,5-2,5,2,1,1,7,3,H
1910-11-05,1910,Oldham Athletic,Notts County,2-1,2,1,1,1,3,1,H
1910-11-05,1910,Preston North End,Manchester United,0-2,0,2,1,1,2,-2,A
1910-11-05,1910,Sheffield Wednesday,Sunderland,1-1,1,1,1,1,2,0,D
1910-11-05,1910,Tottenham Hotspur,Bury,5-0,5,0,1,1,5,5,H
1910-11-12,1910,Arsenal,Sheffield Wednesday,1-0,1,0,1,1,1,1,H
1910-11-12,1910,Aston Villa,Newcastle United,3-2,3,2,1,1,5,1,H
1910-11-12,1910,Blackburn Rovers,Manchester City,2-0,2,0,1,1,2,2,H
1910-11-12,1910,Bradford City,Everton,3-1,3,1,1,1,4,2,H
1910-11-12,1910,Bury,Middlesbrough,4-2,4,2,1,1,6,2,H
1910-11-12,1910,Liverpool,Preston North End,3-0,3,0,1,1,3,3,H
1910-11-12,1910,Manchester United,Notts County,0-0,0,0,1,1,0,0,D
1910-11-12,1910,Nottingham Forest,Oldham Athletic,4-1,4,1,1,1,5,3,H
1910-11-12,1910,Sheffield United,Tottenham Hotspur,3-0,3,0,1,1,3,3,H
1910-11-12,1910,Sunderland,Bristol City,3-1,3,1,1,1,4,2,H
1910-11-19,1910,Bristol City,Arsenal,0-1,0,1,1,1,1,-1,A
1910-11-19,1910,Everton,Blackburn Rovers,6-1,6,1,1,1,7,5,H
1910-11-19,1910,Manchester City,Nottingham Forest,1-0,1,0,1,1,1,1,H
1910-11-19,1910,Middlesbrough,Sheffield United,3-1,3,1,1,1,4,2,H
1910-11-19,1910,Newcastle United,Sunderland,1-1,1,1,1,1,2,0,D
1910-11-19,1910,Notts County,Liverpool,1-0,1,0,1,1,1,1,H
1910-11-19,1910,Oldham Athletic,Manchester United,1-3,1,3,1,1,4,-2,A
1910-11-19,1910,Preston North End,Bury,2-0,2,0,1,1,2,2,H
1910-11-19,1910,Sheffield Wednesday,Bradford City,0-1,0,1,1,1,1,-1,A
1910-11-19,1910,Tottenham Hotspur,Aston Villa,1-2,1,2,1,1,3,-1,A
1910-11-26,1910,Arsenal,Newcastle United,1-2,1,2,1,1,3,-1,A
1910-11-26,1910,Aston Villa,Middlesbrough,5-0,5,0,1,1,5,5,H
1910-11-26,1910,Blackburn Rovers,Sheffield Wednesday,6-1,6,1,1,1,7,5,H
1910-11-26,1910,Bradford City,Bristol City,3-1,3,1,1,1,4,2,H
1910-11-26,1910,Bury,Notts County,0-0,0,0,1,1,0,0,D
1910-11-26,1910,Liverpool,Manchester United,3-2,3,2,1,1,5,1,H
1910-11-26,1910,Manchester City,Oldham Athletic,2-0,2,0,1,1,2,2,H
1910-11-26,1910,Nottingham Forest,Everton,1-1,1,1,1,1,2,0,D
1910-11-26,1910,Sheffield United,Preston North End,5-0,5,0,1,1,5,5,H
1910-11-26,1910,Sunderland,Tottenham Hotspur,4-0,4,0,1,1,4,4,H
1910-12-03,1910,Bristol City,Blackburn Rovers,1-0,1,0,1,1,1,1,H
1910-12-03,1910,Everton,Manchester City,1-0,1,0,1,1,1,1,H
1910-12-03,1910,Manchester United,Bury,3-2,3,2,1,1,5,1,H
1910-12-03,1910,Middlesbrough,Sunderland,1-0,1,0,1,1,1,1,H
1910-12-03,1910,Newcastle United,Bradford City,6-1,6,1,1,1,7,5,H
1910-12-03,1910,Notts County,Sheffield United,0-3,0,3,1,1,3,-3,A
1910-12-03,1910,Oldham Athletic,Liverpool,3-1,3,1,1,1,4,2,H
1910-12-03,1910,Preston North End,Aston Villa,0-1,0,1,1,1,1,-1,A
1910-12-03,1910,Sheffield Wednesday,Nottingham Forest,5-2,5,2,1,1,7,3,H
1910-12-03,1910,Tottenham Hotspur,Arsenal,3-1,3,1,1,1,4,2,H
1910-12-10,1910,Arsenal,Middlesbrough,0-2,0,2,1,1,2,-2,A
1910-12-10,1910,Aston Villa,Notts County,3-1,3,1,1,1,4,2,H
1910-12-10,1910,Blackburn Rovers,Newcastle United,3-1,3,1,1,1,4,2,H
1910-12-10,1910,Bradford City,Tottenham Hotspur,3-0,3,0,1,1,3,3,H
1910-12-10,1910,Bury,Liverpool,3-0,3,0,1,1,3,3,H
1910-12-10,1910,Everton,Oldham Athletic,1-0,1,0,1,1,1,1,H
1910-12-10,1910,Manchester City,Sheffield Wednesday,1-2,1,2,1,1,3,-1,A
1910-12-10,1910,Nottingham Forest,Bristol City,3-3,3,3,1,1,6,0,D
1910-12-10,1910,Sheffield United,Manchester United,2-0,2,0,1,1,2,2,H
1910-12-10,1910,Sunderland,Preston North End,1-1,1,1,1,1,2,0,D
1910-12-17,1910,Bristol City,Manchester City,2-1,2,1,1,1,3,1,H
1910-12-17,1910,Bury,Oldham Athletic,2-2,2,2,1,1,4,0,D
1910-12-17,1910,Liverpool,Sheffield United,2-0,2,0,1,1,2,2,H
1910-12-17,1910,Manchester United,Aston Villa,2-0,2,0,1,1,2,2,H
1910-12-17,1910,Middlesbrough,Bradford City,3-2,3,2,1,1,5,1,H
1910-12-17,1910,Newcastle United,Nottingham Forest,4-1,4,1,1,1,5,3,H
1910-12-17,1910,Notts County,Sunderland,1-1,1,1,1,1,2,0,D
1910-12-17,1910,Preston North End,Arsenal,4-1,4,1,1,1,5,3,H
1910-12-17,1910,Sheffield Wednesday,Everton,0-2,0,2,1,1,2,-2,A
1910-12-17,1910,Tottenham Hotspur,Blackburn Rovers,2-2,2,2,1,1,4,0,D
1910-12-24,1910,Arsenal,Notts County,2-1,2,1,1,1,3,1,H
1910-12-24,1910,Aston Villa,Liverpool,1-1,1,1,1,1,2,0,D
1910-12-24,1910,Blackburn Rovers,Middlesbrough,5-1,5,1,1,1,6,4,H
1910-12-24,1910,Bradford City,Preston North End,1-0,1,0,1,1,1,1,H
1910-12-24,1910,Everton,Bristol City,4-3,4,3,1,1,7,1,H
1910-12-24,1910,Manchester City,Newcastle United,2-0,2,0,1,1,2,2,H
1910-12-24,1910,Nottingham Forest,Tottenham Hotspur,1-2,1,2,1,1,3,-1,A
1910-12-24,1910,Oldham Athletic,Sheffield Wednesday,1-0,1,0,1,1,1,1,H
1910-12-24,1910,Sheffield United,Bury,3-0,3,0,1,1,3,3,H
1910-12-24,1910,Sunderland,Manchester United,1-2,1,2,1,1,3,-1,A
1910-12-26,1910,Aston Villa,Bury,4-1,4,1,1,1,5,3,H
1910-12-26,1910,Bristol City,Sheffield Wednesday,2-2,2,2,1,1,4,0,D
1910-12-26,1910,Liverpool,Sunderland,1-2,1,2,1,1,3,-1,A
1910-12-26,1910,Manchester United,Arsenal,5-0,5,0,1,1,5,5,H
1910-12-26,1910,Middlesbrough,Manchester City,0-0,0,0,1,1,0,0,D
1910-12-26,1910,Newcastle United,Everton,1-0,1,0,1,1,1,1,H
1910-12-26,1910,Notts County,Bradford City,1-1,1,1,1,1,2,0,D
1910-12-26,1910,Preston North End,Blackburn Rovers,0-0,0,0,1,1,0,0,D
1910-12-26,1910,Sheffield United,Oldham Athletic,1-2,1,2,1,1,3,-1,A
1910-12-26,1910,Tottenham Hotspur,Nottingham Forest,1-4,1,4,1,1,5,-3,A
1910-12-27,1910,Bradford City,Manchester United,1-0,1,0,1,1,1,1,H
1910-12-27,1910,Bristol City,Oldham Athletic,3-2,3,2,1,1,5,1,H
1910-12-27,1910,Everton,Liverpool,0-1,0,1,1,1,1,-1,A
1910-12-27,1910,Nottingham Forest,Middlesbrough,1-1,1,1,1,1,2,0,D
1910-12-27,1910,Sheffield Wednesday,Newcastle United,0-2,0,2,1,1,2,-2,A
1910-12-27,1910,Tottenham Hotspur,Manchester City,1-1,1,1,1,1,2,0,D
1910-12-28,1910,Sheffield United,Aston Villa,2-1,2,1,1,1,3,1,H
1910-12-31,1910,Arsenal,Bury,3-2,3,2,1,1,5,1,H
1910-12-31,1910,Blackburn Rovers,Manchester United,1-0,1,0,1,1,1,1,H
1910-12-31,1910,Bradford City,Liverpool,1-3,1,3,1,1,4,-2,A
1910-12-31,1910,Bristol City,Newcastle United,1-0,1,0,1,1,1,1,H
1910-12-31,1910,Everton,Middlesbrough,2-0,2,0,1,1,2,2,H
1910-12-31,1910,Manchester City,Preston North End,0-2,0,2,1,1,2,-2,A
1910-12-31,1910,Nottingham Forest,Notts County,0-2,0,2,1,1,2,-2,A
1910-12-31,1910,Oldham Athletic,Aston Villa,1-1,1,1,1,1,2,0,D
1910-12-31,1910,Sheffield Wednesday,Tottenham Hotspur,2-1,2,1,1,1,3,1,H
1910-12-31,1910,Sunderland,Sheffield United,0-2,0,2,1,1,2,-2,A
1911-01-02,1910,Blackburn Rovers,Preston North End,0-1,0,1,1,1,1,-1,A
1911-01-02,1910,Bury,Aston Villa,1-0,1,0,1,1,1,1,H
1911-01-02,1910,Everton,Newcastle United,1-5,1,5,1,1,6,-4,A
1911-01-02,1910,Manchester United,Bradford City,1-0,1,0,1,1,1,1,H
1911-01-02,1910,Middlesbrough,Nottingham Forest,2-2,2,2,1,1,4,0,D
1911-01-02,1910,Sheffield Wednesday,Bristol City,2-1,2,1,1,1,3,1,H
1911-01-02,1910,Sunderland,Liverpool,4-0,4,0,1,1,4,4,H
1911-01-03,1910,Manchester City,Tottenham Hotspur,2-1,2,1,1,1,3,1,H
1911-01-03,1910,Newcastle United,Preston North End,1-1,1,1,1,1,2,0,D
1911-01-07,1910,Aston Villa,Sunderland,2-1,2,1,1,1,3,1,H
1911-01-07,1910,Bury,Bradford City,0-1,0,1,1,1,1,-1,A
1911-01-07,1910,Liverpool,Blackburn Rovers,2-2,2,2,1,1,4,0,D
1911-01-07,1910,Manchester United,Nottingham Forest,4-2,4,2,1,1,6,2,H
1911-01-07,1910,Middlesbrough,Sheffield Wednesday,0-1,0,1,1,1,1,-1,A
1911-01-07,1910,Newcastle United,Oldham Athletic,3-0,3,0,1,1,3,3,H
1911-01-07,1910,Notts County,Manchester City,0-1,0,1,1,1,1,-1,A
1911-01-07,1910,Preston North End,Everton,0-2,0,2,1,1,2,-2,A
1911-01-07,1910,Sheffield United,Arsenal,3-2,3,2,1,1,5,1,H
1911-01-07,1910,Tottenham Hotspur,Bristol City,3-2,3,2,1,1,5,1,H
1911-01-21,1910,Blackburn Rovers,Bury,6-2,6,2,1,1,8,4,H
1911-01-21,1910,Bradford City,Sheffield United,0-1,0,1,1,1,1,-1,A
1911-01-21,1910,Bristol City,Middlesbrough,3-2,3,2,1,1,5,1,H
1911-01-21,1910,Everton,Notts County,5-0,5,0,1,1,5,5,H
1911-01-21,1910,Manchester City,Manchester United,1-1,1,1,1,1,2,0,D
1911-01-21,1910,Newcastle United,Tottenham Hotspur,1-1,1,1,1,1,2,0,D
1911-01-21,1910,Nottingham Forest,Liverpool,2-0,2,0,1,1,2,2,H
1911-01-21,1910,Oldham Athletic,Sunderland,2-1,2,1,1,1,3,1,H
1911-01-21,1910,Sheffield Wednesday,Preston North End,0-0,0,0,1,1,0,0,D
1911-01-28,1910,Aston Villa,Bradford City,4-1,4,1,1,1,5,3,H
1911-01-28,1910,Bury,Nottingham Forest,1-0,1,0,1,1,1,1,H
1911-01-28,1910,Liverpool,Manchester City,1-1,1,1,1,1,2,0,D
1911-01-28,1910,Manchester United,Everton,2-2,2,2,1,1,4,0,D
1911-01-28,1910,Middlesbrough,Newcastle United,0-2,0,2,1,1,2,-2,A
1911-01-28,1910,Notts County,Sheffield Wednesday,2-0,2,0,1,1,2,2,H
1911-01-28,1910,Preston North End,Bristol City,4-0,4,0,1,1,4,4,H
1911-01-28,1910,Sheffield United,Blackburn Rovers,1-1,1,1,1,1,2,0,D
1911-01-28,1910,Sunderland,Arsenal,2-2,2,2,1,1,4,0,D
1911-02-04,1910,Bristol City,Notts County,1-0,1,0,1,1,1,1,H
1911-02-04,1910,Nottingham Forest,Sheffield United,1-2,1,2,1,1,3,-1,A
1911-02-04,1910,Sunderland,Bury,4-1,4,1,1,1,5,3,H
1911-02-11,1910,Arsenal,Bradford City,0-0,0,0,1,1,0,0,D
1911-02-11,1910,Aston Villa,Nottingham Forest,3-1,3,1,1,1,4,2,H
1911-02-11,1910,Bury,Everton,0-0,0,0,1,1,0,0,D
1911-02-11,1910,Liverpool,Sheffield Wednesday,3-0,3,0,1,1,3,3,H
1911-02-11,1910,Manchester United,Bristol City,3-1,3,1,1,1,4,2,H
1911-02-11,1910,Middlesbrough,Oldham Athletic,1-2,1,2,1,1,3,-1,A
1911-02-11,1910,Notts County,Newcastle United,2-2,2,2,1,1,4,0,D
1911-02-11,1910,Preston North End,Tottenham Hotspur,2-0,2,0,1,1,2,2,H
1911-02-11,1910,Sheffield United,Manchester City,2-2,2,2,1,1,4,0,D
1911-02-11,1910,Sunderland,Blackburn Rovers,2-2,2,2,1,1,4,0,D
1911-02-13,1910,Tottenham Hotspur,Middlesbrough,6-2,6,2,1,1,8,4,H
1911-02-18,1910,Blackburn Rovers,Arsenal,1-0,1,0,1,1,1,1,H
1911-02-18,1910,Bristol City,Liverpool,1-1,1,1,1,1,2,0,D
1911-02-18,1910,Everton,Sheffield United,1-0,1,0,1,1,1,1,H
1911-02-18,1910,Manchester City,Aston Villa,1-1,1,1,1,1,2,0,D
1911-02-18,1910,Middlesbrough,Preston North End,2-0,2,0,1,1,2,2,H
1911-02-18,1910,Newcastle United,Manchester United,0-1,0,1,1,1,1,-1,A
1911-02-18,1910,Nottingham Forest,Sunderland,1-3,1,3,1,1,4,-2,A
1911-02-18,1910,Oldham Athletic,Bradford City,1-0,1,0,1,1,1,1,H
1911-02-18,1910,Sheffield Wednesday,Bury,1-0,1,0,1,1,1,1,H
1911-02-18,1910,Tottenham Hotspur,Notts County,3-0,3,0,1,1,3,3,H
1911-02-25,1910,Arsenal,Nottingham Forest,3-2,3,2,1,1,5,1,H
1911-02-25,1910,Aston Villa,Tottenham Hotspur,4-0,4,0,1,1,4,4,H
1911-02-25,1910,Bury,Bristol City,2-1,2,1,1,1,3,1,H
1911-02-25,1910,Preston North End,Oldham Athletic,1-1,1,1,1,1,2,0,D
1911-02-25,1910,Sheffield United,Sheffield Wednesday,0-1,0,1,1,1,1,-1,A
1911-02-25,1910,Sunderland,Manchester City,4-0,4,0,1,1,4,4,H
1911-02-27,1910,Liverpool,Newcastle United,3-0,3,0,1,1,3,3,H
1911-02-28,1910,Bradford City,Blackburn Rovers,1-0,1,0,1,1,1,1,H
1911-03-04,1910,Bristol City,Sheffield United,0-2,0,2,1,1,2,-2,A
1911-03-04,1910,Everton,Sunderland,2-2,2,2,1,1,4,0,D
1911-03-04,1910,Manchester City,Arsenal,1-1,1,1,1,1,2,0,D
1911-03-04,1910,Middlesbrough,Manchester United,2-2,2,2,1,1,4,0,D
1911-03-04,1910,Newcastle United,Bury,5-1,5,1,1,1,6,4,H
1911-03-04,1910,Nottingham Forest,Bradford City,0-2,0,2,1,1,2,-2,A
1911-03-04,1910,Oldham Athletic,Blackburn Rovers,2-0,2,0,1,1,2,2,H
1911-03-04,1910,Preston North End,Notts County,2-0,2,0,1,1,2,2,H
1911-03-04,1910,Sheffield Wednesday,Aston Villa,1-0,1,0,1,1,1,1,H
1911-03-04,1910,Tottenham Hotspur,Liverpool,1-0,1,0,1,1,1,1,H
1911-03-06,1910,Oldham Athletic,Arsenal,3-0,3,0,1,1,3,3,H
1911-03-11,1910,Arsenal,Everton,1-0,1,0,1,1,1,1,H
1911-03-11,1910,Aston Villa,Bristol City,2-0,2,0,1,1,2,2,H
1911-03-11,1910,Bury,Tottenham Hotspur,2-1,2,1,1,1,3,1,H
1911-03-11,1910,Liverpool,Middlesbrough,3-0,3,0,1,1,3,3,H
1911-03-11,1910,Manchester United,Preston North End,5-0,5,0,1,1,5,5,H
1911-03-11,1910,Notts County,Oldham Athletic,1-0,1,0,1,1,1,1,H
1911-03-11,1910,Sunderland,Sheffield Wednesday,1-2,1,2,1,1,3,-1,A
1911-03-14,1910,Bradford City,Manchester City,1-0,1,0,1,1,1,1,H
1911-03-15,1910,Arsenal,Aston Villa,1-1,1,1,1,1,2,0,D
1911-03-15,1910,Manchester United,Tottenham Hotspur,3-2,3,2,1,1,5,1,H
1911-03-18,1910,Bristol City,Sunderland,1-1,1,1,1,1,2,0,D
1911-03-18,1910,Everton,Bradford City,0-0,0,0,1,1,0,0,D
1911-03-18,1910,Manchester City,Blackburn Rovers,0-0,0,0,1,1,0,0,D
1911-03-18,1910,Middlesbrough,Bury,2-1,2,1,1,1,3,1,H
1911-03-18,1910,Newcastle United,Aston Villa,1-0,1,0,1,1,1,1,H
1911-03-18,1910,Notts County,Manchester United,1-0,1,0,1,1,1,1,H
1911-03-18,1910,Oldham Athletic,Nottingham Forest,2-0,2,0,1,1,2,2,H
1911-03-18,1910,Preston North End,Liverpool,2-1,2,1,1,1,3,1,H
1911-03-18,1910,Sheffield Wednesday,Arsenal,0-0,0,0,1,1,0,0,D
1911-03-18,1910,Tottenham Hotspur,Sheffield United,2-1,2,1,1,1,3,1,H
1911-03-25,1910,Arsenal,Bristol City,3-0,3,0,1,1,3,3,H
1911-03-25,1910,Bury,Preston North End,1-0,1,0,1,1,1,1,H
1911-03-25,1910,Liverpool,Notts County,2-1,2,1,1,1,3,1,H
1911-03-25,1910,Manchester United,Oldham Athletic,0-0,0,0,1,1,0,0,D
1911-03-25,1910,Nottingham Forest,Manchester City,0-0,0,0,1,1,0,0,D
1911-03-27,1910,Aston Villa,Everton,2-1,2,1,1,1,3,1,H
1911-03-27,1910,Blackburn Rovers,Nottingham Forest,4-1,4,1,1,1,5,3,H
1911-03-27,1910,Sheffield United,Middlesbrough,2-1,2,1,1,1,3,1,H
1911-03-27,1910,Tottenham Hotspur,Oldham Athletic,2-0,2,0,1,1,2,2,H
1911-04-01,1910,Bristol City,Bradford City,0-2,0,2,1,1,2,-2,A
1911-04-01,1910,Manchester United,Liverpool,2-0,2,0,1,1,2,2,H
1911-04-01,1910,Middlesbrough,Aston Villa,0-1,0,1,1,1,1,-1,A
1911-04-01,1910,Newcastle United,Arsenal,0-1,0,1,1,1,1,-1,A
1911-04-01,1910,Notts County,Bury,1-0,1,0,1,1,1,1,H
1911-04-01,1910,Oldham Athletic,Manchester City,1-1,1,1,1,1,2,0,D
1911-04-01,1910,Preston North End,Sheffield United,1-1,1,1,1,1,2,0,D
1911-04-01,1910,Sheffield Wednesday,Blackburn Rovers,1-0,1,0,1,1,1,1,H
1911-04-01,1910,Tottenham Hotspur,Sunderland,1-1,1,1,1,1,2,0,D
1911-04-03,1910,Sheffield United,Newcastle United,0-0,0,0,1,1,0,0,D
1911-04-04,1910,Bradford City,Sheffield Wednesday,5-2,5,2,1,1,7,3,H
1911-04-05,1910,Nottingham Forest,Newcastle United,0-1,0,1,1,1,1,-1,A
1911-04-06,1910,Blackburn Rovers,Everton,0-1,0,1,1,1,1,-1,A
1911-04-08,1910,Arsenal,Tottenham Hotspur,2-0,2,0,1,1,2,2,H
1911-04-08,1910,Aston Villa,Preston North End,0-2,0,2,1,1,2,-2,A
1911-04-08,1910,Blackburn Rovers,Bristol City,2-0,2,0,1,1,2,2,H
1911-04-08,1910,Bradford City,Newcastle United,1-0,1,0,1,1,1,1,H
1911-04-08,1910,Bury,Manchester United,0-3,0,3,1,1,3,-3,A
1911-04-08,1910,Liverpool,Oldham Athletic,1-0,1,0,1,1,1,1,H
1911-04-08,1910,Manchester City,Everton,2-1,2,1,1,1,3,1,H
1911-04-08,1910,Nottingham Forest,Sheffield Wednesday,0-1,0,1,1,1,1,-1,A
1911-04-08,1910,Sheffield United,Notts County,0-2,0,2,1,1,2,-2,A
1911-04-08,1910,Sunderland,Middlesbrough,3-1,3,1,1,1,4,2,H
1911-04-11,1910,Bradford City,Sunderland,3-0,3,0,1,1,3,3,H
1911-04-14,1910,Arsenal,Liverpool,0-0,0,0,1,1,0,0,D
1911-04-14,1910,Aston Villa,Sheffield United,3-0,3,0,1,1,3,3,H
1911-04-14,1910,Bury,Sunderland,0-0,0,0,1,1,0,0,D
1911-04-14,1910,Everton,Nottingham Forest,2-1,2,1,1,1,3,1,H
1911-04-14,1910,Manchester City,Middlesbrough,2-1,2,1,1,1,3,1,H
1911-04-14,1910,Newcastle United,Sheffield Wednesday,0-2,0,2,1,1,2,-2,A
1911-04-14,1910,Notts County,Blackburn Rovers,2-0,2,0,1,1,2,2,H
1911-04-14,1910,Oldham Athletic,Bristol City,1-0,1,0,1,1,1,1,H
1911-04-15,1910,Bristol City,Nottingham Forest,5-1,5,1,1,1,6,4,H
1911-04-15,1910,Liverpool,Bury,2-0,2,0,1,1,2,2,H
1911-04-15,1910,Manchester United,Sheffield United,1-1,1,1,1,1,2,0,D
1911-04-15,1910,Middlesbrough,Arsenal,1-1,1,1,1,1,2,0,D
1911-04-15,1910,Newcastle United,Blackburn Rovers,2-2,2,2,1,1,4,0,D
1911-04-15,1910,Notts County,Aston Villa,1-2,1,2,1,1,3,-1,A
1911-04-15,1910,Oldham Athletic,Everton,2-0,2,0,1,1,2,2,H
1911-04-15,1910,Preston North End,Sunderland,0-2,0,2,1,1,2,-2,A
1911-04-15,1910,Sheffield Wednesday,Manchester City,4-1,4,1,1,1,5,3,H
1911-04-15,1910,Tottenham Hotspur,Bradford City,2-0,2,0,1,1,2,2,H
1911-04-17,1910,Bradford City,Notts County,0-1,0,1,1,1,1,-1,A
1911-04-17,1910,Liverpool,Arsenal,1-1,1,1,1,1,2,0,D
1911-04-17,1910,Oldham Athletic,Sheffield United,3-0,3,0,1,1,3,3,H
1911-04-17,1910,Sheffield Wednesday,Manchester United,0-0,0,0,1,1,0,0,D
1911-04-17,1910,Tottenham Hotspur,Everton,0-1,0,1,1,1,1,-1,A
1911-04-18,1910,Notts County,Middlesbrough,1-0,1,0,1,1,1,1,H
1911-04-22,1910,Arsenal,Preston North End,2-0,2,0,1,1,2,2,H
1911-04-22,1910,Aston Villa,Manchester United,4-2,4,2,1,1,6,2,H
1911-04-22,1910,Blackburn Rovers,Tottenham Hotspur,3-0,3,0,1,1,3,3,H
1911-04-22,1910,Everton,Sheffield Wednesday,1-1,1,1,1,1,2,0,D
1911-04-22,1910,Manchester City,Bristol City,1-2,1,2,1,1,3,-1,A
1911-04-22,1910,Oldham Athletic,Bury,0-0,0,0,1,1,0,0,D
1911-04-22,1910,Sunderland,Notts County,1-1,1,1,1,1,2,0,D
1911-04-24,1910,Blackburn Rovers,Aston Villa,0-0,0,0,1,1,0,0,D
1911-04-27,1910,Bradford City,Middlesbrough,1-0,1,0,1,1,1,1,H
1911-04-29,1910,Bristol City,Everton,0-1,0,1,1,1,1,-1,A
1911-04-29,1910,Bury,Sheffield United,1-1,1,1,1,1,2,0,D
1911-04-29,1910,Liverpool,Aston Villa,3-1,3,1,1,1,4,2,H
1911-04-29,1910,Manchester United,Sunderland,5-1,5,1,1,1,6,4,H
1911-04-29,1910,Middlesbrough,Blackburn Rovers,2-3,2,3,1,1,5,-1,A
1911-04-29,1910,Newcastle United,Manchester City,3-3,3,3,1,1,6,0,D
1911-04-29,1910,Notts County,Arsenal,0-2,0,2,1,1,2,-2,A
1911-04-29,1910,Preston North End,Bradford City,2-0,2,0,1,1,2,2,H
1911-04-29,1910,Sheffield Wednesday,Oldham Athletic,2-0,2,0,1,1,2,2,H
1911-09-02,1911,Arsenal,Liverpool,2-2,2,2,1,1,4,0,D
1911-09-02,1911,Blackburn Rovers,Bury,2-0,2,0,1,1,2,2,H
1911-09-02,1911,Bolton Wanderers,Newcastle United,0-2,0,2,1,1,2,-2,A
1911-09-02,1911,Bradford City,Aston Villa,2-1,2,1,1,1,3,1,H
1911-09-02,1911,Everton,Tottenham Hotspur,2-2,2,2,1,1,4,0,D
1911-09-02,1911,Manchester City,Manchester United,0-0,0,0,1,1,0,0,D
1911-09-02,1911,Oldham Athletic,Sheffield United,2-3,2,3,1,1,5,-1,A
1911-09-02,1911,Sheffield Wednesday,Preston North End,0-1,0,1,1,1,1,-1,A
1911-09-02,1911,Sunderland,Middlesbrough,1-0,1,0,1,1,1,1,H
1911-09-02,1911,West Bromwich Albion,Notts County,2-1,2,1,1,1,3,1,H
1911-09-04,1911,Aston Villa,West Bromwich Albion,0-3,0,3,1,1,3,-3,A
1911-09-04,1911,Bolton Wanderers,Liverpool,2-1,2,1,1,1,3,1,H
1911-09-04,1911,Tottenham Hotspur,Sheffield Wednesday,3-1,3,1,1,1,4,2,H
1911-09-06,1911,Newcastle United,Everton,2-0,2,0,1,1,2,2,H
1911-09-06,1911,Sunderland,Blackburn Rovers,3-0,3,0,1,1,3,3,H
1911-09-09,1911,Aston Villa,Arsenal,4-1,4,1,1,1,5,3,H
1911-09-09,1911,Bury,Sheffield Wednesday,2-2,2,2,1,1,4,0,D
1911-09-09,1911,Liverpool,Manchester City,2-2,2,2,1,1,4,0,D
1911-09-09,1911,Manchester United,Everton,2-1,2,1,1,1,3,1,H
1911-09-09,1911,Middlesbrough,Blackburn Rovers,2-1,2,1,1,1,3,1,H
1911-09-09,1911,Newcastle United,Bradford City,0-2,0,2,1,1,2,-2,A
1911-09-09,1911,Notts County,Sunderland,3-1,3,1,1,1,4,2,H
1911-09-09,1911,Preston North End,Oldham Athletic,0-1,0,1,1,1,1,-1,A
1911-09-09,1911,Sheffield United,Bolton Wanderers,0-5,0,5,1,1,5,-5,A
1911-09-09,1911,Tottenham Hotspur,West Bromwich Albion,1-0,1,0,1,1,1,1,H
1911-09-16,1911,Arsenal,Newcastle United,2-0,2,0,1,1,2,2,H
1911-09-16,1911,Blackburn Rovers,Notts County,0-0,0,0,1,1,0,0,D
1911-09-16,1911,Bolton Wanderers,Oldham Athletic,2-1,2,1,1,1,3,1,H
1911-09-16,1911,Bradford City,Sheffield United,1-0,1,0,1,1,1,1,H
1911-09-16,1911,Bury,Preston North End,0-0,0,0,1,1,0,0,D
1911-09-16,1911,Everton,Liverpool,2-1,2,1,1,1,3,1,H
1911-09-16,1911,Manchester City,Aston Villa,2-6,2,6,1,1,8,-4,A
1911-09-16,1911,Sheffield Wednesday,Middlesbrough,0-2,0,2,1,1,2,-2,A
1911-09-16,1911,Sunderland,Tottenham Hotspur,1-1,1,1,1,1,2,0,D
1911-09-16,1911,West Bromwich Albion,Manchester United,1-0,1,0,1,1,1,1,H
1911-09-23,1911,Aston Villa,Everton,3-0,3,0,1,1,3,3,H
1911-09-23,1911,Liverpool,West Bromwich Albion,1-3,1,3,1,1,4,-2,A
1911-09-23,1911,Manchester United,Sunderland,2-2,2,2,1,1,4,0,D
1911-09-23,1911,Middlesbrough,Bury,1-1,1,1,1,1,2,0,D
1911-09-23,1911,Newcastle United,Manchester City,1-0,1,0,1,1,1,1,H
1911-09-23,1911,Notts County,Sheffield Wednesday,1-0,1,0,1,1,1,1,H
1911-09-23,1911,Oldham Athletic,Bradford City,3-0,3,0,1,1,3,3,H
1911-09-23,1911,Preston North End,Bolton Wanderers,1-2,1,2,1,1,3,-1,A
1911-09-23,1911,Sheffield United,Arsenal,2-1,2,1,1,1,3,1,H
1911-09-23,1911,Tottenham Hotspur,Blackburn Rovers,0-2,0,2,1,1,2,-2,A
1911-09-30,1911,Arsenal,Oldham Athletic,1-1,1,1,1,1,2,0,D
1911-09-30,1911,Blackburn Rovers,Manchester United,2-2,2,2,1,1,4,0,D
1911-09-30,1911,Bradford City,Bolton Wanderers,1-0,1,0,1,1,1,1,H
1911-09-30,1911,Bury,Notts County,0-1,0,1,1,1,1,-1,A
1911-09-30,1911,Everton,Newcastle United,2-0,2,0,1,1,2,2,H
1911-09-30,1911,Manchester City,Sheffield United,0-0,0,0,1,1,0,0,D
1911-09-30,1911,Middlesbrough,Preston North End,4-2,4,2,1,1,6,2,H
1911-09-30,1911,Sheffield Wednesday,Tottenham Hotspur,4-0,4,0,1,1,4,4,H
1911-09-30,1911,Sunderland,Liverpool,1-2,1,2,1,1,3,-1,A
1911-09-30,1911,West Bromwich Albion,Aston Villa,2-2,2,2,1,1,4,0,D
1911-10-05,1911,Notts County,Bradford City,0-0,0,0,1,1,0,0,D
1911-10-07,1911,Aston Villa,Sunderland,1-3,1,3,1,1,4,-2,A
1911-10-07,1911,Bolton Wanderers,Arsenal,2-2,2,2,1,1,4,0,D
1911-10-07,1911,Liverpool,Blackburn Rovers,1-2,1,2,1,1,3,-1,A
1911-10-07,1911,Manchester United,Sheffield Wednesday,3-1,3,1,1,1,4,2,H
1911-10-07,1911,Newcastle United,West Bromwich Albion,0-0,0,0,1,1,0,0,D
1911-10-07,1911,Notts County,Middlesbrough,2-1,2,1,1,1,3,1,H
1911-10-07,1911,Oldham Athletic,Manchester City,4-1,4,1,1,1,5,3,H
1911-10-07,1911,Preston North End,Bradford City,2-2,2,2,1,1,4,0,D
1911-10-07,1911,Sheffield United,Everton,2-1,2,1,1,1,3,1,H
1911-10-07,1911,Tottenham Hotspur,Bury,2-1,2,1,1,1,3,1,H
1911-10-14,1911,Arsenal,Bradford City,2-0,2,0,1,1,2,2,H
1911-10-14,1911,Blackburn Rovers,Aston Villa,3-1,3,1,1,1,4,2,H
1911-10-14,1911,Bury,Manchester United,0-1,0,1,1,1,1,-1,A
1911-10-14,1911,Everton,Oldham Athletic,1-1,1,1,1,1,2,0,D
1911-10-14,1911,Manchester City,Bolton Wanderers,3-1,3,1,1,1,4,2,H
1911-10-14,1911,Middlesbrough,Tottenham Hotspur,2-0,2,0,1,1,2,2,H
1911-10-14,1911,Notts County,Preston North End,1-2,1,2,1,1,3,-1,A
1911-10-14,1911,Sheffield Wednesday,Liverpool,2-2,2,2,1,1,4,0,D
1911-10-14,1911,Sunderland,Newcastle United,1-2,1,2,1,1,3,-1,A
1911-10-14,1911,West Bromwich Albion,Sheffield United,0-1,0,1,1,1,1,-1,A
1911-10-21,1911,Aston Villa,Sheffield Wednesday,2-3,2,3,1,1,5,-1,A
1911-10-21,1911,Bolton Wanderers,Everton,1-2,1,2,1,1,3,-1,A
1911-10-21,1911,Bradford City,Manchester City,4-1,4,1,1,1,5,3,H
1911-10-21,1911,Liverpool,Bury,1-1,1,1,1,1,2,0,D
1911-10-21,1911,Manchester United,Middlesbrough,3-4,3,4,1,1,7,-1,A
1911-10-21,1911,Newcastle United,Blackburn Rovers,4-2,4,2,1,1,6,2,H
1911-10-21,1911,Oldham Athletic,West Bromwich Albion,3-1,3,1,1,1,4,2,H
1911-10-21,1911,Preston North End,Arsenal,0-1,0,1,1,1,1,-1,A
1911-10-21,1911,Sheffield United,Sunderland,1-2,1,2,1,1,3,-1,A
1911-10-21,1911,Tottenham Hotspur,Notts County,2-2,2,2,1,1,4,0,D
1911-10-23,1911,Sheffield United,Aston Villa,0-1,0,1,1,1,1,-1,A
1911-10-28,1911,Blackburn Rovers,Sheffield United,1-0,1,0,1,1,1,1,H
1911-10-28,1911,Bury,Aston Villa,1-1,1,1,1,1,2,0,D
1911-10-28,1911,Everton,Bradford City,1-0,1,0,1,1,1,1,H
1911-10-28,1911,Manchester City,Arsenal,3-3,3,3,1,1,6,0,D
1911-10-28,1911,Middlesbrough,Liverpool,3-2,3,2,1,1,5,1,H
1911-10-28,1911,Notts County,Manchester United,0-1,0,1,1,1,1,-1,A
1911-10-28,1911,Sheffield Wednesday,Newcastle United,1-2,1,2,1,1,3,-1,A
1911-10-28,1911,Sunderland,Oldham Athletic,4-2,4,2,1,1,6,2,H
1911-10-28,1911,Tottenham Hotspur,Preston North End,6-2,6,2,1,1,8,4,H
1911-10-28,1911,West Bromwich Albion,Bolton Wanderers,0-0,0,0,1,1,0,0,D
1911-11-04,1911,Arsenal,Everton,0-1,0,1,1,1,1,-1,A
1911-11-04,1911,Aston Villa,Middlesbrough,2-1,2,1,1,1,3,1,H
1911-11-04,1911,Bolton Wanderers,Sunderland,3-0,3,0,1,1,3,3,H
1911-11-04,1911,Bradford City,West Bromwich Albion,4-1,4,1,1,1,5,3,H
1911-11-04,1911,Liverpool,Notts County,3-0,3,0,1,1,3,3,H
1911-11-04,1911,Manchester United,Tottenham Hotspur,1-2,1,2,1,1,3,-1,A
1911-11-04,1911,Newcastle United,Bury,3-2,3,2,1,1,5,1,H
1911-11-04,1911,Oldham Athletic,Blackburn Rovers,0-1,0,1,1,1,1,-1,A
1911-11-04,1911,Preston North End,Manchester City,2-1,2,1,1,1,3,1,H
1911-11-04,1911,Sheffield United,Sheffield Wednesday,1-1,1,1,1,1,2,0,D
1911-11-11,1911,Blackburn Rovers,Bolton Wanderers,2-0,2,0,1,1,2,2,H
1911-11-11,1911,Everton,Manchester City,1-0,1,0,1,1,1,1,H
1911-11-11,1911,Manchester United,Preston North End,0-0,0,0,1,1,0,0,D
1911-11-11,1911,Middlesbrough,Newcastle United,1-1,1,1,1,1,2,0,D
1911-11-11,1911,Sheffield Wednesday,Oldham Athletic,1-0,1,0,1,1,1,1,H
1911-11-11,1911,Sunderland,Bradford City,1-1,1,1,1,1,2,0,D
1911-11-11,1911,Tottenham Hotspur,Liverpool,2-0,2,0,1,1,2,2,H
1911-11-11,1911,West Bromwich Albion,Arsenal,1-1,1,1,1,1,2,0,D
1911-11-18,1911,Arsenal,Sunderland,3-0,3,0,1,1,3,3,H
1911-11-18,1911,Aston Villa,Tottenham Hotspur,2-2,2,2,1,1,4,0,D
1911-11-18,1911,Bolton Wanderers,Sheffield Wednesday,4-2,4,2,1,1,6,2,H
1911-11-18,1911,Bradford City,Blackburn Rovers,1-0,1,0,1,1,1,1,H
1911-11-18,1911,Liverpool,Manchester United,3-2,3,2,1,1,5,1,H
1911-11-18,1911,Manchester City,West Bromwich Albion,0-2,0,2,1,1,2,-2,A
1911-11-18,1911,Newcastle United,Notts County,3-2,3,2,1,1,5,1,H
1911-11-18,1911,Oldham Athletic,Bury,2-0,2,0,1,1,2,2,H
1911-11-18,1911,Preston North End,Everton,2-1,2,1,1,1,3,1,H
1911-11-18,1911,Sheffield United,Middlesbrough,1-1,1,1,1,1,2,0,D
1911-11-25,1911,Blackburn Rovers,Arsenal,4-0,4,0,1,1,4,4,H
1911-11-25,1911,Bury,Bolton Wanderers,1-3,1,3,1,1,4,-2,A
1911-11-25,1911,Liverpool,Preston North End,0-1,0,1,1,1,1,-1,A
1911-11-25,1911,Manchester United,Aston Villa,3-1,3,1,1,1,4,2,H
1911-11-25,1911,Middlesbrough,Oldham Athletic,3-0,3,0,1,1,3,3,H
1911-11-25,1911,Notts County,Sheffield United,2-0,2,0,1,1,2,2,H
1911-11-25,1911,Sheffield Wednesday,Bradford City,4-2,4,2,1,1,6,2,H
1911-11-25,1911,Sunderland,Manchester City,1-1,1,1,1,1,2,0,D
1911-11-25,1911,Tottenham Hotspur,Newcastle United,1-2,1,2,1,1,3,-1,A
1911-11-25,1911,West Bromwich Albion,Everton,1-0,1,0,1,1,1,1,H
1911-12-02,1911,Arsenal,Sheffield Wednesday,0-2,0,2,1,1,2,-2,A
1911-12-02,1911,Aston Villa,Liverpool,5-0,5,0,1,1,5,5,H
1911-12-02,1911,Bolton Wanderers,Middlesbrough,1-0,1,0,1,1,1,1,H
1911-12-02,1911,Bradford City,Bury,1-0,1,0,1,1,1,1,H
1911-12-02,1911,Everton,Sunderland,1-0,1,0,1,1,1,1,H
1911-12-02,1911,Manchester City,Blackburn Rovers,3-0,3,0,1,1,3,3,H
1911-12-02,1911,Newcastle United,Manchester United,2-3,2,3,1,1,5,-1,A
1911-12-02,1911,Oldham Athletic,Notts County,1-2,1,2,1,1,3,-1,A
1911-12-02,1911,Preston North End,West Bromwich Albion,1-1,1,1,1,1,2,0,D
1911-12-02,1911,Sheffield United,Tottenham Hotspur,1-2,1,2,1,1,3,-1,A
1911-12-09,1911,Aston Villa,Preston North End,1-0,1,0,1,1,1,1,H
1911-12-09,1911,Blackburn Rovers,Everton,2-1,2,1,1,1,3,1,H
1911-12-09,1911,Bury,Arsenal,3-1,3,1,1,1,4,2,H
1911-12-09,1911,Liverpool,Newcastle United,0-1,0,1,1,1,1,-1,A
1911-12-09,1911,Manchester United,Sheffield United,1-0,1,0,1,1,1,1,H
1911-12-09,1911,Middlesbrough,Bradford City,1-0,1,0,1,1,1,1,H
1911-12-09,1911,Notts County,Bolton Wanderers,3-2,3,2,1,1,5,1,H
1911-12-09,1911,Sheffield Wednesday,Manchester City,3-0,3,0,1,1,3,3,H
1911-12-09,1911,Sunderland,West Bromwich Albion,3-2,3,2,1,1,5,1,H
1911-12-09,1911,Tottenham Hotspur,Oldham Athletic,4-0,4,0,1,1,4,4,H
1911-12-16,1911,Arsenal,Middlesbrough,3-1,3,1,1,1,4,2,H
1911-12-16,1911,Bolton Wanderers,Tottenham Hotspur,1-0,1,0,1,1,1,1,H
1911-12-16,1911,Bradford City,Notts County,2-3,2,3,1,1,5,-1,A
1911-12-16,1911,Everton,Sheffield Wednesday,1-0,1,0,1,1,1,1,H
1911-12-16,1911,Manchester City,Bury,2-0,2,0,1,1,2,2,H
1911-12-16,1911,Newcastle United,Aston Villa,6-2,6,2,1,1,8,4,H
1911-12-16,1911,Oldham Athletic,Manchester United,2-2,2,2,1,1,4,0,D
1911-12-16,1911,Sheffield United,Liverpool,3-1,3,1,1,1,4,2,H
1911-12-16,1911,Sunderland,Preston North End,3-0,3,0,1,1,3,3,H
1911-12-16,1911,West Bromwich Albion,Blackburn Rovers,2-0,2,0,1,1,2,2,H
1911-12-23,1911,Aston Villa,Sheffield United,1-0,1,0,1,1,1,1,H
1911-12-23,1911,Blackburn Rovers,Sunderland,2-2,2,2,1,1,4,0,D
1911-12-23,1911,Bury,Everton,1-2,1,2,1,1,3,-1,A
1911-12-23,1911,Liverpool,Oldham Athletic,1-0,1,0,1,1,1,1,H
1911-12-23,1911,Manchester United,Bolton Wanderers,2-0,2,0,1,1,2,2,H
1911-12-23,1911,Middlesbrough,Manchester City,3-1,3,1,1,1,4,2,H
1911-12-23,1911,Notts County,Arsenal,3-1,3,1,1,1,4,2,H
1911-12-23,1911,Preston North End,Newcastle United,2-1,2,1,1,1,3,1,H
1911-12-23,1911,Sheffield Wednesday,West Bromwich Albion,4-1,4,1,1,1,5,3,H
1911-12-23,1911,Tottenham Hotspur,Bradford City,2-3,2,3,1,1,5,-1,A
1911-12-25,1911,Blackburn Rovers,Sheffield Wednesday,0-0,0,0,1,1,0,0,D
1911-12-25,1911,Bury,Sunderland,0-2,0,2,1,1,2,-2,A
1911-12-25,1911,Liverpool,Bolton Wanderers,1-0,1,0,1,1,1,1,H
1911-12-25,1911,Manchester United,Bradford City,0-1,0,1,1,1,1,-1,A
1911-12-25,1911,Middlesbrough,Everton,0-0,0,0,1,1,0,0,D
1911-12-25,1911,Notts County,Manchester City,0-1,0,1,1,1,1,-1,A
1911-12-25,1911,Oldham Athletic,Newcastle United,2-4,2,4,1,1,6,-2,A
1911-12-25,1911,Tottenham Hotspur,Arsenal,5-0,5,0,1,1,5,5,H
1911-12-26,1911,Arsenal,Tottenham Hotspur,3-1,3,1,1,1,4,2,H
1911-12-26,1911,Aston Villa,Oldham Athletic,6-1,6,1,1,1,7,5,H
1911-12-26,1911,Bradford City,Manchester United,0-1,0,1,1,1,1,-1,A
1911-12-26,1911,Everton,Middlesbrough,1-0,1,0,1,1,1,1,H
1911-12-26,1911,Manchester City,Notts County,4-0,4,0,1,1,4,4,H
1911-12-26,1911,Newcastle United,Sheffield United,2-2,2,2,1,1,4,0,D
1911-12-26,1911,Preston North End,Blackburn Rovers,2-2,2,2,1,1,4,0,D
1911-12-26,1911,Sheffield Wednesday,Sunderland,8-0,8,0,1,1,8,8,H
1911-12-26,1911,West Bromwich Albion,Bury,2-0,2,0,1,1,2,2,H
1911-12-28,1911,Sheffield United,Preston North End,4-2,4,2,1,1,6,2,H
1911-12-30,1911,Aston Villa,Bradford City,0-0,0,0,1,1,0,0,D
1911-12-30,1911,Bury,Blackburn Rovers,1-2,1,2,1,1,3,-1,A
1911-12-30,1911,Liverpool,Arsenal,4-1,4,1,1,1,5,3,H
1911-12-30,1911,Manchester United,Manchester City,0-0,0,0,1,1,0,0,D
1911-12-30,1911,Middlesbrough,Sunderland,3-3,3,3,1,1,6,0,D
1911-12-30,1911,Newcastle United,Bolton Wanderers,5-2,5,2,1,1,7,3,H
1911-12-30,1911,Notts County,West Bromwich Albion,2-0,2,0,1,1,2,2,H
1911-12-30,1911,Preston North End,Sheffield Wednesday,2-3,2,3,1,1,5,-1,A
1911-12-30,1911,Sheffield United,Oldham Athletic,4-0,4,0,1,1,4,4,H
1911-12-30,1911,Tottenham Hotspur,Everton,0-1,0,1,1,1,1,-1,A
1912-01-01,1911,Blackburn Rovers,Preston North End,3-0,3,0,1,1,3,3,H
1912-01-01,1911,Bolton Wanderers,Aston Villa,3-0,3,0,1,1,3,3,H
1912-01-01,1911,Bury,West Bromwich Albion,1-0,1,0,1,1,1,1,H
1912-01-01,1911,Liverpool,Bradford City,1-0,1,0,1,1,1,1,H
1912-01-01,1911,Manchester United,Arsenal,2-0,2,0,1,1,2,2,H
1912-01-01,1911,Sheffield United,Newcastle United,2-1,2,1,1,1,3,1,H
1912-01-01,1911,Sunderland,Sheffield Wednesday,0-0,0,0,1,1,0,0,D
1912-01-06,1911,Arsenal,Aston Villa,2-2,2,2,1,1,4,0,D
1912-01-06,1911,Blackburn Rovers,Middlesbrough,2-1,2,1,1,1,3,1,H
1912-01-06,1911,Bolton Wanderers,Sheffield United,0-3,0,3,1,1,3,-3,A
1912-01-06,1911,Everton,Manchester United,4-0,4,0,1,1,4,4,H
1912-01-06,1911,Manchester City,Liverpool,2-3,2,3,1,1,5,-1,A
1912-01-06,1911,Oldham Athletic,Preston North End,1-0,1,0,1,1,1,1,H
1912-01-06,1911,Sunderland,Notts County,5-0,5,0,1,1,5,5,H
1912-01-20,1911,Aston Villa,Manchester City,3-1,3,1,1,1,4,2,H
1912-01-20,1911,Liverpool,Everton,1-3,1,3,1,1,4,-2,A
1912-01-20,1911,Manchester United,West Bromwich Albion,1-2,1,2,1,1,3,-1,A
1912-01-20,1911,Middlesbrough,Sheffield Wednesday,1-1,1,1,1,1,2,0,D
1912-01-20,1911,Newcastle United,Arsenal,1-2,1,2,1,1,3,-1,A
1912-01-20,1911,Notts County,Blackburn Rovers,1-3,1,3,1,1,4,-2,A
1912-01-20,1911,Oldham Athletic,Bolton Wanderers,3-1,3,1,1,1,4,2,H
1912-01-20,1911,Preston North End,Bury,1-0,1,0,1,1,1,1,H
1912-01-20,1911,Tottenham Hotspur,Sunderland,0-0,0,0,1,1,0,0,D
1912-01-27,1911,Arsenal,Sheffield United,3-1,3,1,1,1,4,2,H
1912-01-27,1911,Blackburn Rovers,Tottenham Hotspur,0-0,0,0,1,1,0,0,D
1912-01-27,1911,Bolton Wanderers,Preston North End,3-0,3,0,1,1,3,3,H
1912-01-27,1911,Bradford City,Oldham Athletic,0-0,0,0,1,1,0,0,D
1912-01-27,1911,Bury,Middlesbrough,0-2,0,2,1,1,2,-2,A
1912-01-27,1911,Everton,Aston Villa,1-1,1,1,1,1,2,0,D
1912-01-27,1911,Manchester City,Newcastle United,1-1,1,1,1,1,2,0,D
1912-01-27,1911,Sheffield Wednesday,Notts County,3-0,3,0,1,1,3,3,H
1912-01-27,1911,Sunderland,Manchester United,5-0,5,0,1,1,5,5,H
1912-01-27,1911,West Bromwich Albion,Liverpool,1-0,1,0,1,1,1,1,H
1912-02-10,1911,Arsenal,Bolton Wanderers,3-0,3,0,1,1,3,3,H
1912-02-10,1911,Blackburn Rovers,Liverpool,1-0,1,0,1,1,1,1,H
1912-02-10,1911,Bradford City,Preston North End,0-1,0,1,1,1,1,-1,A
1912-02-10,1911,Bury,Tottenham Hotspur,2-1,2,1,1,1,3,1,H
1912-02-10,1911,Everton,Sheffield United,3-2,3,2,1,1,5,1,H
1912-02-10,1911,Manchester City,Oldham Athletic,1-3,1,3,1,1,4,-2,A
1912-02-10,1911,Middlesbrough,Notts County,4-0,4,0,1,1,4,4,H
1912-02-10,1911,Sheffield Wednesday,Manchester United,3-0,3,0,1,1,3,3,H
1912-02-10,1911,Sunderland,Aston Villa,2-2,2,2,1,1,4,0,D
1912-02-10,1911,West Bromwich Albion,Newcastle United,3-1,3,1,1,1,4,2,H
1912-02-14,1911,Bolton Wanderers,Bradford City,2-0,2,0,1,1,2,2,H
1912-02-14,1911,Notts County,Bury,2-0,2,0,1,1,2,2,H
1912-02-17,1911,Aston Villa,Blackburn Rovers,0-3,0,3,1,1,3,-3,A
1912-02-17,1911,Bolton Wanderers,Manchester City,2-1,2,1,1,1,3,1,H
1912-02-17,1911,Bradford City,Arsenal,1-1,1,1,1,1,2,0,D
1912-02-17,1911,Liverpool,Sheffield Wednesday,1-1,1,1,1,1,2,0,D
1912-02-17,1911,Manchester United,Bury,0-0,0,0,1,1,0,0,D
1912-02-17,1911,Newcastle United,Sunderland,3-1,3,1,1,1,4,2,H
1912-02-17,1911,Oldham Athletic,Everton,3-0,3,0,1,1,3,3,H
1912-02-17,1911,Preston North End,Notts County,2-1,2,1,1,1,3,1,H
1912-02-17,1911,Sheffield United,West Bromwich Albion,1-1,1,1,1,1,2,0,D
1912-02-17,1911,Tottenham Hotspur,Middlesbrough,2-1,2,1,1,1,3,1,H
1912-02-20,1911,Bury,Sheffield United,3-1,3,1,1,1,4,2,H
1912-02-24,1911,Bury,Liverpool,2-2,2,2,1,1,4,0,D
1912-02-24,1911,Middlesbrough,Arsenal,0-2,0,2,1,1,2,-2,A
1912-02-24,1911,Newcastle United,Preston North End,1-0,1,0,1,1,1,1,H
1912-02-24,1911,Notts County,Tottenham Hotspur,2-2,2,2,1,1,4,0,D
1912-02-24,1911,Sheffield Wednesday,Aston Villa,3-0,3,0,1,1,3,3,H
1912-02-26,1911,Sheffield United,Manchester City,6-2,6,2,1,1,8,4,H
1912-02-28,1911,Everton,Bolton Wanderers,1-0,1,0,1,1,1,1,H
1912-02-28,1911,Sunderland,Sheffield United,0-0,0,0,1,1,0,0,D
1912-03-02,1911,Arsenal,Manchester City,2-0,2,0,1,1,2,2,H
1912-03-02,1911,Aston Villa,Bury,5-2,5,2,1,1,7,3,H
1912-03-02,1911,Bolton Wanderers,West Bromwich Albion,2-0,2,0,1,1,2,2,H
1912-03-02,1911,Bradford City,Everton,1-0,1,0,1,1,1,1,H
1912-03-02,1911,Liverpool,Middlesbrough,1-1,1,1,1,1,2,0,D
1912-03-02,1911,Manchester United,Notts County,2-0,2,0,1,1,2,2,H
1912-03-02,1911,Newcastle United,Sheffield Wednesday,0-2,0,2,1,1,2,-2,A
1912-03-02,1911,Oldham Athletic,Sunderland,0-0,0,0,1,1,0,0,D
1912-03-02,1911,Preston North End,Tottenham Hotspur,0-1,0,1,1,1,1,-1,A
1912-03-02,1911,Sheffield United,Blackburn Rovers,1-1,1,1,1,1,2,0,D
1912-03-04,1911,Sheffield United,Bradford City,7-3,7,3,1,1,10,4,H
1912-03-09,1911,Bury,Newcastle United,2-1,2,1,1,1,3,1,H
1912-03-09,1911,Manchester City,Preston North End,0-0,0,0,1,1,0,0,D
1912-03-09,1911,Middlesbrough,Aston Villa,1-2,1,2,1,1,3,-1,A
1912-03-09,1911,Notts County,Liverpool,0-0,0,0,1,1,0,0,D
1912-03-09,1911,Oldham Athletic,Arsenal,0-0,0,0,1,1,0,0,D
1912-03-09,1911,Sheffield Wednesday,Sheffield United,1-1,1,1,1,1,2,0,D
1912-03-09,1911,Sunderland,Bolton Wanderers,0-1,0,1,1,1,1,-1,A
1912-03-13,1911,Notts County,Aston Villa,2-0,2,0,1,1,2,2,H
1912-03-13,1911,West Bromwich Albion,Tottenham Hotspur,2-0,2,0,1,1,2,2,H
1912-03-16,1911,Arsenal,West Bromwich Albion,0-2,0,2,1,1,2,-2,A
1912-03-16,1911,Aston Villa,Notts County,5-1,5,1,1,1,6,4,H
1912-03-16,1911,Bolton Wanderers,Blackburn Rovers,2-0,2,0,1,1,2,2,H
1912-03-16,1911,Bradford City,Sunderland,2-1,2,1,1,1,3,1,H
1912-03-16,1911,Liverpool,Tottenham Hotspur,1-2,1,2,1,1,3,-1,A
1912-03-16,1911,Manchester City,Everton,4-0,4,0,1,1,4,4,H
1912-03-16,1911,Newcastle United,Middlesbrough,0-1,0,1,1,1,1,-1,A
1912-03-16,1911,Oldham Athletic,Sheffield Wednesday,1-0,1,0,1,1,1,1,H
1912-03-16,1911,Preston North End,Manchester United,0-0,0,0,1,1,0,0,D
1912-03-16,1911,Sheffield United,Bury,4-0,4,0,1,1,4,4,H
1912-03-18,1911,Sheffield Wednesday,Bury,2-1,2,1,1,1,3,1,H
1912-03-23,1911,Blackburn Rovers,Bradford City,3-1,3,1,1,1,4,2,H
1912-03-23,1911,Bury,Oldham Athletic,1-1,1,1,1,1,2,0,D
1912-03-23,1911,Everton,Preston North End,1-0,1,0,1,1,1,1,H
1912-03-23,1911,Manchester United,Liverpool,1-1,1,1,1,1,2,0,D
1912-03-23,1911,Middlesbrough,Sheffield United,1-1,1,1,1,1,2,0,D
1912-03-23,1911,Notts County,Newcastle United,1-4,1,4,1,1,5,-3,A
1912-03-23,1911,Sheffield Wednesday,Bolton Wanderers,0-1,0,1,1,1,1,-1,A
1912-03-23,1911,Sunderland,Arsenal,1-0,1,0,1,1,1,1,H
1912-03-23,1911,Tottenham Hotspur,Aston Villa,2-1,2,1,1,1,3,1,H
1912-03-23,1911,West Bromwich Albion,Manchester City,1-1,1,1,1,1,2,0,D
1912-03-27,1911,Everton,Arsenal,1-0,1,0,1,1,1,1,H
1912-03-28,1911,Manchester City,Bradford City,4-0,4,0,1,1,4,4,H
1912-03-30,1911,Aston Villa,Manchester United,6-0,6,0,1,1,6,6,H
1912-03-30,1911,Bolton Wanderers,Bury,1-0,1,0,1,1,1,1,H
1912-03-30,1911,Bradford City,Sheffield Wednesday,5-1,5,1,1,1,6,4,H
1912-03-30,1911,Manchester City,Sunderland,2-0,2,0,1,1,2,2,H
1912-03-30,1911,Newcastle United,Tottenham Hotspur,2-0,2,0,1,1,2,2,H
1912-03-30,1911,Oldham Athletic,Middlesbrough,2-0,2,0,1,1,2,2,H
1912-03-30,1911,Preston North End,Liverpool,2-1,2,1,1,1,3,1,H
1912-03-30,1911,Sheffield United,Notts County,1-3,1,3,1,1,4,-2,A
1912-04-05,1911,Arsenal,Manchester United,2-1,2,1,1,1,3,1,H
1912-04-05,1911,Aston Villa,Bolton Wanderers,0-1,0,1,1,1,1,-1,A
1912-04-05,1911,Liverpool,Sunderland,2-1,2,1,1,1,3,1,H
1912-04-05,1911,Manchester City,Tottenham Hotspur,2-1,2,1,1,1,3,1,H
1912-04-05,1911,Middlesbrough,West Bromwich Albion,1-0,1,0,1,1,1,1,H
1912-04-05,1911,Newcastle United,Oldham Athletic,1-1,1,1,1,1,2,0,D
1912-04-05,1911,Notts County,Everton,0-1,0,1,1,1,1,-1,A
1912-04-05,1911,Preston North End,Sheffield United,3-0,3,0,1,1,3,3,H
1912-04-06,1911,Blackburn Rovers,Manchester City,2-0,2,0,1,1,2,2,H
1912-04-06,1911,Bury,Bradford City,2-0,2,0,1,1,2,2,H
1912-04-06,1911,Liverpool,Aston Villa,1-2,1,2,1,1,3,-1,A
1912-04-06,1911,Manchester United,Newcastle United,0-2,0,2,1,1,2,-2,A
1912-04-06,1911,Middlesbrough,Bolton Wanderers,1-0,1,0,1,1,1,1,H
1912-04-06,1911,Notts County,Oldham Athletic,1-1,1,1,1,1,2,0,D
1912-04-06,1911,Sheffield Wednesday,Arsenal,3-0,3,0,1,1,3,3,H
1912-04-06,1911,Sunderland,Everton,4-0,4,0,1,1,4,4,H
1912-04-06,1911,Tottenham Hotspur,Sheffield United,1-1,1,1,1,1,2,0,D
1912-04-08,1911,Arsenal,Preston North End,4-1,4,1,1,1,5,3,H
1912-04-08,1911,Bradford City,Liverpool,0-2,0,2,1,1,2,-2,A
1912-04-08,1911,Everton,Notts County,1-1,1,1,1,1,2,0,D
1912-04-08,1911,Oldham Athletic,Aston Villa,1-2,1,2,1,1,3,-1,A
1912-04-08,1911,Sheffield Wednesday,Blackburn Rovers,1-1,1,1,1,1,2,0,D
1912-04-08,1911,Sunderland,Bury,1-0,1,0,1,1,1,1,H
1912-04-08,1911,Tottenham Hotspur,Manchester City,0-2,0,2,1,1,2,-2,A
1912-04-08,1911,West Bromwich Albion,Middlesbrough,3-1,3,1,1,1,4,2,H
1912-04-09,1911,Bradford City,Newcastle United,1-1,1,1,1,1,2,0,D
1912-04-09,1911,Tottenham Hotspur,Manchester United,1-1,1,1,1,1,2,0,D
1912-04-09,1911,West Bromwich Albion,Preston North End,0-2,0,2,1,1,2,-2,A
1912-04-13,1911,Arsenal,Bury,1-0,1,0,1,1,1,1,H
1912-04-13,1911,Bolton Wanderers,Notts County,3-0,3,0,1,1,3,3,H
1912-04-13,1911,Bradford City,Middlesbrough,2-1,2,1,1,1,3,1,H
1912-04-13,1911,Everton,Blackburn Rovers,1-3,1,3,1,1,4,-2,A
1912-04-13,1911,Manchester City,Sheffield Wednesday,4-0,4,0,1,1,4,4,H
1912-04-13,1911,Newcastle United,Liverpool,1-1,1,1,1,1,2,0,D
1912-04-13,1911,Oldham Athletic,Tottenham Hotspur,2-1,2,1,1,1,3,1,H
1912-04-13,1911,Preston North End,Aston Villa,4-1,4,1,1,1,5,3,H
1912-04-13,1911,Sheffield United,Manchester United,6-1,6,1,1,1,7,5,H
1912-04-13,1911,West Bromwich Albion,Sunderland,1-0,1,0,1,1,1,1,H
1912-04-15,1911,Blackburn Rovers,Oldham Athletic,1-0,1,0,1,1,1,1,H
1912-04-17,1911,Middlesbrough,Manchester United,3-0,3,0,1,1,3,3,H
1912-04-20,1911,Aston Villa,Newcastle United,2-0,2,0,1,1,2,2,H
1912-04-20,1911,Bury,Manchester City,1-2,1,2,1,1,3,-1,A
1912-04-20,1911,Liverpool,Sheffield United,2-0,2,0,1,1,2,2,H
1912-04-20,1911,Manchester United,Oldham Athletic,3-1,3,1,1,1,4,2,H
1912-04-20,1911,Preston North End,Sunderland,0-3,0,3,1,1,3,-3,A
1912-04-20,1911,Sheffield Wednesday,Everton,1-3,1,3,1,1,4,-2,A
1912-04-20,1911,Tottenham Hotspur,Bolton Wanderers,1-0,1,0,1,1,1,1,H
1912-04-22,1911,Arsenal,Blackburn Rovers,5-1,5,1,1,1,6,4,H
1912-04-22,1911,Everton,West Bromwich Albion,3-0,3,0,1,1,3,3,H
1912-04-22,1911,Preston North End,Middlesbrough,0-3,0,3,1,1,3,-3,A
1912-04-25,1911,Blackburn Rovers,West Bromwich Albion,4-1,4,1,1,1,5,3,H
1912-04-26,1911,West Bromwich Albion,Bradford City,0-0,0,0,1,1,0,0,D
1912-04-27,1911,Arsenal,Notts County,0-3,0,3,1,1,3,-3,A
1912-04-27,1911,Blackburn Rovers,Newcastle United,1-1,1,1,1,1,2,0,D
1912-04-27,1911,Bolton Wanderers,Manchester United,1-1,1,1,1,1,2,0,D
1912-04-27,1911,Bradford City,Tottenham Hotspur,3-0,3,0,1,1,3,3,H
1912-04-27,1911,Everton,Bury,1-1,1,1,1,1,2,0,D
1912-04-27,1911,Manchester City,Middlesbrough,2-0,2,0,1,1,2,2,H
1912-04-27,1911,Oldham Athletic,Liverpool,0-1,0,1,1,1,1,-1,A
1912-04-27,1911,West Bromwich Albion,Sheffield Wednesday,1-5,1,5,1,1,6,-4,A
1912-04-29,1911,Manchester United,Blackburn Rovers,3-1,3,1,1,1,4,2,H
1912-04-29,1911,West Bromwich Albion,Oldham Athletic,0-0,0,0,1,1,0,0,D
1912-09-02,1912,Arsenal,Manchester United,0-0,0,0,1,1,0,0,D
1912-09-02,1912,Aston Villa,Chelsea,1-0,1,0,1,1,1,1,H
1912-09-02,1912,Bolton Wanderers,Newcastle United,1-2,1,2,1,1,3,-1,A
1912-09-02,1912,Notts County,Manchester City,0-1,0,1,1,1,1,-1,A
1912-09-02,1912,Sheffield Wednesday,Blackburn Rovers,2-1,2,1,1,1,3,1,H
1912-09-02,1912,Tottenham Hotspur,Everton,0-2,0,2,1,1,2,-2,A
1912-09-04,1912,Liverpool,Oldham Athletic,2-0,2,0,1,1,2,2,H
1912-09-04,1912,West Bromwich Albion,Middlesbrough,2-0,2,0,1,1,2,2,H
1912-09-07,1912,Aston Villa,Bradford City,3-1,3,1,1,1,4,2,H
1912-09-07,1912,Bolton Wanderers,Chelsea,1-0,1,0,1,1,1,1,H
1912-09-07,1912,Derby County,Blackburn Rovers,1-1,1,1,1,1,2,0,D
1912-09-07,1912,Liverpool,Arsenal,3-0,3,0,1,1,3,3,H
1912-09-07,1912,Manchester United,Manchester City,0-1,0,1,1,1,1,-1,A
1912-09-07,1912,Middlesbrough,Everton,0-0,0,0,1,1,0,0,D
1912-09-07,1912,Newcastle United,Sunderland,1-1,1,1,1,1,2,0,D
1912-09-07,1912,Notts County,West Bromwich Albion,1-1,1,1,1,1,2,0,D
1912-09-07,1912,Sheffield United,Oldham Athletic,1-1,1,1,1,1,2,0,D
1912-09-07,1912,Tottenham Hotspur,Sheffield Wednesday,2-4,2,4,1,1,6,-2,A
1912-09-09,1912,Blackburn Rovers,Sunderland,4-0,4,0,1,1,4,4,H
1912-09-09,1912,Chelsea,Liverpool,1-2,1,2,1,1,3,-1,A
1912-09-09,1912,Oldham Athletic,Aston Villa,2-2,2,2,1,1,4,0,D
1912-09-11,1912,Newcastle United,Bolton Wanderers,2-1,2,1,1,1,3,1,H
1912-09-14,1912,Arsenal,Bolton Wanderers,1-2,1,2,1,1,3,-1,A
1912-09-14,1912,Blackburn Rovers,Tottenham Hotspur,6-1,6,1,1,1,7,5,H
1912-09-14,1912,Bradford City,Liverpool,2-0,2,0,1,1,2,2,H
1912-09-14,1912,Chelsea,Sheffield United,4-2,4,2,1,1,6,2,H
1912-09-14,1912,Everton,Notts County,4-0,4,0,1,1,4,4,H
1912-09-14,1912,Manchester City,Aston Villa,1-0,1,0,1,1,1,1,H
1912-09-14,1912,Oldham Athletic,Newcastle United,1-0,1,0,1,1,1,1,H
1912-09-14,1912,Sheffield Wednesday,Middlesbrough,3-1,3,1,1,1,4,2,H
1912-09-14,1912,Sunderland,Derby County,0-2,0,2,1,1,2,-2,A
1912-09-14,1912,West Bromwich Albion,Manchester United,1-2,1,2,1,1,3,-1,A
1912-09-16,1912,Arsenal,Aston Villa,0-3,0,3,1,1,3,-3,A
1912-09-18,1912,Derby County,Everton,1-4,1,4,1,1,5,-3,A
1912-09-18,1912,Sunderland,Blackburn Rovers,2-4,2,4,1,1,6,-2,A
1912-09-21,1912,Aston Villa,West Bromwich Albion,2-4,2,4,1,1,6,-2,A
1912-09-21,1912,Bolton Wanderers,Bradford City,2-0,2,0,1,1,2,2,H
1912-09-21,1912,Liverpool,Manchester City,1-2,1,2,1,1,3,-1,A
1912-09-21,1912,Manchester United,Everton,2-0,2,0,1,1,2,2,H
1912-09-21,1912,Middlesbrough,Blackburn Rovers,0-0,0,0,1,1,0,0,D
1912-09-21,1912,Newcastle United,Chelsea,3-2,3,2,1,1,5,1,H
1912-09-21,1912,Notts County,Sheffield Wednesday,1-2,1,2,1,1,3,-1,A
1912-09-21,1912,Oldham Athletic,Sunderland,3-0,3,0,1,1,3,3,H
1912-09-21,1912,Sheffield United,Arsenal,1-3,1,3,1,1,4,-2,A
1912-09-21,1912,Tottenham Hotspur,Derby County,1-2,1,2,1,1,3,-1,A
1912-09-28,1912,Arsenal,Newcastle United,1-1,1,1,1,1,2,0,D
1912-09-28,1912,Blackburn Rovers,Notts County,2-1,2,1,1,1,3,1,H
1912-09-28,1912,Bradford City,Sheffield United,3-1,3,1,1,1,4,2,H
1912-09-28,1912,Chelsea,Oldham Athletic,1-1,1,1,1,1,2,0,D
1912-09-28,1912,Derby County,Middlesbrough,0-2,0,2,1,1,2,-2,A
1912-09-28,1912,Everton,Aston Villa,0-1,0,1,1,1,1,-1,A
1912-09-28,1912,Manchester City,Bolton Wanderers,2-0,2,0,1,1,2,2,H
1912-09-28,1912,Sheffield Wednesday,Manchester United,3-3,3,3,1,1,6,0,D
1912-09-28,1912,Sunderland,Tottenham Hotspur,2-2,2,2,1,1,4,0,D
1912-09-28,1912,West Bromwich Albion,Liverpool,3-1,3,1,1,1,4,2,H
1912-10-05,1912,Aston Villa,Sheffield Wednesday,10-0,10,0,1,1,10,10,H
1912-10-05,1912,Bolton Wanderers,West Bromwich Albion,2-1,2,1,1,1,3,1,H
1912-10-05,1912,Chelsea,Sunderland,2-0,2,0,1,1,2,2,H
1912-10-05,1912,Liverpool,Everton,0-2,0,2,1,1,2,-2,A
1912-10-05,1912,Manchester United,Blackburn Rovers,1-1,1,1,1,1,2,0,D
1912-10-05,1912,Middlesbrough,Tottenham Hotspur,1-1,1,1,1,1,2,0,D
1912-10-05,1912,Newcastle United,Bradford City,1-1,1,1,1,1,2,0,D
1912-10-05,1912,Notts County,Derby County,0-1,0,1,1,1,1,-1,A
1912-10-05,1912,Oldham Athletic,Arsenal,0-0,0,0,1,1,0,0,D
1912-10-05,1912,Sheffield United,Manchester City,1-1,1,1,1,1,2,0,D
1912-10-12,1912,Arsenal,Chelsea,0-1,0,1,1,1,1,-1,A
1912-10-12,1912,Blackburn Rovers,Aston Villa,2-2,2,2,1,1,4,0,D
1912-10-12,1912,Bradford City,Oldham Athletic,0-0,0,0,1,1,0,0,D
1912-10-12,1912,Derby County,Manchester United,2-1,2,1,1,1,3,1,H
1912-10-12,1912,Everton,Bolton Wanderers,2-3,2,3,1,1,5,-1,A
1912-10-12,1912,Manchester City,Newcastle United,0-1,0,1,1,1,1,-1,A
1912-10-12,1912,Sheffield Wednesday,Liverpool,1-0,1,0,1,1,1,1,H
1912-10-12,1912,Sunderland,Middlesbrough,4-0,4,0,1,1,4,4,H
1912-10-12,1912,West Bromwich Albion,Sheffield United,3-1,3,1,1,1,4,2,H
1912-10-14,1912,Sheffield United,Liverpool,4-1,4,1,1,1,5,3,H
1912-10-19,1912,Arsenal,Sunderland,1-3,1,3,1,1,4,-2,A
1912-10-19,1912,Aston Villa,Derby County,5-1,5,1,1,1,6,4,H
1912-10-19,1912,Bolton Wanderers,Sheffield Wednesday,3-0,3,0,1,1,3,3,H
1912-10-19,1912,Chelsea,Bradford City,0-3,0,3,1,1,3,-3,A
1912-10-19,1912,Liverpool,Blackburn Rovers,4-1,4,1,1,1,5,3,H
1912-10-19,1912,Manchester United,Tottenham Hotspur,2-0,2,0,1,1,2,2,H
1912-10-19,1912,Newcastle United,West Bromwich Albion,1-1,1,1,1,1,2,0,D
1912-10-19,1912,Notts County,Middlesbrough,1-3,1,3,1,1,4,-2,A
1912-10-19,1912,Oldham Athletic,Manchester City,2-1,2,1,1,1,3,1,H
1912-10-19,1912,Sheffield United,Everton,4-1,4,1,1,1,5,3,H
1912-10-26,1912,Blackburn Rovers,Bolton Wanderers,6-0,6,0,1,1,6,6,H
1912-10-26,1912,Bradford City,Arsenal,3-1,3,1,1,1,4,2,H
1912-10-26,1912,Derby County,Liverpool,4-2,4,2,1,1,6,2,H
1912-10-26,1912,Everton,Newcastle United,0-6,0,6,1,1,6,-6,A
1912-10-26,1912,Manchester City,Chelsea,2-0,2,0,1,1,2,2,H
1912-10-26,1912,Middlesbrough,Manchester United,3-2,3,2,1,1,5,1,H
1912-10-26,1912,Sheffield Wednesday,Sheffield United,1-0,1,0,1,1,1,1,H
1912-10-26,1912,Sunderland,Notts County,4-0,4,0,1,1,4,4,H
1912-10-26,1912,Tottenham Hotspur,Aston Villa,3-3,3,3,1,1,6,0,D
1912-10-26,1912,West Bromwich Albion,Oldham Athletic,2-3,2,3,1,1,5,-1,A
1912-11-02,1912,Arsenal,Manchester City,0-4,0,4,1,1,4,-4,A
1912-11-02,1912,Aston Villa,Middlesbrough,5-1,5,1,1,1,6,4,H
1912-11-02,1912,Bolton Wanderers,Derby County,1-1,1,1,1,1,2,0,D
1912-11-02,1912,Bradford City,Sunderland,1-5,1,5,1,1,6,-4,A
1912-11-02,1912,Chelsea,West Bromwich Albion,0-2,0,2,1,1,2,-2,A
1912-11-02,1912,Liverpool,Tottenham Hotspur,4-1,4,1,1,1,5,3,H
1912-11-02,1912,Manchester United,Notts County,2-1,2,1,1,1,3,1,H
1912-11-02,1912,Newcastle United,Sheffield Wednesday,1-0,1,0,1,1,1,1,H
1912-11-02,1912,Oldham Athletic,Everton,2-0,2,0,1,1,2,2,H
1912-11-02,1912,Sheffield United,Blackburn Rovers,0-0,0,0,1,1,0,0,D
1912-11-04,1912,Tottenham Hotspur,Notts County,0-3,0,3,1,1,3,-3,A
1912-11-09,1912,Blackburn Rovers,Newcastle United,2-0,2,0,1,1,2,2,H
1912-11-09,1912,Derby County,Sheffield United,5-1,5,1,1,1,6,4,H
1912-11-09,1912,Everton,Chelsea,1-0,1,0,1,1,1,1,H
1912-11-09,1912,Manchester City,Bradford City,1-3,1,3,1,1,4,-2,A
1912-11-09,1912,Middlesbrough,Liverpool,3-4,3,4,1,1,7,-1,A
1912-11-09,1912,Notts County,Aston Villa,1-1,1,1,1,1,2,0,D
1912-11-09,1912,Sheffield Wednesday,Oldham Athletic,5-0,5,0,1,1,5,5,H
1912-11-09,1912,Sunderland,Manchester United,3-1,3,1,1,1,4,2,H
1912-11-09,1912,Tottenham Hotspur,Bolton Wanderers,0-1,0,1,1,1,1,-1,A
1912-11-09,1912,West Bromwich Albion,Arsenal,2-1,2,1,1,1,3,1,H
1912-11-16,1912,Arsenal,Everton,0-0,0,0,1,1,0,0,D
1912-11-16,1912,Aston Villa,Manchester United,4-2,4,2,1,1,6,2,H
1912-11-16,1912,Bolton Wanderers,Middlesbrough,3-2,3,2,1,1,5,1,H
1912-11-16,1912,Bradford City,West Bromwich Albion,1-1,1,1,1,1,2,0,D
1912-11-16,1912,Chelsea,Sheffield Wednesday,0-4,0,4,1,1,4,-4,A
1912-11-16,1912,Liverpool,Notts County,0-0,0,0,1,1,0,0,D
1912-11-16,1912,Manchester City,Sunderland,1-0,1,0,1,1,1,1,H
1912-11-16,1912,Newcastle United,Derby County,2-4,2,4,1,1,6,-2,A
1912-11-16,1912,Sheffield United,Tottenham Hotspur,4-0,4,0,1,1,4,4,H
1912-11-23,1912,Blackburn Rovers,Chelsea,1-1,1,1,1,1,2,0,D
1912-11-23,1912,Derby County,Oldham Athletic,1-2,1,2,1,1,3,-1,A
1912-11-23,1912,Everton,Bradford City,2-1,2,1,1,1,3,1,H
1912-11-23,1912,Manchester United,Liverpool,3-1,3,1,1,1,4,2,H
1912-11-23,1912,Middlesbrough,Sheffield United,4-1,4,1,1,1,5,3,H
1912-11-23,1912,Notts County,Bolton Wanderers,1-0,1,0,1,1,1,1,H
1912-11-23,1912,Sheffield Wednesday,Arsenal,2-0,2,0,1,1,2,2,H
1912-11-23,1912,Sunderland,Aston Villa,3-1,3,1,1,1,4,2,H
1912-11-23,1912,Tottenham Hotspur,Newcastle United,1-0,1,0,1,1,1,1,H
1912-11-23,1912,West Bromwich Albion,Manchester City,0-2,0,2,1,1,2,-2,A
1912-11-30,1912,Arsenal,Blackburn Rovers,0-1,0,1,1,1,1,-1,A
1912-11-30,1912,Bolton Wanderers,Manchester United,2-1,2,1,1,1,3,1,H
1912-11-30,1912,Bradford City,Sheffield Wednesday,0-0,0,0,1,1,0,0,D
1912-11-30,1912,Chelsea,Derby County,3-1,3,1,1,1,4,2,H
1912-11-30,1912,Liverpool,Aston Villa,2-0,2,0,1,1,2,2,H
1912-11-30,1912,Manchester City,Everton,1-0,1,0,1,1,1,1,H
1912-11-30,1912,Newcastle United,Middlesbrough,3-1,3,1,1,1,4,2,H
1912-11-30,1912,Oldham Athletic,Tottenham Hotspur,4-1,4,1,1,1,5,3,H
1912-11-30,1912,Sheffield United,Notts County,2-0,2,0,1,1,2,2,H
1912-11-30,1912,West Bromwich Albion,Sunderland,3-1,3,1,1,1,4,2,H
1912-12-07,1912,Aston Villa,Bolton Wanderers,1-1,1,1,1,1,2,0,D
1912-12-07,1912,Blackburn Rovers,Bradford City,5-0,5,0,1,1,5,5,H
1912-12-07,1912,Derby County,Arsenal,4-1,4,1,1,1,5,3,H
1912-12-07,1912,Everton,West Bromwich Albion,1-3,1,3,1,1,4,-2,A
1912-12-07,1912,Manchester United,Sheffield United,4-0,4,0,1,1,4,4,H
1912-12-07,1912,Middlesbrough,Oldham Athletic,2-2,2,2,1,1,4,0,D
1912-12-07,1912,Notts County,Newcastle United,0-1,0,1,1,1,1,-1,A
1912-12-07,1912,Sheffield Wednesday,Manchester City,1-0,1,0,1,1,1,1,H
1912-12-07,1912,Sunderland,Liverpool,7-0,7,0,1,1,7,7,H
1912-12-07,1912,Tottenham Hotspur,Chelsea,1-0,1,0,1,1,1,1,H
1912-12-14,1912,Arsenal,Tottenham Hotspur,0-3,0,3,1,1,3,-3,A
1912-12-14,1912,Bolton Wanderers,Liverpool,1-1,1,1,1,1,2,0,D
1912-12-14,1912,Bradford City,Derby County,2-3,2,3,1,1,5,-1,A
1912-12-14,1912,Chelsea,Middlesbrough,2-3,2,3,1,1,5,-1,A
1912-12-14,1912,Everton,Sunderland,0-4,0,4,1,1,4,-4,A
1912-12-14,1912,Manchester City,Blackburn Rovers,3-1,3,1,1,1,4,2,H
1912-12-14,1912,Newcastle United,Manchester United,1-3,1,3,1,1,4,-2,A
1912-12-14,1912,Oldham Athletic,Notts County,4-0,4,0,1,1,4,4,H
1912-12-14,1912,Sheffield United,Aston Villa,3-2,3,2,1,1,5,1,H
1912-12-14,1912,West Bromwich Albion,Sheffield Wednesday,1-1,1,1,1,1,2,0,D
1912-12-21,1912,Aston Villa,Newcastle United,3-1,3,1,1,1,4,2,H
1912-12-21,1912,Blackburn Rovers,West Bromwich Albion,2-4,2,4,1,1,6,-2,A
1912-12-21,1912,Derby County,Manchester City,2-0,2,0,1,1,2,2,H
1912-12-21,1912,Liverpool,Sheffield United,2-2,2,2,1,1,4,0,D
1912-12-21,1912,Manchester United,Oldham Athletic,0-0,0,0,1,1,0,0,D
1912-12-21,1912,Middlesbrough,Arsenal,2-0,2,0,1,1,2,2,H
1912-12-21,1912,Notts County,Chelsea,0-0,0,0,1,1,0,0,D
1912-12-21,1912,Sheffield Wednesday,Everton,1-2,1,2,1,1,3,-1,A
1912-12-21,1912,Sunderland,Bolton Wanderers,2-1,2,1,1,1,3,1,H
1912-12-21,1912,Tottenham Hotspur,Bradford City,2-1,2,1,1,1,3,1,H
1912-12-25,1912,Arsenal,Notts County,0-0,0,0,1,1,0,0,D
1912-12-25,1912,Chelsea,Manchester United,1-4,1,4,1,1,5,-3,A
1912-12-25,1912,Derby County,West Bromwich Albion,1-2,1,2,1,1,3,-1,A
1912-12-25,1912,Everton,Blackburn Rovers,2-1,2,1,1,1,3,1,H
1912-12-25,1912,Manchester City,Tottenham Hotspur,2-2,2,2,1,1,4,0,D
1912-12-25,1912,Newcastle United,Sheffield United,1-2,1,2,1,1,3,-1,A
1912-12-25,1912,Sheffield Wednesday,Sunderland,1-2,1,2,1,1,3,-1,A
1912-12-26,1912,Aston Villa,Oldham Athletic,7-1,7,1,1,1,8,6,H
1912-12-26,1912,Blackburn Rovers,Everton,1-2,1,2,1,1,3,-1,A
1912-12-26,1912,Liverpool,Newcastle United,2-1,2,1,1,1,3,1,H
1912-12-26,1912,Manchester United,Chelsea,4-2,4,2,1,1,6,2,H
1912-12-26,1912,Middlesbrough,Bradford City,1-1,1,1,1,1,2,0,D
1912-12-26,1912,Notts County,Arsenal,2-1,2,1,1,1,3,1,H
1912-12-26,1912,Sheffield United,Bolton Wanderers,0-2,0,2,1,1,2,-2,A
1912-12-26,1912,Sunderland,Sheffield Wednesday,0-2,0,2,1,1,2,-2,A
1912-12-26,1912,Tottenham Hotspur,Manchester City,4-0,4,0,1,1,4,4,H
1912-12-26,1912,West Bromwich Albion,Derby County,0-0,0,0,1,1,0,0,D
1912-12-28,1912,Arsenal,Liverpool,1-1,1,1,1,1,2,0,D
1912-12-28,1912,Blackburn Rovers,Derby County,0-1,0,1,1,1,1,-1,A
1912-12-28,1912,Bradford City,Aston Villa,1-1,1,1,1,1,2,0,D
1912-12-28,1912,Chelsea,Bolton Wanderers,2-3,2,3,1,1,5,-1,A
1912-12-28,1912,Everton,Middlesbrough,1-0,1,0,1,1,1,1,H
1912-12-28,1912,Manchester City,Manchester United,0-2,0,2,1,1,2,-2,A
1912-12-28,1912,Oldham Athletic,Sheffield United,2-0,2,0,1,1,2,2,H
1912-12-28,1912,Sheffield Wednesday,Tottenham Hotspur,2-1,2,1,1,1,3,1,H
1912-12-28,1912,Sunderland,Newcastle United,2-0,2,0,1,1,2,2,H
1912-12-28,1912,West Bromwich Albion,Notts County,2-0,2,0,1,1,2,2,H
1912-12-30,1912,Sheffield United,Newcastle United,1-1,1,1,1,1,2,0,D
1913-01-01,1912,Bolton Wanderers,Sheffield United,4-2,4,2,1,1,6,2,H
1913-01-01,1912,Everton,Tottenham Hotspur,1-2,1,2,1,1,3,-1,A
1913-01-01,1912,Manchester United,Bradford City,2-0,2,0,1,1,2,2,H
1913-01-01,1912,Middlesbrough,West Bromwich Albion,3-1,3,1,1,1,4,2,H
1913-01-01,1912,Newcastle United,Liverpool,0-0,0,0,1,1,0,0,D
1913-01-01,1912,Oldham Athletic,Blackburn Rovers,0-0,0,0,1,1,0,0,D
1913-01-01,1912,Sheffield Wednesday,Derby County,3-3,3,3,1,1,6,0,D
1913-01-01,1912,Sunderland,Arsenal,4-1,4,1,1,1,5,3,H
1913-01-02,1912,Manchester City,Notts County,4-0,4,0,1,1,4,4,H
1913-01-04,1912,Aston Villa,Manchester City,2-0,2,0,1,1,2,2,H
1913-01-04,1912,Bolton Wanderers,Arsenal,5-1,5,1,1,1,6,4,H
1913-01-04,1912,Liverpool,Bradford City,2-1,2,1,1,1,3,1,H
1913-01-04,1912,Manchester United,West Bromwich Albion,1-1,1,1,1,1,2,0,D
1913-01-04,1912,Middlesbrough,Sheffield Wednesday,0-2,0,2,1,1,2,-2,A
1913-01-04,1912,Newcastle United,Oldham Athletic,4-1,4,1,1,1,5,3,H
1913-01-04,1912,Notts County,Everton,0-1,0,1,1,1,1,-1,A
1913-01-04,1912,Sheffield United,Chelsea,3-3,3,3,1,1,6,0,D
1913-01-04,1912,Tottenham Hotspur,Blackburn Rovers,0-1,0,1,1,1,1,-1,A
1913-01-18,1912,Arsenal,Sheffield United,1-3,1,3,1,1,4,-2,A
1913-01-18,1912,Bradford City,Bolton Wanderers,4-1,4,1,1,1,5,3,H
1913-01-18,1912,Chelsea,Newcastle United,1-0,1,0,1,1,1,1,H
1913-01-18,1912,Derby County,Tottenham Hotspur,5-0,5,0,1,1,5,5,H
1913-01-18,1912,Everton,Manchester United,4-1,4,1,1,1,5,3,H
1913-01-18,1912,Manchester City,Liverpool,4-1,4,1,1,1,5,3,H
1913-01-18,1912,Sheffield Wednesday,Notts County,3-1,3,1,1,1,4,2,H
1913-01-18,1912,Sunderland,Oldham Athletic,1-1,1,1,1,1,2,0,D
1913-01-18,1912,West Bromwich Albion,Aston Villa,2-2,2,2,1,1,4,0,D
1913-01-25,1912,Aston Villa,Everton,1-1,1,1,1,1,2,0,D
1913-01-25,1912,Bolton Wanderers,Manchester City,2-2,2,2,1,1,4,0,D
1913-01-25,1912,Liverpool,West Bromwich Albion,2-1,2,1,1,1,3,1,H
1913-01-25,1912,Manchester United,Sheffield Wednesday,2-0,2,0,1,1,2,2,H
1913-01-25,1912,Middlesbrough,Derby County,4-1,4,1,1,1,5,3,H
1913-01-25,1912,Newcastle United,Arsenal,3-1,3,1,1,1,4,2,H
1913-01-25,1912,Notts County,Blackburn Rovers,3-1,3,1,1,1,4,2,H
1913-01-25,1912,Oldham Athletic,Chelsea,3-2,3,2,1,1,5,1,H
1913-01-25,1912,Sheffield United,Bradford City,3-2,3,2,1,1,5,1,H
1913-01-25,1912,Tottenham Hotspur,Sunderland,1-2,1,2,1,1,3,-1,A
1913-02-04,1912,Bradford City,Middlesbrough,1-2,1,2,1,1,3,-1,A
1913-02-08,1912,Arsenal,Oldham Athletic,0-0,0,0,1,1,0,0,D
1913-02-08,1912,Blackburn Rovers,Manchester United,0-0,0,0,1,1,0,0,D
1913-02-08,1912,Bradford City,Newcastle United,2-0,2,0,1,1,2,2,H
1913-02-08,1912,Derby County,Notts County,1-0,1,0,1,1,1,1,H
1913-02-08,1912,Everton,Liverpool,0-2,0,2,1,1,2,-2,A
1913-02-08,1912,Manchester City,Sheffield United,3-0,3,0,1,1,3,3,H
1913-02-08,1912,Sheffield Wednesday,Aston Villa,1-1,1,1,1,1,2,0,D
1913-02-08,1912,Sunderland,Chelsea,4-0,4,0,1,1,4,4,H
1913-02-08,1912,Tottenham Hotspur,Middlesbrough,5-3,5,3,1,1,8,2,H
1913-02-08,1912,West Bromwich Albion,Bolton Wanderers,2-2,2,2,1,1,4,0,D
1913-02-10,1912,Blackburn Rovers,Middlesbrough,5-2,5,2,1,1,7,3,H
1913-02-10,1912,Oldham Athletic,Liverpool,3-1,3,1,1,1,4,2,H
1913-02-15,1912,Aston Villa,Blackburn Rovers,1-1,1,1,1,1,2,0,D
1913-02-15,1912,Bolton Wanderers,Everton,0-0,0,0,1,1,0,0,D
1913-02-15,1912,Chelsea,Arsenal,1-1,1,1,1,1,2,0,D
1913-02-15,1912,Liverpool,Sheffield Wednesday,2-1,2,1,1,1,3,1,H
1913-02-15,1912,Manchester United,Derby County,4-0,4,0,1,1,4,4,H
1913-02-15,1912,Middlesbrough,Sunderland,0-2,0,2,1,1,2,-2,A
1913-02-15,1912,Newcastle United,Manchester City,0-1,0,1,1,1,1,-1,A
1913-02-15,1912,Notts County,Tottenham Hotspur,0-1,0,1,1,1,1,-1,A
1913-02-15,1912,Oldham Athletic,Bradford City,0-0,0,0,1,1,0,0,D
1913-02-15,1912,Sheffield United,West Bromwich Albion,1-0,1,0,1,1,1,1,H
1913-02-22,1912,Bradford City,Chelsea,2-2,2,2,1,1,4,0,D
1913-02-22,1912,Tottenham Hotspur,Sheffield United,1-0,1,0,1,1,1,1,H
1913-02-24,1912,Sheffield Wednesday,Bolton Wanderers,2-2,2,2,1,1,4,0,D
1913-02-26,1912,Derby County,Sunderland,0-3,0,3,1,1,3,-3,A
1913-03-01,1912,Arsenal,Bradford City,1-1,1,1,1,1,2,0,D
1913-03-01,1912,Aston Villa,Tottenham Hotspur,1-0,1,0,1,1,1,1,H
1913-03-01,1912,Bolton Wanderers,Blackburn Rovers,1-1,1,1,1,1,2,0,D
1913-03-01,1912,Chelsea,Manchester City,2-1,2,1,1,1,3,1,H
1913-03-01,1912,Liverpool,Derby County,2-1,2,1,1,1,3,1,H
1913-03-01,1912,Manchester United,Middlesbrough,2-3,2,3,1,1,5,-1,A
1913-03-01,1912,Newcastle United,Everton,2-0,2,0,1,1,2,2,H
1913-03-01,1912,Notts County,Sunderland,2-1,2,1,1,1,3,1,H
1913-03-01,1912,Oldham Athletic,West Bromwich Albion,0-0,0,0,1,1,0,0,D
1913-03-01,1912,Sheffield United,Sheffield Wednesday,0-2,0,2,1,1,2,-2,A
1913-03-08,1912,Derby County,Bolton Wanderers,3-3,3,3,1,1,6,0,D
1913-03-08,1912,Manchester City,Arsenal,0-1,0,1,1,1,1,-1,A
1913-03-08,1912,Notts County,Manchester United,1-2,1,2,1,1,3,-1,A
1913-03-08,1912,Tottenham Hotspur,Liverpool,1-0,1,0,1,1,1,1,H
1913-03-08,1912,West Bromwich Albion,Chelsea,0-1,0,1,1,1,1,-1,A
1913-03-10,1912,Blackburn Rovers,Liverpool,5-1,5,1,1,1,6,4,H
1913-03-12,1912,Derby County,Aston Villa,0-1,0,1,1,1,1,-1,A
1913-03-12,1912,Everton,Sheffield United,0-1,0,1,1,1,1,-1,A
1913-03-12,1912,Manchester City,Oldham Athletic,2-0,2,0,1,1,2,2,H
1913-03-15,1912,Arsenal,West Bromwich Albion,1-0,1,0,1,1,1,1,H
1913-03-15,1912,Aston Villa,Notts County,1-0,1,0,1,1,1,1,H
1913-03-15,1912,Bolton Wanderers,Tottenham Hotspur,2-0,2,0,1,1,2,2,H
1913-03-15,1912,Bradford City,Manchester City,2-1,2,1,1,1,3,1,H
1913-03-15,1912,Chelsea,Everton,1-3,1,3,1,1,4,-2,A
1913-03-15,1912,Liverpool,Middlesbrough,4-2,4,2,1,1,6,2,H
1913-03-15,1912,Manchester United,Sunderland,1-3,1,3,1,1,4,-2,A
1913-03-15,1912,Newcastle United,Blackburn Rovers,0-1,0,1,1,1,1,-1,A
1913-03-15,1912,Oldham Athletic,Sheffield Wednesday,2-0,2,0,1,1,2,2,H
1913-03-15,1912,Sheffield United,Derby County,4-1,4,1,1,1,5,3,H
1913-03-21,1912,Blackburn Rovers,Sheffield Wednesday,0-1,0,1,1,1,1,-1,A
1913-03-21,1912,Bolton Wanderers,Oldham Athletic,3-0,3,0,1,1,3,3,H
1913-03-21,1912,Bradford City,Notts County,1-0,1,0,1,1,1,1,H
1913-03-21,1912,Chelsea,Aston Villa,1-2,1,2,1,1,3,-1,A
1913-03-21,1912,Everton,Derby County,2-2,2,2,1,1,4,0,D
1913-03-21,1912,Manchester United,Arsenal,2-0,2,0,1,1,2,2,H
1913-03-21,1912,Middlesbrough,Manchester City,0-0,0,0,1,1,0,0,D
1913-03-21,1912,Sunderland,Sheffield United,1-0,1,0,1,1,1,1,H
1913-03-21,1912,Tottenham Hotspur,West Bromwich Albion,3-1,3,1,1,1,4,2,H
1913-03-22,1912,Blackburn Rovers,Oldham Athletic,7-1,7,1,1,1,8,6,H
1913-03-22,1912,Derby County,Newcastle United,2-1,2,1,1,1,3,1,H
1913-03-22,1912,Everton,Arsenal,3-0,3,0,1,1,3,3,H
1913-03-22,1912,Manchester United,Aston Villa,4-0,4,0,1,1,4,4,H
1913-03-22,1912,Middlesbrough,Bolton Wanderers,4-0,4,0,1,1,4,4,H
1913-03-22,1912,Notts County,Liverpool,3-0,3,0,1,1,3,3,H
1913-03-22,1912,Sheffield Wednesday,Chelsea,3-2,3,2,1,1,5,1,H
1913-03-22,1912,Sunderland,Manchester City,1-0,1,0,1,1,1,1,H
1913-03-22,1912,West Bromwich Albion,Bradford City,1-1,1,1,1,1,2,0,D
1913-03-24,1912,Aston Villa,Arsenal,4-1,4,1,1,1,5,3,H
1913-03-24,1912,Derby County,Sheffield Wednesday,1-4,1,4,1,1,5,-3,A
1913-03-24,1912,Liverpool,Chelsea,1-2,1,2,1,1,3,-1,A
1913-03-24,1912,Manchester City,Middlesbrough,3-0,3,0,1,1,3,3,H
1913-03-24,1912,Notts County,Bradford City,1-1,1,1,1,1,2,0,D
1913-03-24,1912,Sheffield United,Sunderland,1-3,1,3,1,1,4,-2,A
1913-03-24,1912,West Bromwich Albion,Tottenham Hotspur,4-1,4,1,1,1,5,3,H
1913-03-25,1912,Bradford City,Manchester United,1-0,1,0,1,1,1,1,H
1913-03-25,1912,Oldham Athletic,Bolton Wanderers,2-3,2,3,1,1,5,-1,A
1913-03-29,1912,Arsenal,Sheffield Wednesday,2-5,2,5,1,1,7,-3,A
1913-03-29,1912,Bolton Wanderers,Notts County,0-0,0,0,1,1,0,0,D
1913-03-29,1912,Bradford City,Everton,4-1,4,1,1,1,5,3,H
1913-03-29,1912,Chelsea,Blackburn Rovers,1-6,1,6,1,1,7,-5,A
1913-03-29,1912,Liverpool,Manchester United,0-2,0,2,1,1,2,-2,A
1913-03-29,1912,Manchester City,West Bromwich Albion,2-1,2,1,1,1,3,1,H
1913-03-29,1912,Newcastle United,Tottenham Hotspur,3-0,3,0,1,1,3,3,H
1913-03-31,1912,Sheffield United,Middlesbrough,1-0,1,0,1,1,1,1,H
1913-03-31,1912,Tottenham Hotspur,Manchester United,1-1,1,1,1,1,2,0,D
1913-04-02,1912,Everton,Oldham Athletic,2-3,2,3,1,1,5,-1,A
1913-04-02,1912,Middlesbrough,Notts County,1-1,1,1,1,1,2,0,D
1913-04-05,1912,Aston Villa,Liverpool,1-3,1,3,1,1,4,-2,A
1913-04-05,1912,Blackburn Rovers,Arsenal,1-1,1,1,1,1,2,0,D
1913-04-05,1912,Derby County,Chelsea,3-1,3,1,1,1,4,2,H
1913-04-05,1912,Everton,Manchester City,0-0,0,0,1,1,0,0,D
1913-04-05,1912,Manchester United,Bolton Wanderers,2-1,2,1,1,1,3,1,H
1913-04-05,1912,Middlesbrough,Newcastle United,0-0,0,0,1,1,0,0,D
1913-04-05,1912,Notts County,Sheffield United,0-1,0,1,1,1,1,-1,A
1913-04-05,1912,Sheffield Wednesday,Bradford City,6-0,6,0,1,1,6,6,H
1913-04-05,1912,Sunderland,West Bromwich Albion,3-1,3,1,1,1,4,2,H
1913-04-05,1912,Tottenham Hotspur,Oldham Athletic,1-0,1,0,1,1,1,1,H
1913-04-07,1912,Blackburn Rovers,Sheffield United,3-1,3,1,1,1,4,2,H
1913-04-09,1912,Middlesbrough,Aston Villa,1-1,1,1,1,1,2,0,D
1913-04-09,1912,Sunderland,Everton,3-1,3,1,1,1,4,2,H
1913-04-09,1912,West Bromwich Albion,Newcastle United,1-0,1,0,1,1,1,1,H
1913-04-12,1912,Arsenal,Derby County,1-2,1,2,1,1,3,-1,A
1913-04-12,1912,Bolton Wanderers,Aston Villa,2-3,2,3,1,1,5,-1,A
1913-04-12,1912,Bradford City,Blackburn Rovers,0-2,0,2,1,1,2,-2,A
1913-04-12,1912,Chelsea,Tottenham Hotspur,1-0,1,0,1,1,1,1,H
1913-04-12,1912,Liverpool,Sunderland,2-5,2,5,1,1,7,-3,A
1913-04-12,1912,Manchester City,Sheffield Wednesday,2-2,2,2,1,1,4,0,D
1913-04-12,1912,Newcastle United,Notts County,0-0,0,0,1,1,0,0,D
1913-04-12,1912,Oldham Athletic,Middlesbrough,1-0,1,0,1,1,1,1,H
1913-04-12,1912,Sheffield United,Manchester United,2-1,2,1,1,1,3,1,H
1913-04-12,1912,West Bromwich Albion,Everton,0-0,0,0,1,1,0,0,D
1913-04-14,1912,Sheffield Wednesday,Newcastle United,1-2,1,2,1,1,3,-1,A
1913-04-15,1912,Oldham Athletic,Derby County,2-2,2,2,1,1,4,0,D
1913-04-19,1912,Blackburn Rovers,Manchester City,2-2,2,2,1,1,4,0,D
1913-04-19,1912,Derby County,Bradford City,4-0,4,0,1,1,4,4,H
1913-04-19,1912,Liverpool,Bolton Wanderers,5-0,5,0,1,1,5,5,H
1913-04-19,1912,Manchester United,Newcastle United,3-0,3,0,1,1,3,3,H
1913-04-19,1912,Middlesbrough,Chelsea,0-3,0,3,1,1,3,-3,A
1913-04-19,1912,Notts County,Oldham Athletic,2-1,2,1,1,1,3,1,H
1913-04-19,1912,Sheffield Wednesday,West Bromwich Albion,3-2,3,2,1,1,5,1,H
1913-04-19,1912,Tottenham Hotspur,Arsenal,1-1,1,1,1,1,2,0,D
1913-04-23,1912,Aston Villa,Sunderland,1-1,1,1,1,1,2,0,D
1913-04-26,1912,Arsenal,Middlesbrough,1-1,1,1,1,1,2,0,D
1913-04-26,1912,Bolton Wanderers,Sunderland,1-3,1,3,1,1,4,-2,A
1913-04-26,1912,Bradford City,Tottenham Hotspur,3-1,3,1,1,1,4,2,H
1913-04-26,1912,Chelsea,Notts County,5-2,5,2,1,1,7,3,H
1913-04-26,1912,Everton,Sheffield Wednesday,3-1,3,1,1,1,4,2,H
1913-04-26,1912,Manchester City,Derby County,1-1,1,1,1,1,2,0,D
1913-04-26,1912,Newcastle United,Aston Villa,2-3,2,3,1,1,5,-1,A
1913-04-26,1912,Oldham Athletic,Manchester United,0-0,0,0,1,1,0,0,D
1913-04-26,1912,West Bromwich Albion,Blackburn Rovers,1-1,1,1,1,1,2,0,D
1913-04-28,1912,Aston Villa,Sheffield United,4-2,4,2,1,1,6,2,H
1913-04-30,1912,Sunderland,Bradford City,1-0,1,0,1,1,1,1,H
1913-09-01,1913,Aston Villa,Manchester City,1-1,1,1,1,1,2,0,D
1913-09-01,1913,Blackburn Rovers,Newcastle United,3-0,3,0,1,1,3,3,H
1913-09-01,1913,Bolton Wanderers,Sheffield Wednesday,0-1,0,1,1,1,1,-1,A
1913-09-01,1913,Derby County,Liverpool,1-1,1,1,1,1,2,0,D
1913-09-01,1913,Everton,Burnley,1-1,1,1,1,1,2,0,D
1913-09-01,1913,Preston North End,Sunderland,2-2,2,2,1,1,4,0,D
1913-09-01,1913,Sheffield United,Tottenham Hotspur,1-4,1,4,1,1,5,-3,A
1913-09-06,1913,Blackburn Rovers,Liverpool,6-2,6,2,1,1,8,4,H
1913-09-06,1913,Bolton Wanderers,Oldham Athletic,6-2,6,2,1,1,8,4,H
1913-09-06,1913,Bradford City,Aston Villa,0-0,0,0,1,1,0,0,D
1913-09-06,1913,Chelsea,Tottenham Hotspur,1-3,1,3,1,1,4,-2,A
1913-09-06,1913,Derby County,Sheffield United,3-5,3,5,1,1,8,-2,A
1913-09-06,1913,Everton,Preston North End,2-0,2,0,1,1,2,2,H
1913-09-06,1913,Manchester City,Middlesbrough,1-1,1,1,1,1,2,0,D
1913-09-06,1913,Sheffield Wednesday,Manchester United,1-3,1,3,1,1,4,-2,A
1913-09-06,1913,Sunderland,Newcastle United,1-2,1,2,1,1,3,-1,A
1913-09-06,1913,West Bromwich Albion,Burnley,4-1,4,1,1,1,5,3,H
1913-09-08,1913,Burnley,Blackburn Rovers,1-2,1,2,1,1,3,-1,A
1913-09-08,1913,Chelsea,West Bromwich Albion,1-1,1,1,1,1,2,0,D
1913-09-08,1913,Manchester United,Sunderland,3-1,3,1,1,1,4,2,H
1913-09-08,1913,Tottenham Hotspur,Sheffield United,2-1,2,1,1,1,3,1,H
1913-09-10,1913,Derby County,Middlesbrough,2-2,2,2,1,1,4,0,D
1913-09-13,1913,Aston Villa,Blackburn Rovers,1-3,1,3,1,1,4,-2,A
1913-09-13,1913,Burnley,Sheffield Wednesday,3-0,3,0,1,1,3,3,H
1913-09-13,1913,Liverpool,Sunderland,1-3,1,3,1,1,4,-2,A
1913-09-13,1913,Manchester United,Bolton Wanderers,0-1,0,1,1,1,1,-1,A
1913-09-13,1913,Middlesbrough,Bradford City,1-1,1,1,1,1,2,0,D
1913-09-13,1913,Newcastle United,Everton,0-1,0,1,1,1,1,-1,A
1913-09-13,1913,Oldham Athletic,Chelsea,3-2,3,2,1,1,5,1,H
1913-09-13,1913,Preston North End,West Bromwich Albion,0-2,0,2,1,1,2,-2,A
1913-09-13,1913,Sheffield United,Manchester City,1-3,1,3,1,1,4,-2,A
1913-09-13,1913,Tottenham Hotspur,Derby County,1-1,1,1,1,1,2,0,D
1913-09-17,1913,Bradford City,Preston North End,0-0,0,0,1,1,0,0,D
1913-09-20,1913,Blackburn Rovers,Middlesbrough,6-0,6,0,1,1,6,6,H
1913-09-20,1913,Bolton Wanderers,Burnley,0-0,0,0,1,1,0,0,D
1913-09-20,1913,Bradford City,Sheffield United,2-1,2,1,1,1,3,1,H
1913-09-20,1913,Chelsea,Manchester United,0-2,0,2,1,1,2,-2,A
1913-09-20,1913,Everton,Liverpool,1-2,1,2,1,1,3,-1,A
1913-09-20,1913,Manchester City,Derby County,1-2,1,2,1,1,3,-1,A
1913-09-20,1913,Oldham Athletic,Tottenham Hotspur,3-0,3,0,1,1,3,3,H
1913-09-20,1913,Sheffield Wednesday,Preston North End,2-1,2,1,1,1,3,1,H
1913-09-20,1913,Sunderland,Aston Villa,2-0,2,0,1,1,2,2,H
1913-09-20,1913,West Bromwich Albion,Newcastle United,1-1,1,1,1,1,2,0,D
1913-09-22,1913,Sheffield Wednesday,Oldham Athletic,1-2,1,2,1,1,3,-1,A
1913-09-27,1913,Aston Villa,Everton,3-1,3,1,1,1,4,2,H
1913-09-27,1913,Burnley,Chelsea,6-1,6,1,1,1,7,5,H
1913-09-27,1913,Derby County,Bradford City,3-1,3,1,1,1,4,2,H
1913-09-27,1913,Liverpool,West Bromwich Albion,0-0,0,0,1,1,0,0,D
1913-09-27,1913,Manchester United,Oldham Athletic,4-1,4,1,1,1,5,3,H
1913-09-27,1913,Middlesbrough,Sunderland,3-4,3,4,1,1,7,-1,A
1913-09-27,1913,Newcastle United,Sheffield Wednesday,3-1,3,1,1,1,4,2,H
1913-09-27,1913,Preston North End,Bolton Wanderers,1-1,1,1,1,1,2,0,D
1913-09-27,1913,Sheffield United,Blackburn Rovers,1-1,1,1,1,1,2,0,D
1913-09-27,1913,Tottenham Hotspur,Manchester City,3-1,3,1,1,1,4,2,H
1913-10-04,1913,Blackburn Rovers,Derby County,3-1,3,1,1,1,4,2,H
1913-10-04,1913,Bolton Wanderers,Newcastle United,3-1,3,1,1,1,4,2,H
1913-10-04,1913,Bradford City,Manchester City,3-2,3,2,1,1,5,1,H
1913-10-04,1913,Chelsea,Preston North End,2-0,2,0,1,1,2,2,H
1913-10-04,1913,Everton,Middlesbrough,2-0,2,0,1,1,2,2,H
1913-10-04,1913,Manchester United,Tottenham Hotspur,3-1,3,1,1,1,4,2,H
1913-10-04,1913,Oldham Athletic,Burnley,1-1,1,1,1,1,2,0,D
1913-10-04,1913,Sheffield Wednesday,Liverpool,4-1,4,1,1,1,5,3,H
1913-10-04,1913,Sunderland,Sheffield United,1-2,1,2,1,1,3,-1,A
1913-10-04,1913,West Bromwich Albion,Aston Villa,1-0,1,0,1,1,1,1,H
1913-10-11,1913,Aston Villa,Sheffield Wednesday,2-0,2,0,1,1,2,2,H
1913-10-11,1913,Burnley,Manchester United,1-2,1,2,1,1,3,-1,A
1913-10-11,1913,Derby County,Sunderland,1-1,1,1,1,1,2,0,D
1913-10-11,1913,Liverpool,Bolton Wanderers,2-1,2,1,1,1,3,1,H
1913-10-11,1913,Manchester City,Blackburn Rovers,1-2,1,2,1,1,3,-1,A
1913-10-11,1913,Middlesbrough,West Bromwich Albion,3-0,3,0,1,1,3,3,H
1913-10-11,1913,Newcastle United,Chelsea,1-0,1,0,1,1,1,1,H
1913-10-11,1913,Preston North End,Oldham Athletic,0-1,0,1,1,1,1,-1,A
1913-10-11,1913,Sheffield United,Everton,4-1,4,1,1,1,5,3,H
1913-10-11,1913,Tottenham Hotspur,Bradford City,0-0,0,0,1,1,0,0,D
1913-10-18,1913,Blackburn Rovers,Bradford City,0-0,0,0,1,1,0,0,D
1913-10-18,1913,Bolton Wanderers,Aston Villa,3-0,3,0,1,1,3,3,H
1913-10-18,1913,Burnley,Tottenham Hotspur,3-1,3,1,1,1,4,2,H
1913-10-18,1913,Chelsea,Liverpool,3-0,3,0,1,1,3,3,H
1913-10-18,1913,Everton,Derby County,5-0,5,0,1,1,5,5,H
1913-10-18,1913,Manchester United,Preston North End,3-0,3,0,1,1,3,3,H
1913-10-18,1913,Oldham Athletic,Newcastle United,3-0,3,0,1,1,3,3,H
1913-10-18,1913,Sheffield Wednesday,Middlesbrough,2-0,2,0,1,1,2,2,H
1913-10-18,1913,Sunderland,Manchester City,0-0,0,0,1,1,0,0,D
1913-10-18,1913,West Bromwich Albion,Sheffield United,2-1,2,1,1,1,3,1,H
1913-10-25,1913,Aston Villa,Chelsea,1-2,1,2,1,1,3,-1,A
1913-10-25,1913,Bradford City,Sunderland,0-2,0,2,1,1,2,-2,A
1913-10-25,1913,Derby County,West Bromwich Albion,1-2,1,2,1,1,3,-1,A
1913-10-25,1913,Liverpool,Oldham Athletic,0-3,0,3,1,1,3,-3,A
1913-10-25,1913,Manchester City,Everton,1-1,1,1,1,1,2,0,D
1913-10-25,1913,Middlesbrough,Bolton Wanderers,2-3,2,3,1,1,5,-1,A
1913-10-25,1913,Newcastle United,Manchester United,0-1,0,1,1,1,1,-1,A
1913-10-25,1913,Preston North End,Burnley,2-1,2,1,1,1,3,1,H
1913-10-25,1913,Sheffield United,Sheffield Wednesday,0-1,0,1,1,1,1,-1,A
1913-10-25,1913,Tottenham Hotspur,Blackburn Rovers,3-3,3,3,1,1,6,0,D
1913-11-01,1913,Bolton Wanderers,Sheffield United,3-1,3,1,1,1,4,2,H
1913-11-01,1913,Burnley,Newcastle United,1-0,1,0,1,1,1,1,H
1913-11-01,1913,Chelsea,Middlesbrough,3-2,3,2,1,1,5,1,H
1913-11-01,1913,Everton,Bradford City,1-1,1,1,1,1,2,0,D
1913-11-01,1913,Manchester United,Liverpool,3-0,3,0,1,1,3,3,H
1913-11-01,1913,Oldham Athletic,Aston Villa,0-1,0,1,1,1,1,-1,A
1913-11-01,1913,Preston North End,Tottenham Hotspur,1-2,1,2,1,1,3,-1,A
1913-11-01,1913,Sheffield Wednesday,Derby County,1-3,1,3,1,1,4,-2,A
1913-11-01,1913,Sunderland,Blackburn Rovers,2-1,2,1,1,1,3,1,H
1913-11-01,1913,West Bromwich Albion,Manchester City,0-0,0,0,1,1,0,0,D
1913-11-08,1913,Aston Villa,Manchester United,3-1,3,1,1,1,4,2,H
1913-11-08,1913,Blackburn Rovers,Everton,6-0,6,0,1,1,6,6,H
1913-11-08,1913,Bradford City,West Bromwich Albion,1-0,1,0,1,1,1,1,H
1913-11-08,1913,Derby County,Bolton Wanderers,3-3,3,3,1,1,6,0,D
1913-11-08,1913,Liverpool,Burnley,1-1,1,1,1,1,2,0,D
1913-11-08,1913,Manchester City,Sheffield Wednesday,1-2,1,2,1,1,3,-1,A
1913-11-08,1913,Middlesbrough,Oldham Athletic,0-0,0,0,1,1,0,0,D
1913-11-08,1913,Newcastle United,Preston North End,2-0,2,0,1,1,2,2,H
1913-11-08,1913,Sheffield United,Chelsea,3-2,3,2,1,1,5,1,H
1913-11-08,1913,Tottenham Hotspur,Sunderland,1-4,1,4,1,1,5,-3,A
1913-11-15,1913,Bolton Wanderers,Manchester City,3-0,3,0,1,1,3,3,H
1913-11-15,1913,Burnley,Aston Villa,4-0,4,0,1,1,4,4,H
1913-11-15,1913,Chelsea,Derby County,2-1,2,1,1,1,3,1,H
1913-11-15,1913,Everton,Sunderland,1-5,1,5,1,1,6,-4,A
1913-11-15,1913,Manchester United,Middlesbrough,0-1,0,1,1,1,1,-1,A
1913-11-15,1913,Newcastle United,Tottenham Hotspur,2-0,2,0,1,1,2,2,H
1913-11-15,1913,Oldham Athletic,Sheffield United,1-2,1,2,1,1,3,-1,A
1913-11-15,1913,Preston North End,Liverpool,0-1,0,1,1,1,1,-1,A
1913-11-15,1913,Sheffield Wednesday,Bradford City,1-3,1,3,1,1,4,-2,A
1913-11-15,1913,West Bromwich Albion,Blackburn Rovers,2-0,2,0,1,1,2,2,H
1913-11-22,1913,Aston Villa,Preston North End,3-0,3,0,1,1,3,3,H
1913-11-22,1913,Blackburn Rovers,Sheffield Wednesday,3-2,3,2,1,1,5,1,H
1913-11-22,1913,Bradford City,Bolton Wanderers,5-1,5,1,1,1,6,4,H
1913-11-22,1913,Derby County,Oldham Athletic,1-2,1,2,1,1,3,-1,A
1913-11-22,1913,Liverpool,Newcastle United,0-0,0,0,1,1,0,0,D
1913-11-22,1913,Manchester City,Chelsea,2-1,2,1,1,1,3,1,H
1913-11-22,1913,Middlesbrough,Burnley,2-1,2,1,1,1,3,1,H
1913-11-22,1913,Sheffield United,Manchester United,2-0,2,0,1,1,2,2,H
1913-11-22,1913,Sunderland,West Bromwich Albion,0-0,0,0,1,1,0,0,D
1913-11-22,1913,Tottenham Hotspur,Everton,4-1,4,1,1,1,5,3,H
1913-11-29,1913,Bolton Wanderers,Blackburn Rovers,1-0,1,0,1,1,1,1,H
1913-11-29,1913,Burnley,Sheffield United,0-0,0,0,1,1,0,0,D
1913-11-29,1913,Chelsea,Bradford City,2-1,2,1,1,1,3,1,H
1913-11-29,1913,Liverpool,Tottenham Hotspur,2-1,2,1,1,1,3,1,H
1913-11-29,1913,Manchester United,Derby County,3-3,3,3,1,1,6,0,D
1913-11-29,1913,Newcastle United,Aston Villa,2-2,2,2,1,1,4,0,D
1913-11-29,1913,Oldham Athletic,Manchester City,1-3,1,3,1,1,4,-2,A
1913-11-29,1913,Preston North End,Middlesbrough,4-1,4,1,1,1,5,3,H
1913-11-29,1913,Sheffield Wednesday,Sunderland,2-1,2,1,1,1,3,1,H
1913-11-29,1913,West Bromwich Albion,Everton,1-1,1,1,1,1,2,0,D
1913-12-06,1913,Aston Villa,Liverpool,2-1,2,1,1,1,3,1,H
1913-12-06,1913,Blackburn Rovers,Chelsea,3-1,3,1,1,1,4,2,H
1913-12-06,1913,Bradford City,Oldham Athletic,0-1,0,1,1,1,1,-1,A
1913-12-06,1913,Derby County,Burnley,3-1,3,1,1,1,4,2,H
1913-12-06,1913,Everton,Sheffield Wednesday,1-1,1,1,1,1,2,0,D
1913-12-06,1913,Manchester City,Manchester United,0-2,0,2,1,1,2,-2,A
1913-12-06,1913,Middlesbrough,Newcastle United,3-0,3,0,1,1,3,3,H
1913-12-06,1913,Sheffield United,Preston North End,2-0,2,0,1,1,2,2,H
1913-12-06,1913,Sunderland,Bolton Wanderers,3-2,3,2,1,1,5,1,H
1913-12-06,1913,Tottenham Hotspur,West Bromwich Albion,3-0,3,0,1,1,3,3,H
1913-12-13,1913,Aston Villa,Tottenham Hotspur,3-3,3,3,1,1,6,0,D
1913-12-13,1913,Bolton Wanderers,Everton,0-0,0,0,1,1,0,0,D
1913-12-13,1913,Burnley,Manchester City,2-0,2,0,1,1,2,2,H
1913-12-13,1913,Chelsea,Sunderland,1-1,1,1,1,1,2,0,D
1913-12-13,1913,Liverpool,Middlesbrough,2-1,2,1,1,1,3,1,H
1913-12-13,1913,Manchester United,Bradford City,1-1,1,1,1,1,2,0,D
1913-12-13,1913,Newcastle United,Sheffield United,2-1,2,1,1,1,3,1,H
1913-12-13,1913,Oldham Athletic,Blackburn Rovers,1-1,1,1,1,1,2,0,D
1913-12-13,1913,Preston North End,Derby County,2-0,2,0,1,1,2,2,H
1913-12-13,1913,Sheffield Wednesday,West Bromwich Albion,1-4,1,4,1,1,5,-3,A
1913-12-20,1913,Blackburn Rovers,Manchester United,0-1,0,1,1,1,1,-1,A
1913-12-20,1913,Bradford City,Burnley,1-1,1,1,1,1,2,0,D
1913-12-20,1913,Derby County,Newcastle United,2-0,2,0,1,1,2,2,H
1913-12-20,1913,Everton,Chelsea,0-0,0,0,1,1,0,0,D
1913-12-20,1913,Manchester City,Preston North End,1-1,1,1,1,1,2,0,D
1913-12-20,1913,Middlesbrough,Aston Villa,5-2,5,2,1,1,7,3,H
1913-12-20,1913,Sheffield United,Liverpool,0-1,0,1,1,1,1,-1,A
1913-12-20,1913,Sunderland,Oldham Athletic,2-0,2,0,1,1,2,2,H
1913-12-20,1913,Tottenham Hotspur,Sheffield Wednesday,1-1,1,1,1,1,2,0,D
1913-12-20,1913,West Bromwich Albion,Bolton Wanderers,1-1,1,1,1,1,2,0,D
1913-12-25,1913,Blackburn Rovers,Preston North End,5-0,5,0,1,1,5,5,H
1913-12-25,1913,Burnley,Sunderland,0-1,0,1,1,1,1,-1,A
1913-12-25,1913,Chelsea,Sheffield Wednesday,2-1,2,1,1,1,3,1,H
1913-12-25,1913,Derby County,Aston Villa,0-2,0,2,1,1,2,-2,A
1913-12-25,1913,Liverpool,Manchester City,4-2,4,2,1,1,6,2,H
1913-12-25,1913,Manchester United,Everton,0-1,0,1,1,1,1,-1,A
1913-12-25,1913,Newcastle United,Bradford City,0-0,0,0,1,1,0,0,D
1913-12-25,1913,Oldham Athletic,West Bromwich Albion,2-0,2,0,1,1,2,2,H
1913-12-25,1913,Sheffield United,Middlesbrough,3-1,3,1,1,1,4,2,H
1913-12-26,1913,Aston Villa,Sheffield United,3-0,3,0,1,1,3,3,H
1913-12-26,1913,Bradford City,Newcastle United,2-0,2,0,1,1,2,2,H
1913-12-26,1913,Everton,Manchester United,5-0,5,0,1,1,5,5,H
1913-12-26,1913,Manchester City,Liverpool,1-0,1,0,1,1,1,1,H
1913-12-26,1913,Preston North End,Blackburn Rovers,1-5,1,5,1,1,6,-4,A
1913-12-26,1913,Sheffield Wednesday,Chelsea,3-0,3,0,1,1,3,3,H
1913-12-26,1913,Sunderland,Burnley,1-1,1,1,1,1,2,0,D
1913-12-26,1913,Tottenham Hotspur,Middlesbrough,0-1,0,1,1,1,1,-1,A
1913-12-26,1913,West Bromwich Albion,Oldham Athletic,2-2,2,2,1,1,4,0,D
1913-12-27,1913,Aston Villa,Bradford City,0-1,0,1,1,1,1,-1,A
1913-12-27,1913,Burnley,West Bromwich Albion,0-0,0,0,1,1,0,0,D
1913-12-27,1913,Liverpool,Blackburn Rovers,3-3,3,3,1,1,6,0,D
1913-12-27,1913,Manchester United,Sheffield Wednesday,2-1,2,1,1,1,3,1,H
1913-12-27,1913,Middlesbrough,Manchester City,2-0,2,0,1,1,2,2,H
1913-12-27,1913,Newcastle United,Sunderland,2-1,2,1,1,1,3,1,H
1913-12-27,1913,Oldham Athletic,Bolton Wanderers,2-0,2,0,1,1,2,2,H
1913-12-27,1913,Preston North End,Everton,1-0,1,0,1,1,1,1,H
1913-12-27,1913,Sheffield United,Derby County,2-2,2,2,1,1,4,0,D
1913-12-27,1913,Tottenham Hotspur,Chelsea,1-2,1,2,1,1,3,-1,A
1913-12-29,1913,Sheffield Wednesday,Bolton Wanderers,1-1,1,1,1,1,2,0,D
1914-01-01,1913,Blackburn Rovers,Burnley,0-0,0,0,1,1,0,0,D
1914-01-01,1913,Bolton Wanderers,Tottenham Hotspur,3-0,3,0,1,1,3,3,H
1914-01-01,1913,Liverpool,Bradford City,0-1,0,1,1,1,1,-1,A
1914-01-01,1913,Manchester United,West Bromwich Albion,1-0,1,0,1,1,1,1,H
1914-01-01,1913,Middlesbrough,Derby County,3-2,3,2,1,1,5,1,H
1914-01-01,1913,Newcastle United,Manchester City,0-1,0,1,1,1,1,-1,A
1914-01-01,1913,Oldham Athletic,Everton,2-0,2,0,1,1,2,2,H
1914-01-01,1913,Sheffield United,Aston Villa,3-0,3,0,1,1,3,3,H
1914-01-01,1913,Sunderland,Preston North End,3-1,3,1,1,1,4,2,H
1914-01-03,1913,Blackburn Rovers,Aston Villa,0-0,0,0,1,1,0,0,D
1914-01-03,1913,Bolton Wanderers,Manchester United,6-1,6,1,1,1,7,5,H
1914-01-03,1913,Bradford City,Middlesbrough,2-3,2,3,1,1,5,-1,A
1914-01-03,1913,Chelsea,Oldham Athletic,2-1,2,1,1,1,3,1,H
1914-01-03,1913,Derby County,Tottenham Hotspur,4-0,4,0,1,1,4,4,H
1914-01-03,1913,Everton,Newcastle United,2-0,2,0,1,1,2,2,H
1914-01-03,1913,Manchester City,Sheffield United,2-1,2,1,1,1,3,1,H
1914-01-03,1913,Sheffield Wednesday,Burnley,2-6,2,6,1,1,8,-4,A
1914-01-03,1913,Sunderland,Liverpool,1-2,1,2,1,1,3,-1,A
1914-01-03,1913,West Bromwich Albion,Preston North End,1-0,1,0,1,1,1,1,H
1914-01-17,1913,Aston Villa,Sunderland,5-0,5,0,1,1,5,5,H
1914-01-17,1913,Burnley,Bolton Wanderers,2-2,2,2,1,1,4,0,D
1914-01-17,1913,Derby County,Manchester City,2-4,2,4,1,1,6,-2,A
1914-01-17,1913,Liverpool,Everton,1-2,1,2,1,1,3,-1,A
1914-01-17,1913,Manchester United,Chelsea,0-1,0,1,1,1,1,-1,A
1914-01-17,1913,Middlesbrough,Blackburn Rovers,3-0,3,0,1,1,3,3,H
1914-01-17,1913,Newcastle United,West Bromwich Albion,3-3,3,3,1,1,6,0,D
1914-01-17,1913,Preston North End,Sheffield Wednesday,5-0,5,0,1,1,5,5,H
1914-01-17,1913,Sheffield United,Bradford City,1-1,1,1,1,1,2,0,D
1914-01-17,1913,Tottenham Hotspur,Oldham Athletic,3-1,3,1,1,1,4,2,H
1914-01-24,1913,Blackburn Rovers,Sheffield United,3-2,3,2,1,1,5,1,H
1914-01-24,1913,Bolton Wanderers,Preston North End,0-3,0,3,1,1,3,-3,A
1914-01-24,1913,Bradford City,Derby County,0-0,0,0,1,1,0,0,D
1914-01-24,1913,Chelsea,Burnley,0-0,0,0,1,1,0,0,D
1914-01-24,1913,Everton,Aston Villa,1-4,1,4,1,1,5,-3,A
1914-01-24,1913,Manchester City,Tottenham Hotspur,2-1,2,1,1,1,3,1,H
1914-01-24,1913,Oldham Athletic,Manchester United,2-2,2,2,1,1,4,0,D
1914-01-24,1913,Sheffield Wednesday,Newcastle United,0-0,0,0,1,1,0,0,D
1914-01-24,1913,Sunderland,Middlesbrough,4-2,4,2,1,1,6,2,H
1914-01-24,1913,West Bromwich Albion,Liverpool,0-1,0,1,1,1,1,-1,A
1914-02-07,1913,Aston Villa,West Bromwich Albion,2-0,2,0,1,1,2,2,H
1914-02-07,1913,Burnley,Oldham Athletic,2-0,2,0,1,1,2,2,H
1914-02-07,1913,Derby County,Blackburn Rovers,2-3,2,3,1,1,5,-1,A
1914-02-07,1913,Liverpool,Sheffield Wednesday,1-2,1,2,1,1,3,-1,A
1914-02-07,1913,Manchester City,Bradford City,1-0,1,0,1,1,1,1,H
1914-02-07,1913,Middlesbrough,Everton,2-0,2,0,1,1,2,2,H
1914-02-07,1913,Newcastle United,Bolton Wanderers,4-3,4,3,1,1,7,1,H
1914-02-07,1913,Preston North End,Chelsea,3-3,3,3,1,1,6,0,D
1914-02-07,1913,Sheffield United,Sunderland,1-0,1,0,1,1,1,1,H
1914-02-07,1913,Tottenham Hotspur,Manchester United,2-1,2,1,1,1,3,1,H
1914-02-11,1913,Bolton Wanderers,Chelsea,1-1,1,1,1,1,2,0,D
1914-02-14,1913,Blackburn Rovers,Manchester City,2-1,2,1,1,1,3,1,H
1914-02-14,1913,Bolton Wanderers,Liverpool,2-1,2,1,1,1,3,1,H
1914-02-14,1913,Bradford City,Tottenham Hotspur,2-1,2,1,1,1,3,1,H
1914-02-14,1913,Chelsea,Newcastle United,0-1,0,1,1,1,1,-1,A
1914-02-14,1913,Everton,Sheffield United,5-0,5,0,1,1,5,5,H
1914-02-14,1913,Manchester United,Burnley,0-1,0,1,1,1,1,-1,A
1914-02-14,1913,Oldham Athletic,Preston North End,1-0,1,0,1,1,1,1,H
1914-02-14,1913,Sheffield Wednesday,Aston Villa,2-3,2,3,1,1,5,-1,A
1914-02-14,1913,Sunderland,Derby County,1-0,1,0,1,1,1,1,H
1914-02-14,1913,West Bromwich Albion,Middlesbrough,2-1,2,1,1,1,3,1,H
1914-02-21,1913,Derby County,Everton,1-0,1,0,1,1,1,1,H
1914-02-21,1913,Middlesbrough,Manchester United,3-1,3,1,1,1,4,2,H
1914-02-21,1913,Newcastle United,Oldham Athletic,0-0,0,0,1,1,0,0,D
1914-02-23,1913,Tottenham Hotspur,Burnley,2-0,2,0,1,1,2,2,H
1914-02-25,1913,Aston Villa,Bolton Wanderers,1-0,1,0,1,1,1,1,H
1914-02-25,1913,Bradford City,Blackburn Rovers,0-2,0,2,1,1,2,-2,A
1914-02-28,1913,Blackburn Rovers,Tottenham Hotspur,1-1,1,1,1,1,2,0,D
1914-02-28,1913,Bolton Wanderers,Middlesbrough,1-1,1,1,1,1,2,0,D
1914-02-28,1913,Burnley,Preston North End,3-4,3,4,1,1,7,-1,A
1914-02-28,1913,Chelsea,Aston Villa,0-3,0,3,1,1,3,-3,A
1914-02-28,1913,Everton,Manchester City,1-0,1,0,1,1,1,1,H
1914-02-28,1913,Manchester United,Newcastle United,2-2,2,2,1,1,4,0,D
1914-02-28,1913,Oldham Athletic,Liverpool,2-2,2,2,1,1,4,0,D
1914-02-28,1913,Sheffield Wednesday,Sheffield United,2-1,2,1,1,1,3,1,H
1914-02-28,1913,Sunderland,Bradford City,0-1,0,1,1,1,1,-1,A
1914-02-28,1913,West Bromwich Albion,Derby County,2-1,2,1,1,1,3,1,H
1914-03-05,1913,Preston North End,Manchester United,4-2,4,2,1,1,6,2,H
1914-03-07,1913,Bolton Wanderers,West Bromwich Albion,1-0,1,0,1,1,1,1,H
1914-03-07,1913,Bradford City,Everton,0-1,0,1,1,1,1,-1,A
1914-03-07,1913,Middlesbrough,Chelsea,2-0,2,0,1,1,2,2,H
1914-03-07,1913,Tottenham Hotspur,Preston North End,1-0,1,0,1,1,1,1,H
1914-03-11,1913,Derby County,Sheffield Wednesday,1-1,1,1,1,1,2,0,D
1914-03-14,1913,Bolton Wanderers,Derby County,3-1,3,1,1,1,4,2,H
1914-03-14,1913,Burnley,Liverpool,5-2,5,2,1,1,7,3,H
1914-03-14,1913,Chelsea,Sheffield United,2-0,2,0,1,1,2,2,H
1914-03-14,1913,Everton,Blackburn Rovers,0-0,0,0,1,1,0,0,D
1914-03-14,1913,Manchester United,Aston Villa,0-6,0,6,1,1,6,-6,A
1914-03-14,1913,Oldham Athletic,Middlesbrough,3-0,3,0,1,1,3,3,H
1914-03-14,1913,Preston North End,Newcastle United,4-1,4,1,1,1,5,3,H
1914-03-14,1913,Sheffield Wednesday,Manchester City,2-2,2,2,1,1,4,0,D
1914-03-14,1913,Sunderland,Tottenham Hotspur,2-0,2,0,1,1,2,2,H
1914-03-14,1913,West Bromwich Albion,Bradford City,2-1,2,1,1,1,3,1,H
1914-03-18,1913,Aston Villa,Oldham Athletic,0-0,0,0,1,1,0,0,D
1914-03-18,1913,Liverpool,Chelsea,3-0,3,0,1,1,3,3,H
1914-03-18,1913,Manchester City,Sunderland,3-1,3,1,1,1,4,2,H
1914-03-18,1913,Middlesbrough,Sheffield Wednesday,5-2,5,2,1,1,7,3,H
1914-03-18,1913,Newcastle United,Burnley,3-1,3,1,1,1,4,2,H
1914-03-19,1913,Sheffield United,West Bromwich Albion,1-1,1,1,1,1,2,0,D
1914-03-21,1913,Aston Villa,Burnley,1-0,1,0,1,1,1,1,H
1914-03-21,1913,Blackburn Rovers,West Bromwich Albion,2-0,2,0,1,1,2,2,H
1914-03-21,1913,Bradford City,Sheffield Wednesday,3-1,3,1,1,1,4,2,H
1914-03-21,1913,Derby County,Chelsea,0-1,0,1,1,1,1,-1,A
1914-03-21,1913,Liverpool,Preston North End,3-1,3,1,1,1,4,2,H
1914-03-21,1913,Manchester City,Bolton Wanderers,0-1,0,1,1,1,1,-1,A
1914-03-21,1913,Sheffield United,Oldham Athletic,2-1,2,1,1,1,3,1,H
1914-03-21,1913,Sunderland,Everton,5-2,5,2,1,1,7,3,H
1914-03-21,1913,Tottenham Hotspur,Newcastle United,0-0,0,0,1,1,0,0,D
1914-03-23,1913,Blackburn Rovers,Sunderland,3-1,3,1,1,1,4,2,H
1914-03-25,1913,Manchester City,West Bromwich Albion,2-3,2,3,1,1,5,-1,A
1914-03-28,1913,Bolton Wanderers,Bradford City,3-0,3,0,1,1,3,3,H
1914-03-28,1913,Chelsea,Manchester City,1-0,1,0,1,1,1,1,H
1914-03-28,1913,Everton,Tottenham Hotspur,1-1,1,1,1,1,2,0,D
1914-03-28,1913,Oldham Athletic,Derby County,0-0,0,0,1,1,0,0,D
1914-03-28,1913,Sheffield Wednesday,Blackburn Rovers,3-1,3,1,1,1,4,2,H
1914-03-28,1913,West Bromwich Albion,Sunderland,2-1,2,1,1,1,3,1,H
1914-04-01,1913,Newcastle United,Liverpool,1-2,1,2,1,1,3,-1,A
1914-04-01,1913,Preston North End,Aston Villa,3-2,3,2,1,1,5,1,H
1914-04-04,1913,Aston Villa,Newcastle United,1-3,1,3,1,1,4,-2,A
1914-04-04,1913,Blackburn Rovers,Bolton Wanderers,3-2,3,2,1,1,5,1,H
1914-04-04,1913,Bradford City,Chelsea,0-0,0,0,1,1,0,0,D
1914-04-04,1913,Derby County,Manchester United,4-2,4,2,1,1,6,2,H
1914-04-04,1913,Everton,West Bromwich Albion,2-0,2,0,1,1,2,2,H
1914-04-04,1913,Manchester City,Oldham Athletic,2-1,2,1,1,1,3,1,H
1914-04-04,1913,Middlesbrough,Preston North End,4-1,4,1,1,1,5,3,H
1914-04-04,1913,Sheffield United,Burnley,5-0,5,0,1,1,5,5,H
1914-04-04,1913,Sunderland,Sheffield Wednesday,0-1,0,1,1,1,1,-1,A
1914-04-04,1913,Tottenham Hotspur,Liverpool,0-0,0,0,1,1,0,0,D
1914-04-06,1913,Burnley,Middlesbrough,1-2,1,2,1,1,3,-1,A
1914-04-06,1913,Sheffield United,Bolton Wanderers,2-0,2,0,1,1,2,2,H
1914-04-10,1913,Burnley,Everton,2-0,2,0,1,1,2,2,H
1914-04-10,1913,Liverpool,Derby County,1-0,1,0,1,1,1,1,H
1914-04-10,1913,Manchester City,Aston Villa,3-1,3,1,1,1,4,2,H
1914-04-10,1913,Middlesbrough,Sheffield United,2-3,2,3,1,1,5,-1,A
1914-04-10,1913,Newcastle United,Blackburn Rovers,0-0,0,0,1,1,0,0,D
1914-04-10,1913,Preston North End,Bradford City,2-1,2,1,1,1,3,1,H
1914-04-10,1913,Sunderland,Manchester United,2-0,2,0,1,1,2,2,H
1914-04-10,1913,Tottenham Hotspur,Bolton Wanderers,3-0,3,0,1,1,3,3,H
1914-04-11,1913,Bolton Wanderers,Sunderland,2-1,2,1,1,1,3,1,H
1914-04-11,1913,Burnley,Derby County,5-1,5,1,1,1,6,4,H
1914-04-11,1913,Chelsea,Blackburn Rovers,2-0,2,0,1,1,2,2,H
1914-04-11,1913,Liverpool,Aston Villa,0-1,0,1,1,1,1,-1,A
1914-04-11,1913,Manchester United,Manchester City,0-1,0,1,1,1,1,-1,A
1914-04-11,1913,Newcastle United,Middlesbrough,1-0,1,0,1,1,1,1,H
1914-04-11,1913,Oldham Athletic,Bradford City,3-1,3,1,1,1,4,2,H
1914-04-11,1913,Preston North End,Sheffield United,2-4,2,4,1,1,6,-2,A
1914-04-11,1913,Sheffield Wednesday,Everton,2-2,2,2,1,1,4,0,D
1914-04-11,1913,West Bromwich Albion,Tottenham Hotspur,1-1,1,1,1,1,2,0,D
1914-04-13,1913,Aston Villa,Derby County,3-2,3,2,1,1,5,1,H
1914-04-13,1913,Bradford City,Liverpool,1-0,1,0,1,1,1,1,H
1914-04-13,1913,Chelsea,Bolton Wanderers,2-1,2,1,1,1,3,1,H
1914-04-13,1913,Everton,Oldham Athletic,0-2,0,2,1,1,2,-2,A
1914-04-13,1913,Manchester City,Newcastle United,0-1,0,1,1,1,1,-1,A
1914-04-13,1913,Middlesbrough,Tottenham Hotspur,6-0,6,0,1,1,6,6,H
1914-04-13,1913,West Bromwich Albion,Manchester United,2-1,2,1,1,1,3,1,H
1914-04-14,1913,Oldham Athletic,Sheffield Wednesday,2-0,2,0,1,1,2,2,H
1914-04-14,1913,West Bromwich Albion,Chelsea,3-1,3,1,1,1,4,2,H
1914-04-15,1913,Liverpool,Manchester United,1-2,1,2,1,1,3,-1,A
1914-04-18,1913,Blackburn Rovers,Oldham Athletic,2-1,2,1,1,1,3,1,H
1914-04-18,1913,Bradford City,Manchester United,1-1,1,1,1,1,2,0,D
1914-04-18,1913,Derby County,Preston North End,0-1,0,1,1,1,1,-1,A
1914-04-18,1913,Everton,Bolton Wanderers,1-1,1,1,1,1,2,0,D
1914-04-18,1913,Manchester City,Burnley,4-1,4,1,1,1,5,3,H
1914-04-18,1913,Middlesbrough,Liverpool,4-0,4,0,1,1,4,4,H
1914-04-18,1913,Sheffield United,Newcastle United,2-0,2,0,1,1,2,2,H
1914-04-18,1913,Sunderland,Chelsea,2-0,2,0,1,1,2,2,H
1914-04-18,1913,Tottenham Hotspur,Aston Villa,0-2,0,2,1,1,2,-2,A
1914-04-18,1913,West Bromwich Albion,Sheffield Wednesday,1-1,1,1,1,1,2,0,D
1914-04-22,1913,Manchester United,Sheffield United,2-1,2,1,1,1,3,1,H
1914-04-25,1913,Aston Villa,Middlesbrough,1-3,1,3,1,1,4,-2,A
1914-04-25,1913,Chelsea,Everton,2-0,2,0,1,1,2,2,H
1914-04-25,1913,Manchester United,Blackburn Rovers,0-0,0,0,1,1,0,0,D
1914-04-25,1913,Newcastle United,Derby County,1-1,1,1,1,1,2,0,D
1914-04-25,1913,Oldham Athletic,Sunderland,2-1,2,1,1,1,3,1,H
1914-04-25,1913,Preston North End,Manchester City,2-2,2,2,1,1,4,0,D
1914-04-25,1913,Sheffield Wednesday,Tottenham Hotspur,2-0,2,0,1,1,2,2,H
1914-04-27,1913,Burnley,Bradford City,2-2,2,2,1,1,4,0,D
1914-04-27,1913,Liverpool,Sheffield United,2-1,2,1,1,1,3,1,H
1914-09-01,1914,Manchester City,Bradford City,4-1,4,1,1,1,5,3,H
1914-09-01,1914,Sheffield Wednesday,Middlesbrough,3-1,3,1,1,1,4,2,H
1914-09-02,1914,Aston Villa,Notts County,2-1,2,1,1,1,3,1,H
1914-09-02,1914,Liverpool,Bolton Wanderers,4-3,4,3,1,1,7,1,H
1914-09-02,1914,Manchester United,Oldham Athletic,1-3,1,3,1,1,4,-2,A
1914-09-02,1914,Newcastle United,West Bromwich Albion,1-2,1,2,1,1,3,-1,A
1914-09-02,1914,Sunderland,Sheffield United,3-2,3,2,1,1,5,1,H
1914-09-02,1914,Tottenham Hotspur,Everton,1-3,1,3,1,1,4,-2,A
1914-09-05,1914,Aston Villa,Sunderland,1-3,1,3,1,1,4,-2,A
1914-09-05,1914,Bradford Park Avenue,Blackburn Rovers,1-2,1,2,1,1,3,-1,A
1914-09-05,1914,Burnley,Bradford City,0-1,0,1,1,1,1,-1,A
1914-09-05,1914,Liverpool,Notts County,1-1,1,1,1,1,2,0,D
1914-09-05,1914,Manchester United,Manchester City,0-0,0,0,1,1,0,0,D
1914-09-05,1914,Middlesbrough,West Bromwich Albion,2-0,2,0,1,1,2,2,H
1914-09-05,1914,Newcastle United,Everton,0-1,0,1,1,1,1,-1,A
1914-09-05,1914,Oldham Athletic,Bolton Wanderers,5-3,5,3,1,1,8,2,H
1914-09-05,1914,Sheffield United,Sheffield Wednesday,0-1,0,1,1,1,1,-1,A
1914-09-05,1914,Tottenham Hotspur,Chelsea,1-1,1,1,1,1,2,0,D
1914-09-07,1914,Bolton Wanderers,Blackburn Rovers,3-2,3,2,1,1,5,1,H
1914-09-07,1914,Burnley,Everton,1-0,1,0,1,1,1,1,H
1914-09-09,1914,Bradford City,Chelsea,2-2,2,2,1,1,4,0,D
1914-09-09,1914,Newcastle United,Sheffield Wednesday,0-0,0,0,1,1,0,0,D
1914-09-12,1914,Blackburn Rovers,Oldham Athletic,4-1,4,1,1,1,5,3,H
1914-09-12,1914,Bolton Wanderers,Manchester United,3-0,3,0,1,1,3,3,H
1914-09-12,1914,Bradford City,Tottenham Hotspur,2-2,2,2,1,1,4,0,D
1914-09-12,1914,Chelsea,Newcastle United,0-3,0,3,1,1,3,-3,A
1914-09-12,1914,Everton,Middlesbrough,2-3,2,3,1,1,5,-1,A
1914-09-12,1914,Manchester City,Burnley,1-0,1,0,1,1,1,1,H
1914-09-12,1914,Notts County,Bradford Park Avenue,1-2,1,2,1,1,3,-1,A
1914-09-12,1914,Sheffield Wednesday,Aston Villa,5-2,5,2,1,1,7,3,H
1914-09-12,1914,Sunderland,Liverpool,2-2,2,2,1,1,4,0,D
1914-09-12,1914,West Bromwich Albion,Sheffield United,1-1,1,1,1,1,2,0,D
1914-09-19,1914,Aston Villa,West Bromwich Albion,2-1,2,1,1,1,3,1,H
1914-09-19,1914,Bolton Wanderers,Manchester City,2-3,2,3,1,1,5,-1,A
1914-09-19,1914,Bradford Park Avenue,Sunderland,2-1,2,1,1,1,3,1,H
1914-09-19,1914,Liverpool,Sheffield Wednesday,2-1,2,1,1,1,3,1,H
1914-09-19,1914,Manchester United,Blackburn Rovers,2-0,2,0,1,1,2,2,H
1914-09-19,1914,Middlesbrough,Chelsea,3-0,3,0,1,1,3,3,H
1914-09-19,1914,Newcastle United,Bradford City,1-0,1,0,1,1,1,1,H
1914-09-19,1914,Oldham Athletic,Notts County,2-0,2,0,1,1,2,2,H
1914-09-19,1914,Sheffield United,Everton,1-0,1,0,1,1,1,1,H
1914-09-19,1914,Tottenham Hotspur,Burnley,1-3,1,3,1,1,4,-2,A
1914-09-21,1914,Blackburn Rovers,Liverpool,4-2,4,2,1,1,6,2,H
1914-09-26,1914,Blackburn Rovers,Bolton Wanderers,2-2,2,2,1,1,4,0,D
1914-09-26,1914,Bradford City,Middlesbrough,1-1,1,1,1,1,2,0,D
1914-09-26,1914,Burnley,Newcastle United,2-0,2,0,1,1,2,2,H
1914-09-26,1914,Chelsea,Sheffield United,1-1,1,1,1,1,2,0,D
1914-09-26,1914,Everton,Aston Villa,0-0,0,0,1,1,0,0,D
1914-09-26,1914,Manchester City,Tottenham Hotspur,2-1,2,1,1,1,3,1,H
1914-09-26,1914,Notts County,Manchester United,4-2,4,2,1,1,6,2,H
1914-09-26,1914,Sheffield Wednesday,Bradford Park Avenue,6-0,6,0,1,1,6,6,H
1914-09-26,1914,Sunderland,Oldham Athletic,1-2,1,2,1,1,3,-1,A
1914-09-26,1914,West Bromwich Albion,Liverpool,4-0,4,0,1,1,4,4,H
1914-09-28,1914,Tottenham Hotspur,West Bromwich Albion,2-0,2,0,1,1,2,2,H
1914-10-03,1914,Aston Villa,Chelsea,2-1,2,1,1,1,3,1,H
1914-10-03,1914,Blackburn Rovers,Manchester City,0-1,0,1,1,1,1,-1,A
1914-10-03,1914,Bolton Wanderers,Notts County,1-2,1,2,1,1,3,-1,A
1914-10-03,1914,Bradford Park Avenue,West Bromwich Albion,1-4,1,4,1,1,5,-3,A
1914-10-03,1914,Liverpool,Everton,0-5,0,5,1,1,5,-5,A
1914-10-03,1914,Manchester United,Sunderland,3-0,3,0,1,1,3,3,H
1914-10-03,1914,Middlesbrough,Burnley,1-1,1,1,1,1,2,0,D
1914-10-03,1914,Newcastle United,Tottenham Hotspur,4-0,4,0,1,1,4,4,H
1914-10-03,1914,Oldham Athletic,Sheffield Wednesday,5-2,5,2,1,1,7,3,H
1914-10-03,1914,Sheffield United,Bradford City,1-1,1,1,1,1,2,0,D
1914-10-07,1914,Bradford Park Avenue,Bolton Wanderers,1-2,1,2,1,1,3,-1,A
1914-10-10,1914,Bradford City,Aston Villa,3-0,3,0,1,1,3,3,H
1914-10-10,1914,Burnley,Sheffield United,1-2,1,2,1,1,3,-1,A
1914-10-10,1914,Chelsea,Liverpool,3-1,3,1,1,1,4,2,H
1914-10-10,1914,Everton,Bradford Park Avenue,4-1,4,1,1,1,5,3,H
1914-10-10,1914,Manchester City,Newcastle United,1-1,1,1,1,1,2,0,D
1914-10-10,1914,Notts County,Blackburn Rovers,1-1,1,1,1,1,2,0,D
1914-10-10,1914,Sheffield Wednesday,Manchester United,1-0,1,0,1,1,1,1,H
1914-10-10,1914,Sunderland,Bolton Wanderers,4-3,4,3,1,1,7,1,H
1914-10-10,1914,Tottenham Hotspur,Middlesbrough,3-3,3,3,1,1,6,0,D
1914-10-10,1914,West Bromwich Albion,Oldham Athletic,0-0,0,0,1,1,0,0,D
1914-10-17,1914,Aston Villa,Burnley,3-3,3,3,1,1,6,0,D
1914-10-17,1914,Blackburn Rovers,Sunderland,3-1,3,1,1,1,4,2,H
1914-10-17,1914,Bolton Wanderers,Sheffield Wednesday,0-3,0,3,1,1,3,-3,A
1914-10-17,1914,Bradford Park Avenue,Chelsea,3-0,3,0,1,1,3,3,H
1914-10-17,1914,Liverpool,Bradford City,2-1,2,1,1,1,3,1,H
1914-10-17,1914,Manchester United,West Bromwich Albion,0-0,0,0,1,1,0,0,D
1914-10-17,1914,Middlesbrough,Newcastle United,1-1,1,1,1,1,2,0,D
1914-10-17,1914,Notts County,Manchester City,0-2,0,2,1,1,2,-2,A
1914-10-17,1914,Oldham Athletic,Everton,1-1,1,1,1,1,2,0,D
1914-10-17,1914,Sheffield United,Tottenham Hotspur,1-1,1,1,1,1,2,0,D
1914-10-24,1914,Bradford City,Bradford Park Avenue,3-2,3,2,1,1,5,1,H
1914-10-24,1914,Burnley,Liverpool,3-0,3,0,1,1,3,3,H
1914-10-24,1914,Chelsea,Oldham Athletic,2-2,2,2,1,1,4,0,D
1914-10-24,1914,Everton,Manchester United,4-2,4,2,1,1,6,2,H
1914-10-24,1914,Manchester City,Middlesbrough,1-1,1,1,1,1,2,0,D
1914-10-24,1914,Newcastle United,Sheffield United,4-3,4,3,1,1,7,1,H
1914-10-24,1914,Sheffield Wednesday,Blackburn Rovers,1-1,1,1,1,1,2,0,D
1914-10-24,1914,Sunderland,Notts County,3-1,3,1,1,1,4,2,H
1914-10-24,1914,Tottenham Hotspur,Aston Villa,0-2,0,2,1,1,2,-2,A
1914-10-24,1914,West Bromwich Albion,Bolton Wanderers,3-0,3,0,1,1,3,3,H
1914-10-31,1914,Aston Villa,Newcastle United,2-1,2,1,1,1,3,1,H
1914-10-31,1914,Blackburn Rovers,West Bromwich Albion,2-1,2,1,1,1,3,1,H
1914-10-31,1914,Bolton Wanderers,Everton,0-0,0,0,1,1,0,0,D
1914-10-31,1914,Bradford Park Avenue,Burnley,2-2,2,2,1,1,4,0,D
1914-10-31,1914,Liverpool,Tottenham Hotspur,7-2,7,2,1,1,9,5,H
1914-10-31,1914,Manchester United,Chelsea,2-2,2,2,1,1,4,0,D
1914-10-31,1914,Notts County,Sheffield Wednesday,1-2,1,2,1,1,3,-1,A
1914-10-31,1914,Oldham Athletic,Bradford City,1-0,1,0,1,1,1,1,H
1914-10-31,1914,Sheffield United,Middlesbrough,0-1,0,1,1,1,1,-1,A
1914-10-31,1914,Sunderland,Manchester City,0-2,0,2,1,1,2,-2,A
1914-11-07,1914,Bradford City,Manchester United,4-2,4,2,1,1,6,2,H
1914-11-07,1914,Burnley,Oldham Athletic,2-3,2,3,1,1,5,-1,A
1914-11-07,1914,Chelsea,Bolton Wanderers,2-1,2,1,1,1,3,1,H
1914-11-07,1914,Everton,Blackburn Rovers,1-3,1,3,1,1,4,-2,A
1914-11-07,1914,Manchester City,Sheffield United,0-0,0,0,1,1,0,0,D
1914-11-07,1914,Middlesbrough,Aston Villa,1-1,1,1,1,1,2,0,D
1914-11-07,1914,Newcastle United,Liverpool,0-0,0,0,1,1,0,0,D
1914-11-07,1914,Sheffield Wednesday,Sunderland,1-2,1,2,1,1,3,-1,A
1914-11-07,1914,Tottenham Hotspur,Bradford Park Avenue,3-0,3,0,1,1,3,3,H
1914-11-07,1914,West Bromwich Albion,Notts County,4-1,4,1,1,1,5,3,H
1914-11-14,1914,Aston Villa,Sheffield United,1-0,1,0,1,1,1,1,H
1914-11-14,1914,Blackburn Rovers,Chelsea,3-2,3,2,1,1,5,1,H
1914-11-14,1914,Bolton Wanderers,Bradford City,3-5,3,5,1,1,8,-2,A
1914-11-14,1914,Bradford Park Avenue,Newcastle United,1-0,1,0,1,1,1,1,H
1914-11-14,1914,Liverpool,Middlesbrough,1-1,1,1,1,1,2,0,D
1914-11-14,1914,Manchester United,Burnley,0-2,0,2,1,1,2,-2,A
1914-11-14,1914,Notts County,Everton,0-0,0,0,1,1,0,0,D
1914-11-14,1914,Oldham Athletic,Tottenham Hotspur,4-1,4,1,1,1,5,3,H
1914-11-14,1914,Sheffield Wednesday,Manchester City,2-1,2,1,1,1,3,1,H
1914-11-14,1914,Sunderland,West Bromwich Albion,1-2,1,2,1,1,3,-1,A
1914-11-21,1914,Bradford City,Blackburn Rovers,3-0,3,0,1,1,3,3,H
1914-11-21,1914,Burnley,Bolton Wanderers,5-0,5,0,1,1,5,5,H
1914-11-21,1914,Chelsea,Notts County,4-1,4,1,1,1,5,3,H
1914-11-21,1914,Everton,Sunderland,7-1,7,1,1,1,8,6,H
1914-11-21,1914,Middlesbrough,Bradford Park Avenue,1-3,1,3,1,1,4,-2,A
1914-11-21,1914,Newcastle United,Oldham Athletic,1-2,1,2,1,1,3,-1,A
1914-11-21,1914,Sheffield United,Liverpool,2-1,2,1,1,1,3,1,H
1914-11-21,1914,Tottenham Hotspur,Manchester United,2-0,2,0,1,1,2,2,H
1914-11-21,1914,West Bromwich Albion,Sheffield Wednesday,0-0,0,0,1,1,0,0,D
1914-11-25,1914,Manchester City,Aston Villa,1-0,1,0,1,1,1,1,H
1914-11-28,1914,Blackburn Rovers,Burnley,6-0,6,0,1,1,6,6,H
1914-11-28,1914,Bolton Wanderers,Tottenham Hotspur,4-2,4,2,1,1,6,2,H
1914-11-28,1914,Bradford Park Avenue,Sheffield United,2-0,2,0,1,1,2,2,H
1914-11-28,1914,Liverpool,Aston Villa,3-6,3,6,1,1,9,-3,A
1914-11-28,1914,Manchester United,Newcastle United,1-0,1,0,1,1,1,1,H
1914-11-28,1914,Notts County,Bradford City,0-0,0,0,1,1,0,0,D
1914-11-28,1914,Oldham Athletic,Middlesbrough,5-1,5,1,1,1,6,4,H
1914-11-28,1914,Sheffield Wednesday,Everton,1-4,1,4,1,1,5,-3,A
1914-11-28,1914,Sunderland,Chelsea,2-1,2,1,1,1,3,1,H
1914-11-28,1914,West Bromwich Albion,Manchester City,0-1,0,1,1,1,1,-1,A
1914-12-05,1914,Aston Villa,Bradford Park Avenue,1-2,1,2,1,1,3,-1,A
1914-12-05,1914,Bradford City,Sunderland,3-1,3,1,1,1,4,2,H
1914-12-05,1914,Burnley,Notts County,0-0,0,0,1,1,0,0,D
1914-12-05,1914,Chelsea,Sheffield Wednesday,0-0,0,0,1,1,0,0,D
1914-12-05,1914,Everton,West Bromwich Albion,2-1,2,1,1,1,3,1,H
1914-12-05,1914,Manchester City,Liverpool,1-1,1,1,1,1,2,0,D
1914-12-05,1914,Middlesbrough,Manchester United,1-1,1,1,1,1,2,0,D
1914-12-05,1914,Newcastle United,Bolton Wanderers,1-2,1,2,1,1,3,-1,A
1914-12-05,1914,Sheffield United,Oldham Athletic,3-0,3,0,1,1,3,3,H
1914-12-05,1914,Tottenham Hotspur,Blackburn Rovers,0-4,0,4,1,1,4,-4,A
1914-12-12,1914,Blackburn Rovers,Newcastle United,2-3,2,3,1,1,5,-1,A
1914-12-12,1914,Bolton Wanderers,Middlesbrough,4-0,4,0,1,1,4,4,H
1914-12-12,1914,Bradford Park Avenue,Liverpool,1-0,1,0,1,1,1,1,H
1914-12-12,1914,Everton,Manchester City,4-1,4,1,1,1,5,3,H
1914-12-12,1914,Manchester United,Sheffield United,1-2,1,2,1,1,3,-1,A
1914-12-12,1914,Notts County,Tottenham Hotspur,1-2,1,2,1,1,3,-1,A
1914-12-12,1914,Oldham Athletic,Aston Villa,3-3,3,3,1,1,6,0,D
1914-12-12,1914,Sheffield Wednesday,Bradford City,3-3,3,3,1,1,6,0,D
1914-12-12,1914,Sunderland,Burnley,2-1,2,1,1,1,3,1,H
1914-12-12,1914,West Bromwich Albion,Chelsea,2-0,2,0,1,1,2,2,H
1914-12-19,1914,Aston Villa,Manchester United,3-3,3,3,1,1,6,0,D
1914-12-19,1914,Bradford City,West Bromwich Albion,5-0,5,0,1,1,5,5,H
1914-12-19,1914,Burnley,Sheffield Wednesday,2-3,2,3,1,1,5,-1,A
1914-12-19,1914,Chelsea,Everton,2-0,2,0,1,1,2,2,H
1914-12-19,1914,Liverpool,Oldham Athletic,1-2,1,2,1,1,3,-1,A
1914-12-19,1914,Manchester City,Bradford Park Avenue,2-3,2,3,1,1,5,-1,A
1914-12-19,1914,Middlesbrough,Blackburn Rovers,1-4,1,4,1,1,5,-3,A
1914-12-19,1914,Newcastle United,Notts County,1-1,1,1,1,1,2,0,D
1914-12-19,1914,Sheffield United,Bolton Wanderers,3-1,3,1,1,1,4,2,H
1914-12-19,1914,Tottenham Hotspur,Sunderland,0-6,0,6,1,1,6,-6,A
1914-12-25,1914,Blackburn Rovers,Aston Villa,1-2,1,2,1,1,3,-1,A
1914-12-25,1914,Bolton Wanderers,Liverpool,0-1,0,1,1,1,1,-1,A
1914-12-25,1914,Bradford Park Avenue,Oldham Athletic,1-1,1,1,1,1,2,0,D
1914-12-25,1914,Burnley,West Bromwich Albion,0-2,0,2,1,1,2,-2,A
1914-12-25,1914,Chelsea,Manchester City,0-0,0,0,1,1,0,0,D
1914-12-25,1914,Everton,Bradford City,1-1,1,1,1,1,2,0,D
1914-12-25,1914,Middlesbrough,Notts County,1-0,1,0,1,1,1,1,H
1914-12-25,1914,Newcastle United,Sunderland,2-5,2,5,1,1,7,-3,A
1914-12-25,1914,Sheffield Wednesday,Tottenham Hotspur,3-2,3,2,1,1,5,1,H
1914-12-26,1914,Aston Villa,Bolton Wanderers,1-7,1,7,1,1,8,-6,A
1914-12-26,1914,Bradford City,Everton,0-1,0,1,1,1,1,-1,A
1914-12-26,1914,Liverpool,Manchester United,1-1,1,1,1,1,2,0,D
1914-12-26,1914,Manchester City,Chelsea,2-1,2,1,1,1,3,1,H
1914-12-26,1914,Notts County,Middlesbrough,5-1,5,1,1,1,6,4,H
1914-12-26,1914,Oldham Athletic,Bradford Park Avenue,6-2,6,2,1,1,8,4,H
1914-12-26,1914,Sheffield United,Blackburn Rovers,1-2,1,2,1,1,3,-1,A
1914-12-26,1914,Sunderland,Newcastle United,2-4,2,4,1,1,6,-2,A
1914-12-26,1914,Tottenham Hotspur,Sheffield Wednesday,6-1,6,1,1,1,7,5,H
1914-12-26,1914,West Bromwich Albion,Burnley,3-0,3,0,1,1,3,3,H
1914-12-28,1914,Chelsea,Burnley,1-4,1,4,1,1,5,-3,A
1914-12-28,1914,Sheffield United,Notts County,1-0,1,0,1,1,1,1,H
1915-01-01,1914,Blackburn Rovers,Sheffield United,1-2,1,2,1,1,3,-1,A
1915-01-01,1914,Bolton Wanderers,Aston Villa,2-2,2,2,1,1,4,0,D
1915-01-01,1914,Everton,Tottenham Hotspur,1-1,1,1,1,1,2,0,D
1915-01-01,1914,Manchester United,Bradford Park Avenue,1-2,1,2,1,1,3,-1,A
1915-01-01,1914,Middlesbrough,Sunderland,2-3,2,3,1,1,5,-1,A
1915-01-01,1914,Oldham Athletic,Manchester City,0-0,0,0,1,1,0,0,D
1915-01-01,1914,Sheffield Wednesday,Newcastle United,2-1,2,1,1,1,3,1,H
1915-01-02,1914,Blackburn Rovers,Bradford Park Avenue,2-2,2,2,1,1,4,0,D
1915-01-02,1914,Bolton Wanderers,Oldham Athletic,2-0,2,0,1,1,2,2,H
1915-01-02,1914,Bradford City,Burnley,0-0,0,0,1,1,0,0,D
1915-01-02,1914,Chelsea,Tottenham Hotspur,1-1,1,1,1,1,2,0,D
1915-01-02,1914,Everton,Newcastle United,3-0,3,0,1,1,3,3,H
1915-01-02,1914,Manchester City,Manchester United,1-1,1,1,1,1,2,0,D
1915-01-02,1914,Notts County,Liverpool,3-1,3,1,1,1,4,2,H
1915-01-02,1914,Sheffield Wednesday,Sheffield United,1-1,1,1,1,1,2,0,D
1915-01-02,1914,Sunderland,Aston Villa,4-0,4,0,1,1,4,4,H
1915-01-02,1914,West Bromwich Albion,Middlesbrough,1-0,1,0,1,1,1,1,H
1915-01-16,1914,Aston Villa,Sheffield Wednesday,0-0,0,0,1,1,0,0,D
1915-01-16,1914,Bradford Park Avenue,Notts County,3-1,3,1,1,1,4,2,H
1915-01-16,1914,Liverpool,Sunderland,2-1,2,1,1,1,3,1,H
1915-01-16,1914,Manchester United,Bolton Wanderers,4-1,4,1,1,1,5,3,H
1915-01-16,1914,Middlesbrough,Everton,5-1,5,1,1,1,6,4,H
1915-01-16,1914,Oldham Athletic,Blackburn Rovers,3-2,3,2,1,1,5,1,H
1915-01-16,1914,Sheffield United,West Bromwich Albion,2-0,2,0,1,1,2,2,H
1915-01-16,1914,Tottenham Hotspur,Bradford City,0-0,0,0,1,1,0,0,D
1915-01-18,1914,Burnley,Manchester City,1-2,1,2,1,1,3,-1,A
1915-01-23,1914,Blackburn Rovers,Manchester United,3-3,3,3,1,1,6,0,D
1915-01-23,1914,Bradford City,Newcastle United,1-1,1,1,1,1,2,0,D
1915-01-23,1914,Burnley,Tottenham Hotspur,3-1,3,1,1,1,4,2,H
1915-01-23,1914,Chelsea,Middlesbrough,2-2,2,2,1,1,4,0,D
1915-01-23,1914,Everton,Sheffield United,0-0,0,0,1,1,0,0,D
1915-01-23,1914,Manchester City,Bolton Wanderers,2-1,2,1,1,1,3,1,H
1915-01-23,1914,Notts County,Oldham Athletic,2-1,2,1,1,1,3,1,H
1915-01-23,1914,Sheffield Wednesday,Liverpool,2-1,2,1,1,1,3,1,H
1915-01-23,1914,Sunderland,Bradford Park Avenue,3-3,3,3,1,1,6,0,D
1915-01-23,1914,West Bromwich Albion,Aston Villa,2-0,2,0,1,1,2,2,H
1915-01-30,1914,Manchester United,Notts County,2-2,2,2,1,1,4,0,D
1915-02-01,1914,Oldham Athletic,Sunderland,4-5,4,5,1,1,9,-1,A
1915-02-03,1914,Middlesbrough,Bradford City,3-0,3,0,1,1,3,3,H
1915-02-06,1914,Bradford City,Sheffield United,1-1,1,1,1,1,2,0,D
1915-02-06,1914,Burnley,Middlesbrough,4-0,4,0,1,1,4,4,H
1915-02-06,1914,Chelsea,Aston Villa,3-1,3,1,1,1,4,2,H
1915-02-06,1914,Everton,Liverpool,1-3,1,3,1,1,4,-2,A
1915-02-06,1914,Manchester City,Blackburn Rovers,1-3,1,3,1,1,4,-2,A
1915-02-06,1914,Sheffield Wednesday,Oldham Athletic,2-2,2,2,1,1,4,0,D
1915-02-06,1914,Sunderland,Manchester United,1-0,1,0,1,1,1,1,H
1915-02-06,1914,West Bromwich Albion,Bradford Park Avenue,1-0,1,0,1,1,1,1,H
1915-02-10,1914,Aston Villa,Everton,1-5,1,5,1,1,6,-4,A
1915-02-13,1914,Aston Villa,Bradford City,0-0,0,0,1,1,0,0,D
1915-02-13,1914,Blackburn Rovers,Notts County,5-1,5,1,1,1,6,4,H
1915-02-13,1914,Liverpool,Chelsea,3-3,3,3,1,1,6,0,D
1915-02-13,1914,Manchester United,Sheffield Wednesday,2-0,2,0,1,1,2,2,H
1915-02-13,1914,Middlesbrough,Tottenham Hotspur,7-5,7,5,1,1,12,2,H
1915-02-13,1914,Newcastle United,Manchester City,2-1,2,1,1,1,3,1,H
1915-02-13,1914,Sheffield United,Burnley,1-0,1,0,1,1,1,1,H
1915-02-20,1914,Sunderland,Blackburn Rovers,5-1,5,1,1,1,6,4,H
1915-02-20,1914,Tottenham Hotspur,Notts County,2-0,2,0,1,1,2,2,H
1915-02-20,1914,West Bromwich Albion,Manchester United,0-0,0,0,1,1,0,0,D
1915-02-22,1914,Burnley,Aston Villa,2-1,2,1,1,1,3,1,H
1915-02-22,1914,Manchester City,Notts County,0-0,0,0,1,1,0,0,D
1915-02-27,1914,Aston Villa,Tottenham Hotspur,3-1,3,1,1,1,4,2,H
1915-02-27,1914,Blackburn Rovers,Sheffield Wednesday,1-1,1,1,1,1,2,0,D
1915-02-27,1914,Bolton Wanderers,West Bromwich Albion,1-1,1,1,1,1,2,0,D
1915-02-27,1914,Liverpool,Burnley,3-0,3,0,1,1,3,3,H
1915-02-27,1914,Manchester United,Everton,1-2,1,2,1,1,3,-1,A
1915-02-27,1914,Middlesbrough,Manchester City,1-0,1,0,1,1,1,1,H
1915-02-27,1914,Notts County,Sunderland,2-1,2,1,1,1,3,1,H
1915-02-27,1914,Oldham Athletic,Chelsea,0-0,0,0,1,1,0,0,D
1915-02-27,1914,Sheffield United,Newcastle United,1-0,1,0,1,1,1,1,H
1915-03-01,1914,Chelsea,Bradford Park Avenue,0-1,0,1,1,1,1,-1,A
1915-03-01,1914,Sheffield Wednesday,Bolton Wanderers,7-0,7,0,1,1,7,7,H
1915-03-06,1914,Burnley,Bradford Park Avenue,2-0,2,0,1,1,2,2,H
1915-03-06,1914,Manchester City,Sunderland,2-0,2,0,1,1,2,2,H
1915-03-06,1914,Sheffield Wednesday,Notts County,0-0,0,0,1,1,0,0,D
1915-03-06,1914,Tottenham Hotspur,Liverpool,1-1,1,1,1,1,2,0,D
1915-03-06,1914,West Bromwich Albion,Blackburn Rovers,0-0,0,0,1,1,0,0,D
1915-03-08,1914,Sheffield United,Chelsea,1-1,1,1,1,1,2,0,D
1915-03-09,1914,Oldham Athletic,West Bromwich Albion,1-1,1,1,1,1,2,0,D
1915-03-10,1914,Bolton Wanderers,Sunderland,1-1,1,1,1,1,2,0,D
1915-03-10,1914,Bradford City,Liverpool,3-2,3,2,1,1,5,1,H
1915-03-10,1914,Newcastle United,Middlesbrough,1-2,1,2,1,1,3,-1,A
1915-03-13,1914,Aston Villa,Middlesbrough,5-0,5,0,1,1,5,5,H
1915-03-13,1914,Blackburn Rovers,Everton,2-1,2,1,1,1,3,1,H
1915-03-13,1914,Bolton Wanderers,Burnley,3-1,3,1,1,1,4,2,H
1915-03-13,1914,Bradford Park Avenue,Tottenham Hotspur,5-1,5,1,1,1,6,4,H
1915-03-13,1914,Liverpool,Manchester City,3-2,3,2,1,1,5,1,H
1915-03-13,1914,Manchester United,Bradford City,1-0,1,0,1,1,1,1,H
1915-03-13,1914,Notts County,West Bromwich Albion,1-1,1,1,1,1,2,0,D
1915-03-13,1914,Sunderland,Sheffield Wednesday,3-1,3,1,1,1,4,2,H
1915-03-15,1914,Tottenham Hotspur,Manchester City,2-2,2,2,1,1,4,0,D
1915-03-17,1914,Bradford Park Avenue,Sheffield Wednesday,1-1,1,1,1,1,2,0,D
1915-03-17,1914,Everton,Oldham Athletic,3-4,3,4,1,1,7,-1,A
1915-03-17,1914,Middlesbrough,Sheffield United,2-2,2,2,1,1,4,0,D
1915-03-17,1914,Newcastle United,Chelsea,2-0,2,0,1,1,2,2,H
1915-03-17,1914,Notts County,Bolton Wanderers,0-0,0,0,1,1,0,0,D
1915-03-20,1914,Bradford City,Bolton Wanderers,4-2,4,2,1,1,6,2,H
1915-03-20,1914,Burnley,Manchester United,3-0,3,0,1,1,3,3,H
1915-03-20,1914,Chelsea,Blackburn Rovers,1-3,1,3,1,1,4,-2,A
1915-03-20,1914,Everton,Notts County,4-0,4,0,1,1,4,4,H
1915-03-20,1914,Manchester City,Sheffield Wednesday,4-0,4,0,1,1,4,4,H
1915-03-20,1914,Middlesbrough,Liverpool,3-0,3,0,1,1,3,3,H
1915-03-20,1914,Newcastle United,Bradford Park Avenue,1-1,1,1,1,1,2,0,D
1915-03-20,1914,Sheffield United,Aston Villa,3-0,3,0,1,1,3,3,H
1915-03-20,1914,Tottenham Hotspur,Oldham Athletic,1-0,1,0,1,1,1,1,H
1915-03-20,1914,West Bromwich Albion,Sunderland,1-2,1,2,1,1,3,-1,A
1915-03-22,1914,Everton,Bolton Wanderers,5-3,5,3,1,1,8,2,H
1915-03-24,1914,Bradford City,Oldham Athletic,1-0,1,0,1,1,1,1,H
1915-03-24,1914,Liverpool,West Bromwich Albion,3-1,3,1,1,1,4,2,H
1915-03-27,1914,Bradford Park Avenue,Middlesbrough,2-0,2,0,1,1,2,2,H
1915-03-27,1914,Manchester United,Tottenham Hotspur,1-1,1,1,1,1,2,0,D
1915-03-27,1914,Oldham Athletic,Newcastle United,1-0,1,0,1,1,1,1,H
1915-03-27,1914,Sheffield Wednesday,West Bromwich Albion,0-0,0,0,1,1,0,0,D
1915-03-29,1914,Blackburn Rovers,Bradford City,2-1,2,1,1,1,3,1,H
1915-03-29,1914,Liverpool,Newcastle United,2-2,2,2,1,1,4,0,D
1915-03-29,1914,Sheffield United,Manchester City,0-0,0,0,1,1,0,0,D
1915-04-02,1914,Aston Villa,Blackburn Rovers,2-1,2,1,1,1,3,1,H
1915-04-02,1914,Bolton Wanderers,Bradford Park Avenue,3-2,3,2,1,1,5,1,H
1915-04-02,1914,Chelsea,Bradford City,2-0,2,0,1,1,2,2,H
1915-04-02,1914,Everton,Burnley,0-2,0,2,1,1,2,-2,A
1915-04-02,1914,Manchester United,Liverpool,2-0,2,0,1,1,2,2,H
1915-04-02,1914,Notts County,Sheffield United,3-1,3,1,1,1,4,2,H
1915-04-02,1914,Sunderland,Middlesbrough,4-1,4,1,1,1,5,3,H
1915-04-02,1914,Tottenham Hotspur,Newcastle United,0-0,0,0,1,1,0,0,D
1915-04-03,1914,Aston Villa,Liverpool,6-2,6,2,1,1,8,4,H
1915-04-03,1914,Bradford City,Notts County,3-1,3,1,1,1,4,2,H
1915-04-03,1914,Burnley,Blackburn Rovers,3-2,3,2,1,1,5,1,H
1915-04-03,1914,Chelsea,Sunderland,3-0,3,0,1,1,3,3,H
1915-04-03,1914,Everton,Sheffield Wednesday,0-1,0,1,1,1,1,-1,A
1915-04-03,1914,Manchester City,West Bromwich Albion,4-0,4,0,1,1,4,4,H
1915-04-03,1914,Middlesbrough,Oldham Athletic,4-1,4,1,1,1,5,3,H
1915-04-03,1914,Newcastle United,Manchester United,2-0,2,0,1,1,2,2,H
1915-04-03,1914,Sheffield United,Bradford Park Avenue,3-2,3,2,1,1,5,1,H
1915-04-03,1914,Tottenham Hotspur,Bolton Wanderers,4-2,4,2,1,1,6,2,H
1915-04-05,1914,Bradford Park Avenue,Manchester United,5-0,5,0,1,1,5,5,H
1915-04-05,1914,Burnley,Chelsea,2-0,2,0,1,1,2,2,H
1915-04-05,1914,Liverpool,Blackburn Rovers,3-0,3,0,1,1,3,3,H
1915-04-05,1914,Manchester City,Oldham Athletic,0-0,0,0,1,1,0,0,D
1915-04-05,1914,Middlesbrough,Sheffield Wednesday,3-1,3,1,1,1,4,2,H
1915-04-05,1914,Notts County,Aston Villa,1-1,1,1,1,1,2,0,D
1915-04-05,1914,Sheffield United,Sunderland,1-1,1,1,1,1,2,0,D
1915-04-05,1914,West Bromwich Albion,Newcastle United,2-0,2,0,1,1,2,2,H
1915-04-06,1914,Bradford City,Manchester City,0-0,0,0,1,1,0,0,D
1915-04-06,1914,Oldham Athletic,Manchester United,1-0,1,0,1,1,1,1,H
1915-04-06,1914,Sunderland,Everton,0-3,0,3,1,1,3,-3,A
1915-04-06,1914,West Bromwich Albion,Tottenham Hotspur,3-2,3,2,1,1,5,1,H
1915-04-10,1914,Blackburn Rovers,Tottenham Hotspur,4-1,4,1,1,1,5,3,H
1915-04-10,1914,Bolton Wanderers,Newcastle United,0-0,0,0,1,1,0,0,D
1915-04-10,1914,Bradford Park Avenue,Aston Villa,2-2,2,2,1,1,4,0,D
1915-04-10,1914,Manchester United,Middlesbrough,2-2,2,2,1,1,4,0,D
1915-04-10,1914,Notts County,Burnley,0-0,0,0,1,1,0,0,D
1915-04-10,1914,Oldham Athletic,Sheffield United,3-0,3,0,1,1,3,3,H
1915-04-10,1914,Sheffield Wednesday,Chelsea,3-2,3,2,1,1,5,1,H
1915-04-10,1914,Sunderland,Bradford City,1-1,1,1,1,1,2,0,D
1915-04-10,1914,West Bromwich Albion,Everton,1-2,1,2,1,1,3,-1,A
1915-04-12,1914,Liverpool,Sheffield United,2-1,2,1,1,1,3,1,H
1915-04-14,1914,Bolton Wanderers,Chelsea,3-1,3,1,1,1,4,2,H
1915-04-14,1914,Bradford Park Avenue,Everton,1-2,1,2,1,1,3,-1,A
1915-04-14,1914,Newcastle United,Burnley,1-2,1,2,1,1,3,-1,A
1915-04-17,1914,Aston Villa,Oldham Athletic,0-0,0,0,1,1,0,0,D
1915-04-17,1914,Bradford City,Sheffield Wednesday,1-0,1,0,1,1,1,1,H
1915-04-17,1914,Burnley,Sunderland,2-1,2,1,1,1,3,1,H
1915-04-17,1914,Chelsea,West Bromwich Albion,4-1,4,1,1,1,5,3,H
1915-04-17,1914,Liverpool,Bradford Park Avenue,2-1,2,1,1,1,3,1,H
1915-04-17,1914,Manchester City,Everton,0-1,0,1,1,1,1,-1,A
1915-04-17,1914,Middlesbrough,Bolton Wanderers,0-0,0,0,1,1,0,0,D
1915-04-17,1914,Newcastle United,Blackburn Rovers,2-1,2,1,1,1,3,1,H
1915-04-17,1914,Sheffield United,Manchester United,3-1,3,1,1,1,4,2,H
1915-04-19,1914,Chelsea,Manchester United,1-3,1,3,1,1,4,-2,A
1915-04-19,1914,Tottenham Hotspur,Sheffield United,1-1,1,1,1,1,2,0,D
1915-04-20,1914,Oldham Athletic,Burnley,1-2,1,2,1,1,3,-1,A
1915-04-21,1914,Aston Villa,Manchester City,4-1,4,1,1,1,5,3,H
1915-04-24,1914,Blackburn Rovers,Middlesbrough,4-0,4,0,1,1,4,4,H
1915-04-24,1914,Bradford Park Avenue,Manchester City,3-1,3,1,1,1,4,2,H
1915-04-24,1914,Notts County,Newcastle United,1-0,1,0,1,1,1,1,H
1915-04-24,1914,Oldham Athletic,Liverpool,0-2,0,2,1,1,2,-2,A
1915-04-24,1914,Sheffield Wednesday,Burnley,0-0,0,0,1,1,0,0,D
1915-04-24,1914,Sunderland,Tottenham Hotspur,5-0,5,0,1,1,5,5,H
1915-04-24,1914,West Bromwich Albion,Bradford City,3-0,3,0,1,1,3,3,H
1915-04-26,1914,Bolton Wanderers,Sheffield United,0-1,0,1,1,1,1,-1,A
1915-04-26,1914,Everton,Chelsea,2-2,2,2,1,1,4,0,D
1915-04-26,1914,Manchester United,Aston Villa,1-0,1,0,1,1,1,1,H
1915-04-28,1914,Bradford Park Avenue,Bradford City,3-0,3,0,1,1,3,3,H
1915-04-28,1914,Newcastle United,Aston Villa,3-0,3,0,1,1,3,3,H
1915-04-28,1914,Notts County,Chelsea,2-0,2,0,1,1,2,2,H
1919-08-30,1919,Arsenal,Newcastle United,0-1,0,1,1,1,1,-1,A
1919-08-30,1919,Blackburn Rovers,Preston North End,4-0,4,0,1,1,4,4,H
1919-08-30,1919,Bolton Wanderers,Bradford Park Avenue,1-2,1,2,1,1,3,-1,A
1919-08-30,1919,Bradford City,Liverpool,1-3,1,3,1,1,4,-2,A
1919-08-30,1919,Derby County,Manchester United,1-1,1,1,1,1,2,0,D
1919-08-30,1919,Everton,Chelsea,2-3,2,3,1,1,5,-1,A
1919-08-30,1919,Manchester City,Sheffield United,3-3,3,3,1,1,6,0,D
1919-08-30,1919,Notts County,Burnley,2-0,2,0,1,1,2,2,H
1919-08-30,1919,Sheffield Wednesday,Middlesbrough,0-1,0,1,1,1,1,-1,A
1919-08-30,1919,Sunderland,Aston Villa,2-1,2,1,1,1,3,1,H
1919-08-30,1919,West Bromwich Albion,Oldham Athletic,3-1,3,1,1,1,4,2,H
1919-09-01,1919,Aston Villa,Derby County,2-2,2,2,1,1,4,0,D
1919-09-01,1919,Bolton Wanderers,Burnley,1-1,1,1,1,1,2,0,D
1919-09-01,1919,Chelsea,Sunderland,2-0,2,0,1,1,2,2,H
1919-09-01,1919,Liverpool,Arsenal,2-3,2,3,1,1,5,-1,A
1919-09-01,1919,Manchester United,Sheffield Wednesday,0-0,0,0,1,1,0,0,D
1919-09-01,1919,Oldham Athletic,Manchester City,1-3,1,3,1,1,4,-2,A
1919-09-01,1919,Preston North End,Bradford City,1-5,1,5,1,1,6,-4,A
1919-09-01,1919,Sheffield United,Notts County,3-0,3,0,1,1,3,3,H
1919-09-03,1919,Bradford Park Avenue,Everton,0-2,0,2,1,1,2,-2,A
1919-09-03,1919,Middlesbrough,Blackburn Rovers,2-2,2,2,1,1,4,0,D
1919-09-03,1919,Newcastle United,West Bromwich Albion,0-2,0,2,1,1,2,-2,A
1919-09-06,1919,Aston Villa,Sunderland,0-3,0,3,1,1,3,-3,A
1919-09-06,1919,Bradford Park Avenue,Bolton Wanderers,2-0,2,0,1,1,2,2,H
1919-09-06,1919,Burnley,Notts County,2-1,2,1,1,1,3,1,H
1919-09-06,1919,Chelsea,Everton,0-1,0,1,1,1,1,-1,A
1919-09-06,1919,Liverpool,Bradford City,2-1,2,1,1,1,3,1,H
1919-09-06,1919,Manchester United,Derby County,0-2,0,2,1,1,2,-2,A
1919-09-06,1919,Middlesbrough,Sheffield Wednesday,3-0,3,0,1,1,3,3,H
1919-09-06,1919,Newcastle United,Arsenal,3-1,3,1,1,1,4,2,H
1919-09-06,1919,Oldham Athletic,West Bromwich Albion,2-1,2,1,1,1,3,1,H
1919-09-06,1919,Preston North End,Blackburn Rovers,0-0,0,0,1,1,0,0,D
1919-09-06,1919,Sheffield United,Manchester City,3-1,3,1,1,1,4,2,H
1919-09-08,1919,Arsenal,Liverpool,1-0,1,0,1,1,1,1,H
1919-09-08,1919,Burnley,Bradford City,1-1,1,1,1,1,2,0,D
1919-09-08,1919,Derby County,Aston Villa,1-0,1,0,1,1,1,1,H
1919-09-08,1919,Everton,Bradford Park Avenue,2-0,2,0,1,1,2,2,H
1919-09-08,1919,Manchester City,Oldham Athletic,3-1,3,1,1,1,4,2,H
1919-09-08,1919,Sheffield Wednesday,Manchester United,1-3,1,3,1,1,4,-2,A
1919-09-08,1919,West Bromwich Albion,Newcastle United,3-0,3,0,1,1,3,3,H
1919-09-10,1919,Bradford City,Preston North End,2-2,2,2,1,1,4,0,D
1919-09-10,1919,Burnley,Bolton Wanderers,2-1,2,1,1,1,3,1,H
1919-09-10,1919,Sunderland,Chelsea,3-2,3,2,1,1,5,1,H
1919-09-13,1919,Blackburn Rovers,Burnley,2-3,2,3,1,1,5,-1,A
1919-09-13,1919,Bradford Park Avenue,Oldham Athletic,2-0,2,0,1,1,2,2,H
1919-09-13,1919,Chelsea,Newcastle United,0-0,0,0,1,1,0,0,D
1919-09-13,1919,Derby County,Bradford City,3-0,3,0,1,1,3,3,H
1919-09-13,1919,Liverpool,Aston Villa,2-1,2,1,1,1,3,1,H
1919-09-13,1919,Manchester City,Bolton Wanderers,1-4,1,4,1,1,5,-3,A
1919-09-13,1919,Middlesbrough,Sheffield United,1-0,1,0,1,1,1,1,H
1919-09-13,1919,Preston North End,Manchester United,2-3,2,3,1,1,5,-1,A
1919-09-13,1919,Sheffield Wednesday,Notts County,0-0,0,0,1,1,0,0,D
1919-09-13,1919,Sunderland,Arsenal,1-1,1,1,1,1,2,0,D
1919-09-13,1919,West Bromwich Albion,Everton,4-3,4,3,1,1,7,1,H
1919-09-15,1919,Blackburn Rovers,Middlesbrough,0-2,0,2,1,1,2,-2,A
1919-09-17,1919,Middlesbrough,Bolton Wanderers,1-3,1,3,1,1,4,-2,A
1919-09-20,1919,Arsenal,Sunderland,3-2,3,2,1,1,5,1,H
1919-09-20,1919,Aston Villa,Liverpool,0-1,0,1,1,1,1,-1,A
1919-09-20,1919,Bolton Wanderers,Manchester City,6-2,6,2,1,1,8,4,H
1919-09-20,1919,Bradford City,Derby County,3-1,3,1,1,1,4,2,H
1919-09-20,1919,Burnley,Blackburn Rovers,3-1,3,1,1,1,4,2,H
1919-09-20,1919,Everton,West Bromwich Albion,2-5,2,5,1,1,7,-3,A
1919-09-20,1919,Manchester United,Preston North End,5-1,5,1,1,1,6,4,H
1919-09-20,1919,Newcastle United,Chelsea,3-0,3,0,1,1,3,3,H
1919-09-20,1919,Notts County,Sheffield Wednesday,3-1,3,1,1,1,4,2,H
1919-09-20,1919,Oldham Athletic,Bradford Park Avenue,2-2,2,2,1,1,4,0,D
1919-09-20,1919,Sheffield United,Middlesbrough,5-1,5,1,1,1,6,4,H
1919-09-24,1919,Newcastle United,Derby County,0-0,0,0,1,1,0,0,D
1919-09-27,1919,Blackburn Rovers,Arsenal,2-2,2,2,1,1,4,0,D
1919-09-27,1919,Bradford Park Avenue,Aston Villa,6-1,6,1,1,1,7,5,H
1919-09-27,1919,Chelsea,Burnley,0-1,0,1,1,1,1,-1,A
1919-09-27,1919,Derby County,Bolton Wanderers,1-2,1,2,1,1,3,-1,A
1919-09-27,1919,Liverpool,Newcastle United,1-1,1,1,1,1,2,0,D
1919-09-27,1919,Manchester City,Notts County,4-1,4,1,1,1,5,3,H
1919-09-27,1919,Middlesbrough,Manchester United,1-1,1,1,1,1,2,0,D
1919-09-27,1919,Preston North End,Oldham Athletic,2-1,2,1,1,1,3,1,H
1919-09-27,1919,Sheffield Wednesday,Sheffield United,2-1,2,1,1,1,3,1,H
1919-09-27,1919,Sunderland,Everton,2-3,2,3,1,1,5,-1,A
1919-09-27,1919,West Bromwich Albion,Bradford City,4-1,4,1,1,1,5,3,H
1919-10-02,1919,Notts County,Sheffield United,2-2,2,2,1,1,4,0,D
1919-10-04,1919,Arsenal,Blackburn Rovers,0-1,0,1,1,1,1,-1,A
1919-10-04,1919,Aston Villa,Bradford Park Avenue,1-0,1,0,1,1,1,1,H
1919-10-04,1919,Bolton Wanderers,Derby County,3-0,3,0,1,1,3,3,H
1919-10-04,1919,Bradford City,West Bromwich Albion,3-0,3,0,1,1,3,3,H
1919-10-04,1919,Burnley,Chelsea,2-3,2,3,1,1,5,-1,A
1919-10-04,1919,Everton,Sunderland,1-3,1,3,1,1,4,-2,A
1919-10-04,1919,Manchester United,Middlesbrough,1-1,1,1,1,1,2,0,D
1919-10-04,1919,Newcastle United,Liverpool,3-0,3,0,1,1,3,3,H
1919-10-04,1919,Notts County,Manchester City,4-1,4,1,1,1,5,3,H
1919-10-04,1919,Oldham Athletic,Preston North End,4-1,4,1,1,1,5,3,H
1919-10-04,1919,Sheffield United,Sheffield Wednesday,3-0,3,0,1,1,3,3,H
1919-10-11,1919,Bradford Park Avenue,Newcastle United,0-1,0,1,1,1,1,-1,A
1919-10-11,1919,Burnley,Sheffield United,2-2,2,2,1,1,4,0,D
1919-10-11,1919,Chelsea,Liverpool,1-0,1,0,1,1,1,1,H
1919-10-11,1919,Derby County,Notts County,3-1,3,1,1,1,4,2,H
1919-10-11,1919,Everton,Arsenal,2-3,2,3,1,1,5,-1,A
1919-10-11,1919,Manchester City,Manchester United,3-3,3,3,1,1,6,0,D
1919-10-11,1919,Middlesbrough,Oldham Athletic,1-0,1,0,1,1,1,1,H
1919-10-11,1919,Preston North End,Aston Villa,3-0,3,0,1,1,3,3,H
1919-10-11,1919,Sheffield Wednesday,Blackburn Rovers,0-0,0,0,1,1,0,0,D
1919-10-11,1919,Sunderland,Bradford City,2-0,2,0,1,1,2,2,H
1919-10-11,1919,West Bromwich Albion,Bolton Wanderers,4-1,4,1,1,1,5,3,H
1919-10-18,1919,Arsenal,Everton,1-1,1,1,1,1,2,0,D
1919-10-18,1919,Aston Villa,Preston North End,2-4,2,4,1,1,6,-2,A
1919-10-18,1919,Blackburn Rovers,Sheffield Wednesday,1-0,1,0,1,1,1,1,H
1919-10-18,1919,Bolton Wanderers,West Bromwich Albion,1-2,1,2,1,1,3,-1,A
1919-10-18,1919,Bradford City,Sunderland,2-0,2,0,1,1,2,2,H
1919-10-18,1919,Liverpool,Chelsea,0-1,0,1,1,1,1,-1,A
1919-10-18,1919,Manchester United,Manchester City,1-0,1,0,1,1,1,1,H
1919-10-18,1919,Newcastle United,Bradford Park Avenue,4-0,4,0,1,1,4,4,H
1919-10-18,1919,Notts County,Derby County,2-2,2,2,1,1,4,0,D
1919-10-18,1919,Oldham Athletic,Middlesbrough,1-2,1,2,1,1,3,-1,A
1919-10-18,1919,Sheffield United,Burnley,1-3,1,3,1,1,4,-2,A
1919-10-20,1919,Sheffield United,Blackburn Rovers,2-0,2,0,1,1,2,2,H
1919-10-25,1919,Arsenal,Bradford City,1-2,1,2,1,1,3,-1,A
1919-10-25,1919,Bradford Park Avenue,Chelsea,1-0,1,0,1,1,1,1,H
1919-10-25,1919,Burnley,Liverpool,1-2,1,2,1,1,3,-1,A
1919-10-25,1919,Derby County,Oldham Athletic,1-1,1,1,1,1,2,0,D
1919-10-25,1919,Everton,Blackburn Rovers,3-0,3,0,1,1,3,3,H
1919-10-25,1919,Manchester City,Sheffield Wednesday,4-2,4,2,1,1,6,2,H
1919-10-25,1919,Middlesbrough,Aston Villa,1-4,1,4,1,1,5,-3,A
1919-10-25,1919,Preston North End,Newcastle United,2-3,2,3,1,1,5,-1,A
1919-10-25,1919,Sheffield United,Manchester United,2-2,2,2,1,1,4,0,D
1919-10-25,1919,Sunderland,Bolton Wanderers,2-0,2,0,1,1,2,2,H
1919-10-25,1919,West Bromwich Albion,Notts County,8-0,8,0,1,1,8,8,H
1919-11-01,1919,Aston Villa,Middlesbrough,5-3,5,3,1,1,8,2,H
1919-11-01,1919,Blackburn Rovers,Everton,3-2,3,2,1,1,5,1,H
1919-11-01,1919,Bolton Wanderers,Sunderland,1-0,1,0,1,1,1,1,H
1919-11-01,1919,Bradford City,Arsenal,1-1,1,1,1,1,2,0,D
1919-11-01,1919,Chelsea,Bradford Park Avenue,4-0,4,0,1,1,4,4,H
1919-11-01,1919,Liverpool,Burnley,0-1,0,1,1,1,1,-1,A
1919-11-01,1919,Manchester United,Sheffield United,3-0,3,0,1,1,3,3,H
1919-11-01,1919,Newcastle United,Preston North End,1-0,1,0,1,1,1,1,H
1919-11-01,1919,Notts County,West Bromwich Albion,2-0,2,0,1,1,2,2,H
1919-11-01,1919,Oldham Athletic,Derby County,3-0,3,0,1,1,3,3,H
1919-11-01,1919,Sheffield Wednesday,Manchester City,0-0,0,0,1,1,0,0,D
1919-11-08,1919,Arsenal,Bolton Wanderers,2-2,2,2,1,1,4,0,D
1919-11-08,1919,Bradford Park Avenue,Liverpool,1-2,1,2,1,1,3,-1,A
1919-11-08,1919,Burnley,Manchester United,2-1,2,1,1,1,3,1,H
1919-11-08,1919,Derby County,Sheffield Wednesday,2-1,2,1,1,1,3,1,H
1919-11-08,1919,Everton,Bradford City,4-1,4,1,1,1,5,3,H
1919-11-08,1919,Manchester City,Blackburn Rovers,8-2,8,2,1,1,10,6,H
1919-11-08,1919,Middlesbrough,Newcastle United,0-1,0,1,1,1,1,-1,A
1919-11-08,1919,Preston North End,Chelsea,3-1,3,1,1,1,4,2,H
1919-11-08,1919,Sheffield United,Oldham Athletic,1-0,1,0,1,1,1,1,H
1919-11-08,1919,Sunderland,Notts County,3-1,3,1,1,1,4,2,H
1919-11-10,1919,West Bromwich Albion,Aston Villa,1-2,1,2,1,1,3,-1,A
1919-11-15,1919,Aston Villa,West Bromwich Albion,2-4,2,4,1,1,6,-2,A
1919-11-15,1919,Blackburn Rovers,Manchester City,1-4,1,4,1,1,5,-3,A
1919-11-15,1919,Bolton Wanderers,Arsenal,2-2,2,2,1,1,4,0,D
1919-11-15,1919,Bradford City,Everton,3-3,3,3,1,1,6,0,D
1919-11-15,1919,Chelsea,Preston North End,4-0,4,0,1,1,4,4,H
1919-11-15,1919,Liverpool,Bradford Park Avenue,3-3,3,3,1,1,6,0,D
1919-11-15,1919,Manchester United,Burnley,0-1,0,1,1,1,1,-1,A
1919-11-15,1919,Notts County,Sunderland,2-2,2,2,1,1,4,0,D
1919-11-15,1919,Oldham Athletic,Sheffield United,4-0,4,0,1,1,4,4,H
1919-11-15,1919,Sheffield Wednesday,Derby County,2-0,2,0,1,1,2,2,H
1919-11-22,1919,Arsenal,Notts County,3-1,3,1,1,1,4,2,H
1919-11-22,1919,Bradford City,Blackburn Rovers,3-1,3,1,1,1,4,2,H
1919-11-22,1919,Burnley,Bradford Park Avenue,2-6,2,6,1,1,8,-4,A
1919-11-22,1919,Everton,Bolton Wanderers,3-3,3,3,1,1,6,0,D
1919-11-22,1919,Manchester City,Derby County,3-1,3,1,1,1,4,2,H
1919-11-22,1919,Middlesbrough,Chelsea,0-0,0,0,1,1,0,0,D
1919-11-22,1919,Oldham Athletic,Manchester United,0-3,0,3,1,1,3,-3,A
1919-11-22,1919,Preston North End,Liverpool,2-1,2,1,1,1,3,1,H
1919-11-22,1919,Sheffield United,Aston Villa,1-2,1,2,1,1,3,-1,A
1919-11-22,1919,Sunderland,Newcastle United,2-0,2,0,1,1,2,2,H
1919-11-22,1919,West Bromwich Albion,Sheffield Wednesday,1-3,1,3,1,1,4,-2,A
1919-11-29,1919,Aston Villa,Sheffield United,4-0,4,0,1,1,4,4,H
1919-11-29,1919,Bolton Wanderers,Everton,0-2,0,2,1,1,2,-2,A
1919-11-29,1919,Bradford Park Avenue,Burnley,0-1,0,1,1,1,1,-1,A
1919-11-29,1919,Chelsea,Middlesbrough,3-1,3,1,1,1,4,2,H
1919-11-29,1919,Derby County,Manchester City,0-0,0,0,1,1,0,0,D
1919-11-29,1919,Liverpool,Preston North End,1-2,1,2,1,1,3,-1,A
1919-11-29,1919,Newcastle United,Sunderland,2-3,2,3,1,1,5,-1,A
1919-11-29,1919,Notts County,Arsenal,2-2,2,2,1,1,4,0,D
1919-11-29,1919,Sheffield Wednesday,West Bromwich Albion,0-3,0,3,1,1,3,-3,A
1919-12-03,1919,Newcastle United,Middlesbrough,0-0,0,0,1,1,0,0,D
1919-12-06,1919,Arsenal,Chelsea,1-1,1,1,1,1,2,0,D
1919-12-06,1919,Aston Villa,Manchester United,2-0,2,0,1,1,2,2,H
1919-12-06,1919,Blackburn Rovers,Derby County,2-0,2,0,1,1,2,2,H
1919-12-06,1919,Bradford City,Bolton Wanderers,0-1,0,1,1,1,1,-1,A
1919-12-06,1919,Everton,Notts County,1-2,1,2,1,1,3,-1,A
1919-12-06,1919,Manchester City,West Bromwich Albion,2-3,2,3,1,1,5,-1,A
1919-12-06,1919,Middlesbrough,Liverpool,3-2,3,2,1,1,5,1,H
1919-12-06,1919,Oldham Athletic,Burnley,1-0,1,0,1,1,1,1,H
1919-12-06,1919,Preston North End,Bradford Park Avenue,0-3,0,3,1,1,3,-3,A
1919-12-06,1919,Sheffield United,Newcastle United,2-1,2,1,1,1,3,1,H
1919-12-06,1919,Sunderland,Sheffield Wednesday,2-1,2,1,1,1,3,1,H
1919-12-11,1919,Blackburn Rovers,Bradford City,4-1,4,1,1,1,5,3,H
1919-12-13,1919,Bolton Wanderers,Bradford City,1-1,1,1,1,1,2,0,D
1919-12-13,1919,Bradford Park Avenue,Preston North End,3-3,3,3,1,1,6,0,D
1919-12-13,1919,Burnley,Oldham Athletic,2-1,2,1,1,1,3,1,H
1919-12-13,1919,Chelsea,Arsenal,3-1,3,1,1,1,4,2,H
1919-12-13,1919,Derby County,Blackburn Rovers,0-0,0,0,1,1,0,0,D
1919-12-13,1919,Liverpool,Middlesbrough,1-0,1,0,1,1,1,1,H
1919-12-13,1919,Manchester United,Aston Villa,1-2,1,2,1,1,3,-1,A
1919-12-13,1919,Newcastle United,Sheffield United,2-1,2,1,1,1,3,1,H
1919-12-13,1919,Notts County,Everton,1-1,1,1,1,1,2,0,D
1919-12-13,1919,Sheffield Wednesday,Sunderland,0-2,0,2,1,1,2,-2,A
1919-12-13,1919,West Bromwich Albion,Manchester City,2-0,2,0,1,1,2,2,H
1919-12-20,1919,Arsenal,Sheffield Wednesday,3-1,3,1,1,1,4,2,H
1919-12-20,1919,Aston Villa,Oldham Athletic,3-0,3,0,1,1,3,3,H
1919-12-20,1919,Blackburn Rovers,Bolton Wanderers,2-2,2,2,1,1,4,0,D
1919-12-20,1919,Bradford City,Notts County,3-4,3,4,1,1,7,-1,A
1919-12-20,1919,Derby County,West Bromwich Albion,0-4,0,4,1,1,4,-4,A
1919-12-20,1919,Everton,Liverpool,0-0,0,0,1,1,0,0,D
1919-12-20,1919,Manchester United,Newcastle United,2-1,2,1,1,1,3,1,H
1919-12-20,1919,Middlesbrough,Bradford Park Avenue,1-2,1,2,1,1,3,-1,A
1919-12-20,1919,Preston North End,Burnley,0-1,0,1,1,1,1,-1,A
1919-12-20,1919,Sheffield United,Chelsea,3-1,3,1,1,1,4,2,H
1919-12-20,1919,Sunderland,Manchester City,2-1,2,1,1,1,3,1,H
1919-12-25,1919,Aston Villa,Chelsea,5-2,5,2,1,1,7,3,H
1919-12-25,1919,Bolton Wanderers,Preston North End,4-1,4,1,1,1,5,3,H
1919-12-25,1919,Bradford City,Sheffield Wednesday,1-1,1,1,1,1,2,0,D
1919-12-25,1919,Burnley,Middlesbrough,5-3,5,3,1,1,8,2,H
1919-12-25,1919,Derby County,Arsenal,2-1,2,1,1,1,3,1,H
1919-12-25,1919,Liverpool,Sunderland,3-2,3,2,1,1,5,1,H
1919-12-25,1919,Manchester City,Everton,1-1,1,1,1,1,2,0,D
1919-12-25,1919,Notts County,Blackburn Rovers,5-0,5,0,1,1,5,5,H
1919-12-25,1919,Sheffield United,Bradford Park Avenue,2-2,2,2,1,1,4,0,D
1919-12-26,1919,Arsenal,Derby County,1-0,1,0,1,1,1,1,H
1919-12-26,1919,Bradford Park Avenue,Sheffield United,1-0,1,0,1,1,1,1,H
1919-12-26,1919,Chelsea,Oldham Athletic,1-0,1,0,1,1,1,1,H
1919-12-26,1919,Everton,Manchester City,2-0,2,0,1,1,2,2,H
1919-12-26,1919,Manchester United,Liverpool,0-0,0,0,1,1,0,0,D
1919-12-26,1919,Newcastle United,Burnley,0-0,0,0,1,1,0,0,D
1919-12-26,1919,Preston North End,Bolton Wanderers,1-1,1,1,1,1,2,0,D
1919-12-26,1919,Sheffield Wednesday,Bradford City,1-0,1,0,1,1,1,1,H
1919-12-26,1919,West Bromwich Albion,Sunderland,4-0,4,0,1,1,4,4,H
1919-12-27,1919,Bolton Wanderers,Blackburn Rovers,2-1,2,1,1,1,3,1,H
1919-12-27,1919,Bradford Park Avenue,Middlesbrough,1-1,1,1,1,1,2,0,D
1919-12-27,1919,Burnley,Preston North End,1-1,1,1,1,1,2,0,D
1919-12-27,1919,Chelsea,Sheffield United,1-0,1,0,1,1,1,1,H
1919-12-27,1919,Liverpool,Everton,3-1,3,1,1,1,4,2,H
1919-12-27,1919,Manchester City,Sunderland,1-0,1,0,1,1,1,1,H
1919-12-27,1919,Newcastle United,Manchester United,2-1,2,1,1,1,3,1,H
1919-12-27,1919,Notts County,Bradford City,5-2,5,2,1,1,7,3,H
1919-12-27,1919,Oldham Athletic,Aston Villa,0-3,0,3,1,1,3,-3,A
1919-12-27,1919,Sheffield Wednesday,Arsenal,1-2,1,2,1,1,3,-1,A
1919-12-27,1919,West Bromwich Albion,Derby County,3-0,3,0,1,1,3,3,H
1920-01-01,1919,Blackburn Rovers,Notts County,1-1,1,1,1,1,2,0,D
1920-01-01,1919,Bolton Wanderers,Sheffield Wednesday,2-0,2,0,1,1,2,2,H
1920-01-01,1919,Liverpool,Manchester United,0-0,0,0,1,1,0,0,D
1920-01-01,1919,Manchester City,Bradford City,1-0,1,0,1,1,1,1,H
1920-01-01,1919,Middlesbrough,Burnley,4-0,4,0,1,1,4,4,H
1920-01-01,1919,Newcastle United,Aston Villa,2-0,2,0,1,1,2,2,H
1920-01-01,1919,Oldham Athletic,Chelsea,1-0,1,0,1,1,1,1,H
1920-01-01,1919,Sheffield United,Preston North End,2-1,2,1,1,1,3,1,H
1920-01-01,1919,Sunderland,West Bromwich Albion,4-1,4,1,1,1,5,3,H
1920-01-03,1919,Arsenal,Manchester City,2-2,2,2,1,1,4,0,D
1920-01-03,1919,Aston Villa,Burnley,2-2,2,2,1,1,4,0,D
1920-01-03,1919,Blackburn Rovers,West Bromwich Albion,1-5,1,5,1,1,6,-4,A
1920-01-03,1919,Bolton Wanderers,Notts County,1-0,1,0,1,1,1,1,H
1920-01-03,1919,Bradford City,Bradford Park Avenue,0-0,0,0,1,1,0,0,D
1920-01-03,1919,Derby County,Sunderland,3-1,3,1,1,1,4,2,H
1920-01-03,1919,Everton,Sheffield Wednesday,1-1,1,1,1,1,2,0,D
1920-01-03,1919,Manchester United,Chelsea,0-2,0,2,1,1,2,-2,A
1920-01-03,1919,Middlesbrough,Preston North End,4-1,4,1,1,1,5,3,H
1920-01-03,1919,Newcastle United,Oldham Athletic,0-1,0,1,1,1,1,-1,A
1920-01-03,1919,Sheffield United,Liverpool,3-2,3,2,1,1,5,1,H
1920-01-17,1919,Burnley,Aston Villa,0-0,0,0,1,1,0,0,D
1920-01-17,1919,Chelsea,Manchester United,1-0,1,0,1,1,1,1,H
1920-01-17,1919,Liverpool,Sheffield United,2-0,2,0,1,1,2,2,H
1920-01-17,1919,Manchester City,Arsenal,4-1,4,1,1,1,5,3,H
1920-01-17,1919,Notts County,Bolton Wanderers,2-2,2,2,1,1,4,0,D
1920-01-17,1919,Oldham Athletic,Newcastle United,1-0,1,0,1,1,1,1,H
1920-01-17,1919,Preston North End,Middlesbrough,3-1,3,1,1,1,4,2,H
1920-01-17,1919,Sheffield Wednesday,Everton,1-0,1,0,1,1,1,1,H
1920-01-17,1919,Sunderland,Derby County,2-1,2,1,1,1,3,1,H
1920-01-17,1919,West Bromwich Albion,Blackburn Rovers,5-2,5,2,1,1,7,3,H
1920-01-24,1919,Arsenal,Aston Villa,0-1,0,1,1,1,1,-1,A
1920-01-24,1919,Blackburn Rovers,Bradford Park Avenue,3-3,3,3,1,1,6,0,D
1920-01-24,1919,Bolton Wanderers,Liverpool,0-3,0,3,1,1,3,-3,A
1920-01-24,1919,Bradford City,Chelsea,3-1,3,1,1,1,4,2,H
1920-01-24,1919,Derby County,Sheffield United,5-1,5,1,1,1,6,4,H
1920-01-24,1919,Everton,Newcastle United,4-0,4,0,1,1,4,4,H
1920-01-24,1919,Manchester City,Middlesbrough,1-0,1,0,1,1,1,1,H
1920-01-24,1919,Notts County,Preston North End,1-2,1,2,1,1,3,-1,A
1920-01-24,1919,Sheffield Wednesday,Burnley,3-1,3,1,1,1,4,2,H
1920-01-24,1919,Sunderland,Oldham Athletic,3-0,3,0,1,1,3,3,H
1920-01-24,1919,West Bromwich Albion,Manchester United,2-1,2,1,1,1,3,1,H
1920-02-04,1919,Chelsea,Bradford City,1-0,1,0,1,1,1,1,H
1920-02-04,1919,Liverpool,Bolton Wanderers,2-0,2,0,1,1,2,2,H
1920-02-07,1919,Arsenal,Oldham Athletic,3-2,3,2,1,1,5,1,H
1920-02-07,1919,Blackburn Rovers,Liverpool,0-2,0,2,1,1,2,-2,A
1920-02-07,1919,Bolton Wanderers,Chelsea,1-2,1,2,1,1,3,-1,A
1920-02-07,1919,Bradford City,Newcastle United,1-0,1,0,1,1,1,1,H
1920-02-07,1919,Derby County,Middlesbrough,1-2,1,2,1,1,3,-1,A
1920-02-07,1919,Everton,Aston Villa,1-1,1,1,1,1,2,0,D
1920-02-07,1919,Manchester City,Burnley,3-1,3,1,1,1,4,2,H
1920-02-07,1919,Notts County,Bradford Park Avenue,0-2,0,2,1,1,2,-2,A
1920-02-07,1919,Sheffield Wednesday,Preston North End,0-1,0,1,1,1,1,-1,A
1920-02-07,1919,Sunderland,Manchester United,3-0,3,0,1,1,3,3,H
1920-02-07,1919,West Bromwich Albion,Sheffield United,0-2,0,2,1,1,2,-2,A
1920-02-09,1919,Sheffield United,Derby County,0-0,0,0,1,1,0,0,D
1920-02-11,1919,Aston Villa,Arsenal,2-1,2,1,1,1,3,1,H
1920-02-11,1919,Bradford Park Avenue,Bradford City,0-0,0,0,1,1,0,0,D
1920-02-11,1919,Manchester United,Oldham Athletic,1-1,1,1,1,1,2,0,D
1920-02-11,1919,Newcastle United,Everton,3-0,3,0,1,1,3,3,H
1920-02-14,1919,Aston Villa,Everton,2-2,2,2,1,1,4,0,D
1920-02-14,1919,Bradford Park Avenue,Notts County,0-1,0,1,1,1,1,-1,A
1920-02-14,1919,Burnley,Manchester City,2-0,2,0,1,1,2,2,H
1920-02-14,1919,Chelsea,Bolton Wanderers,2-3,2,3,1,1,5,-1,A
1920-02-14,1919,Liverpool,Blackburn Rovers,3-0,3,0,1,1,3,3,H
1920-02-14,1919,Manchester United,Sunderland,2-0,2,0,1,1,2,2,H
1920-02-14,1919,Middlesbrough,Derby County,2-0,2,0,1,1,2,2,H
1920-02-14,1919,Newcastle United,Bradford City,0-1,0,1,1,1,1,-1,A
1920-02-14,1919,Oldham Athletic,Arsenal,3-0,3,0,1,1,3,3,H
1920-02-14,1919,Preston North End,Sheffield Wednesday,3-0,3,0,1,1,3,3,H
1920-02-14,1919,Sheffield United,West Bromwich Albion,1-0,1,0,1,1,1,1,H
1920-02-17,1919,Burnley,Sheffield Wednesday,2-0,2,0,1,1,2,2,H
1920-02-18,1919,Everton,Oldham Athletic,0-2,0,2,1,1,2,-2,A
1920-02-18,1919,Middlesbrough,Manchester City,0-2,0,2,1,1,2,-2,A
1920-02-21,1919,Arsenal,Manchester United,0-3,0,3,1,1,3,-3,A
1920-02-21,1919,Bolton Wanderers,Newcastle United,0-3,0,3,1,1,3,-3,A
1920-02-21,1919,Derby County,Burnley,0-2,0,2,1,1,2,-2,A
1920-02-21,1919,West Bromwich Albion,Middlesbrough,4-1,4,1,1,1,5,3,H
1920-02-23,1919,Bradford Park Avenue,Blackburn Rovers,5-2,5,2,1,1,7,3,H
1920-02-25,1919,Manchester United,West Bromwich Albion,1-2,1,2,1,1,3,-1,A
1920-02-26,1919,Notts County,Liverpool,1-0,1,0,1,1,1,1,H
1920-02-28,1919,Aston Villa,Bradford City,3-1,3,1,1,1,4,2,H
1920-02-28,1919,Bradford Park Avenue,Sheffield Wednesday,3-0,3,0,1,1,3,3,H
1920-02-28,1919,Burnley,Derby County,2-0,2,0,1,1,2,2,H
1920-02-28,1919,Chelsea,Blackburn Rovers,2-1,2,1,1,1,3,1,H
1920-02-28,1919,Liverpool,Notts County,3-0,3,0,1,1,3,3,H
1920-02-28,1919,Manchester United,Arsenal,0-1,0,1,1,1,1,-1,A
1920-02-28,1919,Middlesbrough,West Bromwich Albion,0-0,0,0,1,1,0,0,D
1920-02-28,1919,Newcastle United,Bolton Wanderers,0-1,0,1,1,1,1,-1,A
1920-02-28,1919,Oldham Athletic,Everton,4-1,4,1,1,1,5,3,H
1920-02-28,1919,Preston North End,Manchester City,1-1,1,1,1,1,2,0,D
1920-02-28,1919,Sheffield United,Sunderland,3-1,3,1,1,1,4,2,H
1920-03-04,1919,Preston North End,Notts County,2-0,2,0,1,1,2,2,H
1920-03-06,1919,Burnley,West Bromwich Albion,2-2,2,2,1,1,4,0,D
1920-03-06,1919,Manchester United,Everton,1-0,1,0,1,1,1,1,H
1920-03-06,1919,Middlesbrough,Sunderland,0-2,0,2,1,1,2,-2,A
1920-03-06,1919,Newcastle United,Blackburn Rovers,0-0,0,0,1,1,0,0,D
1920-03-06,1919,Preston North End,Derby County,1-1,1,1,1,1,2,0,D
1920-03-06,1919,Sheffield United,Arsenal,2-0,2,0,1,1,2,2,H
1920-03-08,1919,Oldham Athletic,Sunderland,2-1,2,1,1,1,3,1,H
1920-03-10,1919,Liverpool,Sheffield Wednesday,1-0,1,0,1,1,1,1,H
1920-03-11,1919,Blackburn Rovers,Chelsea,3-1,3,1,1,1,4,2,H
1920-03-13,1919,Arsenal,Sheffield United,3-0,3,0,1,1,3,3,H
1920-03-13,1919,Blackburn Rovers,Newcastle United,2-0,2,0,1,1,2,2,H
1920-03-13,1919,Bolton Wanderers,Aston Villa,2-1,2,1,1,1,3,1,H
1920-03-13,1919,Bradford City,Oldham Athletic,1-1,1,1,1,1,2,0,D
1920-03-13,1919,Derby County,Preston North End,2-0,2,0,1,1,2,2,H
1920-03-13,1919,Everton,Manchester United,0-0,0,0,1,1,0,0,D
1920-03-13,1919,Manchester City,Bradford Park Avenue,4-1,4,1,1,1,5,3,H
1920-03-13,1919,Notts County,Chelsea,0-1,0,1,1,1,1,-1,A
1920-03-13,1919,Sheffield Wednesday,Liverpool,2-2,2,2,1,1,4,0,D
1920-03-13,1919,Sunderland,Middlesbrough,1-1,1,1,1,1,2,0,D
1920-03-13,1919,West Bromwich Albion,Burnley,4-1,4,1,1,1,5,3,H
1920-03-17,1919,Bradford City,Aston Villa,3-1,3,1,1,1,4,2,H
1920-03-17,1919,Chelsea,Notts County,2-0,2,0,1,1,2,2,H
1920-03-17,1919,Manchester City,Preston North End,1-0,1,0,1,1,1,1,H
1920-03-17,1919,Sunderland,Sheffield United,3-2,3,2,1,1,5,1,H
1920-03-20,1919,Aston Villa,Blackburn Rovers,1-2,1,2,1,1,3,-1,A
1920-03-20,1919,Bradford Park Avenue,Derby County,1-1,1,1,1,1,2,0,D
1920-03-20,1919,Burnley,Sunderland,2-1,2,1,1,1,3,1,H
1920-03-20,1919,Chelsea,Sheffield Wednesday,1-1,1,1,1,1,2,0,D
1920-03-20,1919,Liverpool,Manchester City,1-0,1,0,1,1,1,1,H
1920-03-20,1919,Manchester United,Bradford City,0-0,0,0,1,1,0,0,D
1920-03-20,1919,Middlesbrough,Arsenal,1-0,1,0,1,1,1,1,H
1920-03-20,1919,Newcastle United,Notts County,2-1,2,1,1,1,3,1,H
1920-03-20,1919,Oldham Athletic,Bolton Wanderers,2-0,2,0,1,1,2,2,H
1920-03-20,1919,Preston North End,West Bromwich Albion,0-1,0,1,1,1,1,-1,A
1920-03-20,1919,Sheffield United,Everton,1-1,1,1,1,1,2,0,D
1920-03-22,1919,Bradford Park Avenue,Manchester City,2-1,2,1,1,1,3,1,H
1920-03-22,1919,Oldham Athletic,Bradford City,0-1,0,1,1,1,1,-1,A
1920-03-22,1919,Sheffield Wednesday,Newcastle United,0-1,0,1,1,1,1,-1,A
1920-03-27,1919,Arsenal,Middlesbrough,2-1,2,1,1,1,3,1,H
1920-03-27,1919,Bolton Wanderers,Oldham Athletic,1-0,1,0,1,1,1,1,H
1920-03-27,1919,Bradford City,Manchester United,2-1,2,1,1,1,3,1,H
1920-03-27,1919,Derby County,Bradford Park Avenue,0-0,0,0,1,1,0,0,D
1920-03-27,1919,Everton,Sheffield United,3-0,3,0,1,1,3,3,H
1920-03-27,1919,Manchester City,Liverpool,2-1,2,1,1,1,3,1,H
1920-03-27,1919,Notts County,Newcastle United,0-0,0,0,1,1,0,0,D
1920-03-27,1919,Sunderland,Burnley,3-0,3,0,1,1,3,3,H
1920-03-27,1919,West Bromwich Albion,Preston North End,4-1,4,1,1,1,5,3,H
1920-04-02,1919,Blackburn Rovers,Sunderland,3-0,3,0,1,1,3,3,H
1920-04-02,1919,Burnley,Newcastle United,1-0,1,0,1,1,1,1,H
1920-04-02,1919,Chelsea,Aston Villa,2-1,2,1,1,1,3,1,H
1920-04-02,1919,Everton,Derby County,4-0,4,0,1,1,4,4,H
1920-04-02,1919,Manchester United,Bradford Park Avenue,0-1,0,1,1,1,1,-1,A
1920-04-02,1919,Notts County,Middlesbrough,1-1,1,1,1,1,2,0,D
1920-04-02,1919,Oldham Athletic,Liverpool,1-1,1,1,1,1,2,0,D
1920-04-02,1919,Preston North End,Sheffield United,2-0,2,0,1,1,2,2,H
1920-04-03,1919,Aston Villa,Notts County,3-1,3,1,1,1,4,2,H
1920-04-03,1919,Bradford Park Avenue,West Bromwich Albion,0-4,0,4,1,1,4,-4,A
1920-04-03,1919,Burnley,Arsenal,2-1,2,1,1,1,3,1,H
1920-04-03,1919,Chelsea,Manchester City,1-0,1,0,1,1,1,1,H
1920-04-03,1919,Liverpool,Derby County,3-0,3,0,1,1,3,3,H
1920-04-03,1919,Manchester United,Bolton Wanderers,1-1,1,1,1,1,2,0,D
1920-04-03,1919,Middlesbrough,Everton,1-1,1,1,1,1,2,0,D
1920-04-03,1919,Newcastle United,Sheffield Wednesday,1-1,1,1,1,1,2,0,D
1920-04-03,1919,Oldham Athletic,Blackburn Rovers,0-0,0,0,1,1,0,0,D
1920-04-03,1919,Preston North End,Sunderland,5-2,5,2,1,1,7,3,H
1920-04-03,1919,Sheffield United,Bradford City,0-0,0,0,1,1,0,0,D
1920-04-05,1919,Arsenal,West Bromwich Albion,1-0,1,0,1,1,1,1,H
1920-04-05,1919,Aston Villa,Newcastle United,4-0,4,0,1,1,4,4,H
1920-04-05,1919,Bradford City,Manchester City,1-0,1,0,1,1,1,1,H
1920-04-05,1919,Derby County,Everton,2-1,2,1,1,1,3,1,H
1920-04-05,1919,Liverpool,Oldham Athletic,2-2,2,2,1,1,4,0,D
1920-04-05,1919,Middlesbrough,Notts County,5-2,5,2,1,1,7,3,H
1920-04-05,1919,Sheffield Wednesday,Bolton Wanderers,0-2,0,2,1,1,2,-2,A
1920-04-05,1919,Sunderland,Blackburn Rovers,2-0,2,0,1,1,2,2,H
1920-04-06,1919,Bradford Park Avenue,Manchester United,1-4,1,4,1,1,5,-3,A
1920-04-06,1919,Sheffield Wednesday,Chelsea,0-2,0,2,1,1,2,-2,A
1920-04-06,1919,West Bromwich Albion,Arsenal,1-0,1,0,1,1,1,1,H
1920-04-07,1919,Aston Villa,Bolton Wanderers,3-6,3,6,1,1,9,-3,A
1920-04-10,1919,Arsenal,Burnley,2-0,2,0,1,1,2,2,H
1920-04-10,1919,Blackburn Rovers,Oldham Athletic,0-1,0,1,1,1,1,-1,A
1920-04-10,1919,Bolton Wanderers,Manchester United,3-5,3,5,1,1,8,-2,A
1920-04-10,1919,Bradford City,Sheffield United,1-2,1,2,1,1,3,-1,A
1920-04-10,1919,Derby County,Liverpool,3-0,3,0,1,1,3,3,H
1920-04-10,1919,Everton,Middlesbrough,5-2,5,2,1,1,7,3,H
1920-04-10,1919,Manchester City,Chelsea,1-0,1,0,1,1,1,1,H
1920-04-10,1919,Notts County,Aston Villa,2-1,2,1,1,1,3,1,H
1920-04-10,1919,Sunderland,Preston North End,1-0,1,0,1,1,1,1,H
1920-04-10,1919,West Bromwich Albion,Bradford Park Avenue,3-1,3,1,1,1,4,2,H
1920-04-15,1919,Blackburn Rovers,Aston Villa,5-1,5,1,1,1,6,4,H
1920-04-17,1919,Aston Villa,Sheffield Wednesday,3-1,3,1,1,1,4,2,H
1920-04-17,1919,Bradford Park Avenue,Sunderland,2-2,2,2,1,1,4,0,D
1920-04-17,1919,Burnley,Everton,5-0,5,0,1,1,5,5,H
1920-04-17,1919,Chelsea,Derby County,0-0,0,0,1,1,0,0,D
1920-04-17,1919,Liverpool,West Bromwich Albion,0-0,0,0,1,1,0,0,D
1920-04-17,1919,Manchester United,Blackburn Rovers,1-1,1,1,1,1,2,0,D
1920-04-17,1919,Middlesbrough,Bradford City,4-0,4,0,1,1,4,4,H
1920-04-17,1919,Newcastle United,Manchester City,3-0,3,0,1,1,3,3,H
1920-04-17,1919,Oldham Athletic,Notts County,0-0,0,0,1,1,0,0,D
1920-04-17,1919,Preston North End,Arsenal,1-1,1,1,1,1,2,0,D
1920-04-17,1919,Sheffield United,Bolton Wanderers,3-2,3,2,1,1,5,1,H
1920-04-19,1919,Sheffield Wednesday,Bradford Park Avenue,0-1,0,1,1,1,1,-1,A
1920-04-24,1919,Arsenal,Preston North End,0-0,0,0,1,1,0,0,D
1920-04-24,1919,Blackburn Rovers,Manchester United,5-0,5,0,1,1,5,5,H
1920-04-24,1919,Bolton Wanderers,Sheffield United,1-0,1,0,1,1,1,1,H
1920-04-24,1919,Bradford City,Middlesbrough,0-1,0,1,1,1,1,-1,A
1920-04-24,1919,Derby County,Chelsea,5-0,5,0,1,1,5,5,H
1920-04-24,1919,Everton,Burnley,2-2,2,2,1,1,4,0,D
1920-04-24,1919,Manchester City,Newcastle United,0-0,0,0,1,1,0,0,D
1920-04-24,1919,Notts County,Oldham Athletic,2-1,2,1,1,1,3,1,H
1920-04-24,1919,Sunderland,Bradford Park Avenue,2-0,2,0,1,1,2,2,H
1920-04-24,1919,West Bromwich Albion,Liverpool,1-1,1,1,1,1,2,0,D
1920-04-26,1919,Aston Villa,Manchester City,0-1,0,1,1,1,1,-1,A
1920-04-26,1919,Chelsea,West Bromwich Albion,2-0,2,0,1,1,2,2,H
1920-04-26,1919,Manchester United,Notts County,0-0,0,0,1,1,0,0,D
1920-04-26,1919,Oldham Athletic,Sheffield Wednesday,1-0,1,0,1,1,1,1,H
1920-04-26,1919,Preston North End,Everton,1-1,1,1,1,1,2,0,D
1920-04-28,1919,Bradford Park Avenue,Arsenal,0-0,0,0,1,1,0,0,D
1920-04-29,1919,Sheffield Wednesday,Aston Villa,0-1,0,1,1,1,1,-1,A
1920-05-01,1919,Arsenal,Bradford Park Avenue,3-0,3,0,1,1,3,3,H
1920-05-01,1919,Blackburn Rovers,Sheffield United,4-0,4,0,1,1,4,4,H
1920-05-01,1919,Bolton Wanderers,Middlesbrough,2-1,2,1,1,1,3,1,H
1920-05-01,1919,Bradford City,Burnley,2-1,2,1,1,1,3,1,H
1920-05-01,1919,Derby County,Newcastle United,1-0,1,0,1,1,1,1,H
1920-05-01,1919,Everton,Preston North End,0-1,0,1,1,1,1,-1,A
1920-05-01,1919,Manchester City,Aston Villa,2-2,2,2,1,1,4,0,D
1920-05-01,1919,Notts County,Manchester United,0-2,0,2,1,1,2,-2,A
1920-05-01,1919,Sheffield Wednesday,Oldham Athletic,1-0,1,0,1,1,1,1,H
1920-05-01,1919,Sunderland,Liverpool,0-1,0,1,1,1,1,-1,A
1920-05-01,1919,West Bromwich Albion,Chelsea,4-0,4,0,1,1,4,4,H
1920-08-28,1920,Aston Villa,Arsenal,5-0,5,0,1,1,5,5,H
1920-08-28,1920,Bradford Park Avenue,Everton,3-3,3,3,1,1,6,0,D
1920-08-28,1920,Burnley,Bradford City,1-4,1,4,1,1,5,-3,A
1920-08-28,1920,Derby County,Chelsea,0-0,0,0,1,1,0,0,D
1920-08-28,1920,Liverpool,Manchester City,4-2,4,2,1,1,6,2,H
1920-08-28,1920,Manchester United,Bolton Wanderers,2-3,2,3,1,1,5,-1,A
1920-08-28,1920,Middlesbrough,Oldham Athletic,1-2,1,2,1,1,3,-1,A
1920-08-28,1920,Newcastle United,West Bromwich Albion,1-1,1,1,1,1,2,0,D
1920-08-28,1920,Preston North End,Huddersfield Town,0-1,0,1,1,1,1,-1,A
1920-08-28,1920,Sheffield United,Sunderland,1-1,1,1,1,1,2,0,D
1920-08-28,1920,Tottenham Hotspur,Blackburn Rovers,1-2,1,2,1,1,3,-1,A
1920-08-30,1920,Arsenal,Manchester United,2-0,2,0,1,1,2,2,H
1920-08-30,1920,Bradford City,Sheffield United,4-0,4,0,1,1,4,4,H
1920-08-30,1920,Derby County,Tottenham Hotspur,2-2,2,2,1,1,4,0,D
1920-08-30,1920,Huddersfield Town,Burnley,1-0,1,0,1,1,1,1,H
1920-08-30,1920,Manchester City,Aston Villa,3-1,3,1,1,1,4,2,H
1920-08-30,1920,Middlesbrough,Preston North End,0-0,0,0,1,1,0,0,D
1920-08-30,1920,Oldham Athletic,Blackburn Rovers,1-0,1,0,1,1,1,1,H
1920-09-01,1920,Chelsea,Bolton Wanderers,1-0,1,0,1,1,1,1,H
1920-09-01,1920,Everton,Newcastle United,3-1,3,1,1,1,4,2,H
1920-09-01,1920,Sunderland,Bradford Park Avenue,5-1,5,1,1,1,6,4,H
1920-09-01,1920,West Bromwich Albion,Liverpool,1-1,1,1,1,1,2,0,D
1920-09-04,1920,Arsenal,Aston Villa,0-1,0,1,1,1,1,-1,A
1920-09-04,1920,Blackburn Rovers,Tottenham Hotspur,1-1,1,1,1,1,2,0,D
1920-09-04,1920,Bolton Wanderers,Manchester United,1-1,1,1,1,1,2,0,D
1920-09-04,1920,Bradford City,Burnley,2-0,2,0,1,1,2,2,H
1920-09-04,1920,Chelsea,Derby County,1-1,1,1,1,1,2,0,D
1920-09-04,1920,Everton,Bradford Park Avenue,1-1,1,1,1,1,2,0,D
1920-09-04,1920,Huddersfield Town,Preston North End,1-0,1,0,1,1,1,1,H
1920-09-04,1920,Manchester City,Liverpool,3-2,3,2,1,1,5,1,H
1920-09-04,1920,Oldham Athletic,Middlesbrough,3-3,3,3,1,1,6,0,D
1920-09-04,1920,Sunderland,Sheffield United,3-1,3,1,1,1,4,2,H
1920-09-04,1920,West Bromwich Albion,Newcastle United,0-0,0,0,1,1,0,0,D
1920-09-06,1920,Aston Villa,Manchester City,3-1,3,1,1,1,4,2,H
1920-09-06,1920,Bolton Wanderers,Chelsea,3-1,3,1,1,1,4,2,H
1920-09-06,1920,Burnley,Huddersfield Town,3-0,3,0,1,1,3,3,H
1920-09-06,1920,Liverpool,West Bromwich Albion,0-0,0,0,1,1,0,0,D
1920-09-06,1920,Manchester United,Arsenal,1-1,1,1,1,1,2,0,D
1920-09-06,1920,Preston North End,Middlesbrough,2-0,2,0,1,1,2,2,H
1920-09-06,1920,Sheffield United,Bradford City,4-1,4,1,1,1,5,3,H
1920-09-06,1920,Tottenham Hotspur,Derby County,2-0,2,0,1,1,2,2,H
1920-09-08,1920,Bradford Park Avenue,Sunderland,1-1,1,1,1,1,2,0,D
1920-09-08,1920,Newcastle United,Everton,2-0,2,0,1,1,2,2,H
1920-09-11,1920,Arsenal,Manchester City,2-1,2,1,1,1,3,1,H
1920-09-11,1920,Aston Villa,Tottenham Hotspur,4-2,4,2,1,1,6,2,H
1920-09-11,1920,Blackburn Rovers,Sunderland,2-0,2,0,1,1,2,2,H
1920-09-11,1920,Bolton Wanderers,West Bromwich Albion,3-0,3,0,1,1,3,3,H
1920-09-11,1920,Bradford Park Avenue,Sheffield United,2-0,2,0,1,1,2,2,H
1920-09-11,1920,Burnley,Middlesbrough,2-1,2,1,1,1,3,1,H
1920-09-11,1920,Derby County,Everton,2-4,2,4,1,1,6,-2,A
1920-09-11,1920,Huddersfield Town,Bradford City,1-0,1,0,1,1,1,1,H
1920-09-11,1920,Liverpool,Oldham Athletic,5-2,5,2,1,1,7,3,H
1920-09-11,1920,Manchester United,Chelsea,3-1,3,1,1,1,4,2,H
1920-09-11,1920,Newcastle United,Preston North End,4-2,4,2,1,1,6,2,H
1920-09-15,1920,Bolton Wanderers,Aston Villa,5-0,5,0,1,1,5,5,H
1920-09-18,1920,Bradford City,Huddersfield Town,0-2,0,2,1,1,2,-2,A
1920-09-18,1920,Chelsea,Manchester United,1-2,1,2,1,1,3,-1,A
1920-09-18,1920,Everton,Derby County,3-1,3,1,1,1,4,2,H
1920-09-18,1920,Manchester City,Arsenal,3-1,3,1,1,1,4,2,H
1920-09-18,1920,Middlesbrough,Burnley,0-0,0,0,1,1,0,0,D
1920-09-18,1920,Oldham Athletic,Liverpool,0-0,0,0,1,1,0,0,D
1920-09-18,1920,Preston North End,Newcastle United,3-2,3,2,1,1,5,1,H
1920-09-18,1920,Sheffield United,Bradford Park Avenue,2-0,2,0,1,1,2,2,H
1920-09-18,1920,Sunderland,Blackburn Rovers,2-0,2,0,1,1,2,2,H
1920-09-18,1920,Tottenham Hotspur,Aston Villa,1-2,1,2,1,1,3,-1,A
1920-09-18,1920,West Bromwich Albion,Bolton Wanderers,2-1,2,1,1,1,3,1,H
1920-09-20,1920,Blackburn Rovers,Oldham Athletic,5-1,5,1,1,1,6,4,H
1920-09-22,1920,Everton,Sheffield United,3-0,3,0,1,1,3,3,H
1920-09-25,1920,Arsenal,Middlesbrough,2-2,2,2,1,1,4,0,D
1920-09-25,1920,Aston Villa,Oldham Athletic,3-0,3,0,1,1,3,3,H
1920-09-25,1920,Blackburn Rovers,Everton,0-0,0,0,1,1,0,0,D
1920-09-25,1920,Bolton Wanderers,Manchester City,3-0,3,0,1,1,3,3,H
1920-09-25,1920,Bradford Park Avenue,Bradford City,1-2,1,2,1,1,3,-1,A
1920-09-25,1920,Burnley,Chelsea,4-0,4,0,1,1,4,4,H
1920-09-25,1920,Derby County,West Bromwich Albion,1-1,1,1,1,1,2,0,D
1920-09-25,1920,Huddersfield Town,Sunderland,0-0,0,0,1,1,0,0,D
1920-09-25,1920,Liverpool,Preston North End,6-0,6,0,1,1,6,6,H
1920-09-25,1920,Manchester United,Tottenham Hotspur,0-1,0,1,1,1,1,-1,A
1920-09-25,1920,Newcastle United,Sheffield United,3-0,3,0,1,1,3,3,H
1920-10-02,1920,Bradford City,Bradford Park Avenue,2-1,2,1,1,1,3,1,H
1920-10-02,1920,Chelsea,Burnley,1-1,1,1,1,1,2,0,D
1920-10-02,1920,Everton,Blackburn Rovers,2-1,2,1,1,1,3,1,H
1920-10-02,1920,Manchester City,Bolton Wanderers,3-1,3,1,1,1,4,2,H
1920-10-02,1920,Middlesbrough,Arsenal,2-1,2,1,1,1,3,1,H
1920-10-02,1920,Oldham Athletic,Aston Villa,1-1,1,1,1,1,2,0,D
1920-10-02,1920,Preston North End,Liverpool,2-3,2,3,1,1,5,-1,A
1920-10-02,1920,Sheffield United,Newcastle United,0-3,0,3,1,1,3,-3,A
1920-10-02,1920,Sunderland,Huddersfield Town,2-1,2,1,1,1,3,1,H
1920-10-02,1920,Tottenham Hotspur,Manchester United,4-1,4,1,1,1,5,3,H
1920-10-02,1920,West Bromwich Albion,Derby County,3-0,3,0,1,1,3,3,H
1920-10-04,1920,Sheffield United,Everton,2-0,2,0,1,1,2,2,H
1920-10-09,1920,Arsenal,Bolton Wanderers,0-0,0,0,1,1,0,0,D
1920-10-09,1920,Aston Villa,Preston North End,1-0,1,0,1,1,1,1,H
1920-10-09,1920,Blackburn Rovers,West Bromwich Albion,5-1,5,1,1,1,6,4,H
1920-10-09,1920,Bradford Park Avenue,Burnley,1-3,1,3,1,1,4,-2,A
1920-10-09,1920,Derby County,Manchester City,3-0,3,0,1,1,3,3,H
1920-10-09,1920,Huddersfield Town,Everton,0-1,0,1,1,1,1,-1,A
1920-10-09,1920,Liverpool,Sheffield United,2-2,2,2,1,1,4,0,D
1920-10-09,1920,Manchester United,Oldham Athletic,4-1,4,1,1,1,5,3,H
1920-10-09,1920,Middlesbrough,Bradford City,2-1,2,1,1,1,3,1,H
1920-10-09,1920,Newcastle United,Sunderland,6-1,6,1,1,1,7,5,H
1920-10-09,1920,Tottenham Hotspur,Chelsea,5-0,5,0,1,1,5,5,H
1920-10-16,1920,Bolton Wanderers,Arsenal,1-1,1,1,1,1,2,0,D
1920-10-16,1920,Bradford City,Middlesbrough,0-1,0,1,1,1,1,-1,A
1920-10-16,1920,Burnley,Bradford Park Avenue,1-0,1,0,1,1,1,1,H
1920-10-16,1920,Chelsea,Tottenham Hotspur,0-4,0,4,1,1,4,-4,A
1920-10-16,1920,Everton,Huddersfield Town,0-0,0,0,1,1,0,0,D
1920-10-16,1920,Manchester City,Derby County,0-0,0,0,1,1,0,0,D
1920-10-16,1920,Oldham Athletic,Manchester United,2-2,2,2,1,1,4,0,D
1920-10-16,1920,Preston North End,Aston Villa,6-1,6,1,1,1,7,5,H
1920-10-16,1920,Sheffield United,Liverpool,0-1,0,1,1,1,1,-1,A
1920-10-16,1920,Sunderland,Newcastle United,0-2,0,2,1,1,2,-2,A
1920-10-16,1920,West Bromwich Albion,Blackburn Rovers,1-1,1,1,1,1,2,0,D
1920-10-23,1920,Aston Villa,Sheffield United,4-0,4,0,1,1,4,4,H
1920-10-23,1920,Blackburn Rovers,Manchester City,0-2,0,2,1,1,2,-2,A
1920-10-23,1920,Bradford City,Sunderland,2-2,2,2,1,1,4,0,D
1920-10-23,1920,Chelsea,Oldham Athletic,1-1,1,1,1,1,2,0,D
1920-10-23,1920,Derby County,Arsenal,1-1,1,1,1,1,2,0,D
1920-10-23,1920,Huddersfield Town,West Bromwich Albion,5-1,5,1,1,1,6,4,H
1920-10-23,1920,Liverpool,Everton,1-0,1,0,1,1,1,1,H
1920-10-23,1920,Manchester United,Preston North End,1-0,1,0,1,1,1,1,H
1920-10-23,1920,Middlesbrough,Bolton Wanderers,4-1,4,1,1,1,5,3,H
1920-10-23,1920,Newcastle United,Bradford Park Avenue,2-1,2,1,1,1,3,1,H
1920-10-23,1920,Tottenham Hotspur,Burnley,1-2,1,2,1,1,3,-1,A
1920-10-30,1920,Arsenal,Derby County,2-0,2,0,1,1,2,2,H
1920-10-30,1920,Bolton Wanderers,Middlesbrough,6-2,6,2,1,1,8,4,H
1920-10-30,1920,Bradford Park Avenue,Newcastle United,0-2,0,2,1,1,2,-2,A
1920-10-30,1920,Burnley,Tottenham Hotspur,2-0,2,0,1,1,2,2,H
1920-10-30,1920,Everton,Liverpool,0-3,0,3,1,1,3,-3,A
1920-10-30,1920,Manchester City,Blackburn Rovers,0-0,0,0,1,1,0,0,D
1920-10-30,1920,Oldham Athletic,Chelsea,1-2,1,2,1,1,3,-1,A
1920-10-30,1920,Preston North End,Manchester United,0-0,0,0,1,1,0,0,D
1920-10-30,1920,Sheffield United,Aston Villa,0-0,0,0,1,1,0,0,D
1920-10-30,1920,Sunderland,Bradford City,0-0,0,0,1,1,0,0,D
1920-10-30,1920,West Bromwich Albion,Huddersfield Town,3-0,3,0,1,1,3,3,H
1920-11-06,1920,Aston Villa,West Bromwich Albion,0-0,0,0,1,1,0,0,D
1920-11-06,1920,Blackburn Rovers,Arsenal,2-2,2,2,1,1,4,0,D
1920-11-06,1920,Bradford City,Everton,2-2,2,2,1,1,4,0,D
1920-11-06,1920,Chelsea,Preston North End,1-1,1,1,1,1,2,0,D
1920-11-06,1920,Derby County,Bolton Wanderers,0-0,0,0,1,1,0,0,D
1920-11-06,1920,Huddersfield Town,Manchester City,0-1,0,1,1,1,1,-1,A
1920-11-06,1920,Liverpool,Bradford Park Avenue,0-1,0,1,1,1,1,-1,A
1920-11-06,1920,Manchester United,Sheffield United,2-1,2,1,1,1,3,1,H
1920-11-06,1920,Middlesbrough,Sunderland,2-0,2,0,1,1,2,2,H
1920-11-06,1920,Newcastle United,Burnley,1-2,1,2,1,1,3,-1,A
1920-11-06,1920,Tottenham Hotspur,Oldham Athletic,5-1,5,1,1,1,6,4,H
1920-11-13,1920,Arsenal,Blackburn Rovers,2-0,2,0,1,1,2,2,H
1920-11-13,1920,Bolton Wanderers,Derby County,1-0,1,0,1,1,1,1,H
1920-11-13,1920,Bradford Park Avenue,Liverpool,1-3,1,3,1,1,4,-2,A
1920-11-13,1920,Burnley,Newcastle United,3-1,3,1,1,1,4,2,H
1920-11-13,1920,Everton,Bradford City,2-2,2,2,1,1,4,0,D
1920-11-13,1920,Manchester City,Huddersfield Town,3-2,3,2,1,1,5,1,H
1920-11-13,1920,Oldham Athletic,Tottenham Hotspur,2-5,2,5,1,1,7,-3,A
1920-11-13,1920,Preston North End,Chelsea,0-1,0,1,1,1,1,-1,A
1920-11-13,1920,Sheffield United,Manchester United,0-0,0,0,1,1,0,0,D
1920-11-13,1920,Sunderland,Middlesbrough,1-2,1,2,1,1,3,-1,A
1920-11-13,1920,West Bromwich Albion,Aston Villa,2-1,2,1,1,1,3,1,H
1920-11-20,1920,Aston Villa,Bradford Park Avenue,4-1,4,1,1,1,5,3,H
1920-11-20,1920,Blackburn Rovers,Bolton Wanderers,2-2,2,2,1,1,4,0,D
1920-11-20,1920,Chelsea,Sheffield United,2-1,2,1,1,1,3,1,H
1920-11-20,1920,Everton,Sunderland,1-1,1,1,1,1,2,0,D
1920-11-20,1920,Huddersfield Town,Arsenal,0-4,0,4,1,1,4,-4,A
1920-11-20,1920,Manchester United,Manchester City,1-1,1,1,1,1,2,0,D
1920-11-20,1920,Middlesbrough,Derby County,1-0,1,0,1,1,1,1,H
1920-11-20,1920,Newcastle United,Liverpool,2-0,2,0,1,1,2,2,H
1920-11-20,1920,Oldham Athletic,Burnley,2-2,2,2,1,1,4,0,D
1920-11-20,1920,Tottenham Hotspur,Preston North End,1-2,1,2,1,1,3,-1,A
1920-11-27,1920,Arsenal,Huddersfield Town,2-0,2,0,1,1,2,2,H
1920-11-27,1920,Bolton Wanderers,Blackburn Rovers,2-1,2,1,1,1,3,1,H
1920-11-27,1920,Bradford Park Avenue,Aston Villa,4-0,4,0,1,1,4,4,H
1920-11-27,1920,Burnley,Oldham Athletic,7-1,7,1,1,1,8,6,H
1920-11-27,1920,Derby County,Middlesbrough,0-1,0,1,1,1,1,-1,A
1920-11-27,1920,Liverpool,Newcastle United,0-1,0,1,1,1,1,-1,A
1920-11-27,1920,Manchester City,Manchester United,3-0,3,0,1,1,3,3,H
1920-11-27,1920,Preston North End,Tottenham Hotspur,4-1,4,1,1,1,5,3,H
1920-11-27,1920,Sheffield United,Chelsea,0-1,0,1,1,1,1,-1,A
1920-11-27,1920,Sunderland,Everton,0-2,0,2,1,1,2,-2,A
1920-11-27,1920,West Bromwich Albion,Bradford City,2-0,2,0,1,1,2,2,H
1920-12-04,1920,Blackburn Rovers,Derby County,2-0,2,0,1,1,2,2,H
1920-12-04,1920,Bradford City,Manchester City,1-2,1,2,1,1,3,-1,A
1920-12-04,1920,Chelsea,Arsenal,1-2,1,2,1,1,3,-1,A
1920-12-04,1920,Huddersfield Town,Bolton Wanderers,0-0,0,0,1,1,0,0,D
1920-12-04,1920,Liverpool,Burnley,0-0,0,0,1,1,0,0,D
1920-12-04,1920,Manchester United,Bradford Park Avenue,5-1,5,1,1,1,6,4,H
1920-12-04,1920,Middlesbrough,Everton,3-1,3,1,1,1,4,2,H
1920-12-04,1920,Newcastle United,Aston Villa,2-1,2,1,1,1,3,1,H
1920-12-04,1920,Oldham Athletic,Preston North End,0-2,0,2,1,1,2,-2,A
1920-12-04,1920,Tottenham Hotspur,Sheffield United,4-1,4,1,1,1,5,3,H
1920-12-04,1920,West Bromwich Albion,Sunderland,4-1,4,1,1,1,5,3,H
1920-12-11,1920,Arsenal,Chelsea,1-1,1,1,1,1,2,0,D
1920-12-11,1920,Aston Villa,Newcastle United,0-0,0,0,1,1,0,0,D
1920-12-11,1920,Bolton Wanderers,Huddersfield Town,3-1,3,1,1,1,4,2,H
1920-12-11,1920,Bradford Park Avenue,Manchester United,2-4,2,4,1,1,6,-2,A
1920-12-11,1920,Burnley,Liverpool,1-0,1,0,1,1,1,1,H
1920-12-11,1920,Derby County,Blackburn Rovers,0-1,0,1,1,1,1,-1,A
1920-12-11,1920,Everton,Middlesbrough,2-1,2,1,1,1,3,1,H
1920-12-11,1920,Manchester City,Bradford City,1-0,1,0,1,1,1,1,H
1920-12-11,1920,Preston North End,Oldham Athletic,4-0,4,0,1,1,4,4,H
1920-12-11,1920,Sheffield United,Tottenham Hotspur,1-1,1,1,1,1,2,0,D
1920-12-11,1920,Sunderland,West Bromwich Albion,3-0,3,0,1,1,3,3,H
1920-12-18,1920,Blackburn Rovers,Middlesbrough,3-2,3,2,1,1,5,1,H
1920-12-18,1920,Bradford City,Arsenal,3-1,3,1,1,1,4,2,H
1920-12-18,1920,Burnley,Preston North End,2-0,2,0,1,1,2,2,H
1920-12-18,1920,Chelsea,Bradford Park Avenue,4-1,4,1,1,1,5,3,H
1920-12-18,1920,Huddersfield Town,Derby County,2-0,2,0,1,1,2,2,H
1920-12-18,1920,Liverpool,Aston Villa,4-1,4,1,1,1,5,3,H
1920-12-18,1920,Manchester United,Newcastle United,2-0,2,0,1,1,2,2,H
1920-12-18,1920,Oldham Athletic,Sheffield United,0-0,0,0,1,1,0,0,D
1920-12-18,1920,Sunderland,Manchester City,1-0,1,0,1,1,1,1,H
1920-12-18,1920,Tottenham Hotspur,Bolton Wanderers,5-2,5,2,1,1,7,3,H
1920-12-18,1920,West Bromwich Albion,Everton,1-2,1,2,1,1,3,-1,A
1920-12-25,1920,Aston Villa,Manchester United,3-4,3,4,1,1,7,-1,A
1920-12-25,1920,Blackburn Rovers,Preston North End,2-2,2,2,1,1,4,0,D
1920-12-25,1920,Bolton Wanderers,Sunderland,6-2,6,2,1,1,8,4,H
1920-12-25,1920,Bradford City,Derby County,2-2,2,2,1,1,4,0,D
1920-12-25,1920,Burnley,Sheffield United,6-0,6,0,1,1,6,6,H
1920-12-25,1920,Chelsea,Liverpool,1-1,1,1,1,1,2,0,D
1920-12-25,1920,Everton,Arsenal,2-4,2,4,1,1,6,-2,A
1920-12-25,1920,Manchester City,West Bromwich Albion,4-0,4,0,1,1,4,4,H
1920-12-25,1920,Middlesbrough,Huddersfield Town,2-0,2,0,1,1,2,2,H
1920-12-25,1920,Newcastle United,Tottenham Hotspur,1-1,1,1,1,1,2,0,D
1920-12-25,1920,Oldham Athletic,Bradford Park Avenue,1-0,1,0,1,1,1,1,H
1920-12-27,1920,Arsenal,Everton,1-1,1,1,1,1,2,0,D
1920-12-27,1920,Bradford Park Avenue,Oldham Athletic,2-1,2,1,1,1,3,1,H
1920-12-27,1920,Derby County,Bradford City,1-1,1,1,1,1,2,0,D
1920-12-27,1920,Huddersfield Town,Middlesbrough,0-1,0,1,1,1,1,-1,A
1920-12-27,1920,Liverpool,Chelsea,2-1,2,1,1,1,3,1,H
1920-12-27,1920,Manchester United,Aston Villa,1-3,1,3,1,1,4,-2,A
1920-12-27,1920,Preston North End,Blackburn Rovers,4-2,4,2,1,1,6,2,H
1920-12-27,1920,Sheffield United,Burnley,1-1,1,1,1,1,2,0,D
1920-12-27,1920,Sunderland,Bolton Wanderers,0-0,0,0,1,1,0,0,D
1920-12-27,1920,Tottenham Hotspur,Newcastle United,2-0,2,0,1,1,2,2,H
1920-12-27,1920,West Bromwich Albion,Manchester City,2-2,2,2,1,1,4,0,D
1920-12-29,1920,Sheffield United,Huddersfield Town,1-1,1,1,1,1,2,0,D
1921-01-01,1920,Arsenal,Bradford City,1-2,1,2,1,1,3,-1,A
1921-01-01,1920,Aston Villa,Liverpool,0-2,0,2,1,1,2,-2,A
1921-01-01,1920,Bolton Wanderers,Tottenham Hotspur,1-0,1,0,1,1,1,1,H
1921-01-01,1920,Bradford Park Avenue,Chelsea,0-2,0,2,1,1,2,-2,A
1921-01-01,1920,Derby County,Huddersfield Town,2-1,2,1,1,1,3,1,H
1921-01-01,1920,Everton,West Bromwich Albion,2-2,2,2,1,1,4,0,D
1921-01-01,1920,Manchester City,Sunderland,3-1,3,1,1,1,4,2,H
1921-01-01,1920,Middlesbrough,Blackburn Rovers,1-1,1,1,1,1,2,0,D
1921-01-01,1920,Newcastle United,Manchester United,6-3,6,3,1,1,9,3,H
1921-01-01,1920,Preston North End,Burnley,0-3,0,3,1,1,3,-3,A
1921-01-01,1920,Sheffield United,Oldham Athletic,3-0,3,0,1,1,3,3,H
1921-01-15,1920,Aston Villa,Everton,1-3,1,3,1,1,4,-2,A
1921-01-15,1920,Bradford Park Avenue,Huddersfield Town,1-1,1,1,1,1,2,0,D
1921-01-15,1920,Burnley,Blackburn Rovers,4-1,4,1,1,1,5,3,H
1921-01-15,1920,Chelsea,Manchester City,2-1,2,1,1,1,3,1,H
1921-01-15,1920,Liverpool,Sunderland,0-0,0,0,1,1,0,0,D
1921-01-15,1920,Manchester United,West Bromwich Albion,1-4,1,4,1,1,5,-3,A
1921-01-15,1920,Newcastle United,Bradford City,4-0,4,0,1,1,4,4,H
1921-01-15,1920,Oldham Athletic,Bolton Wanderers,0-0,0,0,1,1,0,0,D
1921-01-15,1920,Preston North End,Derby County,2-1,2,1,1,1,3,1,H
1921-01-15,1920,Sheffield United,Middlesbrough,1-1,1,1,1,1,2,0,D
1921-01-15,1920,Tottenham Hotspur,Arsenal,2-1,2,1,1,1,3,1,H
1921-01-22,1920,Arsenal,Tottenham Hotspur,3-2,3,2,1,1,5,1,H
1921-01-22,1920,Blackburn Rovers,Burnley,1-3,1,3,1,1,4,-2,A
1921-01-22,1920,Bolton Wanderers,Oldham Athletic,1-1,1,1,1,1,2,0,D
1921-01-22,1920,Bradford City,Newcastle United,1-1,1,1,1,1,2,0,D
1921-01-22,1920,Derby County,Preston North End,1-1,1,1,1,1,2,0,D
1921-01-22,1920,Everton,Aston Villa,1-1,1,1,1,1,2,0,D
1921-01-22,1920,Huddersfield Town,Bradford Park Avenue,0-0,0,0,1,1,0,0,D
1921-01-22,1920,Manchester City,Chelsea,1-0,1,0,1,1,1,1,H
1921-01-22,1920,Middlesbrough,Sheffield United,2-2,2,2,1,1,4,0,D
1921-01-22,1920,Sunderland,Liverpool,2-1,2,1,1,1,3,1,H
1921-01-22,1920,West Bromwich Albion,Manchester United,0-2,0,2,1,1,2,-2,A
1921-01-29,1920,Arsenal,Sunderland,1-2,1,2,1,1,3,-1,A
1921-01-29,1920,Middlesbrough,West Bromwich Albion,0-1,0,1,1,1,1,-1,A
1921-02-03,1920,Tottenham Hotspur,Bradford Park Avenue,2-0,2,0,1,1,2,2,H
1921-02-05,1920,Bolton Wanderers,Bradford City,1-1,1,1,1,1,2,0,D
1921-02-05,1920,Bradford Park Avenue,Tottenham Hotspur,1-1,1,1,1,1,2,0,D
1921-02-05,1920,Burnley,Aston Villa,7-1,7,1,1,1,8,6,H
1921-02-05,1920,Chelsea,Newcastle United,2-0,2,0,1,1,2,2,H
1921-02-05,1920,Derby County,Oldham Athletic,3-3,3,3,1,1,6,0,D
1921-02-05,1920,Everton,Manchester City,3-0,3,0,1,1,3,3,H
1921-02-05,1920,Huddersfield Town,Blackburn Rovers,0-0,0,0,1,1,0,0,D
1921-02-05,1920,Manchester United,Liverpool,1-1,1,1,1,1,2,0,D
1921-02-05,1920,Sheffield United,Preston North End,1-0,1,0,1,1,1,1,H
1921-02-05,1920,Sunderland,Arsenal,5-1,5,1,1,1,6,4,H
1921-02-05,1920,West Bromwich Albion,Middlesbrough,0-1,0,1,1,1,1,-1,A
1921-02-07,1920,Preston North End,Sheffield United,2-0,2,0,1,1,2,2,H
1921-02-09,1920,Aston Villa,Burnley,0-0,0,0,1,1,0,0,D
1921-02-09,1920,Bradford City,West Bromwich Albion,1-1,1,1,1,1,2,0,D
1921-02-09,1920,Liverpool,Manchester United,2-0,2,0,1,1,2,2,H
1921-02-09,1920,Newcastle United,Chelsea,1-0,1,0,1,1,1,1,H
1921-02-10,1920,Blackburn Rovers,Huddersfield Town,1-2,1,2,1,1,3,-1,A
1921-02-12,1920,Aston Villa,Sunderland,1-5,1,5,1,1,6,-4,A
1921-02-12,1920,Bradford Park Avenue,Middlesbrough,3-0,3,0,1,1,3,3,H
1921-02-12,1920,Burnley,Derby County,2-1,2,1,1,1,3,1,H
1921-02-12,1920,Chelsea,West Bromwich Albion,3-0,3,0,1,1,3,3,H
1921-02-12,1920,Liverpool,Bradford City,2-1,2,1,1,1,3,1,H
1921-02-12,1920,Manchester United,Everton,1-2,1,2,1,1,3,-1,A
1921-02-12,1920,Newcastle United,Huddersfield Town,1-0,1,0,1,1,1,1,H
1921-02-12,1920,Oldham Athletic,Arsenal,1-1,1,1,1,1,2,0,D
1921-02-12,1920,Preston North End,Bolton Wanderers,1-2,1,2,1,1,3,-1,A
1921-02-12,1920,Sheffield United,Blackburn Rovers,1-1,1,1,1,1,2,0,D
1921-02-12,1920,Tottenham Hotspur,Manchester City,2-0,2,0,1,1,2,2,H
1921-02-14,1920,Oldham Athletic,Derby County,2-1,2,1,1,1,3,1,H
1921-02-16,1920,Bradford City,Bolton Wanderers,2-2,2,2,1,1,4,0,D
1921-02-19,1920,Arsenal,Oldham Athletic,2-2,2,2,1,1,4,0,D
1921-02-19,1920,Blackburn Rovers,Sheffield United,1-1,1,1,1,1,2,0,D
1921-02-19,1920,Bradford City,Liverpool,0-0,0,0,1,1,0,0,D
1921-02-19,1920,Middlesbrough,Bradford Park Avenue,2-1,2,1,1,1,3,1,H
1921-02-23,1920,Derby County,Burnley,0-0,0,0,1,1,0,0,D
1921-02-23,1920,Huddersfield Town,Newcastle United,1-3,1,3,1,1,4,-2,A
1921-02-23,1920,Manchester City,Everton,2-0,2,0,1,1,2,2,H
1921-02-23,1920,Sunderland,Aston Villa,0-1,0,1,1,1,1,-1,A
1921-02-23,1920,West Bromwich Albion,Tottenham Hotspur,3-1,3,1,1,1,4,2,H
1921-02-26,1920,Aston Villa,Bradford City,1-2,1,2,1,1,3,-1,A
1921-02-26,1920,Bradford Park Avenue,Blackburn Rovers,1-1,1,1,1,1,2,0,D
1921-02-26,1920,Burnley,Bolton Wanderers,3-1,3,1,1,1,4,2,H
1921-02-26,1920,Chelsea,Everton,0-1,0,1,1,1,1,-1,A
1921-02-26,1920,Liverpool,Huddersfield Town,4-1,4,1,1,1,5,3,H
1921-02-26,1920,Manchester United,Sunderland,3-0,3,0,1,1,3,3,H
1921-02-26,1920,Newcastle United,Middlesbrough,2-0,2,0,1,1,2,2,H
1921-02-26,1920,Oldham Athletic,Manchester City,2-0,2,0,1,1,2,2,H
1921-02-26,1920,Preston North End,Arsenal,0-1,0,1,1,1,1,-1,A
1921-02-26,1920,Sheffield United,Derby County,0-1,0,1,1,1,1,-1,A
1921-02-26,1920,Tottenham Hotspur,West Bromwich Albion,1-0,1,0,1,1,1,1,H
1921-03-05,1920,Blackburn Rovers,Bradford Park Avenue,1-0,1,0,1,1,1,1,H
1921-03-05,1920,Bolton Wanderers,Burnley,1-1,1,1,1,1,2,0,D
1921-03-05,1920,Derby County,Sheffield United,1-1,1,1,1,1,2,0,D
1921-03-05,1920,Huddersfield Town,Liverpool,1-2,1,2,1,1,3,-1,A
1921-03-05,1920,Manchester City,Oldham Athletic,3-1,3,1,1,1,4,2,H
1921-03-05,1920,Middlesbrough,Newcastle United,0-0,0,0,1,1,0,0,D
1921-03-05,1920,Sunderland,Manchester United,2-3,2,3,1,1,5,-1,A
1921-03-07,1920,Bradford City,Aston Villa,3-0,3,0,1,1,3,3,H
1921-03-09,1920,Everton,Manchester United,2-0,2,0,1,1,2,2,H
1921-03-09,1920,Manchester City,Tottenham Hotspur,2-0,2,0,1,1,2,2,H
1921-03-12,1920,Aston Villa,Huddersfield Town,0-0,0,0,1,1,0,0,D
1921-03-12,1920,Bradford Park Avenue,Derby County,2-1,2,1,1,1,3,1,H
1921-03-12,1920,Burnley,Arsenal,1-0,1,0,1,1,1,1,H
1921-03-12,1920,Chelsea,Sunderland,3-1,3,1,1,1,4,2,H
1921-03-12,1920,Liverpool,Middlesbrough,0-0,0,0,1,1,0,0,D
1921-03-12,1920,Manchester United,Bradford City,1-1,1,1,1,1,2,0,D
1921-03-12,1920,Newcastle United,Blackburn Rovers,1-2,1,2,1,1,3,-1,A
1921-03-12,1920,Oldham Athletic,West Bromwich Albion,0-3,0,3,1,1,3,-3,A
1921-03-12,1920,Preston North End,Manchester City,0-1,0,1,1,1,1,-1,A
1921-03-12,1920,Sheffield United,Bolton Wanderers,2-2,2,2,1,1,4,0,D
1921-03-12,1920,Tottenham Hotspur,Everton,2-0,2,0,1,1,2,2,H
1921-03-14,1920,West Bromwich Albion,Chelsea,1-1,1,1,1,1,2,0,D
1921-03-19,1920,Arsenal,Burnley,1-1,1,1,1,1,2,0,D
1921-03-19,1920,Blackburn Rovers,Newcastle United,3-3,3,3,1,1,6,0,D
1921-03-19,1920,Bolton Wanderers,Sheffield United,2-2,2,2,1,1,4,0,D
1921-03-19,1920,Bradford City,Manchester United,1-1,1,1,1,1,2,0,D
1921-03-19,1920,Derby County,Bradford Park Avenue,1-0,1,0,1,1,1,1,H
1921-03-19,1920,Huddersfield Town,Aston Villa,1-0,1,0,1,1,1,1,H
1921-03-19,1920,Middlesbrough,Liverpool,0-1,0,1,1,1,1,-1,A
1921-03-19,1920,Sunderland,Chelsea,1-0,1,0,1,1,1,1,H
1921-03-19,1920,West Bromwich Albion,Oldham Athletic,0-0,0,0,1,1,0,0,D
1921-03-25,1920,Blackburn Rovers,Bradford City,2-3,2,3,1,1,5,-1,A
1921-03-25,1920,Bolton Wanderers,Everton,4-2,4,2,1,1,6,2,H
1921-03-25,1920,Burnley,Manchester United,1-0,1,0,1,1,1,1,H
1921-03-25,1920,Liverpool,Tottenham Hotspur,1-1,1,1,1,1,2,0,D
1921-03-25,1920,Manchester City,Middlesbrough,2-1,2,1,1,1,3,1,H
1921-03-25,1920,Newcastle United,Oldham Athletic,1-2,1,2,1,1,3,-1,A
1921-03-25,1920,Preston North End,Bradford Park Avenue,3-3,3,3,1,1,6,0,D
1921-03-25,1920,Sunderland,Derby County,3-0,3,0,1,1,3,3,H
1921-03-26,1920,Arsenal,Sheffield United,2-6,2,6,1,1,8,-4,A
1921-03-26,1920,Blackburn Rovers,Liverpool,1-1,1,1,1,1,2,0,D
1921-03-26,1920,Bolton Wanderers,Bradford Park Avenue,2-0,2,0,1,1,2,2,H
1921-03-26,1920,Bradford City,Chelsea,1-1,1,1,1,1,2,0,D
1921-03-26,1920,Derby County,Newcastle United,0-1,0,1,1,1,1,-1,A
1921-03-26,1920,Everton,Oldham Athletic,5-2,5,2,1,1,7,3,H
1921-03-26,1920,Huddersfield Town,Manchester United,5-2,5,2,1,1,7,3,H
1921-03-26,1920,Manchester City,Burnley,3-0,3,0,1,1,3,3,H
1921-03-26,1920,Middlesbrough,Aston Villa,1-4,1,4,1,1,5,-3,A
1921-03-26,1920,Sunderland,Tottenham Hotspur,0-1,0,1,1,1,1,-1,A
1921-03-26,1920,West Bromwich Albion,Preston North End,0-3,0,3,1,1,3,-3,A
1921-03-28,1920,Arsenal,West Bromwich Albion,2-1,2,1,1,1,3,1,H
1921-03-28,1920,Aston Villa,Chelsea,3-0,3,0,1,1,3,3,H
1921-03-28,1920,Bradford Park Avenue,Preston North End,1-3,1,3,1,1,4,-2,A
1921-03-28,1920,Derby County,Sunderland,0-1,0,1,1,1,1,-1,A
1921-03-28,1920,Everton,Bolton Wanderers,2-3,2,3,1,1,5,-1,A
1921-03-28,1920,Manchester United,Burnley,0-3,0,3,1,1,3,-3,A
1921-03-28,1920,Middlesbrough,Manchester City,3-1,3,1,1,1,4,2,H
1921-03-28,1920,Oldham Athletic,Newcastle United,0-0,0,0,1,1,0,0,D
1921-03-28,1920,Tottenham Hotspur,Liverpool,1-0,1,0,1,1,1,1,H
1921-03-29,1920,Bradford City,Blackburn Rovers,3-4,3,4,1,1,7,-1,A
1921-03-29,1920,Chelsea,Aston Villa,5-1,5,1,1,1,6,4,H
1921-03-29,1920,Huddersfield Town,Sheffield United,1-0,1,0,1,1,1,1,H
1921-03-29,1920,West Bromwich Albion,Arsenal,3-4,3,4,1,1,7,-1,A
1921-04-02,1920,Aston Villa,Middlesbrough,0-1,0,1,1,1,1,-1,A
1921-04-02,1920,Bradford Park Avenue,Bolton Wanderers,2-1,2,1,1,1,3,1,H
1921-04-02,1920,Burnley,Manchester City,2-1,2,1,1,1,3,1,H
1921-04-02,1920,Chelsea,Bradford City,3-1,3,1,1,1,4,2,H
1921-04-02,1920,Liverpool,Blackburn Rovers,2-0,2,0,1,1,2,2,H
1921-04-02,1920,Manchester United,Huddersfield Town,2-0,2,0,1,1,2,2,H
1921-04-02,1920,Newcastle United,Derby County,0-1,0,1,1,1,1,-1,A
1921-04-02,1920,Oldham Athletic,Everton,0-1,0,1,1,1,1,-1,A
1921-04-02,1920,Preston North End,West Bromwich Albion,2-1,2,1,1,1,3,1,H
1921-04-02,1920,Sheffield United,Arsenal,1-1,1,1,1,1,2,0,D
1921-04-02,1920,Tottenham Hotspur,Sunderland,0-0,0,0,1,1,0,0,D
1921-04-04,1920,Bolton Wanderers,Preston North End,3-0,3,0,1,1,3,3,H
1921-04-06,1920,Everton,Chelsea,5-1,5,1,1,1,6,4,H
1921-04-09,1920,Arsenal,Bradford Park Avenue,2-1,2,1,1,1,3,1,H
1921-04-09,1920,Blackburn Rovers,Aston Villa,0-1,0,1,1,1,1,-1,A
1921-04-09,1920,Bolton Wanderers,Newcastle United,3-1,3,1,1,1,4,2,H
1921-04-09,1920,Bradford City,Tottenham Hotspur,1-0,1,0,1,1,1,1,H
1921-04-09,1920,Derby County,Liverpool,0-0,0,0,1,1,0,0,D
1921-04-09,1920,Everton,Preston North End,0-1,0,1,1,1,1,-1,A
1921-04-09,1920,Huddersfield Town,Chelsea,2-0,2,0,1,1,2,2,H
1921-04-09,1920,Manchester City,Sheffield United,2-1,2,1,1,1,3,1,H
1921-04-09,1920,Middlesbrough,Manchester United,2-4,2,4,1,1,6,-2,A
1921-04-09,1920,Sunderland,Oldham Athletic,1-1,1,1,1,1,2,0,D
1921-04-09,1920,West Bromwich Albion,Burnley,2-0,2,0,1,1,2,2,H
1921-04-16,1920,Aston Villa,Blackburn Rovers,3-0,3,0,1,1,3,3,H
1921-04-16,1920,Bradford Park Avenue,Arsenal,0-1,0,1,1,1,1,-1,A
1921-04-16,1920,Burnley,West Bromwich Albion,1-1,1,1,1,1,2,0,D
1921-04-16,1920,Chelsea,Huddersfield Town,1-1,1,1,1,1,2,0,D
1921-04-16,1920,Liverpool,Derby County,1-1,1,1,1,1,2,0,D
1921-04-16,1920,Manchester United,Middlesbrough,0-1,0,1,1,1,1,-1,A
1921-04-16,1920,Newcastle United,Bolton Wanderers,1-0,1,0,1,1,1,1,H
1921-04-16,1920,Oldham Athletic,Sunderland,2-1,2,1,1,1,3,1,H
1921-04-16,1920,Preston North End,Everton,1-0,1,0,1,1,1,1,H
1921-04-16,1920,Sheffield United,Manchester City,1-1,1,1,1,1,2,0,D
1921-04-16,1920,Tottenham Hotspur,Bradford City,2-0,2,0,1,1,2,2,H
1921-04-20,1920,Manchester City,Preston North End,5-1,5,1,1,1,6,4,H
1921-04-23,1920,Arsenal,Newcastle United,1-1,1,1,1,1,2,0,D
1921-04-23,1920,Blackburn Rovers,Manchester United,2-0,2,0,1,1,2,2,H
1921-04-23,1920,Bolton Wanderers,Liverpool,1-0,1,0,1,1,1,1,H
1921-04-23,1920,Bradford City,Oldham Athletic,1-3,1,3,1,1,4,-2,A
1921-04-23,1920,Derby County,Aston Villa,2-3,2,3,1,1,5,-1,A
1921-04-23,1920,Everton,Burnley,1-1,1,1,1,1,2,0,D
1921-04-23,1920,Manchester City,Bradford Park Avenue,1-0,1,0,1,1,1,1,H
1921-04-23,1920,Middlesbrough,Chelsea,0-0,0,0,1,1,0,0,D
1921-04-23,1920,Sunderland,Preston North End,2-2,2,2,1,1,4,0,D
1921-04-23,1920,West Bromwich Albion,Sheffield United,1-1,1,1,1,1,2,0,D
1921-04-25,1920,Arsenal,Preston North End,2-1,2,1,1,1,3,1,H
1921-04-25,1920,Huddersfield Town,Tottenham Hotspur,2-0,2,0,1,1,2,2,H
1921-04-27,1920,Everton,Tottenham Hotspur,0-0,0,0,1,1,0,0,D
1921-04-30,1920,Aston Villa,Derby County,1-0,1,0,1,1,1,1,H
1921-04-30,1920,Bradford Park Avenue,Manchester City,1-2,1,2,1,1,3,-1,A
1921-04-30,1920,Burnley,Everton,1-1,1,1,1,1,2,0,D
1921-04-30,1920,Chelsea,Middlesbrough,1-1,1,1,1,1,2,0,D
1921-04-30,1920,Liverpool,Bolton Wanderers,2-3,2,3,1,1,5,-1,A
1921-04-30,1920,Manchester United,Blackburn Rovers,0-1,0,1,1,1,1,-1,A
1921-04-30,1920,Newcastle United,Arsenal,1-0,1,0,1,1,1,1,H
1921-04-30,1920,Oldham Athletic,Bradford City,2-0,2,0,1,1,2,2,H
1921-04-30,1920,Preston North End,Sunderland,1-1,1,1,1,1,2,0,D
1921-04-30,1920,Sheffield United,West Bromwich Albion,0-2,0,2,1,1,2,-2,A
1921-04-30,1920,Tottenham Hotspur,Huddersfield Town,1-0,1,0,1,1,1,1,H
1921-05-02,1920,Arsenal,Liverpool,0-0,0,0,1,1,0,0,D
1921-05-02,1920,Blackburn Rovers,Chelsea,0-0,0,0,1,1,0,0,D
1921-05-02,1920,Bradford City,Preston North End,6-2,6,2,1,1,8,4,H
1921-05-02,1920,Derby County,Manchester United,1-1,1,1,1,1,2,0,D
1921-05-02,1920,Huddersfield Town,Oldham Athletic,3-1,3,1,1,1,4,2,H
1921-05-02,1920,Manchester City,Newcastle United,3-1,3,1,1,1,4,2,H
1921-05-02,1920,Middlesbrough,Tottenham Hotspur,1-0,1,0,1,1,1,1,H
1921-05-02,1920,Sunderland,Burnley,1-0,1,0,1,1,1,1,H
1921-05-02,1920,West Bromwich Albion,Bradford Park Avenue,0-1,0,1,1,1,1,-1,A
1921-05-07,1920,Aston Villa,Bolton Wanderers,2-0,2,0,1,1,2,2,H
1921-05-07,1920,Bradford Park Avenue,West Bromwich Albion,0-3,0,3,1,1,3,-3,A
1921-05-07,1920,Burnley,Sunderland,2-2,2,2,1,1,4,0,D
1921-05-07,1920,Chelsea,Blackburn Rovers,1-2,1,2,1,1,3,-1,A
1921-05-07,1920,Liverpool,Arsenal,3-0,3,0,1,1,3,3,H
1921-05-07,1920,Manchester United,Derby County,3-0,3,0,1,1,3,3,H
1921-05-07,1920,Newcastle United,Manchester City,1-1,1,1,1,1,2,0,D
1921-05-07,1920,Oldham Athletic,Huddersfield Town,1-2,1,2,1,1,3,-1,A
1921-05-07,1920,Preston North End,Bradford City,1-1,1,1,1,1,2,0,D
1921-05-07,1920,Tottenham Hotspur,Middlesbrough,2-2,2,2,1,1,4,0,D
1921-08-27,1921,Arsenal,Sheffield United,1-2,1,2,1,1,3,-1,A
1921-08-27,1921,Birmingham City,Burnley,2-3,2,3,1,1,5,-1,A
1921-08-27,1921,Blackburn Rovers,Chelsea,1-1,1,1,1,1,2,0,D
1921-08-27,1921,Bolton Wanderers,Preston North End,2-2,2,2,1,1,4,0,D
1921-08-27,1921,Cardiff City,Tottenham Hotspur,0-1,0,1,1,1,1,-1,A
1921-08-27,1921,Everton,Manchester United,5-0,5,0,1,1,5,5,H
1921-08-27,1921,Huddersfield Town,Newcastle United,1-2,1,2,1,1,3,-1,A
1921-08-27,1921,Manchester City,Aston Villa,2-1,2,1,1,1,3,1,H
1921-08-27,1921,Oldham Athletic,Bradford City,0-0,0,0,1,1,0,0,D
1921-08-27,1921,Sunderland,Liverpool,3-0,3,0,1,1,3,3,H
1921-08-27,1921,West Bromwich Albion,Middlesbrough,0-0,0,0,1,1,0,0,D
1921-08-29,1921,Aston Villa,Cardiff City,2-1,2,1,1,1,3,1,H
1921-08-29,1921,Bradford City,Blackburn Rovers,1-1,1,1,1,1,2,0,D
1921-08-29,1921,Chelsea,Birmingham City,1-2,1,2,1,1,3,-1,A
1921-08-29,1921,Manchester United,West Bromwich Albion,2-3,2,3,1,1,5,-1,A
1921-08-29,1921,Middlesbrough,Oldham Athletic,1-1,1,1,1,1,2,0,D
1921-08-29,1921,Preston North End,Arsenal,3-2,3,2,1,1,5,1,H
1921-08-29,1921,Sheffield United,Huddersfield Town,1-1,1,1,1,1,2,0,D
1921-08-29,1921,Tottenham Hotspur,Bolton Wanderers,1-2,1,2,1,1,3,-1,A
1921-08-31,1921,Liverpool,Manchester City,3-2,3,2,1,1,5,1,H
1921-08-31,1921,Newcastle United,Everton,3-0,3,0,1,1,3,3,H
1921-08-31,1921,Sunderland,Burnley,3-2,3,2,1,1,5,1,H
1921-09-03,1921,Aston Villa,Manchester City,4-0,4,0,1,1,4,4,H
1921-09-03,1921,Bradford City,Oldham Athletic,3-0,3,0,1,1,3,3,H
1921-09-03,1921,Burnley,Birmingham City,3-1,3,1,1,1,4,2,H
1921-09-03,1921,Chelsea,Blackburn Rovers,1-0,1,0,1,1,1,1,H
1921-09-03,1921,Liverpool,Sunderland,2-1,2,1,1,1,3,1,H
1921-09-03,1921,Manchester United,Everton,2-1,2,1,1,1,3,1,H
1921-09-03,1921,Middlesbrough,West Bromwich Albion,3-2,3,2,1,1,5,1,H
1921-09-03,1921,Newcastle United,Huddersfield Town,1-2,1,2,1,1,3,-1,A
1921-09-03,1921,Preston North End,Bolton Wanderers,3-1,3,1,1,1,4,2,H
1921-09-03,1921,Sheffield United,Arsenal,4-1,4,1,1,1,5,3,H
1921-09-03,1921,Tottenham Hotspur,Cardiff City,4-1,4,1,1,1,5,3,H
1921-09-05,1921,Arsenal,Preston North End,1-0,1,0,1,1,1,1,H
1921-09-05,1921,Birmingham City,Chelsea,5-1,5,1,1,1,6,4,H
1921-09-05,1921,Bolton Wanderers,Tottenham Hotspur,1-0,1,0,1,1,1,1,H
1921-09-05,1921,Burnley,Sunderland,2-0,2,0,1,1,2,2,H
1921-09-05,1921,Cardiff City,Aston Villa,0-4,0,4,1,1,4,-4,A
1921-09-05,1921,Oldham Athletic,Middlesbrough,0-1,0,1,1,1,1,-1,A
1921-09-06,1921,Huddersfield Town,Sheffield United,1-1,1,1,1,1,2,0,D
1921-09-07,1921,Everton,Newcastle United,2-3,2,3,1,1,5,-1,A
1921-09-07,1921,Manchester City,Liverpool,1-1,1,1,1,1,2,0,D
1921-09-07,1921,West Bromwich Albion,Manchester United,0-0,0,0,1,1,0,0,D
1921-09-10,1921,Bolton Wanderers,Bradford City,3-3,3,3,1,1,6,0,D
1921-09-10,1921,Burnley,Newcastle United,2-0,2,0,1,1,2,2,H
1921-09-10,1921,Cardiff City,Oldham Athletic,0-1,0,1,1,1,1,-1,A
1921-09-10,1921,Chelsea,Manchester United,0-0,0,0,1,1,0,0,D
1921-09-10,1921,Everton,Birmingham City,2-1,2,1,1,1,3,1,H
1921-09-10,1921,Manchester City,Arsenal,2-0,2,0,1,1,2,2,H
1921-09-10,1921,Preston North End,Aston Villa,1-0,1,0,1,1,1,1,H
1921-09-10,1921,Sheffield United,Liverpool,0-1,0,1,1,1,1,-1,A
1921-09-10,1921,Sunderland,Huddersfield Town,2-2,2,2,1,1,4,0,D
1921-09-10,1921,Tottenham Hotspur,Middlesbrough,2-4,2,4,1,1,6,-2,A
1921-09-10,1921,West Bromwich Albion,Blackburn Rovers,0-2,0,2,1,1,2,-2,A
1921-09-12,1921,Aston Villa,Blackburn Rovers,1-1,1,1,1,1,2,0,D
1921-09-17,1921,Arsenal,Manchester City,0-1,0,1,1,1,1,-1,A
1921-09-17,1921,Aston Villa,Preston North End,2-0,2,0,1,1,2,2,H
1921-09-17,1921,Birmingham City,Everton,1-1,1,1,1,1,2,0,D
1921-09-17,1921,Blackburn Rovers,West Bromwich Albion,2-3,2,3,1,1,5,-1,A
1921-09-17,1921,Bradford City,Bolton Wanderers,4-3,4,3,1,1,7,1,H
1921-09-17,1921,Huddersfield Town,Sunderland,1-2,1,2,1,1,3,-1,A
1921-09-17,1921,Liverpool,Sheffield United,1-1,1,1,1,1,2,0,D
1921-09-17,1921,Manchester United,Chelsea,0-0,0,0,1,1,0,0,D
1921-09-17,1921,Middlesbrough,Tottenham Hotspur,0-0,0,0,1,1,0,0,D
1921-09-17,1921,Newcastle United,Burnley,2-1,2,1,1,1,3,1,H
1921-09-17,1921,Oldham Athletic,Cardiff City,2-1,2,1,1,1,3,1,H
1921-09-19,1921,Blackburn Rovers,Bradford City,3-1,3,1,1,1,4,2,H
1921-09-24,1921,Bolton Wanderers,Huddersfield Town,3-1,3,1,1,1,4,2,H
1921-09-24,1921,Burnley,Bradford City,4-0,4,0,1,1,4,4,H
1921-09-24,1921,Cardiff City,Middlesbrough,3-1,3,1,1,1,4,2,H
1921-09-24,1921,Chelsea,Liverpool,0-1,0,1,1,1,1,-1,A
1921-09-24,1921,Everton,Arsenal,1-1,1,1,1,1,2,0,D
1921-09-24,1921,Manchester City,Blackburn Rovers,1-1,1,1,1,1,2,0,D
1921-09-24,1921,Preston North End,Manchester United,3-2,3,2,1,1,5,1,H
1921-09-24,1921,Sheffield United,Newcastle United,1-1,1,1,1,1,2,0,D
1921-09-24,1921,Sunderland,Birmingham City,2-1,2,1,1,1,3,1,H
1921-09-24,1921,Tottenham Hotspur,Aston Villa,3-1,3,1,1,1,4,2,H
1921-09-24,1921,West Bromwich Albion,Oldham Athletic,0-1,0,1,1,1,1,-1,A
1921-10-01,1921,Arsenal,Everton,1-0,1,0,1,1,1,1,H
1921-10-01,1921,Aston Villa,Tottenham Hotspur,2-1,2,1,1,1,3,1,H
1921-10-01,1921,Birmingham City,Sunderland,1-0,1,0,1,1,1,1,H
1921-10-01,1921,Blackburn Rovers,Manchester City,3-1,3,1,1,1,4,2,H
1921-10-01,1921,Bradford City,Burnley,0-4,0,4,1,1,4,-4,A
1921-10-01,1921,Huddersfield Town,Bolton Wanderers,3-0,3,0,1,1,3,3,H
1921-10-01,1921,Liverpool,Chelsea,1-1,1,1,1,1,2,0,D
1921-10-01,1921,Manchester United,Preston North End,1-1,1,1,1,1,2,0,D
1921-10-01,1921,Middlesbrough,Cardiff City,0-0,0,0,1,1,0,0,D
1921-10-01,1921,Newcastle United,Sheffield United,2-1,2,1,1,1,3,1,H
1921-10-01,1921,Oldham Athletic,West Bromwich Albion,1-0,1,0,1,1,1,1,H
1921-10-08,1921,Birmingham City,Huddersfield Town,0-2,0,2,1,1,2,-2,A
1921-10-08,1921,Bradford City,Middlesbrough,0-2,0,2,1,1,2,-2,A
1921-10-08,1921,Burnley,Sheffield United,2-1,2,1,1,1,3,1,H
1921-10-08,1921,Cardiff City,Bolton Wanderers,1-2,1,2,1,1,3,-1,A
1921-10-08,1921,Chelsea,Newcastle United,1-1,1,1,1,1,2,0,D
1921-10-08,1921,Everton,Blackburn Rovers,2-0,2,0,1,1,2,2,H
1921-10-08,1921,Manchester City,Oldham Athletic,2-1,2,1,1,1,3,1,H
1921-10-08,1921,Preston North End,Liverpool,1-1,1,1,1,1,2,0,D
1921-10-08,1921,Sunderland,Arsenal,1-0,1,0,1,1,1,1,H
1921-10-08,1921,Tottenham Hotspur,Manchester United,2-2,2,2,1,1,4,0,D
1921-10-08,1921,West Bromwich Albion,Aston Villa,0-1,0,1,1,1,1,-1,A
1921-10-15,1921,Arsenal,Sunderland,1-2,1,2,1,1,3,-1,A
1921-10-15,1921,Aston Villa,West Bromwich Albion,0-1,0,1,1,1,1,-1,A
1921-10-15,1921,Blackburn Rovers,Everton,2-2,2,2,1,1,4,0,D
1921-10-15,1921,Bolton Wanderers,Cardiff City,1-2,1,2,1,1,3,-1,A
1921-10-15,1921,Huddersfield Town,Birmingham City,1-0,1,0,1,1,1,1,H
1921-10-15,1921,Liverpool,Preston North End,4-0,4,0,1,1,4,4,H
1921-10-15,1921,Manchester United,Tottenham Hotspur,2-1,2,1,1,1,3,1,H
1921-10-15,1921,Middlesbrough,Bradford City,1-2,1,2,1,1,3,-1,A
1921-10-15,1921,Newcastle United,Chelsea,1-0,1,0,1,1,1,1,H
1921-10-15,1921,Oldham Athletic,Manchester City,0-1,0,1,1,1,1,-1,A
1921-10-15,1921,Sheffield United,Burnley,0-1,0,1,1,1,1,-1,A
1921-10-22,1921,Birmingham City,Bolton Wanderers,1-1,1,1,1,1,2,0,D
1921-10-22,1921,Bradford City,Sheffield United,1-1,1,1,1,1,2,0,D
1921-10-22,1921,Burnley,Chelsea,5-0,5,0,1,1,5,5,H
1921-10-22,1921,Everton,Oldham Athletic,2-2,2,2,1,1,4,0,D
1921-10-22,1921,Huddersfield Town,Arsenal,2-0,2,0,1,1,2,2,H
1921-10-22,1921,Manchester City,Manchester United,4-1,4,1,1,1,5,3,H
1921-10-22,1921,Middlesbrough,Aston Villa,5-0,5,0,1,1,5,5,H
1921-10-22,1921,Preston North End,Newcastle United,2-0,2,0,1,1,2,2,H
1921-10-22,1921,Sunderland,Blackburn Rovers,3-1,3,1,1,1,4,2,H
1921-10-22,1921,Tottenham Hotspur,Liverpool,0-1,0,1,1,1,1,-1,A
1921-10-22,1921,West Bromwich Albion,Cardiff City,2-2,2,2,1,1,4,0,D
1921-10-29,1921,Arsenal,Huddersfield Town,1-3,1,3,1,1,4,-2,A
1921-10-29,1921,Aston Villa,Middlesbrough,6-2,6,2,1,1,8,4,H
1921-10-29,1921,Blackburn Rovers,Sunderland,1-2,1,2,1,1,3,-1,A
1921-10-29,1921,Bolton Wanderers,Birmingham City,1-2,1,2,1,1,3,-1,A
1921-10-29,1921,Cardiff City,West Bromwich Albion,2-0,2,0,1,1,2,2,H
1921-10-29,1921,Chelsea,Burnley,4-1,4,1,1,1,5,3,H
1921-10-29,1921,Liverpool,Tottenham Hotspur,1-1,1,1,1,1,2,0,D
1921-10-29,1921,Manchester United,Manchester City,3-1,3,1,1,1,4,2,H
1921-10-29,1921,Newcastle United,Preston North End,3-1,3,1,1,1,4,2,H
1921-10-29,1921,Oldham Athletic,Everton,0-0,0,0,1,1,0,0,D
1921-10-29,1921,Sheffield United,Bradford City,1-0,1,0,1,1,1,1,H
1921-11-05,1921,Birmingham City,Arsenal,0-1,0,1,1,1,1,-1,A
1921-11-05,1921,Bradford City,Aston Villa,3-2,3,2,1,1,5,1,H
1921-11-05,1921,Burnley,Preston North End,3-3,3,3,1,1,6,0,D
1921-11-05,1921,Cardiff City,Manchester City,0-2,0,2,1,1,2,-2,A
1921-11-05,1921,Chelsea,Sheffield United,0-2,0,2,1,1,2,-2,A
1921-11-05,1921,Everton,Liverpool,1-1,1,1,1,1,2,0,D
1921-11-05,1921,Huddersfield Town,Blackburn Rovers,3-0,3,0,1,1,3,3,H
1921-11-05,1921,Manchester United,Middlesbrough,3-5,3,5,1,1,8,-2,A
1921-11-05,1921,Sunderland,Oldham Athletic,5-1,5,1,1,1,6,4,H
1921-11-05,1921,Tottenham Hotspur,Newcastle United,4-0,4,0,1,1,4,4,H
1921-11-05,1921,West Bromwich Albion,Bolton Wanderers,0-1,0,1,1,1,1,-1,A
1921-11-12,1921,Arsenal,Birmingham City,5-2,5,2,1,1,7,3,H
1921-11-12,1921,Aston Villa,Bradford City,7-1,7,1,1,1,8,6,H
1921-11-12,1921,Blackburn Rovers,Huddersfield Town,2-0,2,0,1,1,2,2,H
1921-11-12,1921,Bolton Wanderers,West Bromwich Albion,2-0,2,0,1,1,2,2,H
1921-11-12,1921,Liverpool,Everton,1-1,1,1,1,1,2,0,D
1921-11-12,1921,Manchester City,Cardiff City,1-1,1,1,1,1,2,0,D
1921-11-12,1921,Middlesbrough,Manchester United,2-0,2,0,1,1,2,2,H
1921-11-12,1921,Newcastle United,Tottenham Hotspur,0-2,0,2,1,1,2,-2,A
1921-11-12,1921,Oldham Athletic,Sunderland,3-0,3,0,1,1,3,3,H
1921-11-12,1921,Preston North End,Burnley,2-1,2,1,1,1,3,1,H
1921-11-12,1921,Sheffield United,Chelsea,1-2,1,2,1,1,3,-1,A
1921-11-19,1921,Aston Villa,Manchester United,3-1,3,1,1,1,4,2,H
1921-11-19,1921,Blackburn Rovers,Birmingham City,1-1,1,1,1,1,2,0,D
1921-11-19,1921,Bolton Wanderers,Arsenal,1-0,1,0,1,1,1,1,H
1921-11-19,1921,Cardiff City,Everton,2-1,2,1,1,1,3,1,H
1921-11-19,1921,Chelsea,Bradford City,1-0,1,0,1,1,1,1,H
1921-11-19,1921,Liverpool,Middlesbrough,4-0,4,0,1,1,4,4,H
1921-11-19,1921,Manchester City,West Bromwich Albion,6-1,6,1,1,1,7,5,H
1921-11-19,1921,Newcastle United,Sunderland,2-2,2,2,1,1,4,0,D
1921-11-19,1921,Oldham Athletic,Huddersfield Town,1-1,1,1,1,1,2,0,D
1921-11-19,1921,Sheffield United,Preston North End,3-0,3,0,1,1,3,3,H
1921-11-19,1921,Tottenham Hotspur,Burnley,1-1,1,1,1,1,2,0,D
1921-11-26,1921,Birmingham City,Blackburn Rovers,1-0,1,0,1,1,1,1,H
1921-11-26,1921,Bradford City,Chelsea,0-1,0,1,1,1,1,-1,A
1921-11-26,1921,Burnley,Tottenham Hotspur,1-0,1,0,1,1,1,1,H
1921-11-26,1921,Everton,Cardiff City,0-1,0,1,1,1,1,-1,A
1921-11-26,1921,Huddersfield Town,Oldham Athletic,1-0,1,0,1,1,1,1,H
1921-11-26,1921,Manchester United,Aston Villa,1-0,1,0,1,1,1,1,H
1921-11-26,1921,Middlesbrough,Liverpool,3-1,3,1,1,1,4,2,H
1921-11-26,1921,Preston North End,Sheffield United,3-0,3,0,1,1,3,3,H
1921-11-26,1921,Sunderland,Newcastle United,0-0,0,0,1,1,0,0,D
1921-11-26,1921,West Bromwich Albion,Manchester City,2-0,2,0,1,1,2,2,H
1921-12-03,1921,Aston Villa,Liverpool,1-1,1,1,1,1,2,0,D
1921-12-03,1921,Blackburn Rovers,Arsenal,0-1,0,1,1,1,1,-1,A
1921-12-03,1921,Bradford City,Manchester United,2-1,2,1,1,1,3,1,H
1921-12-03,1921,Cardiff City,Sunderland,2-0,2,0,1,1,2,2,H
1921-12-03,1921,Chelsea,Preston North End,0-0,0,0,1,1,0,0,D
1921-12-03,1921,Everton,West Bromwich Albion,1-2,1,2,1,1,3,-1,A
1921-12-03,1921,Huddersfield Town,Burnley,1-0,1,0,1,1,1,1,H
1921-12-03,1921,Manchester City,Bolton Wanderers,2-3,2,3,1,1,5,-1,A
1921-12-03,1921,Newcastle United,Middlesbrough,0-0,0,0,1,1,0,0,D
1921-12-03,1921,Oldham Athletic,Birmingham City,0-1,0,1,1,1,1,-1,A
1921-12-03,1921,Tottenham Hotspur,Sheffield United,2-1,2,1,1,1,3,1,H
1921-12-10,1921,Arsenal,Blackburn Rovers,1-1,1,1,1,1,2,0,D
1921-12-10,1921,Birmingham City,Oldham Athletic,3-0,3,0,1,1,3,3,H
1921-12-10,1921,Bolton Wanderers,Manchester City,5-0,5,0,1,1,5,5,H
1921-12-10,1921,Burnley,Huddersfield Town,1-0,1,0,1,1,1,1,H
1921-12-10,1921,Liverpool,Aston Villa,2-0,2,0,1,1,2,2,H
1921-12-10,1921,Manchester United,Bradford City,1-1,1,1,1,1,2,0,D
1921-12-10,1921,Middlesbrough,Newcastle United,1-1,1,1,1,1,2,0,D
1921-12-10,1921,Preston North End,Chelsea,2-0,2,0,1,1,2,2,H
1921-12-10,1921,Sheffield United,Tottenham Hotspur,1-0,1,0,1,1,1,1,H
1921-12-10,1921,Sunderland,Cardiff City,4-1,4,1,1,1,5,3,H
1921-12-10,1921,West Bromwich Albion,Everton,1-1,1,1,1,1,2,0,D
1921-12-12,1921,Arsenal,Bolton Wanderers,1-1,1,1,1,1,2,0,D
1921-12-17,1921,Birmingham City,Sheffield United,2-1,2,1,1,1,3,1,H
1921-12-17,1921,Blackburn Rovers,Bolton Wanderers,1-2,1,2,1,1,3,-1,A
1921-12-17,1921,Bradford City,Preston North End,1-0,1,0,1,1,1,1,H
1921-12-17,1921,Cardiff City,Huddersfield Town,0-0,0,0,1,1,0,0,D
1921-12-17,1921,Liverpool,Manchester United,2-1,2,1,1,1,3,1,H
1921-12-17,1921,Manchester City,Everton,2-1,2,1,1,1,3,1,H
1921-12-17,1921,Middlesbrough,Burnley,4-1,4,1,1,1,5,3,H
1921-12-17,1921,Newcastle United,Aston Villa,1-2,1,2,1,1,3,-1,A
1921-12-17,1921,Oldham Athletic,Arsenal,2-1,2,1,1,1,3,1,H
1921-12-17,1921,Tottenham Hotspur,Chelsea,0-0,0,0,1,1,0,0,D
1921-12-17,1921,West Bromwich Albion,Sunderland,2-1,2,1,1,1,3,1,H
1921-12-24,1921,Arsenal,Oldham Athletic,0-1,0,1,1,1,1,-1,A
1921-12-24,1921,Aston Villa,Newcastle United,1-0,1,0,1,1,1,1,H
1921-12-24,1921,Bolton Wanderers,Blackburn Rovers,1-1,1,1,1,1,2,0,D
1921-12-24,1921,Burnley,Middlesbrough,3-1,3,1,1,1,4,2,H
1921-12-24,1921,Chelsea,Tottenham Hotspur,1-2,1,2,1,1,3,-1,A
1921-12-24,1921,Everton,Manchester City,2-2,2,2,1,1,4,0,D
1921-12-24,1921,Huddersfield Town,Cardiff City,0-1,0,1,1,1,1,-1,A
1921-12-24,1921,Manchester United,Liverpool,0-0,0,0,1,1,0,0,D
1921-12-24,1921,Preston North End,Bradford City,2-1,2,1,1,1,3,1,H
1921-12-24,1921,Sheffield United,Birmingham City,1-2,1,2,1,1,3,-1,A
1921-12-24,1921,Sunderland,West Bromwich Albion,5-0,5,0,1,1,5,5,H
1921-12-26,1921,Arsenal,Cardiff City,0-0,0,0,1,1,0,0,D
1921-12-26,1921,Blackburn Rovers,Preston North End,3-0,3,0,1,1,3,3,H
1921-12-26,1921,Huddersfield Town,Manchester City,2-0,2,0,1,1,2,2,H
1921-12-26,1921,Liverpool,Newcastle United,1-0,1,0,1,1,1,1,H
1921-12-26,1921,Manchester United,Burnley,0-1,0,1,1,1,1,-1,A
1921-12-26,1921,Middlesbrough,Chelsea,0-1,0,1,1,1,1,-1,A
1921-12-26,1921,Oldham Athletic,Bolton Wanderers,0-0,0,0,1,1,0,0,D
1921-12-26,1921,Sheffield United,Aston Villa,2-3,2,3,1,1,5,-1,A
1921-12-26,1921,Sunderland,Everton,1-2,1,2,1,1,3,-1,A
1921-12-26,1921,Tottenham Hotspur,Bradford City,1-0,1,0,1,1,1,1,H
1921-12-26,1921,West Bromwich Albion,Birmingham City,1-0,1,0,1,1,1,1,H
1921-12-27,1921,Aston Villa,Sheffield United,5-3,5,3,1,1,8,2,H
1921-12-27,1921,Birmingham City,West Bromwich Albion,0-2,0,2,1,1,2,-2,A
1921-12-27,1921,Bradford City,Tottenham Hotspur,0-4,0,4,1,1,4,-4,A
1921-12-27,1921,Burnley,Manchester United,4-2,4,2,1,1,6,2,H
1921-12-27,1921,Cardiff City,Arsenal,4-3,4,3,1,1,7,1,H
1921-12-27,1921,Chelsea,Middlesbrough,1-1,1,1,1,1,2,0,D
1921-12-27,1921,Liverpool,Huddersfield Town,2-0,2,0,1,1,2,2,H
1921-12-27,1921,Preston North End,Blackburn Rovers,2-1,2,1,1,1,3,1,H
1921-12-31,1921,Birmingham City,Cardiff City,0-1,0,1,1,1,1,-1,A
1921-12-31,1921,Bradford City,Liverpool,0-0,0,0,1,1,0,0,D
1921-12-31,1921,Burnley,Aston Villa,2-1,2,1,1,1,3,1,H
1921-12-31,1921,Chelsea,Arsenal,0-2,0,2,1,1,2,-2,A
1921-12-31,1921,Everton,Bolton Wanderers,1-0,1,0,1,1,1,1,H
1921-12-31,1921,Manchester City,Sunderland,3-0,3,0,1,1,3,3,H
1921-12-31,1921,Newcastle United,Manchester United,3-0,3,0,1,1,3,3,H
1921-12-31,1921,Oldham Athletic,Blackburn Rovers,1-1,1,1,1,1,2,0,D
1921-12-31,1921,Sheffield United,Middlesbrough,6-1,6,1,1,1,7,5,H
1921-12-31,1921,Tottenham Hotspur,Preston North End,5-0,5,0,1,1,5,5,H
1921-12-31,1921,West Bromwich Albion,Huddersfield Town,3-2,3,2,1,1,5,1,H
1922-01-02,1921,Blackburn Rovers,Cardiff City,1-3,1,3,1,1,4,-2,A
1922-01-02,1921,Bolton Wanderers,Oldham Athletic,5-1,5,1,1,1,6,4,H
1922-01-02,1921,Everton,Sunderland,3-0,3,0,1,1,3,3,H
1922-01-02,1921,Manchester City,Huddersfield Town,2-1,2,1,1,1,3,1,H
1922-01-02,1921,Newcastle United,Liverpool,1-1,1,1,1,1,2,0,D
1922-01-02,1921,Sheffield United,Manchester United,3-0,3,0,1,1,3,3,H
1922-01-14,1921,Arsenal,Chelsea,1-0,1,0,1,1,1,1,H
1922-01-14,1921,Aston Villa,Burnley,2-0,2,0,1,1,2,2,H
1922-01-14,1921,Blackburn Rovers,Oldham Athletic,3-2,3,2,1,1,5,1,H
1922-01-14,1921,Bolton Wanderers,Everton,1-0,1,0,1,1,1,1,H
1922-01-14,1921,Cardiff City,Birmingham City,3-1,3,1,1,1,4,2,H
1922-01-14,1921,Huddersfield Town,West Bromwich Albion,2-0,2,0,1,1,2,2,H
1922-01-14,1921,Liverpool,Bradford City,2-1,2,1,1,1,3,1,H
1922-01-14,1921,Manchester United,Newcastle United,0-1,0,1,1,1,1,-1,A
1922-01-14,1921,Middlesbrough,Sheffield United,1-1,1,1,1,1,2,0,D
1922-01-14,1921,Preston North End,Tottenham Hotspur,1-2,1,2,1,1,3,-1,A
1922-01-14,1921,Sunderland,Manchester City,2-3,2,3,1,1,5,-1,A
1922-01-18,1921,Chelsea,Bolton Wanderers,0-3,0,3,1,1,3,-3,A
1922-01-21,1921,Arsenal,Burnley,0-0,0,0,1,1,0,0,D
1922-01-21,1921,Birmingham City,Newcastle United,0-4,0,4,1,1,4,-4,A
1922-01-21,1921,Blackburn Rovers,Sheffield United,2-3,2,3,1,1,5,-1,A
1922-01-21,1921,Bolton Wanderers,Chelsea,0-2,0,2,1,1,2,-2,A
1922-01-21,1921,Cardiff City,Bradford City,6-3,6,3,1,1,9,3,H
1922-01-21,1921,Everton,Aston Villa,3-2,3,2,1,1,5,1,H
1922-01-21,1921,Huddersfield Town,Liverpool,0-1,0,1,1,1,1,-1,A
1922-01-21,1921,Manchester City,Middlesbrough,2-2,2,2,1,1,4,0,D
1922-01-21,1921,Oldham Athletic,Preston North End,2-0,2,0,1,1,2,2,H
1922-01-21,1921,Sunderland,Manchester United,2-1,2,1,1,1,3,1,H
1922-01-21,1921,West Bromwich Albion,Tottenham Hotspur,3-0,3,0,1,1,3,3,H
1922-01-28,1921,Manchester United,Sunderland,3-1,3,1,1,1,4,2,H
1922-01-30,1921,Tottenham Hotspur,West Bromwich Albion,2-0,2,0,1,1,2,2,H
1922-02-01,1921,Middlesbrough,Manchester City,4-1,4,1,1,1,5,3,H
1922-02-04,1921,Arsenal,Newcastle United,2-1,2,1,1,1,3,1,H
1922-02-04,1921,Birmingham City,Liverpool,0-2,0,2,1,1,2,-2,A
1922-02-04,1921,Blackburn Rovers,Burnley,3-2,3,2,1,1,5,1,H
1922-02-04,1921,Bolton Wanderers,Sheffield United,3-1,3,1,1,1,4,2,H
1922-02-04,1921,Cardiff City,Preston North End,3-0,3,0,1,1,3,3,H
1922-02-04,1921,Manchester City,Tottenham Hotspur,3-3,3,3,1,1,6,0,D
1922-02-04,1921,Oldham Athletic,Chelsea,0-3,0,3,1,1,3,-3,A
1922-02-04,1921,Sunderland,Aston Villa,1-4,1,4,1,1,5,-3,A
1922-02-04,1921,West Bromwich Albion,Bradford City,1-1,1,1,1,1,2,0,D
1922-02-08,1921,Aston Villa,Everton,2-1,2,1,1,1,3,1,H
1922-02-08,1921,Cardiff City,Chelsea,2-0,2,0,1,1,2,2,H
1922-02-08,1921,Newcastle United,Birmingham City,0-1,0,1,1,1,1,-1,A
1922-02-09,1921,Preston North End,Oldham Athletic,0-0,0,0,1,1,0,0,D
1922-02-11,1921,Aston Villa,Sunderland,2-0,2,0,1,1,2,2,H
1922-02-11,1921,Burnley,Blackburn Rovers,1-2,1,2,1,1,3,-1,A
1922-02-11,1921,Chelsea,Oldham Athletic,1-0,1,0,1,1,1,1,H
1922-02-11,1921,Liverpool,Birmingham City,1-0,1,0,1,1,1,1,H
1922-02-11,1921,Manchester United,Huddersfield Town,1-1,1,1,1,1,2,0,D
1922-02-11,1921,Middlesbrough,Everton,3-1,3,1,1,1,4,2,H
1922-02-11,1921,Newcastle United,Arsenal,3-1,3,1,1,1,4,2,H
1922-02-11,1921,Preston North End,Cardiff City,1-1,1,1,1,1,2,0,D
1922-02-11,1921,Sheffield United,Bolton Wanderers,1-0,1,0,1,1,1,1,H
1922-02-11,1921,Tottenham Hotspur,Manchester City,3-1,3,1,1,1,4,2,H
1922-02-18,1921,Birmingham City,Manchester United,0-1,0,1,1,1,1,-1,A
1922-02-18,1921,Bolton Wanderers,Burnley,0-1,0,1,1,1,1,-1,A
1922-02-18,1921,Oldham Athletic,Sheffield United,0-2,0,2,1,1,2,-2,A
1922-02-18,1921,Sunderland,Middlesbrough,1-1,1,1,1,1,2,0,D
1922-02-20,1921,Burnley,Arsenal,1-0,1,0,1,1,1,1,H
1922-02-22,1921,Manchester City,Bradford City,3-2,3,2,1,1,5,1,H
1922-02-25,1921,Aston Villa,Huddersfield Town,2-0,2,0,1,1,2,2,H
1922-02-25,1921,Bradford City,Manchester City,1-2,1,2,1,1,3,-1,A
1922-02-25,1921,Burnley,Bolton Wanderers,2-0,2,0,1,1,2,2,H
1922-02-25,1921,Chelsea,Cardiff City,1-0,1,0,1,1,1,1,H
1922-02-25,1921,Liverpool,Arsenal,4-0,4,0,1,1,4,4,H
1922-02-25,1921,Manchester United,Birmingham City,1-1,1,1,1,1,2,0,D
1922-02-25,1921,Middlesbrough,Sunderland,3-0,3,0,1,1,3,3,H
1922-02-25,1921,Newcastle United,Blackburn Rovers,2-0,2,0,1,1,2,2,H
1922-02-25,1921,Preston North End,West Bromwich Albion,0-3,0,3,1,1,3,-3,A
1922-02-25,1921,Sheffield United,Oldham Athletic,1-0,1,0,1,1,1,1,H
1922-02-25,1921,Tottenham Hotspur,Everton,2-0,2,0,1,1,2,2,H
1922-02-27,1921,Huddersfield Town,Manchester United,1-1,1,1,1,1,2,0,D
1922-02-27,1921,Sheffield United,Blackburn Rovers,0-1,0,1,1,1,1,-1,A
1922-03-01,1921,Everton,Middlesbrough,4-1,4,1,1,1,5,3,H
1922-03-04,1921,Blackburn Rovers,Liverpool,0-0,0,0,1,1,0,0,D
1922-03-04,1921,Bolton Wanderers,Newcastle United,3-2,3,2,1,1,5,1,H
1922-03-04,1921,Everton,Bradford City,2-0,2,0,1,1,2,2,H
1922-03-04,1921,Oldham Athletic,Burnley,0-1,0,1,1,1,1,-1,A
1922-03-04,1921,Sunderland,Sheffield United,1-0,1,0,1,1,1,1,H
1922-03-04,1921,West Bromwich Albion,Chelsea,2-2,2,2,1,1,4,0,D
1922-03-06,1921,Blackburn Rovers,Newcastle United,0-2,0,2,1,1,2,-2,A
1922-03-08,1921,Bradford City,West Bromwich Albion,1-1,1,1,1,1,2,0,D
1922-03-11,1921,Aston Villa,Birmingham City,1-1,1,1,1,1,2,0,D
1922-03-11,1921,Bradford City,Everton,3-1,3,1,1,1,4,2,H
1922-03-11,1921,Burnley,Oldham Athletic,0-1,0,1,1,1,1,-1,A
1922-03-11,1921,Chelsea,West Bromwich Albion,1-1,1,1,1,1,2,0,D
1922-03-11,1921,Liverpool,Blackburn Rovers,2-0,2,0,1,1,2,2,H
1922-03-11,1921,Manchester United,Arsenal,1-0,1,0,1,1,1,1,H
1922-03-11,1921,Middlesbrough,Huddersfield Town,5-1,5,1,1,1,6,4,H
1922-03-11,1921,Newcastle United,Bolton Wanderers,2-1,2,1,1,1,3,1,H
1922-03-11,1921,Preston North End,Manchester City,1-0,1,0,1,1,1,1,H
1922-03-11,1921,Sheffield United,Cardiff City,0-2,0,2,1,1,2,-2,A
1922-03-11,1921,Tottenham Hotspur,Sunderland,1-0,1,0,1,1,1,1,H
1922-03-15,1921,Birmingham City,Aston Villa,1-0,1,0,1,1,1,1,H
1922-03-15,1921,Bradford City,Cardiff City,1-0,1,0,1,1,1,1,H
1922-03-15,1921,Everton,Tottenham Hotspur,0-0,0,0,1,1,0,0,D
1922-03-18,1921,Aston Villa,Arsenal,2-0,2,0,1,1,2,2,H
1922-03-18,1921,Bradford City,Sunderland,0-0,0,0,1,1,0,0,D
1922-03-18,1921,Burnley,Cardiff City,1-1,1,1,1,1,2,0,D
1922-03-18,1921,Chelsea,Manchester City,0-0,0,0,1,1,0,0,D
1922-03-18,1921,Liverpool,Bolton Wanderers,0-2,0,2,1,1,2,-2,A
1922-03-18,1921,Manchester United,Blackburn Rovers,0-1,0,1,1,1,1,-1,A
1922-03-18,1921,Middlesbrough,Birmingham City,1-1,1,1,1,1,2,0,D
1922-03-18,1921,Newcastle United,Oldham Athletic,1-1,1,1,1,1,2,0,D
1922-03-18,1921,Preston North End,Everton,1-0,1,0,1,1,1,1,H
1922-03-18,1921,Sheffield United,West Bromwich Albion,0-0,0,0,1,1,0,0,D
1922-03-18,1921,Tottenham Hotspur,Huddersfield Town,1-0,1,0,1,1,1,1,H
1922-03-22,1921,Arsenal,Liverpool,1-0,1,0,1,1,1,1,H
1922-03-25,1921,Arsenal,Aston Villa,2-0,2,0,1,1,2,2,H
1922-03-25,1921,Birmingham City,Middlesbrough,4-3,4,3,1,1,7,1,H
1922-03-25,1921,Blackburn Rovers,Manchester United,3-0,3,0,1,1,3,3,H
1922-03-25,1921,Bolton Wanderers,Liverpool,1-3,1,3,1,1,4,-2,A
1922-03-25,1921,Cardiff City,Burnley,4-2,4,2,1,1,6,2,H
1922-03-25,1921,Manchester City,Chelsea,0-0,0,0,1,1,0,0,D
1922-03-25,1921,Oldham Athletic,Newcastle United,0-0,0,0,1,1,0,0,D
1922-03-25,1921,Sunderland,Bradford City,0-0,0,0,1,1,0,0,D
1922-03-25,1921,West Bromwich Albion,Sheffield United,3-0,3,0,1,1,3,3,H
1922-03-27,1921,Huddersfield Town,Tottenham Hotspur,1-1,1,1,1,1,2,0,D
1922-03-29,1921,West Bromwich Albion,Preston North End,2-0,2,0,1,1,2,2,H
1922-04-01,1921,Arsenal,Middlesbrough,2-2,2,2,1,1,4,0,D
1922-04-01,1921,Birmingham City,Tottenham Hotspur,0-3,0,3,1,1,3,-3,A
1922-04-01,1921,Blackburn Rovers,Aston Villa,1-2,1,2,1,1,3,-1,A
1922-04-01,1921,Bradford City,Huddersfield Town,4-0,4,0,1,1,4,4,H
1922-04-01,1921,Chelsea,Everton,1-0,1,0,1,1,1,1,H
1922-04-01,1921,Liverpool,Oldham Athletic,2-0,2,0,1,1,2,2,H
1922-04-01,1921,Manchester United,Bolton Wanderers,0-1,0,1,1,1,1,-1,A
1922-04-01,1921,Newcastle United,Cardiff City,0-0,0,0,1,1,0,0,D
1922-04-01,1921,Preston North End,Sunderland,1-1,1,1,1,1,2,0,D
1922-04-01,1921,Sheffield United,Manchester City,1-0,1,0,1,1,1,1,H
1922-04-01,1921,West Bromwich Albion,Burnley,2-0,2,0,1,1,2,2,H
1922-04-05,1921,Arsenal,Manchester United,3-1,3,1,1,1,4,2,H
1922-04-05,1921,Huddersfield Town,Aston Villa,1-0,1,0,1,1,1,1,H
1922-04-05,1921,Manchester City,Preston North End,2-0,2,0,1,1,2,2,H
1922-04-05,1921,Sunderland,Tottenham Hotspur,2-0,2,0,1,1,2,2,H
1922-04-08,1921,Bolton Wanderers,Manchester United,1-0,1,0,1,1,1,1,H
1922-04-08,1921,Burnley,West Bromwich Albion,4-2,4,2,1,1,6,2,H
1922-04-08,1921,Cardiff City,Newcastle United,1-0,1,0,1,1,1,1,H
1922-04-08,1921,Everton,Chelsea,2-3,2,3,1,1,5,-1,A
1922-04-08,1921,Huddersfield Town,Bradford City,1-2,1,2,1,1,3,-1,A
1922-04-08,1921,Manchester City,Sheffield United,2-2,2,2,1,1,4,0,D
1922-04-08,1921,Middlesbrough,Arsenal,4-2,4,2,1,1,6,2,H
1922-04-08,1921,Oldham Athletic,Liverpool,4-0,4,0,1,1,4,4,H
1922-04-08,1921,Sunderland,Preston North End,1-0,1,0,1,1,1,1,H
1922-04-08,1921,Tottenham Hotspur,Birmingham City,2-1,2,1,1,1,3,1,H
1922-04-10,1921,Chelsea,Huddersfield Town,1-0,1,0,1,1,1,1,H
1922-04-10,1921,Everton,Preston North End,0-0,0,0,1,1,0,0,D
1922-04-14,1921,Burnley,Liverpool,1-1,1,1,1,1,2,0,D
1922-04-14,1921,Chelsea,Aston Villa,1-0,1,0,1,1,1,1,H
1922-04-14,1921,Everton,Huddersfield Town,6-2,6,2,1,1,8,4,H
1922-04-14,1921,Manchester City,Birmingham City,1-0,1,0,1,1,1,1,H
1922-04-14,1921,Newcastle United,Bradford City,1-2,1,2,1,1,3,-1,A
1922-04-14,1921,Preston North End,Middlesbrough,1-1,1,1,1,1,2,0,D
1922-04-14,1921,Sunderland,Bolton Wanderers,6-2,6,2,1,1,8,4,H
1922-04-14,1921,Tottenham Hotspur,Oldham Athletic,3-1,3,1,1,1,4,2,H
1922-04-15,1921,Aston Villa,Bolton Wanderers,2-1,2,1,1,1,3,1,H
1922-04-15,1921,Bradford City,Birmingham City,1-2,1,2,1,1,3,-1,A
1922-04-15,1921,Burnley,Manchester City,5-2,5,2,1,1,7,3,H
1922-04-15,1921,Chelsea,Sunderland,1-0,1,0,1,1,1,1,H
1922-04-15,1921,Liverpool,Cardiff City,5-1,5,1,1,1,6,4,H
1922-04-15,1921,Manchester United,Oldham Athletic,0-3,0,3,1,1,3,-3,A
1922-04-15,1921,Middlesbrough,Blackburn Rovers,0-1,0,1,1,1,1,-1,A
1922-04-15,1921,Newcastle United,West Bromwich Albion,3-0,3,0,1,1,3,3,H
1922-04-15,1921,Preston North End,Huddersfield Town,1-1,1,1,1,1,2,0,D
1922-04-15,1921,Sheffield United,Everton,1-0,1,0,1,1,1,1,H
1922-04-15,1921,Tottenham Hotspur,Arsenal,2-0,2,0,1,1,2,2,H
1922-04-17,1921,Aston Villa,Chelsea,1-4,1,4,1,1,5,-3,A
1922-04-17,1921,Bolton Wanderers,Sunderland,1-1,1,1,1,1,2,0,D
1922-04-17,1921,Bradford City,Newcastle United,2-3,2,3,1,1,5,-1,A
1922-04-17,1921,Cardiff City,Blackburn Rovers,1-3,1,3,1,1,4,-2,A
1922-04-17,1921,Liverpool,Burnley,2-1,2,1,1,1,3,1,H
1922-04-17,1921,Manchester United,Sheffield United,3-2,3,2,1,1,5,1,H
1922-04-17,1921,Middlesbrough,Preston North End,1-0,1,0,1,1,1,1,H
1922-04-17,1921,Oldham Athletic,Tottenham Hotspur,1-0,1,0,1,1,1,1,H
1922-04-17,1921,West Bromwich Albion,Arsenal,0-3,0,3,1,1,3,-3,A
1922-04-18,1921,Arsenal,West Bromwich Albion,2-2,2,2,1,1,4,0,D
1922-04-18,1921,Birmingham City,Manchester City,3-1,3,1,1,1,4,2,H
1922-04-18,1921,Huddersfield Town,Everton,1-2,1,2,1,1,3,-1,A
1922-04-22,1921,Arsenal,Tottenham Hotspur,1-0,1,0,1,1,1,1,H
1922-04-22,1921,Birmingham City,Bradford City,1-0,1,0,1,1,1,1,H
1922-04-22,1921,Blackburn Rovers,Middlesbrough,2-2,2,2,1,1,4,0,D
1922-04-22,1921,Bolton Wanderers,Aston Villa,1-0,1,0,1,1,1,1,H
1922-04-22,1921,Cardiff City,Liverpool,2-0,2,0,1,1,2,2,H
1922-04-22,1921,Everton,Sheffield United,1-1,1,1,1,1,2,0,D
1922-04-22,1921,Huddersfield Town,Preston North End,6-0,6,0,1,1,6,6,H
1922-04-22,1921,Manchester City,Burnley,2-0,2,0,1,1,2,2,H
1922-04-22,1921,Oldham Athletic,Manchester United,1-1,1,1,1,1,2,0,D
1922-04-22,1921,Sunderland,Chelsea,1-2,1,2,1,1,3,-1,A
1922-04-22,1921,West Bromwich Albion,Newcastle United,1-2,1,2,1,1,3,-1,A
1922-04-26,1921,Cardiff City,Sheffield United,1-1,1,1,1,1,2,0,D
1922-04-29,1921,Aston Villa,Oldham Athletic,2-0,2,0,1,1,2,2,H
1922-04-29,1921,Bradford City,Arsenal,0-2,0,2,1,1,2,-2,A
1922-04-29,1921,Burnley,Everton,2-0,2,0,1,1,2,2,H
1922-04-29,1921,Liverpool,West Bromwich Albion,1-2,1,2,1,1,3,-1,A
1922-04-29,1921,Manchester United,Cardiff City,1-1,1,1,1,1,2,0,D
1922-04-29,1921,Middlesbrough,Bolton Wanderers,4-2,4,2,1,1,6,2,H
1922-04-29,1921,Newcastle United,Manchester City,5-1,5,1,1,1,6,4,H
1922-04-29,1921,Sheffield United,Sunderland,4-1,4,1,1,1,5,3,H
1922-04-29,1921,Tottenham Hotspur,Blackburn Rovers,2-1,2,1,1,1,3,1,H
1922-05-01,1921,Huddersfield Town,Middlesbrough,2-1,2,1,1,1,3,1,H
1922-05-01,1921,Preston North End,Birmingham City,2-2,2,2,1,1,4,0,D
1922-05-06,1921,Arsenal,Bradford City,1-0,1,0,1,1,1,1,H
1922-05-06,1921,Birmingham City,Preston North End,0-2,0,2,1,1,2,-2,A
1922-05-06,1921,Blackburn Rovers,Tottenham Hotspur,1-1,1,1,1,1,2,0,D
1922-05-06,1921,Bolton Wanderers,Middlesbrough,4-2,4,2,1,1,6,2,H
1922-05-06,1921,Cardiff City,Manchester United,3-1,3,1,1,1,4,2,H
1922-05-06,1921,Everton,Burnley,2-0,2,0,1,1,2,2,H
1922-05-06,1921,Huddersfield Town,Chelsea,2-0,2,0,1,1,2,2,H
1922-05-06,1921,Manchester City,Newcastle United,1-0,1,0,1,1,1,1,H
1922-05-06,1921,Oldham Athletic,Aston Villa,3-1,3,1,1,1,4,2,H
1922-05-06,1921,West Bromwich Albion,Liverpool,1-4,1,4,1,1,5,-3,A
1922-08-26,1922,Aston Villa,Blackburn Rovers,2-0,2,0,1,1,2,2,H
1922-08-26,1922,Burnley,West Bromwich Albion,3-0,3,0,1,1,3,3,H
1922-08-26,1922,Chelsea,Birmingham City,1-1,1,1,1,1,2,0,D
1922-08-26,1922,Liverpool,Arsenal,5-2,5,2,1,1,7,3,H
1922-08-26,1922,Middlesbrough,Huddersfield Town,2-2,2,2,1,1,4,0,D
1922-08-26,1922,Newcastle United,Everton,2-0,2,0,1,1,2,2,H
1922-08-26,1922,Nottingham Forest,Sunderland,1-0,1,0,1,1,1,1,H
1922-08-26,1922,Oldham Athletic,Stoke City,4-1,4,1,1,1,5,3,H
1922-08-26,1922,Preston North End,Bolton Wanderers,3-1,3,1,1,1,4,2,H
1922-08-26,1922,Sheffield United,Manchester City,2-0,2,0,1,1,2,2,H
1922-08-26,1922,Tottenham Hotspur,Cardiff City,1-1,1,1,1,1,2,0,D
1922-08-28,1922,Arsenal,Burnley,1-1,1,1,1,1,2,0,D
1922-08-28,1922,Birmingham City,Newcastle United,0-2,0,2,1,1,2,-2,A
1922-08-28,1922,Cardiff City,Aston Villa,3-0,3,0,1,1,3,3,H
1922-08-28,1922,Huddersfield Town,Nottingham Forest,2-1,2,1,1,1,3,1,H
1922-08-28,1922,Manchester City,Middlesbrough,2-1,2,1,1,1,3,1,H
1922-08-28,1922,Stoke City,Chelsea,1-2,1,2,1,1,3,-1,A
1922-08-28,1922,West Bromwich Albion,Preston North End,2-2,2,2,1,1,4,0,D
1922-08-30,1922,Sunderland,Liverpool,1-0,1,0,1,1,1,1,H
1922-09-02,1922,Arsenal,Liverpool,1-0,1,0,1,1,1,1,H
1922-09-02,1922,Birmingham City,Chelsea,0-1,0,1,1,1,1,-1,A
1922-09-02,1922,Blackburn Rovers,Aston Villa,4-2,4,2,1,1,6,2,H
1922-09-02,1922,Bolton Wanderers,Preston North End,1-1,1,1,1,1,2,0,D
1922-09-02,1922,Cardiff City,Tottenham Hotspur,2-3,2,3,1,1,5,-1,A
1922-09-02,1922,Everton,Newcastle United,3-2,3,2,1,1,5,1,H
1922-09-02,1922,Huddersfield Town,Middlesbrough,0-2,0,2,1,1,2,-2,A
1922-09-02,1922,Manchester City,Sheffield United,3-3,3,3,1,1,6,0,D
1922-09-02,1922,Stoke City,Oldham Athletic,2-2,2,2,1,1,4,0,D
1922-09-02,1922,Sunderland,Nottingham Forest,0-0,0,0,1,1,0,0,D
1922-09-02,1922,West Bromwich Albion,Burnley,2-1,2,1,1,1,3,1,H
1922-09-04,1922,Aston Villa,Cardiff City,1-3,1,3,1,1,4,-2,A
1922-09-04,1922,Bolton Wanderers,Oldham Athletic,3-1,3,1,1,1,4,2,H
1922-09-04,1922,Burnley,Arsenal,4-1,4,1,1,1,5,3,H
1922-09-04,1922,Chelsea,Stoke City,3-2,3,2,1,1,5,1,H
1922-09-04,1922,Middlesbrough,Manchester City,5-0,5,0,1,1,5,5,H
1922-09-04,1922,Nottingham Forest,Huddersfield Town,0-1,0,1,1,1,1,-1,A
1922-09-04,1922,Preston North End,West Bromwich Albion,0-0,0,0,1,1,0,0,D
1922-09-04,1922,Sheffield United,Blackburn Rovers,1-1,1,1,1,1,2,0,D
1922-09-04,1922,Tottenham Hotspur,Everton,2-0,2,0,1,1,2,2,H
1922-09-06,1922,Liverpool,Sunderland,5-1,5,1,1,1,6,4,H
1922-09-06,1922,Newcastle United,Birmingham City,0-0,0,0,1,1,0,0,D
1922-09-09,1922,Aston Villa,West Bromwich Albion,2-0,2,0,1,1,2,2,H
1922-09-09,1922,Bolton Wanderers,Sunderland,1-1,1,1,1,1,2,0,D
1922-09-09,1922,Cardiff City,Arsenal,4-1,4,1,1,1,5,3,H
1922-09-09,1922,Chelsea,Middlesbrough,1-1,1,1,1,1,2,0,D
1922-09-09,1922,Everton,Blackburn Rovers,2-0,2,0,1,1,2,2,H
1922-09-09,1922,Manchester City,Birmingham City,0-1,0,1,1,1,1,-1,A
1922-09-09,1922,Newcastle United,Sheffield United,3-0,3,0,1,1,3,3,H
1922-09-09,1922,Oldham Athletic,Nottingham Forest,2-0,2,0,1,1,2,2,H
1922-09-09,1922,Preston North End,Liverpool,1-3,1,3,1,1,4,-2,A
1922-09-09,1922,Stoke City,Huddersfield Town,2-2,2,2,1,1,4,0,D
1922-09-09,1922,Tottenham Hotspur,Burnley,1-3,1,3,1,1,4,-2,A
1922-09-11,1922,Oldham Athletic,Bolton Wanderers,3-1,3,1,1,1,4,2,H
1922-09-13,1922,Birmingham City,Stoke City,2-0,2,0,1,1,2,2,H
1922-09-16,1922,Arsenal,Cardiff City,2-1,2,1,1,1,3,1,H
1922-09-16,1922,Birmingham City,Manchester City,0-1,0,1,1,1,1,-1,A
1922-09-16,1922,Blackburn Rovers,Everton,5-1,5,1,1,1,6,4,H
1922-09-16,1922,Burnley,Tottenham Hotspur,0-1,0,1,1,1,1,-1,A
1922-09-16,1922,Huddersfield Town,Stoke City,1-0,1,0,1,1,1,1,H
1922-09-16,1922,Liverpool,Preston North End,5-2,5,2,1,1,7,3,H
1922-09-16,1922,Middlesbrough,Chelsea,2-1,2,1,1,1,3,1,H
1922-09-16,1922,Nottingham Forest,Oldham Athletic,1-0,1,0,1,1,1,1,H
1922-09-16,1922,Sheffield United,Newcastle United,2-0,2,0,1,1,2,2,H
1922-09-16,1922,Sunderland,Bolton Wanderers,5-1,5,1,1,1,6,4,H
1922-09-16,1922,West Bromwich Albion,Aston Villa,3-0,3,0,1,1,3,3,H
1922-09-18,1922,Blackburn Rovers,Sheffield United,1-0,1,0,1,1,1,1,H
1922-09-23,1922,Aston Villa,Middlesbrough,2-2,2,2,1,1,4,0,D
1922-09-23,1922,Blackburn Rovers,Sunderland,0-0,0,0,1,1,0,0,D
1922-09-23,1922,Bolton Wanderers,Birmingham City,3-0,3,0,1,1,3,3,H
1922-09-23,1922,Cardiff City,Everton,0-2,0,2,1,1,2,-2,A
1922-09-23,1922,Chelsea,Oldham Athletic,4-0,4,0,1,1,4,4,H
1922-09-23,1922,Liverpool,Burnley,3-0,3,0,1,1,3,3,H
1922-09-23,1922,Manchester City,Huddersfield Town,3-1,3,1,1,1,4,2,H
1922-09-23,1922,Newcastle United,Preston North End,3-1,3,1,1,1,4,2,H
1922-09-23,1922,Nottingham Forest,Sheffield United,1-0,1,0,1,1,1,1,H
1922-09-23,1922,Stoke City,West Bromwich Albion,0-2,0,2,1,1,2,-2,A
1922-09-23,1922,Tottenham Hotspur,Arsenal,1-2,1,2,1,1,3,-1,A
1922-09-30,1922,Arsenal,Tottenham Hotspur,0-2,0,2,1,1,2,-2,A
1922-09-30,1922,Birmingham City,Bolton Wanderers,2-0,2,0,1,1,2,2,H
1922-09-30,1922,Burnley,Liverpool,2-0,2,0,1,1,2,2,H
1922-09-30,1922,Everton,Cardiff City,3-1,3,1,1,1,4,2,H
1922-09-30,1922,Huddersfield Town,Manchester City,0-0,0,0,1,1,0,0,D
1922-09-30,1922,Middlesbrough,Aston Villa,2-2,2,2,1,1,4,0,D
1922-09-30,1922,Oldham Athletic,Chelsea,2-0,2,0,1,1,2,2,H
1922-09-30,1922,Preston North End,Newcastle United,1-0,1,0,1,1,1,1,H
1922-09-30,1922,Sheffield United,Nottingham Forest,0-0,0,0,1,1,0,0,D
1922-09-30,1922,Sunderland,Blackburn Rovers,4-3,4,3,1,1,7,1,H
1922-09-30,1922,West Bromwich Albion,Stoke City,0-1,0,1,1,1,1,-1,A
1922-10-02,1922,Sheffield United,Arsenal,2-1,2,1,1,1,3,1,H
1922-10-05,1922,Nottingham Forest,Bolton Wanderers,1-1,1,1,1,1,2,0,D
1922-10-07,1922,Arsenal,West Bromwich Albion,3-1,3,1,1,1,4,2,H
1922-10-07,1922,Aston Villa,Tottenham Hotspur,2-0,2,0,1,1,2,2,H
1922-10-07,1922,Blackburn Rovers,Birmingham City,1-1,1,1,1,1,2,0,D
1922-10-07,1922,Bolton Wanderers,Huddersfield Town,1-0,1,0,1,1,1,1,H
1922-10-07,1922,Cardiff City,Sunderland,2-4,2,4,1,1,6,-2,A
1922-10-07,1922,Chelsea,Sheffield United,0-0,0,0,1,1,0,0,D
1922-10-07,1922,Liverpool,Everton,5-1,5,1,1,1,6,4,H
1922-10-07,1922,Newcastle United,Burnley,0-2,0,2,1,1,2,-2,A
1922-10-07,1922,Nottingham Forest,Preston North End,3-0,3,0,1,1,3,3,H
1922-10-07,1922,Oldham Athletic,Middlesbrough,0-0,0,0,1,1,0,0,D
1922-10-07,1922,Stoke City,Manchester City,1-1,1,1,1,1,2,0,D
1922-10-14,1922,Birmingham City,Blackburn Rovers,1-1,1,1,1,1,2,0,D
1922-10-14,1922,Burnley,Newcastle United,0-0,0,0,1,1,0,0,D
1922-10-14,1922,Everton,Liverpool,0-1,0,1,1,1,1,-1,A
1922-10-14,1922,Huddersfield Town,Bolton Wanderers,0-2,0,2,1,1,2,-2,A
1922-10-14,1922,Manchester City,Stoke City,2-1,2,1,1,1,3,1,H
1922-10-14,1922,Middlesbrough,Oldham Athletic,2-1,2,1,1,1,3,1,H
1922-10-14,1922,Preston North End,Nottingham Forest,2-2,2,2,1,1,4,0,D
1922-10-14,1922,Sheffield United,Chelsea,0-2,0,2,1,1,2,-2,A
1922-10-14,1922,Sunderland,Cardiff City,2-1,2,1,1,1,3,1,H
1922-10-14,1922,Tottenham Hotspur,Aston Villa,1-2,1,2,1,1,3,-1,A
1922-10-14,1922,West Bromwich Albion,Arsenal,7-0,7,0,1,1,7,7,H
1922-10-21,1922,Aston Villa,Bolton Wanderers,2-0,2,0,1,1,2,2,H
1922-10-21,1922,Burnley,Blackburn Rovers,3-1,3,1,1,1,4,2,H
1922-10-21,1922,Chelsea,Sunderland,1-3,1,3,1,1,4,-2,A
1922-10-21,1922,Liverpool,Cardiff City,3-1,3,1,1,1,4,2,H
1922-10-21,1922,Middlesbrough,Birmingham City,2-1,2,1,1,1,3,1,H
1922-10-21,1922,Newcastle United,Arsenal,1-1,1,1,1,1,2,0,D
1922-10-21,1922,Nottingham Forest,Everton,2-1,2,1,1,1,3,1,H
1922-10-21,1922,Oldham Athletic,Huddersfield Town,0-3,0,3,1,1,3,-3,A
1922-10-21,1922,Preston North End,Manchester City,0-2,0,2,1,1,2,-2,A
1922-10-21,1922,Sheffield United,Stoke City,2-0,2,0,1,1,2,2,H
1922-10-21,1922,Tottenham Hotspur,West Bromwich Albion,3-1,3,1,1,1,4,2,H
1922-10-28,1922,Arsenal,Newcastle United,1-2,1,2,1,1,3,-1,A
1922-10-28,1922,Birmingham City,Middlesbrough,2-0,2,0,1,1,2,2,H
1922-10-28,1922,Blackburn Rovers,Burnley,2-1,2,1,1,1,3,1,H
1922-10-28,1922,Bolton Wanderers,Aston Villa,3-0,3,0,1,1,3,3,H
1922-10-28,1922,Cardiff City,Liverpool,3-0,3,0,1,1,3,3,H
1922-10-28,1922,Everton,Nottingham Forest,4-2,4,2,1,1,6,2,H
1922-10-28,1922,Huddersfield Town,Oldham Athletic,3-0,3,0,1,1,3,3,H
1922-10-28,1922,Manchester City,Preston North End,2-1,2,1,1,1,3,1,H
1922-10-28,1922,Stoke City,Sheffield United,4-0,4,0,1,1,4,4,H
1922-10-28,1922,Sunderland,Chelsea,1-1,1,1,1,1,2,0,D
1922-10-28,1922,West Bromwich Albion,Tottenham Hotspur,5-1,5,1,1,1,6,4,H
1922-11-04,1922,Birmingham City,Cardiff City,0-0,0,0,1,1,0,0,D
1922-11-04,1922,Bolton Wanderers,Stoke City,1-1,1,1,1,1,2,0,D
1922-11-04,1922,Burnley,Nottingham Forest,8-2,8,2,1,1,10,6,H
1922-11-04,1922,Everton,Arsenal,1-0,1,0,1,1,1,1,H
1922-11-04,1922,Huddersfield Town,Blackburn Rovers,0-2,0,2,1,1,2,-2,A
1922-11-04,1922,Middlesbrough,Sheffield United,3-2,3,2,1,1,5,1,H
1922-11-04,1922,Newcastle United,Sunderland,2-1,2,1,1,1,3,1,H
1922-11-04,1922,Oldham Athletic,Aston Villa,0-2,0,2,1,1,2,-2,A
1922-11-04,1922,Preston North End,Chelsea,2-0,2,0,1,1,2,2,H
1922-11-04,1922,Tottenham Hotspur,Liverpool,2-4,2,4,1,1,6,-2,A
1922-11-04,1922,West Bromwich Albion,Manchester City,2-0,2,0,1,1,2,2,H
1922-11-11,1922,Arsenal,Everton,1-2,1,2,1,1,3,-1,A
1922-11-11,1922,Aston Villa,Oldham Athletic,3-0,3,0,1,1,3,3,H
1922-11-11,1922,Blackburn Rovers,Huddersfield Town,0-0,0,0,1,1,0,0,D
1922-11-11,1922,Cardiff City,Birmingham City,1-1,1,1,1,1,2,0,D
1922-11-11,1922,Chelsea,Preston North End,0-1,0,1,1,1,1,-1,A
1922-11-11,1922,Liverpool,Tottenham Hotspur,0-0,0,0,1,1,0,0,D
1922-11-11,1922,Manchester City,West Bromwich Albion,1-1,1,1,1,1,2,0,D
1922-11-11,1922,Nottingham Forest,Burnley,1-0,1,0,1,1,1,1,H
1922-11-11,1922,Sheffield United,Middlesbrough,4-1,4,1,1,1,5,3,H
1922-11-11,1922,Stoke City,Bolton Wanderers,2-0,2,0,1,1,2,2,H
1922-11-11,1922,Sunderland,Newcastle United,2-0,2,0,1,1,2,2,H
1922-11-18,1922,Birmingham City,Nottingham Forest,2-0,2,0,1,1,2,2,H
1922-11-18,1922,Burnley,Chelsea,1-0,1,0,1,1,1,1,H
1922-11-18,1922,Huddersfield Town,Cardiff City,1-0,1,0,1,1,1,1,H
1922-11-18,1922,Liverpool,Aston Villa,3-0,3,0,1,1,3,3,H
1922-11-18,1922,Manchester City,Bolton Wanderers,2-0,2,0,1,1,2,2,H
1922-11-18,1922,Preston North End,Middlesbrough,1-2,1,2,1,1,3,-1,A
1922-11-18,1922,Sheffield United,Oldham Athletic,2-2,2,2,1,1,4,0,D
1922-11-18,1922,Stoke City,Blackburn Rovers,1-1,1,1,1,1,2,0,D
1922-11-18,1922,Sunderland,Arsenal,3-3,3,3,1,1,6,0,D
1922-11-18,1922,Tottenham Hotspur,Newcastle United,0-1,0,1,1,1,1,-1,A
1922-11-18,1922,West Bromwich Albion,Everton,0-0,0,0,1,1,0,0,D
1922-11-25,1922,Arsenal,Sunderland,2-3,2,3,1,1,5,-1,A
1922-11-25,1922,Aston Villa,Liverpool,0-1,0,1,1,1,1,-1,A
1922-11-25,1922,Bolton Wanderers,Manchester City,2-1,2,1,1,1,3,1,H
1922-11-25,1922,Cardiff City,Huddersfield Town,0-1,0,1,1,1,1,-1,A
1922-11-25,1922,Chelsea,Burnley,0-1,0,1,1,1,1,-1,A
1922-11-25,1922,Everton,West Bromwich Albion,0-1,0,1,1,1,1,-1,A
1922-11-25,1922,Middlesbrough,Preston North End,1-1,1,1,1,1,2,0,D
1922-11-25,1922,Newcastle United,Tottenham Hotspur,1-1,1,1,1,1,2,0,D
1922-11-25,1922,Nottingham Forest,Birmingham City,1-1,1,1,1,1,2,0,D
1922-11-25,1922,Oldham Athletic,Sheffield United,0-2,0,2,1,1,2,-2,A
1922-12-02,1922,Birmingham City,Arsenal,3-2,3,2,1,1,5,1,H
1922-12-02,1922,Blackburn Rovers,Manchester City,0-0,0,0,1,1,0,0,D
1922-12-02,1922,Cardiff City,Stoke City,2-1,2,1,1,1,3,1,H
1922-12-02,1922,Chelsea,Huddersfield Town,2-2,2,2,1,1,4,0,D
1922-12-02,1922,Liverpool,Newcastle United,0-2,0,2,1,1,2,-2,A
1922-12-02,1922,Middlesbrough,Burnley,4-1,4,1,1,1,5,3,H
1922-12-02,1922,Preston North End,Oldham Athletic,5-1,5,1,1,1,6,4,H
1922-12-02,1922,Sheffield United,Aston Villa,1-1,1,1,1,1,2,0,D
1922-12-02,1922,Sunderland,Everton,3-1,3,1,1,1,4,2,H
1922-12-02,1922,Tottenham Hotspur,Nottingham Forest,2-1,2,1,1,1,3,1,H
1922-12-02,1922,West Bromwich Albion,Bolton Wanderers,1-1,1,1,1,1,2,0,D
1922-12-09,1922,Arsenal,Birmingham City,1-0,1,0,1,1,1,1,H
1922-12-09,1922,Aston Villa,Sheffield United,0-1,0,1,1,1,1,-1,A
1922-12-09,1922,Bolton Wanderers,West Bromwich Albion,3-0,3,0,1,1,3,3,H
1922-12-09,1922,Burnley,Middlesbrough,3-0,3,0,1,1,3,3,H
1922-12-09,1922,Everton,Sunderland,1-1,1,1,1,1,2,0,D
1922-12-09,1922,Huddersfield Town,Chelsea,3-0,3,0,1,1,3,3,H
1922-12-09,1922,Manchester City,Blackburn Rovers,2-1,2,1,1,1,3,1,H
1922-12-09,1922,Newcastle United,Liverpool,0-1,0,1,1,1,1,-1,A
1922-12-09,1922,Nottingham Forest,Tottenham Hotspur,0-1,0,1,1,1,1,-1,A
1922-12-09,1922,Oldham Athletic,Preston North End,2-1,2,1,1,1,3,1,H
1922-12-09,1922,Stoke City,Cardiff City,3-1,3,1,1,1,4,2,H
1922-12-16,1922,Arsenal,Huddersfield Town,1-1,1,1,1,1,2,0,D
1922-12-16,1922,Aston Villa,Newcastle United,1-1,1,1,1,1,2,0,D
1922-12-16,1922,Birmingham City,Everton,1-1,1,1,1,1,2,0,D
1922-12-16,1922,Blackburn Rovers,Bolton Wanderers,1-0,1,0,1,1,1,1,H
1922-12-16,1922,Burnley,Oldham Athletic,1-1,1,1,1,1,2,0,D
1922-12-16,1922,Cardiff City,Manchester City,3-1,3,1,1,1,4,2,H
1922-12-16,1922,Chelsea,Tottenham Hotspur,0-0,0,0,1,1,0,0,D
1922-12-16,1922,Liverpool,Nottingham Forest,2-1,2,1,1,1,3,1,H
1922-12-16,1922,Middlesbrough,Stoke City,3-1,3,1,1,1,4,2,H
1922-12-16,1922,Sheffield United,Preston North End,2-2,2,2,1,1,4,0,D
1922-12-16,1922,Sunderland,West Bromwich Albion,3-2,3,2,1,1,5,1,H
1922-12-23,1922,Bolton Wanderers,Blackburn Rovers,3-0,3,0,1,1,3,3,H
1922-12-23,1922,Everton,Birmingham City,2-1,2,1,1,1,3,1,H
1922-12-23,1922,Huddersfield Town,Arsenal,4-0,4,0,1,1,4,4,H
1922-12-23,1922,Manchester City,Cardiff City,5-1,5,1,1,1,6,4,H
1922-12-23,1922,Newcastle United,Aston Villa,0-0,0,0,1,1,0,0,D
1922-12-23,1922,Nottingham Forest,Liverpool,1-3,1,3,1,1,4,-2,A
1922-12-23,1922,Oldham Athletic,Burnley,1-1,1,1,1,1,2,0,D
1922-12-23,1922,Preston North End,Sheffield United,2-3,2,3,1,1,5,-1,A
1922-12-23,1922,Stoke City,Middlesbrough,0-0,0,0,1,1,0,0,D
1922-12-23,1922,Tottenham Hotspur,Chelsea,3-1,3,1,1,1,4,2,H
1922-12-23,1922,West Bromwich Albion,Sunderland,1-1,1,1,1,1,2,0,D
1922-12-25,1922,Birmingham City,Huddersfield Town,0-0,0,0,1,1,0,0,D
1922-12-25,1922,Blackburn Rovers,Preston North End,1-1,1,1,1,1,2,0,D
1922-12-25,1922,Bolton Wanderers,Arsenal,4-1,4,1,1,1,5,3,H
1922-12-25,1922,Burnley,Aston Villa,1-1,1,1,1,1,2,0,D
1922-12-25,1922,Chelsea,Nottingham Forest,2-2,2,2,1,1,4,0,D
1922-12-25,1922,Everton,Manchester City,0-0,0,0,1,1,0,0,D
1922-12-25,1922,Newcastle United,Middlesbrough,1-1,1,1,1,1,2,0,D
1922-12-25,1922,Oldham Athletic,Liverpool,0-2,0,2,1,1,2,-2,A
1922-12-25,1922,Tottenham Hotspur,Sheffield United,2-1,2,1,1,1,3,1,H
1922-12-26,1922,Arsenal,Bolton Wanderers,5-0,5,0,1,1,5,5,H
1922-12-26,1922,Aston Villa,Burnley,3-1,3,1,1,1,4,2,H
1922-12-26,1922,Cardiff City,West Bromwich Albion,3-0,3,0,1,1,3,3,H
1922-12-26,1922,Huddersfield Town,Birmingham City,4-0,4,0,1,1,4,4,H
1922-12-26,1922,Liverpool,Oldham Athletic,2-1,2,1,1,1,3,1,H
1922-12-26,1922,Manchester City,Everton,2-1,2,1,1,1,3,1,H
1922-12-26,1922,Middlesbrough,Newcastle United,1-1,1,1,1,1,2,0,D
1922-12-26,1922,Nottingham Forest,Chelsea,0-4,0,4,1,1,4,-4,A
1922-12-26,1922,Preston North End,Blackburn Rovers,1-0,1,0,1,1,1,1,H
1922-12-26,1922,Sheffield United,Tottenham Hotspur,2-0,2,0,1,1,2,2,H
1922-12-26,1922,Stoke City,Sunderland,1-2,1,2,1,1,3,-1,A
1922-12-27,1922,West Bromwich Albion,Cardiff City,3-0,3,0,1,1,3,3,H
1922-12-30,1922,Arsenal,Stoke City,3-0,3,0,1,1,3,3,H
1922-12-30,1922,Aston Villa,Preston North End,1-0,1,0,1,1,1,1,H
1922-12-30,1922,Blackburn Rovers,West Bromwich Albion,5-1,5,1,1,1,6,4,H
1922-12-30,1922,Bolton Wanderers,Cardiff City,0-0,0,0,1,1,0,0,D
1922-12-30,1922,Chelsea,Liverpool,0-0,0,0,1,1,0,0,D
1922-12-30,1922,Everton,Huddersfield Town,0-3,0,3,1,1,3,-3,A
1922-12-30,1922,Manchester City,Oldham Athletic,3-2,3,2,1,1,5,1,H
1922-12-30,1922,Middlesbrough,Tottenham Hotspur,2-0,2,0,1,1,2,2,H
1922-12-30,1922,Nottingham Forest,Newcastle United,0-1,0,1,1,1,1,-1,A
1922-12-30,1922,Sheffield United,Burnley,2-1,2,1,1,1,3,1,H
1922-12-30,1922,Sunderland,Birmingham City,5-3,5,3,1,1,8,2,H
1923-01-01,1922,Blackburn Rovers,Arsenal,0-5,0,5,1,1,5,-5,A
1923-01-01,1922,Everton,Tottenham Hotspur,3-1,3,1,1,1,4,2,H
1923-01-01,1922,Newcastle United,Oldham Athletic,1-0,1,0,1,1,1,1,H
1923-01-01,1922,Sunderland,Stoke City,2-0,2,0,1,1,2,2,H
1923-01-02,1922,Bolton Wanderers,Nottingham Forest,4-2,4,2,1,1,6,2,H
1923-01-06,1922,Birmingham City,Sunderland,1-2,1,2,1,1,3,-1,A
1923-01-06,1922,Burnley,Sheffield United,1-4,1,4,1,1,5,-3,A
1923-01-06,1922,Cardiff City,Bolton Wanderers,1-0,1,0,1,1,1,1,H
1923-01-06,1922,Huddersfield Town,Everton,1-0,1,0,1,1,1,1,H
1923-01-06,1922,Liverpool,Chelsea,1-0,1,0,1,1,1,1,H
1923-01-06,1922,Newcastle United,Nottingham Forest,1-0,1,0,1,1,1,1,H
1923-01-06,1922,Oldham Athletic,Manchester City,0-3,0,3,1,1,3,-3,A
1923-01-06,1922,Preston North End,Aston Villa,3-2,3,2,1,1,5,1,H
1923-01-06,1922,Stoke City,Arsenal,1-0,1,0,1,1,1,1,H
1923-01-06,1922,Tottenham Hotspur,Middlesbrough,2-0,2,0,1,1,2,2,H
1923-01-06,1922,West Bromwich Albion,Blackburn Rovers,3-0,3,0,1,1,3,3,H
1923-01-20,1922,Arsenal,Manchester City,1-0,1,0,1,1,1,1,H
1923-01-20,1922,Birmingham City,West Bromwich Albion,0-2,0,2,1,1,2,-2,A
1923-01-20,1922,Blackburn Rovers,Cardiff City,3-1,3,1,1,1,4,2,H
1923-01-20,1922,Bolton Wanderers,Sheffield United,1-1,1,1,1,1,2,0,D
1923-01-20,1922,Burnley,Preston North End,2-0,2,0,1,1,2,2,H
1923-01-20,1922,Chelsea,Newcastle United,3-0,3,0,1,1,3,3,H
1923-01-20,1922,Everton,Stoke City,4-0,4,0,1,1,4,4,H
1923-01-20,1922,Middlesbrough,Liverpool,0-2,0,2,1,1,2,-2,A
1923-01-20,1922,Nottingham Forest,Aston Villa,3-1,3,1,1,1,4,2,H
1923-01-20,1922,Oldham Athletic,Tottenham Hotspur,0-3,0,3,1,1,3,-3,A
1923-01-20,1922,Sunderland,Huddersfield Town,1-1,1,1,1,1,2,0,D
1923-01-22,1922,Blackburn Rovers,Stoke City,1-5,1,5,1,1,6,-4,A
1923-01-27,1922,Aston Villa,Nottingham Forest,4-0,4,0,1,1,4,4,H
1923-01-27,1922,Cardiff City,Blackburn Rovers,5-0,5,0,1,1,5,5,H
1923-01-27,1922,Huddersfield Town,Sunderland,0-1,0,1,1,1,1,-1,A
1923-01-27,1922,Liverpool,Middlesbrough,2-0,2,0,1,1,2,2,H
1923-01-27,1922,Manchester City,Arsenal,0-0,0,0,1,1,0,0,D
1923-01-27,1922,Newcastle United,Chelsea,0-0,0,0,1,1,0,0,D
1923-01-27,1922,Preston North End,Burnley,3-1,3,1,1,1,4,2,H
1923-01-27,1922,Sheffield United,Bolton Wanderers,2-2,2,2,1,1,4,0,D
1923-01-27,1922,Stoke City,Everton,4-1,4,1,1,1,5,3,H
1923-01-27,1922,Tottenham Hotspur,Oldham Athletic,3-0,3,0,1,1,3,3,H
1923-01-27,1922,West Bromwich Albion,Birmingham City,1-0,1,0,1,1,1,1,H
1923-02-03,1922,Aston Villa,Manchester City,2-0,2,0,1,1,2,2,H
1923-02-03,1922,Nottingham Forest,Arsenal,2-1,2,1,1,1,3,1,H
1923-02-03,1922,Oldham Athletic,Birmingham City,2-0,2,0,1,1,2,2,H
1923-02-07,1922,Liverpool,West Bromwich Albion,2-0,2,0,1,1,2,2,H
1923-02-08,1922,Preston North End,Stoke City,4-2,4,2,1,1,6,2,H
1923-02-10,1922,Arsenal,Nottingham Forest,2-0,2,0,1,1,2,2,H
1923-02-10,1922,Birmingham City,Oldham Athletic,2-3,2,3,1,1,5,-1,A
1923-02-10,1922,Blackburn Rovers,Tottenham Hotspur,1-0,1,0,1,1,1,1,H
1923-02-10,1922,Bolton Wanderers,Burnley,2-1,2,1,1,1,3,1,H
1923-02-10,1922,Cardiff City,Newcastle United,5-0,5,0,1,1,5,5,H
1923-02-10,1922,Everton,Chelsea,3-1,3,1,1,1,4,2,H
1923-02-10,1922,Huddersfield Town,Sheffield United,2-1,2,1,1,1,3,1,H
1923-02-10,1922,Manchester City,Aston Villa,1-1,1,1,1,1,2,0,D
1923-02-10,1922,Stoke City,Preston North End,4-2,4,2,1,1,6,2,H
1923-02-10,1922,Sunderland,Middlesbrough,2-1,2,1,1,1,3,1,H
1923-02-10,1922,West Bromwich Albion,Liverpool,0-0,0,0,1,1,0,0,D
1923-02-14,1922,Chelsea,Everton,3-1,3,1,1,1,4,2,H
1923-02-14,1922,Newcastle United,West Bromwich Albion,2-0,2,0,1,1,2,2,H
1923-02-14,1922,Tottenham Hotspur,Blackburn Rovers,2-0,2,0,1,1,2,2,H
1923-02-17,1922,Aston Villa,Stoke City,6-0,6,0,1,1,6,6,H
1923-02-17,1922,Burnley,Manchester City,2-0,2,0,1,1,2,2,H
1923-02-17,1922,Chelsea,Arsenal,0-0,0,0,1,1,0,0,D
1923-02-17,1922,Liverpool,Blackburn Rovers,3-0,3,0,1,1,3,3,H
1923-02-17,1922,Middlesbrough,Everton,2-4,2,4,1,1,6,-2,A
1923-02-17,1922,Nottingham Forest,Cardiff City,3-2,3,2,1,1,5,1,H
1923-02-17,1922,Oldham Athletic,Sunderland,0-0,0,0,1,1,0,0,D
1923-02-17,1922,Preston North End,Huddersfield Town,1-0,1,0,1,1,1,1,H
1923-02-17,1922,Sheffield United,Birmingham City,7-1,7,1,1,1,8,6,H
1923-02-17,1922,Tottenham Hotspur,Bolton Wanderers,0-1,0,1,1,1,1,-1,A
1923-02-24,1922,Arsenal,Chelsea,3-1,3,1,1,1,4,2,H
1923-02-24,1922,Manchester City,Burnley,1-0,1,0,1,1,1,1,H
1923-02-24,1922,Stoke City,Aston Villa,1-1,1,1,1,1,2,0,D
1923-02-24,1922,Sunderland,Oldham Athletic,2-0,2,0,1,1,2,2,H
1923-02-28,1922,Everton,Middlesbrough,5-3,5,3,1,1,8,2,H
1923-02-28,1922,Newcastle United,Cardiff City,3-1,3,1,1,1,4,2,H
1923-03-03,1922,Aston Villa,Huddersfield Town,2-1,2,1,1,1,3,1,H
1923-03-03,1922,Burnley,Stoke City,3-2,3,2,1,1,5,1,H
1923-03-03,1922,Chelsea,Cardiff City,1-1,1,1,1,1,2,0,D
1923-03-03,1922,Liverpool,Bolton Wanderers,3-0,3,0,1,1,3,3,H
1923-03-03,1922,Middlesbrough,Arsenal,2-0,2,0,1,1,2,2,H
1923-03-03,1922,Newcastle United,Blackburn Rovers,5-1,5,1,1,1,6,4,H
1923-03-03,1922,Nottingham Forest,West Bromwich Albion,0-4,0,4,1,1,4,-4,A
1923-03-03,1922,Oldham Athletic,Everton,1-0,1,0,1,1,1,1,H
1923-03-03,1922,Preston North End,Birmingham City,2-3,2,3,1,1,5,-1,A
1923-03-03,1922,Sheffield United,Sunderland,3-1,3,1,1,1,4,2,H
1923-03-03,1922,Tottenham Hotspur,Manchester City,3-1,3,1,1,1,4,2,H
1923-03-10,1922,Arsenal,Middlesbrough,3-0,3,0,1,1,3,3,H
1923-03-10,1922,Birmingham City,Preston North End,1-0,1,0,1,1,1,1,H
1923-03-10,1922,Blackburn Rovers,Newcastle United,1-1,1,1,1,1,2,0,D
1923-03-10,1922,Cardiff City,Chelsea,6-1,6,1,1,1,7,5,H
1923-03-10,1922,Everton,Oldham Athletic,0-0,0,0,1,1,0,0,D
1923-03-10,1922,Huddersfield Town,Aston Villa,3-5,3,5,1,1,8,-2,A
1923-03-10,1922,Stoke City,Burnley,0-1,0,1,1,1,1,-1,A
1923-03-10,1922,West Bromwich Albion,Nottingham Forest,0-0,0,0,1,1,0,0,D
1923-03-12,1922,Birmingham City,Sheffield United,4-2,4,2,1,1,6,2,H
1923-03-12,1922,Blackburn Rovers,Liverpool,1-0,1,0,1,1,1,1,H
1923-03-12,1922,Burnley,Bolton Wanderers,2-1,2,1,1,1,3,1,H
1923-03-14,1922,Manchester City,Tottenham Hotspur,3-0,3,0,1,1,3,3,H
1923-03-14,1922,West Bromwich Albion,Newcastle United,2-1,2,1,1,1,3,1,H
1923-03-17,1922,Arsenal,Oldham Athletic,2-0,2,0,1,1,2,2,H
1923-03-17,1922,Birmingham City,Aston Villa,1-0,1,0,1,1,1,1,H
1923-03-17,1922,Blackburn Rovers,Nottingham Forest,2-0,2,0,1,1,2,2,H
1923-03-17,1922,Bolton Wanderers,Newcastle United,1-0,1,0,1,1,1,1,H
1923-03-17,1922,Cardiff City,Middlesbrough,2-0,2,0,1,1,2,2,H
1923-03-17,1922,Everton,Sheffield United,5-1,5,1,1,1,6,4,H
1923-03-17,1922,Huddersfield Town,Burnley,2-0,2,0,1,1,2,2,H
1923-03-17,1922,Manchester City,Liverpool,1-0,1,0,1,1,1,1,H
1923-03-17,1922,Stoke City,Tottenham Hotspur,0-0,0,0,1,1,0,0,D
1923-03-17,1922,Sunderland,Preston North End,2-2,2,2,1,1,4,0,D
1923-03-17,1922,West Bromwich Albion,Chelsea,0-0,0,0,1,1,0,0,D
1923-03-21,1922,Huddersfield Town,Preston North End,2-0,2,0,1,1,2,2,H
1923-03-24,1922,Aston Villa,Birmingham City,3-0,3,0,1,1,3,3,H
1923-03-24,1922,Burnley,Huddersfield Town,0-2,0,2,1,1,2,-2,A
1923-03-24,1922,Liverpool,Manchester City,2-0,2,0,1,1,2,2,H
1923-03-24,1922,Middlesbrough,Cardiff City,0-1,0,1,1,1,1,-1,A
1923-03-24,1922,Nottingham Forest,Blackburn Rovers,1-0,1,0,1,1,1,1,H
1923-03-24,1922,Oldham Athletic,Arsenal,0-0,0,0,1,1,0,0,D
1923-03-24,1922,Preston North End,Sunderland,2-0,2,0,1,1,2,2,H
1923-03-24,1922,Tottenham Hotspur,Stoke City,3-1,3,1,1,1,4,2,H
1923-03-30,1922,Aston Villa,Chelsea,1-0,1,0,1,1,1,1,H
1923-03-30,1922,Bolton Wanderers,Everton,0-2,0,2,1,1,2,-2,A
1923-03-30,1922,Burnley,Cardiff City,1-5,1,5,1,1,6,-4,A
1923-03-30,1922,Liverpool,Sheffield United,2-1,2,1,1,1,3,1,H
1923-03-30,1922,Nottingham Forest,Middlesbrough,2-1,2,1,1,1,3,1,H
1923-03-30,1922,Oldham Athletic,Newcastle United,0-0,0,0,1,1,0,0,D
1923-03-30,1922,Sunderland,Manchester City,2-0,2,0,1,1,2,2,H
1923-03-30,1922,Tottenham Hotspur,Preston North End,1-1,1,1,1,1,2,0,D
1923-03-31,1922,Arsenal,Aston Villa,2-0,2,0,1,1,2,2,H
1923-03-31,1922,Birmingham City,Liverpool,0-1,0,1,1,1,1,-1,A
1923-03-31,1922,Blackburn Rovers,Oldham Athletic,1-0,1,0,1,1,1,1,H
1923-03-31,1922,Bolton Wanderers,Middlesbrough,1-1,1,1,1,1,2,0,D
1923-03-31,1922,Cardiff City,Preston North End,1-0,1,0,1,1,1,1,H
1923-03-31,1922,Everton,Burnley,1-0,1,0,1,1,1,1,H
1923-03-31,1922,Huddersfield Town,Newcastle United,2-0,2,0,1,1,2,2,H
1923-03-31,1922,Manchester City,Chelsea,3-0,3,0,1,1,3,3,H
1923-03-31,1922,Stoke City,Nottingham Forest,0-1,0,1,1,1,1,-1,A
1923-03-31,1922,Sunderland,Tottenham Hotspur,2-0,2,0,1,1,2,2,H
1923-03-31,1922,West Bromwich Albion,Sheffield United,4-0,4,0,1,1,4,4,H
1923-04-02,1922,Arsenal,Blackburn Rovers,1-1,1,1,1,1,2,0,D
1923-04-02,1922,Cardiff City,Burnley,2-2,2,2,1,1,4,0,D
1923-04-02,1922,Chelsea,Aston Villa,1-1,1,1,1,1,2,0,D
1923-04-02,1922,Everton,Bolton Wanderers,1-1,1,1,1,1,2,0,D
1923-04-02,1922,Manchester City,Sunderland,1-0,1,0,1,1,1,1,H
1923-04-02,1922,Middlesbrough,Nottingham Forest,4-0,4,0,1,1,4,4,H
1923-04-02,1922,Preston North End,Tottenham Hotspur,2-0,2,0,1,1,2,2,H
1923-04-02,1922,Sheffield United,Liverpool,4-1,4,1,1,1,5,3,H
1923-04-02,1922,Stoke City,Birmingham City,0-0,0,0,1,1,0,0,D
1923-04-02,1922,West Bromwich Albion,Huddersfield Town,0-2,0,2,1,1,2,-2,A
1923-04-03,1922,Huddersfield Town,West Bromwich Albion,4-1,4,1,1,1,5,3,H
1923-04-07,1922,Aston Villa,Arsenal,1-1,1,1,1,1,2,0,D
1923-04-07,1922,Burnley,Everton,0-1,0,1,1,1,1,-1,A
1923-04-07,1922,Chelsea,Manchester City,1-1,1,1,1,1,2,0,D
1923-04-07,1922,Liverpool,Birmingham City,0-0,0,0,1,1,0,0,D
1923-04-07,1922,Middlesbrough,Bolton Wanderers,1-2,1,2,1,1,3,-1,A
1923-04-07,1922,Newcastle United,Huddersfield Town,1-0,1,0,1,1,1,1,H
1923-04-07,1922,Nottingham Forest,Stoke City,0-1,0,1,1,1,1,-1,A
1923-04-07,1922,Oldham Athletic,Blackburn Rovers,1-0,1,0,1,1,1,1,H
1923-04-07,1922,Preston North End,Cardiff City,3-0,3,0,1,1,3,3,H
1923-04-07,1922,Sheffield United,West Bromwich Albion,3-1,3,1,1,1,4,2,H
1923-04-07,1922,Tottenham Hotspur,Sunderland,0-1,0,1,1,1,1,-1,A
1923-04-09,1922,Sheffield United,Huddersfield Town,0-2,0,2,1,1,2,-2,A
1923-04-11,1922,Bolton Wanderers,Tottenham Hotspur,0-2,0,2,1,1,2,-2,A
1923-04-11,1922,Sunderland,Sheffield United,3-5,3,5,1,1,8,-2,A
1923-04-14,1922,Arsenal,Preston North End,1-1,1,1,1,1,2,0,D
1923-04-14,1922,Birmingham City,Tottenham Hotspur,2-1,2,1,1,1,3,1,H
1923-04-14,1922,Blackburn Rovers,Middlesbrough,2-0,2,0,1,1,2,2,H
1923-04-14,1922,Bolton Wanderers,Chelsea,1-1,1,1,1,1,2,0,D
1923-04-14,1922,Cardiff City,Sheffield United,1-0,1,0,1,1,1,1,H
1923-04-14,1922,Everton,Aston Villa,2-1,2,1,1,1,3,1,H
1923-04-14,1922,Huddersfield Town,Liverpool,0-0,0,0,1,1,0,0,D
1923-04-14,1922,Manchester City,Nottingham Forest,1-1,1,1,1,1,2,0,D
1923-04-14,1922,Stoke City,Newcastle United,1-0,1,0,1,1,1,1,H
1923-04-14,1922,Sunderland,Burnley,3-1,3,1,1,1,4,2,H
1923-04-14,1922,West Bromwich Albion,Oldham Athletic,1-0,1,0,1,1,1,1,H
1923-04-16,1922,Newcastle United,Bolton Wanderers,1-0,1,0,1,1,1,1,H
1923-04-16,1922,Sheffield United,Everton,0-1,0,1,1,1,1,-1,A
1923-04-18,1922,Bolton Wanderers,Liverpool,1-1,1,1,1,1,2,0,D
1923-04-18,1922,Middlesbrough,Sunderland,2-0,2,0,1,1,2,2,H
1923-04-21,1922,Aston Villa,Everton,3-0,3,0,1,1,3,3,H
1923-04-21,1922,Burnley,Sunderland,2-0,2,0,1,1,2,2,H
1923-04-21,1922,Chelsea,Bolton Wanderers,3-0,3,0,1,1,3,3,H
1923-04-21,1922,Liverpool,Huddersfield Town,1-1,1,1,1,1,2,0,D
1923-04-21,1922,Middlesbrough,Blackburn Rovers,1-2,1,2,1,1,3,-1,A
1923-04-21,1922,Newcastle United,Stoke City,1-0,1,0,1,1,1,1,H
1923-04-21,1922,Nottingham Forest,Manchester City,2-0,2,0,1,1,2,2,H
1923-04-21,1922,Oldham Athletic,West Bromwich Albion,0-0,0,0,1,1,0,0,D
1923-04-21,1922,Preston North End,Arsenal,1-2,1,2,1,1,3,-1,A
1923-04-21,1922,Sheffield United,Cardiff City,0-0,0,0,1,1,0,0,D
1923-04-21,1922,Tottenham Hotspur,Birmingham City,2-0,2,0,1,1,2,2,H
1923-04-25,1922,Cardiff City,Nottingham Forest,3-1,3,1,1,1,4,2,H
1923-04-25,1922,Chelsea,West Bromwich Albion,2-2,2,2,1,1,4,0,D
1923-04-28,1922,Arsenal,Sheffield United,2-0,2,0,1,1,2,2,H
1923-04-28,1922,Birmingham City,Burnley,1-0,1,0,1,1,1,1,H
1923-04-28,1922,Blackburn Rovers,Chelsea,0-0,0,0,1,1,0,0,D
1923-04-28,1922,Cardiff City,Oldham Athletic,2-0,2,0,1,1,2,2,H
1923-04-28,1922,Everton,Preston North End,1-0,1,0,1,1,1,1,H
1923-04-28,1922,Huddersfield Town,Tottenham Hotspur,1-0,1,0,1,1,1,1,H
1923-04-28,1922,Manchester City,Newcastle United,0-0,0,0,1,1,0,0,D
1923-04-28,1922,Stoke City,Liverpool,0-0,0,0,1,1,0,0,D
1923-04-28,1922,Sunderland,Aston Villa,2-0,2,0,1,1,2,2,H
1923-04-28,1922,West Bromwich Albion,Middlesbrough,1-0,1,0,1,1,1,1,H
1923-05-05,1922,Aston Villa,Sunderland,1-0,1,0,1,1,1,1,H
1923-05-05,1922,Burnley,Birmingham City,0-2,0,2,1,1,2,-2,A
1923-05-05,1922,Chelsea,Blackburn Rovers,1-1,1,1,1,1,2,0,D
1923-05-05,1922,Liverpool,Stoke City,1-0,1,0,1,1,1,1,H
1923-05-05,1922,Middlesbrough,West Bromwich Albion,0-1,0,1,1,1,1,-1,A
1923-05-05,1922,Newcastle United,Manchester City,3-1,3,1,1,1,4,2,H
1923-05-05,1922,Oldham Athletic,Cardiff City,3-1,3,1,1,1,4,2,H
1923-05-05,1922,Preston North End,Everton,2-2,2,2,1,1,4,0,D
1923-05-05,1922,Tottenham Hotspur,Huddersfield Town,0-0,0,0,1,1,0,0,D
1923-08-25,1923,Arsenal,Newcastle United,1-4,1,4,1,1,5,-3,A
1923-08-25,1923,Birmingham City,Aston Villa,3-0,3,0,1,1,3,3,H
1923-08-25,1923,Blackburn Rovers,Chelsea,3-0,3,0,1,1,3,3,H
1923-08-25,1923,Cardiff City,Bolton Wanderers,3-2,3,2,1,1,5,1,H
1923-08-25,1923,Everton,Nottingham Forest,2-1,2,1,1,1,3,1,H
1923-08-25,1923,Huddersfield Town,Middlesbrough,1-0,1,0,1,1,1,1,H
1923-08-25,1923,Manchester City,Sheffield United,2-1,2,1,1,1,3,1,H
1923-08-25,1923,Notts County,Burnley,2-1,2,1,1,1,3,1,H
1923-08-25,1923,Sunderland,West Ham United,0-0,0,0,1,1,0,0,D
1923-08-25,1923,Tottenham Hotspur,Preston North End,2-0,2,0,1,1,2,2,H
1923-08-25,1923,West Bromwich Albion,Liverpool,2-0,2,0,1,1,2,2,H
1923-08-27,1923,Burnley,Everton,2-2,2,2,1,1,4,0,D
1923-08-27,1923,Cardiff City,Sunderland,2-1,2,1,1,1,3,1,H
1923-08-27,1923,Chelsea,Tottenham Hotspur,0-1,0,1,1,1,1,-1,A
1923-08-27,1923,Nottingham Forest,West Bromwich Albion,1-1,1,1,1,1,2,0,D
1923-08-27,1923,Preston North End,Huddersfield Town,1-3,1,3,1,1,4,-2,A
1923-08-27,1923,Sheffield United,Bolton Wanderers,0-0,0,0,1,1,0,0,D
1923-08-27,1923,West Ham United,Arsenal,1-0,1,0,1,1,1,1,H
1923-08-29,1923,Aston Villa,Manchester City,2-0,2,0,1,1,2,2,H
1923-08-29,1923,Liverpool,Birmingham City,6-2,6,2,1,1,8,4,H
1923-08-29,1923,Middlesbrough,Notts County,2-3,2,3,1,1,5,-1,A
1923-08-29,1923,Newcastle United,Blackburn Rovers,2-1,2,1,1,1,3,1,H
1923-09-01,1923,Aston Villa,Birmingham City,0-0,0,0,1,1,0,0,D
1923-09-01,1923,Bolton Wanderers,Cardiff City,2-2,2,2,1,1,4,0,D
1923-09-01,1923,Burnley,Notts County,1-1,1,1,1,1,2,0,D
1923-09-01,1923,Chelsea,Blackburn Rovers,2-0,2,0,1,1,2,2,H
1923-09-01,1923,Liverpool,West Bromwich Albion,0-0,0,0,1,1,0,0,D
1923-09-01,1923,Middlesbrough,Huddersfield Town,2-0,2,0,1,1,2,2,H
1923-09-01,1923,Newcastle United,Arsenal,1-0,1,0,1,1,1,1,H
1923-09-01,1923,Nottingham Forest,Everton,1-0,1,0,1,1,1,1,H
1923-09-01,1923,Preston North End,Tottenham Hotspur,2-2,2,2,1,1,4,0,D
1923-09-01,1923,Sheffield United,Manchester City,3-0,3,0,1,1,3,3,H
1923-09-01,1923,West Ham United,Sunderland,0-1,0,1,1,1,1,-1,A
1923-09-03,1923,Bolton Wanderers,Sheffield United,4-2,4,2,1,1,6,2,H
1923-09-03,1923,Everton,Burnley,3-3,3,3,1,1,6,0,D
1923-09-03,1923,Tottenham Hotspur,Chelsea,0-1,0,1,1,1,1,-1,A
1923-09-03,1923,West Bromwich Albion,Nottingham Forest,3-2,3,2,1,1,5,1,H
1923-09-04,1923,Huddersfield Town,Preston North End,4-0,4,0,1,1,4,4,H
1923-09-05,1923,Birmingham City,Liverpool,2-1,2,1,1,1,3,1,H
1923-09-05,1923,Manchester City,Aston Villa,1-2,1,2,1,1,3,-1,A
1923-09-05,1923,Sunderland,Cardiff City,0-3,0,3,1,1,3,-3,A
1923-09-08,1923,Birmingham City,Sunderland,0-2,0,2,1,1,2,-2,A
1923-09-08,1923,Burnley,Nottingham Forest,2-4,2,4,1,1,6,-2,A
1923-09-08,1923,Chelsea,Aston Villa,0-0,0,0,1,1,0,0,D
1923-09-08,1923,Everton,Blackburn Rovers,0-0,0,0,1,1,0,0,D
1923-09-08,1923,Manchester City,Bolton Wanderers,1-1,1,1,1,1,2,0,D
1923-09-08,1923,Newcastle United,Sheffield United,2-2,2,2,1,1,4,0,D
1923-09-08,1923,Notts County,Huddersfield Town,1-0,1,0,1,1,1,1,H
1923-09-08,1923,Preston North End,Liverpool,0-1,0,1,1,1,1,-1,A
1923-09-08,1923,Tottenham Hotspur,Middlesbrough,2-1,2,1,1,1,3,1,H
1923-09-08,1923,West Bromwich Albion,Arsenal,4-0,4,0,1,1,4,4,H
1923-09-08,1923,West Ham United,Cardiff City,0-0,0,0,1,1,0,0,D
1923-09-10,1923,Arsenal,West Ham United,4-1,4,1,1,1,5,3,H
1923-09-10,1923,Birmingham City,Bolton Wanderers,0-3,0,3,1,1,3,-3,A
1923-09-12,1923,Aston Villa,Everton,1-1,1,1,1,1,2,0,D
1923-09-12,1923,Newcastle United,Bolton Wanderers,1-0,1,0,1,1,1,1,H
1923-09-15,1923,Arsenal,West Bromwich Albion,1-0,1,0,1,1,1,1,H
1923-09-15,1923,Aston Villa,Chelsea,0-0,0,0,1,1,0,0,D
1923-09-15,1923,Blackburn Rovers,Everton,2-0,2,0,1,1,2,2,H
1923-09-15,1923,Bolton Wanderers,Manchester City,0-0,0,0,1,1,0,0,D
1923-09-15,1923,Cardiff City,West Ham United,1-0,1,0,1,1,1,1,H
1923-09-15,1923,Huddersfield Town,Notts County,0-0,0,0,1,1,0,0,D
1923-09-15,1923,Liverpool,Preston North End,3-1,3,1,1,1,4,2,H
1923-09-15,1923,Middlesbrough,Tottenham Hotspur,0-1,0,1,1,1,1,-1,A
1923-09-15,1923,Nottingham Forest,Burnley,0-0,0,0,1,1,0,0,D
1923-09-15,1923,Sheffield United,Newcastle United,2-1,2,1,1,1,3,1,H
1923-09-15,1923,Sunderland,Birmingham City,1-1,1,1,1,1,2,0,D
1923-09-17,1923,Blackburn Rovers,Newcastle United,2-1,2,1,1,1,3,1,H
1923-09-19,1923,Everton,Aston Villa,2-0,2,0,1,1,2,2,H
1923-09-22,1923,Birmingham City,Arsenal,0-2,0,2,1,1,2,-2,A
1923-09-22,1923,Burnley,Liverpool,2-0,2,0,1,1,2,2,H
1923-09-22,1923,Chelsea,Sheffield United,1-1,1,1,1,1,2,0,D
1923-09-22,1923,Everton,Huddersfield Town,1-1,1,1,1,1,2,0,D
1923-09-22,1923,Manchester City,Sunderland,4-1,4,1,1,1,5,3,H
1923-09-22,1923,Newcastle United,Cardiff City,1-1,1,1,1,1,2,0,D
1923-09-22,1923,Notts County,Nottingham Forest,2-1,2,1,1,1,3,1,H
1923-09-22,1923,Preston North End,Aston Villa,2-2,2,2,1,1,4,0,D
1923-09-22,1923,Tottenham Hotspur,Bolton Wanderers,0-0,0,0,1,1,0,0,D
1923-09-22,1923,West Bromwich Albion,Blackburn Rovers,3-3,3,3,1,1,6,0,D
1923-09-22,1923,West Ham United,Middlesbrough,1-1,1,1,1,1,2,0,D
1923-09-29,1923,Arsenal,Birmingham City,0-0,0,0,1,1,0,0,D
1923-09-29,1923,Aston Villa,Preston North End,5-1,5,1,1,1,6,4,H
1923-09-29,1923,Blackburn Rovers,West Bromwich Albion,4-0,4,0,1,1,4,4,H
1923-09-29,1923,Bolton Wanderers,Tottenham Hotspur,3-1,3,1,1,1,4,2,H
1923-09-29,1923,Cardiff City,Newcastle United,1-0,1,0,1,1,1,1,H
1923-09-29,1923,Huddersfield Town,Everton,2-0,2,0,1,1,2,2,H
1923-09-29,1923,Liverpool,Burnley,1-0,1,0,1,1,1,1,H
1923-09-29,1923,Middlesbrough,West Ham United,0-1,0,1,1,1,1,-1,A
1923-09-29,1923,Nottingham Forest,Notts County,1-0,1,0,1,1,1,1,H
1923-09-29,1923,Sheffield United,Chelsea,1-0,1,0,1,1,1,1,H
1923-09-29,1923,Sunderland,Manchester City,5-2,5,2,1,1,7,3,H
1923-10-04,1923,Notts County,Middlesbrough,1-0,1,0,1,1,1,1,H
1923-10-06,1923,Birmingham City,Blackburn Rovers,1-1,1,1,1,1,2,0,D
1923-10-06,1923,Burnley,Aston Villa,1-2,1,2,1,1,3,-1,A
1923-10-06,1923,Chelsea,Cardiff City,1-2,1,2,1,1,3,-1,A
1923-10-06,1923,Everton,Liverpool,1-0,1,0,1,1,1,1,H
1923-10-06,1923,Manchester City,Arsenal,1-0,1,0,1,1,1,1,H
1923-10-06,1923,Middlesbrough,Nottingham Forest,5-2,5,2,1,1,7,3,H
1923-10-06,1923,Notts County,Tottenham Hotspur,0-0,0,0,1,1,0,0,D
1923-10-06,1923,Preston North End,Sheffield United,1-1,1,1,1,1,2,0,D
1923-10-06,1923,Sunderland,Bolton Wanderers,2-2,2,2,1,1,4,0,D
1923-10-06,1923,West Bromwich Albion,Huddersfield Town,2-4,2,4,1,1,6,-2,A
1923-10-06,1923,West Ham United,Newcastle United,1-0,1,0,1,1,1,1,H
1923-10-13,1923,Arsenal,Manchester City,1-2,1,2,1,1,3,-1,A
1923-10-13,1923,Aston Villa,Burnley,1-1,1,1,1,1,2,0,D
1923-10-13,1923,Blackburn Rovers,Birmingham City,4-1,4,1,1,1,5,3,H
1923-10-13,1923,Bolton Wanderers,Sunderland,1-0,1,0,1,1,1,1,H
1923-10-13,1923,Cardiff City,Chelsea,1-1,1,1,1,1,2,0,D
1923-10-13,1923,Huddersfield Town,West Bromwich Albion,0-0,0,0,1,1,0,0,D
1923-10-13,1923,Liverpool,Everton,1-2,1,2,1,1,3,-1,A
1923-10-13,1923,Newcastle United,West Ham United,0-0,0,0,1,1,0,0,D
1923-10-13,1923,Nottingham Forest,Middlesbrough,3-1,3,1,1,1,4,2,H
1923-10-13,1923,Sheffield United,Preston North End,4-0,4,0,1,1,4,4,H
1923-10-13,1923,Tottenham Hotspur,Notts County,1-3,1,3,1,1,4,-2,A
1923-10-17,1923,Sunderland,Chelsea,2-0,2,0,1,1,2,2,H
1923-10-20,1923,Birmingham City,Huddersfield Town,0-1,0,1,1,1,1,-1,A
1923-10-20,1923,Blackburn Rovers,Manchester City,0-1,0,1,1,1,1,-1,A
1923-10-20,1923,Bolton Wanderers,Arsenal,1-2,1,2,1,1,3,-1,A
1923-10-20,1923,Cardiff City,Preston North End,1-1,1,1,1,1,2,0,D
1923-10-20,1923,Chelsea,West Ham United,0-0,0,0,1,1,0,0,D
1923-10-20,1923,Liverpool,Nottingham Forest,4-2,4,2,1,1,6,2,H
1923-10-20,1923,Middlesbrough,Newcastle United,1-0,1,0,1,1,1,1,H
1923-10-20,1923,Notts County,Everton,1-1,1,1,1,1,2,0,D
1923-10-20,1923,Sheffield United,Burnley,2-1,2,1,1,1,3,1,H
1923-10-20,1923,Sunderland,Tottenham Hotspur,1-0,1,0,1,1,1,1,H
1923-10-20,1923,West Bromwich Albion,Aston Villa,1-0,1,0,1,1,1,1,H
1923-10-27,1923,Arsenal,Bolton Wanderers,0-0,0,0,1,1,0,0,D
1923-10-27,1923,Aston Villa,West Bromwich Albion,4-0,4,0,1,1,4,4,H
1923-10-27,1923,Burnley,Sheffield United,2-0,2,0,1,1,2,2,H
1923-10-27,1923,Everton,Notts County,3-0,3,0,1,1,3,3,H
1923-10-27,1923,Huddersfield Town,Birmingham City,1-0,1,0,1,1,1,1,H
1923-10-27,1923,Manchester City,Blackburn Rovers,3-1,3,1,1,1,4,2,H
1923-10-27,1923,Newcastle United,Middlesbrough,3-2,3,2,1,1,5,1,H
1923-10-27,1923,Nottingham Forest,Liverpool,0-1,0,1,1,1,1,-1,A
1923-10-27,1923,Preston North End,Cardiff City,3-1,3,1,1,1,4,2,H
1923-10-27,1923,Tottenham Hotspur,Sunderland,1-1,1,1,1,1,2,0,D
1923-10-27,1923,West Ham United,Chelsea,2-0,2,0,1,1,2,2,H
1923-11-03,1923,Arsenal,Middlesbrough,2-1,2,1,1,1,3,1,H
1923-11-03,1923,Aston Villa,Notts County,0-0,0,0,1,1,0,0,D
1923-11-03,1923,Blackburn Rovers,Burnley,1-1,1,1,1,1,2,0,D
1923-11-03,1923,Cardiff City,West Bromwich Albion,3-0,3,0,1,1,3,3,H
1923-11-03,1923,Chelsea,Bolton Wanderers,0-0,0,0,1,1,0,0,D
1923-11-03,1923,Liverpool,Huddersfield Town,1-1,1,1,1,1,2,0,D
1923-11-03,1923,Manchester City,Newcastle United,1-1,1,1,1,1,2,0,D
1923-11-03,1923,Nottingham Forest,Tottenham Hotspur,0-0,0,0,1,1,0,0,D
1923-11-03,1923,Sheffield United,Everton,4-0,4,0,1,1,4,4,H
1923-11-03,1923,Sunderland,Preston North End,2-1,2,1,1,1,3,1,H
1923-11-03,1923,West Ham United,Birmingham City,4-1,4,1,1,1,5,3,H
1923-11-10,1923,Birmingham City,West Ham United,2-0,2,0,1,1,2,2,H
1923-11-10,1923,Bolton Wanderers,Chelsea,4-0,4,0,1,1,4,4,H
1923-11-10,1923,Burnley,Blackburn Rovers,1-2,1,2,1,1,3,-1,A
1923-11-10,1923,Everton,Sheffield United,2-0,2,0,1,1,2,2,H
1923-11-10,1923,Huddersfield Town,Liverpool,3-1,3,1,1,1,4,2,H
1923-11-10,1923,Middlesbrough,Arsenal,0-0,0,0,1,1,0,0,D
1923-11-10,1923,Newcastle United,Manchester City,4-1,4,1,1,1,5,3,H
1923-11-10,1923,Notts County,Aston Villa,0-1,0,1,1,1,1,-1,A
1923-11-10,1923,Preston North End,Sunderland,1-2,1,2,1,1,3,-1,A
1923-11-10,1923,Tottenham Hotspur,Nottingham Forest,3-0,3,0,1,1,3,3,H
1923-11-10,1923,West Bromwich Albion,Cardiff City,2-4,2,4,1,1,6,-2,A
1923-11-17,1923,Arsenal,Tottenham Hotspur,1-1,1,1,1,1,2,0,D
1923-11-17,1923,Aston Villa,Liverpool,0-0,0,0,1,1,0,0,D
1923-11-17,1923,Birmingham City,Notts County,0-0,0,0,1,1,0,0,D
1923-11-17,1923,Bolton Wanderers,Huddersfield Town,3-1,3,1,1,1,4,2,H
1923-11-17,1923,Burnley,West Ham United,5-1,5,1,1,1,6,4,H
1923-11-17,1923,Everton,West Bromwich Albion,2-0,2,0,1,1,2,2,H
1923-11-17,1923,Manchester City,Cardiff City,1-1,1,1,1,1,2,0,D
1923-11-17,1923,Middlesbrough,Chelsea,2-0,2,0,1,1,2,2,H
1923-11-17,1923,Nottingham Forest,Sheffield United,1-2,1,2,1,1,3,-1,A
1923-11-17,1923,Preston North End,Newcastle United,1-2,1,2,1,1,3,-1,A
1923-11-17,1923,Sunderland,Blackburn Rovers,5-1,5,1,1,1,6,4,H
1923-11-24,1923,Blackburn Rovers,Sunderland,3-2,3,2,1,1,5,1,H
1923-11-24,1923,Cardiff City,Manchester City,1-1,1,1,1,1,2,0,D
1923-11-24,1923,Chelsea,Middlesbrough,2-0,2,0,1,1,2,2,H
1923-11-24,1923,Huddersfield Town,Bolton Wanderers,1-0,1,0,1,1,1,1,H
1923-11-24,1923,Liverpool,Aston Villa,0-1,0,1,1,1,1,-1,A
1923-11-24,1923,Newcastle United,Preston North End,3-1,3,1,1,1,4,2,H
1923-11-24,1923,Notts County,Birmingham City,1-1,1,1,1,1,2,0,D
1923-11-24,1923,Sheffield United,Nottingham Forest,0-0,0,0,1,1,0,0,D
1923-11-24,1923,Tottenham Hotspur,Arsenal,3-0,3,0,1,1,3,3,H
1923-11-24,1923,West Bromwich Albion,Everton,5-0,5,0,1,1,5,5,H
1923-11-24,1923,West Ham United,Burnley,0-0,0,0,1,1,0,0,D
1923-12-01,1923,Arsenal,Blackburn Rovers,2-2,2,2,1,1,4,0,D
1923-12-01,1923,Aston Villa,Middlesbrough,0-0,0,0,1,1,0,0,D
1923-12-01,1923,Bolton Wanderers,West Ham United,1-1,1,1,1,1,2,0,D
1923-12-01,1923,Burnley,Newcastle United,3-2,3,2,1,1,5,1,H
1923-12-01,1923,Everton,Birmingham City,2-0,2,0,1,1,2,2,H
1923-12-01,1923,Manchester City,Notts County,1-0,1,0,1,1,1,1,H
1923-12-01,1923,Nottingham Forest,Cardiff City,0-1,0,1,1,1,1,-1,A
1923-12-01,1923,Preston North End,Chelsea,1-1,1,1,1,1,2,0,D
1923-12-01,1923,Sheffield United,Liverpool,1-1,1,1,1,1,2,0,D
1923-12-01,1923,Sunderland,Huddersfield Town,2-1,2,1,1,1,3,1,H
1923-12-01,1923,Tottenham Hotspur,West Bromwich Albion,0-0,0,0,1,1,0,0,D
1923-12-08,1923,Birmingham City,Everton,0-1,0,1,1,1,1,-1,A
1923-12-08,1923,Blackburn Rovers,Arsenal,2-0,2,0,1,1,2,2,H
1923-12-08,1923,Cardiff City,Nottingham Forest,4-1,4,1,1,1,5,3,H
1923-12-08,1923,Chelsea,Preston North End,1-2,1,2,1,1,3,-1,A
1923-12-08,1923,Huddersfield Town,Sunderland,3-2,3,2,1,1,5,1,H
1923-12-08,1923,Liverpool,Sheffield United,2-3,2,3,1,1,5,-1,A
1923-12-08,1923,Middlesbrough,Aston Villa,0-2,0,2,1,1,2,-2,A
1923-12-08,1923,Newcastle United,Burnley,2-0,2,0,1,1,2,2,H
1923-12-08,1923,Notts County,Manchester City,2-0,2,0,1,1,2,2,H
1923-12-08,1923,West Bromwich Albion,Tottenham Hotspur,4-1,4,1,1,1,5,3,H
1923-12-08,1923,West Ham United,Bolton Wanderers,0-1,0,1,1,1,1,-1,A
1923-12-15,1923,Arsenal,Huddersfield Town,1-3,1,3,1,1,4,-2,A
1923-12-15,1923,Bolton Wanderers,Notts County,7-1,7,1,1,1,8,6,H
1923-12-15,1923,Burnley,Chelsea,2-0,2,0,1,1,2,2,H
1923-12-15,1923,Liverpool,Cardiff City,0-2,0,2,1,1,2,-2,A
1923-12-15,1923,Manchester City,Everton,2-1,2,1,1,1,3,1,H
1923-12-15,1923,Nottingham Forest,West Ham United,2-1,2,1,1,1,3,1,H
1923-12-15,1923,Preston North End,Middlesbrough,4-0,4,0,1,1,4,4,H
1923-12-15,1923,Sheffield United,Aston Villa,2-1,2,1,1,1,3,1,H
1923-12-15,1923,Sunderland,Newcastle United,3-2,3,2,1,1,5,1,H
1923-12-15,1923,Tottenham Hotspur,Blackburn Rovers,2-1,2,1,1,1,3,1,H
1923-12-15,1923,West Bromwich Albion,Birmingham City,0-0,0,0,1,1,0,0,D
1923-12-22,1923,Aston Villa,Sheffield United,2-2,2,2,1,1,4,0,D
1923-12-22,1923,Birmingham City,West Bromwich Albion,0-0,0,0,1,1,0,0,D
1923-12-22,1923,Blackburn Rovers,Tottenham Hotspur,0-1,0,1,1,1,1,-1,A
1923-12-22,1923,Cardiff City,Liverpool,2-0,2,0,1,1,2,2,H
1923-12-22,1923,Chelsea,Burnley,3-2,3,2,1,1,5,1,H
1923-12-22,1923,Everton,Manchester City,6-1,6,1,1,1,7,5,H
1923-12-22,1923,Huddersfield Town,Arsenal,6-1,6,1,1,1,7,5,H
1923-12-22,1923,Middlesbrough,Preston North End,1-2,1,2,1,1,3,-1,A
1923-12-22,1923,Newcastle United,Sunderland,0-2,0,2,1,1,2,-2,A
1923-12-22,1923,Notts County,Bolton Wanderers,1-1,1,1,1,1,2,0,D
1923-12-22,1923,West Ham United,Nottingham Forest,3-2,3,2,1,1,5,1,H
1923-12-25,1923,Aston Villa,West Ham United,1-1,1,1,1,1,2,0,D
1923-12-25,1923,Blackburn Rovers,Preston North End,2-0,2,0,1,1,2,2,H
1923-12-25,1923,Bolton Wanderers,West Bromwich Albion,2-0,2,0,1,1,2,2,H
1923-12-25,1923,Burnley,Middlesbrough,0-0,0,0,1,1,0,0,D
1923-12-25,1923,Liverpool,Newcastle United,0-1,0,1,1,1,1,-1,A
1923-12-25,1923,Nottingham Forest,Chelsea,2-0,2,0,1,1,2,2,H
1923-12-25,1923,Sheffield United,Cardiff City,1-1,1,1,1,1,2,0,D
1923-12-25,1923,Tottenham Hotspur,Huddersfield Town,1-0,1,0,1,1,1,1,H
1923-12-26,1923,Birmingham City,Manchester City,3-0,3,0,1,1,3,3,H
1923-12-26,1923,Cardiff City,Sheffield United,3-1,3,1,1,1,4,2,H
1923-12-26,1923,Chelsea,Nottingham Forest,1-1,1,1,1,1,2,0,D
1923-12-26,1923,Everton,Sunderland,2-3,2,3,1,1,5,-1,A
1923-12-26,1923,Huddersfield Town,Tottenham Hotspur,2-1,2,1,1,1,3,1,H
1923-12-26,1923,Middlesbrough,Burnley,3-0,3,0,1,1,3,3,H
1923-12-26,1923,Newcastle United,Liverpool,2-1,2,1,1,1,3,1,H
1923-12-26,1923,Notts County,Arsenal,1-2,1,2,1,1,3,-1,A
1923-12-26,1923,Preston North End,Blackburn Rovers,0-1,0,1,1,1,1,-1,A
1923-12-26,1923,West Bromwich Albion,Bolton Wanderers,0-5,0,5,1,1,5,-5,A
1923-12-26,1923,West Ham United,Aston Villa,1-0,1,0,1,1,1,1,H
1923-12-27,1923,Arsenal,Notts County,0-0,0,0,1,1,0,0,D
1923-12-29,1923,Arsenal,Chelsea,1-0,1,0,1,1,1,1,H
1923-12-29,1923,Aston Villa,Cardiff City,2-1,2,1,1,1,3,1,H
1923-12-29,1923,Blackburn Rovers,Huddersfield Town,1-0,1,0,1,1,1,1,H
1923-12-29,1923,Bolton Wanderers,Everton,2-0,2,0,1,1,2,2,H
1923-12-29,1923,Burnley,Preston North End,1-0,1,0,1,1,1,1,H
1923-12-29,1923,Liverpool,West Ham United,2-0,2,0,1,1,2,2,H
1923-12-29,1923,Manchester City,West Bromwich Albion,3-3,3,3,1,1,6,0,D
1923-12-29,1923,Nottingham Forest,Newcastle United,0-0,0,0,1,1,0,0,D
1923-12-29,1923,Sheffield United,Middlesbrough,0-1,0,1,1,1,1,-1,A
1923-12-29,1923,Sunderland,Notts County,1-1,1,1,1,1,2,0,D
1923-12-29,1923,Tottenham Hotspur,Birmingham City,1-1,1,1,1,1,2,0,D
1924-01-01,1923,Blackburn Rovers,Notts County,4-1,4,1,1,1,5,3,H
1924-01-01,1923,Bolton Wanderers,Birmingham City,1-1,1,1,1,1,2,0,D
1924-01-01,1923,Liverpool,Chelsea,3-1,3,1,1,1,4,2,H
1924-01-01,1923,Manchester City,Tottenham Hotspur,1-0,1,0,1,1,1,1,H
1924-01-01,1923,Middlesbrough,Cardiff City,0-1,0,1,1,1,1,-1,A
1924-01-01,1923,Newcastle United,Aston Villa,4-1,4,1,1,1,5,3,H
1924-01-01,1923,Sheffield United,West Ham United,0-2,0,2,1,1,2,-2,A
1924-01-01,1923,Sunderland,Everton,3-0,3,0,1,1,3,3,H
1924-01-05,1923,Birmingham City,Tottenham Hotspur,3-2,3,2,1,1,5,1,H
1924-01-05,1923,Cardiff City,Aston Villa,0-2,0,2,1,1,2,-2,A
1924-01-05,1923,Chelsea,Arsenal,0-0,0,0,1,1,0,0,D
1924-01-05,1923,Everton,Bolton Wanderers,2-2,2,2,1,1,4,0,D
1924-01-05,1923,Huddersfield Town,Blackburn Rovers,1-0,1,0,1,1,1,1,H
1924-01-05,1923,Middlesbrough,Sheffield United,0-1,0,1,1,1,1,-1,A
1924-01-05,1923,Newcastle United,Nottingham Forest,4-0,4,0,1,1,4,4,H
1924-01-05,1923,Notts County,Sunderland,1-2,1,2,1,1,3,-1,A
1924-01-05,1923,Preston North End,Burnley,5-0,5,0,1,1,5,5,H
1924-01-05,1923,West Bromwich Albion,Manchester City,2-1,2,1,1,1,3,1,H
1924-01-05,1923,West Ham United,Liverpool,1-0,1,0,1,1,1,1,H
1924-01-19,1923,Arsenal,Cardiff City,1-2,1,2,1,1,3,-1,A
1924-01-19,1923,Birmingham City,Nottingham Forest,0-2,0,2,1,1,2,-2,A
1924-01-19,1923,Blackburn Rovers,West Ham United,0-0,0,0,1,1,0,0,D
1924-01-19,1923,Bolton Wanderers,Aston Villa,1-0,1,0,1,1,1,1,H
1924-01-19,1923,Everton,Middlesbrough,1-0,1,0,1,1,1,1,H
1924-01-19,1923,Huddersfield Town,Chelsea,0-1,0,1,1,1,1,-1,A
1924-01-19,1923,Manchester City,Liverpool,0-1,0,1,1,1,1,-1,A
1924-01-19,1923,Notts County,Preston North End,0-0,0,0,1,1,0,0,D
1924-01-19,1923,Sunderland,Sheffield United,2-2,2,2,1,1,4,0,D
1924-01-19,1923,Tottenham Hotspur,Newcastle United,2-0,2,0,1,1,2,2,H
1924-01-19,1923,West Bromwich Albion,Burnley,0-3,0,3,1,1,3,-3,A
1924-01-26,1923,Aston Villa,Bolton Wanderers,1-0,1,0,1,1,1,1,H
1924-01-26,1923,Burnley,West Bromwich Albion,4-0,4,0,1,1,4,4,H
1924-01-26,1923,Cardiff City,Arsenal,4-0,4,0,1,1,4,4,H
1924-01-26,1923,Chelsea,Huddersfield Town,0-1,0,1,1,1,1,-1,A
1924-01-26,1923,Liverpool,Manchester City,0-0,0,0,1,1,0,0,D
1924-01-26,1923,Middlesbrough,Everton,1-1,1,1,1,1,2,0,D
1924-01-26,1923,Newcastle United,Tottenham Hotspur,2-2,2,2,1,1,4,0,D
1924-01-26,1923,Nottingham Forest,Birmingham City,1-1,1,1,1,1,2,0,D
1924-01-26,1923,Preston North End,Notts County,2-1,2,1,1,1,3,1,H
1924-01-26,1923,Sheffield United,Sunderland,1-1,1,1,1,1,2,0,D
1924-01-26,1923,West Ham United,Blackburn Rovers,0-1,0,1,1,1,1,-1,A
1924-02-02,1923,Blackburn Rovers,Middlesbrough,2-0,2,0,1,1,2,2,H
1924-02-02,1923,Preston North End,Nottingham Forest,3-1,3,1,1,1,4,2,H
1924-02-06,1923,Everton,Preston North End,1-1,1,1,1,1,2,0,D
1924-02-09,1923,Aston Villa,Sunderland,0-1,0,1,1,1,1,-1,A
1924-02-09,1923,Burnley,Birmingham City,1-2,1,2,1,1,3,-1,A
1924-02-09,1923,Cardiff City,Blackburn Rovers,2-0,2,0,1,1,2,2,H
1924-02-09,1923,Chelsea,Notts County,0-6,0,6,1,1,6,-6,A
1924-02-09,1923,Liverpool,Bolton Wanderers,3-1,3,1,1,1,4,2,H
1924-02-09,1923,Middlesbrough,West Bromwich Albion,0-1,0,1,1,1,1,-1,A
1924-02-09,1923,Newcastle United,Huddersfield Town,0-1,0,1,1,1,1,-1,A
1924-02-09,1923,Nottingham Forest,Manchester City,1-2,1,2,1,1,3,-1,A
1924-02-09,1923,Preston North End,Everton,0-1,0,1,1,1,1,-1,A
1924-02-09,1923,Sheffield United,Arsenal,3-1,3,1,1,1,4,2,H
1924-02-09,1923,West Ham United,Tottenham Hotspur,0-0,0,0,1,1,0,0,D
1924-02-13,1923,Manchester City,Nottingham Forest,1-3,1,3,1,1,4,-2,A
1924-02-13,1923,Sunderland,Aston Villa,2-0,2,0,1,1,2,2,H
1924-02-16,1923,Arsenal,Aston Villa,0-1,0,1,1,1,1,-1,A
1924-02-16,1923,Birmingham City,Middlesbrough,2-1,2,1,1,1,3,1,H
1924-02-16,1923,Blackburn Rovers,Sheffield United,1-1,1,1,1,1,2,0,D
1924-02-16,1923,Bolton Wanderers,Nottingham Forest,4-0,4,0,1,1,4,4,H
1924-02-16,1923,Everton,Chelsea,2-0,2,0,1,1,2,2,H
1924-02-16,1923,Huddersfield Town,West Ham United,1-1,1,1,1,1,2,0,D
1924-02-16,1923,Manchester City,Burnley,2-2,2,2,1,1,4,0,D
1924-02-16,1923,Notts County,Newcastle United,1-0,1,0,1,1,1,1,H
1924-02-16,1923,Sunderland,Liverpool,0-0,0,0,1,1,0,0,D
1924-02-16,1923,Tottenham Hotspur,Cardiff City,1-1,1,1,1,1,2,0,D
1924-02-16,1923,West Bromwich Albion,Preston North End,1-2,1,2,1,1,3,-1,A
1924-02-23,1923,Chelsea,Everton,1-1,1,1,1,1,2,0,D
1924-02-23,1923,Middlesbrough,Birmingham City,0-1,0,1,1,1,1,-1,A
1924-02-23,1923,Nottingham Forest,Bolton Wanderers,1-0,1,0,1,1,1,1,H
1924-02-23,1923,Sheffield United,Blackburn Rovers,4-0,4,0,1,1,4,4,H
1924-02-25,1923,Arsenal,Sheffield United,1-3,1,3,1,1,4,-2,A
1924-02-27,1923,Birmingham City,Burnley,2-1,2,1,1,1,3,1,H
1924-02-27,1923,Huddersfield Town,Newcastle United,1-1,1,1,1,1,2,0,D
1924-03-01,1923,Arsenal,Liverpool,3-1,3,1,1,1,4,2,H
1924-03-01,1923,Birmingham City,Preston North End,2-0,2,0,1,1,2,2,H
1924-03-01,1923,Blackburn Rovers,Aston Villa,3-1,3,1,1,1,4,2,H
1924-03-01,1923,Bolton Wanderers,Burnley,0-0,0,0,1,1,0,0,D
1924-03-01,1923,Everton,Newcastle United,2-2,2,2,1,1,4,0,D
1924-03-01,1923,Huddersfield Town,Cardiff City,2-0,2,0,1,1,2,2,H
1924-03-01,1923,Manchester City,Middlesbrough,3-2,3,2,1,1,5,1,H
1924-03-01,1923,Notts County,West Ham United,1-1,1,1,1,1,2,0,D
1924-03-01,1923,Sunderland,Nottingham Forest,1-0,1,0,1,1,1,1,H
1924-03-01,1923,Tottenham Hotspur,Sheffield United,1-2,1,2,1,1,3,-1,A
1924-03-01,1923,West Bromwich Albion,Chelsea,2-2,2,2,1,1,4,0,D
1924-03-05,1923,Notts County,Chelsea,0-0,0,0,1,1,0,0,D
1924-03-08,1923,Middlesbrough,Blackburn Rovers,2-0,2,0,1,1,2,2,H
1924-03-08,1923,Nottingham Forest,Sunderland,1-2,1,2,1,1,3,-1,A
1924-03-08,1923,Preston North End,Birmingham City,1-0,1,0,1,1,1,1,H
1924-03-08,1923,Sheffield United,Tottenham Hotspur,6-2,6,2,1,1,8,4,H
1924-03-08,1923,West Ham United,Notts County,1-1,1,1,1,1,2,0,D
1924-03-12,1923,Aston Villa,Arsenal,2-1,2,1,1,1,3,1,H
1924-03-12,1923,Bolton Wanderers,Liverpool,4-1,4,1,1,1,5,3,H
1924-03-12,1923,Chelsea,West Bromwich Albion,0-0,0,0,1,1,0,0,D
1924-03-15,1923,Aston Villa,Tottenham Hotspur,0-0,0,0,1,1,0,0,D
1924-03-15,1923,Burnley,Sunderland,0-3,0,3,1,1,3,-3,A
1924-03-15,1923,Cardiff City,Notts County,0-2,0,2,1,1,2,-2,A
1924-03-15,1923,Chelsea,Birmingham City,1-1,1,1,1,1,2,0,D
1924-03-15,1923,Liverpool,Blackburn Rovers,0-0,0,0,1,1,0,0,D
1924-03-15,1923,Middlesbrough,Bolton Wanderers,1-2,1,2,1,1,3,-1,A
1924-03-15,1923,Newcastle United,West Bromwich Albion,1-1,1,1,1,1,2,0,D
1924-03-15,1923,Nottingham Forest,Arsenal,2-1,2,1,1,1,3,1,H
1924-03-15,1923,Preston North End,Manchester City,4-1,4,1,1,1,5,3,H
1924-03-15,1923,Sheffield United,Huddersfield Town,0-1,0,1,1,1,1,-1,A
1924-03-15,1923,West Ham United,Everton,2-1,2,1,1,1,3,1,H
1924-03-17,1923,Burnley,Manchester City,3-2,3,2,1,1,5,1,H
1924-03-19,1923,Liverpool,Sunderland,4-2,4,2,1,1,6,2,H
1924-03-19,1923,Newcastle United,Notts County,1-2,1,2,1,1,3,-1,A
1924-03-19,1923,Preston North End,West Bromwich Albion,1-2,1,2,1,1,3,-1,A
1924-03-20,1923,Blackburn Rovers,Cardiff City,2-1,2,1,1,1,3,1,H
1924-03-22,1923,Arsenal,Nottingham Forest,1-0,1,0,1,1,1,1,H
1924-03-22,1923,Birmingham City,Chelsea,1-0,1,0,1,1,1,1,H
1924-03-22,1923,Blackburn Rovers,Liverpool,0-0,0,0,1,1,0,0,D
1924-03-22,1923,Bolton Wanderers,Middlesbrough,2-0,2,0,1,1,2,2,H
1924-03-22,1923,Everton,West Ham United,2-1,2,1,1,1,3,1,H
1924-03-22,1923,Huddersfield Town,Sheffield United,1-0,1,0,1,1,1,1,H
1924-03-22,1923,Manchester City,Preston North End,2-2,2,2,1,1,4,0,D
1924-03-22,1923,Notts County,Cardiff City,1-0,1,0,1,1,1,1,H
1924-03-22,1923,Sunderland,Burnley,0-1,0,1,1,1,1,-1,A
1924-03-22,1923,Tottenham Hotspur,Aston Villa,2-3,2,3,1,1,5,-1,A
1924-03-22,1923,West Bromwich Albion,Newcastle United,0-0,0,0,1,1,0,0,D
1924-03-27,1923,West Ham United,Huddersfield Town,2-3,2,3,1,1,5,-1,A
1924-03-29,1923,Cardiff City,Everton,0-0,0,0,1,1,0,0,D
1924-03-29,1923,Liverpool,Tottenham Hotspur,1-0,1,0,1,1,1,1,H
1924-03-29,1923,Middlesbrough,Sunderland,1-3,1,3,1,1,4,-2,A
1924-03-29,1923,Nottingham Forest,Blackburn Rovers,0-0,0,0,1,1,0,0,D
1924-03-29,1923,Preston North End,Bolton Wanderers,0-2,0,2,1,1,2,-2,A
1924-03-29,1923,West Ham United,West Bromwich Albion,1-0,1,0,1,1,1,1,H
1924-04-01,1923,Burnley,Bolton Wanderers,1-0,1,0,1,1,1,1,H
1924-04-02,1923,Aston Villa,Blackburn Rovers,1-0,1,0,1,1,1,1,H
1924-04-02,1923,Liverpool,Arsenal,0-0,0,0,1,1,0,0,D
1924-04-02,1923,Middlesbrough,Manchester City,1-1,1,1,1,1,2,0,D
1924-04-02,1923,Newcastle United,Everton,3-1,3,1,1,1,4,2,H
1924-04-05,1923,Arsenal,Burnley,2-0,2,0,1,1,2,2,H
1924-04-05,1923,Birmingham City,Newcastle United,4-1,4,1,1,1,5,3,H
1924-04-05,1923,Blackburn Rovers,Nottingham Forest,1-1,1,1,1,1,2,0,D
1924-04-05,1923,Bolton Wanderers,Preston North End,0-0,0,0,1,1,0,0,D
1924-04-05,1923,Everton,Cardiff City,0-0,0,0,1,1,0,0,D
1924-04-05,1923,Huddersfield Town,Aston Villa,1-0,1,0,1,1,1,1,H
1924-04-05,1923,Manchester City,Chelsea,1-0,1,0,1,1,1,1,H
1924-04-05,1923,Notts County,Sheffield United,0-2,0,2,1,1,2,-2,A
1924-04-05,1923,Sunderland,Middlesbrough,3-2,3,2,1,1,5,1,H
1924-04-05,1923,Tottenham Hotspur,Liverpool,1-1,1,1,1,1,2,0,D
1924-04-05,1923,West Bromwich Albion,West Ham United,0-0,0,0,1,1,0,0,D
1924-04-07,1923,Cardiff City,Tottenham Hotspur,2-1,2,1,1,1,3,1,H
1924-04-07,1923,Sheffield United,Notts County,3-1,3,1,1,1,4,2,H
1924-04-09,1923,Newcastle United,Birmingham City,2-1,2,1,1,1,3,1,H
1924-04-09,1923,West Bromwich Albion,Middlesbrough,1-1,1,1,1,1,2,0,D
1924-04-12,1923,Arsenal,Sunderland,2-0,2,0,1,1,2,2,H
1924-04-12,1923,Blackburn Rovers,Bolton Wanderers,3-1,3,1,1,1,4,2,H
1924-04-12,1923,Cardiff City,Burnley,2-0,2,0,1,1,2,2,H
1924-04-12,1923,Huddersfield Town,Manchester City,1-1,1,1,1,1,2,0,D
1924-04-12,1923,Liverpool,Middlesbrough,3-1,3,1,1,1,4,2,H
1924-04-12,1923,Newcastle United,Chelsea,2-1,2,1,1,1,3,1,H
1924-04-12,1923,Nottingham Forest,Aston Villa,0-0,0,0,1,1,0,0,D
1924-04-12,1923,Sheffield United,Birmingham City,0-2,0,2,1,1,2,-2,A
1924-04-12,1923,Tottenham Hotspur,Everton,2-5,2,5,1,1,7,-3,A
1924-04-12,1923,West Bromwich Albion,Notts County,5-0,5,0,1,1,5,5,H
1924-04-12,1923,West Ham United,Preston North End,3-1,3,1,1,1,4,2,H
1924-04-14,1923,Cardiff City,Huddersfield Town,0-0,0,0,1,1,0,0,D
1924-04-18,1923,Bolton Wanderers,Newcastle United,0-1,0,1,1,1,1,-1,A
1924-04-18,1923,Burnley,Huddersfield Town,1-1,1,1,1,1,2,0,D
1924-04-18,1923,Chelsea,Liverpool,2-1,2,1,1,1,3,1,H
1924-04-18,1923,Everton,Arsenal,3-1,3,1,1,1,4,2,H
1924-04-18,1923,Manchester City,Birmingham City,1-0,1,0,1,1,1,1,H
1924-04-18,1923,Notts County,Blackburn Rovers,3-0,3,0,1,1,3,3,H
1924-04-18,1923,Sunderland,West Bromwich Albion,2-0,2,0,1,1,2,2,H
1924-04-19,1923,Aston Villa,Nottingham Forest,2-0,2,0,1,1,2,2,H
1924-04-19,1923,Birmingham City,Sheffield United,0-1,0,1,1,1,1,-1,A
1924-04-19,1923,Bolton Wanderers,Blackburn Rovers,3-0,3,0,1,1,3,3,H
1924-04-19,1923,Burnley,Cardiff City,1-2,1,2,1,1,3,-1,A
1924-04-19,1923,Chelsea,Newcastle United,1-0,1,0,1,1,1,1,H
1924-04-19,1923,Everton,Tottenham Hotspur,4-2,4,2,1,1,6,2,H
1924-04-19,1923,Manchester City,Huddersfield Town,1-1,1,1,1,1,2,0,D
1924-04-19,1923,Middlesbrough,Liverpool,1-1,1,1,1,1,2,0,D
1924-04-19,1923,Notts County,West Bromwich Albion,1-0,1,0,1,1,1,1,H
1924-04-19,1923,Preston North End,West Ham United,2-1,2,1,1,1,3,1,H
1924-04-19,1923,Sunderland,Arsenal,1-1,1,1,1,1,2,0,D
1924-04-21,1923,Arsenal,Everton,0-1,0,1,1,1,1,-1,A
1924-04-21,1923,Aston Villa,Newcastle United,6-1,6,1,1,1,7,5,H
1924-04-21,1923,Cardiff City,Middlesbrough,1-0,1,0,1,1,1,1,H
1924-04-21,1923,Nottingham Forest,Preston North End,1-1,1,1,1,1,2,0,D
1924-04-21,1923,Tottenham Hotspur,Manchester City,4-1,4,1,1,1,5,3,H
1924-04-21,1923,West Bromwich Albion,Sunderland,3-1,3,1,1,1,4,2,H
1924-04-21,1923,West Ham United,Sheffield United,2-2,2,2,1,1,4,0,D
1924-04-22,1923,Huddersfield Town,Burnley,1-0,1,0,1,1,1,1,H
1924-04-22,1923,Tottenham Hotspur,West Ham United,0-1,0,1,1,1,1,-1,A
1924-04-26,1923,Burnley,Tottenham Hotspur,2-2,2,2,1,1,4,0,D
1924-04-26,1923,Cardiff City,Birmingham City,2-0,2,0,1,1,2,2,H
1924-04-26,1923,Chelsea,Sunderland,4-1,4,1,1,1,5,3,H
1924-04-26,1923,Liverpool,Notts County,1-0,1,0,1,1,1,1,H
1924-04-26,1923,Nottingham Forest,Huddersfield Town,1-1,1,1,1,1,2,0,D
1924-04-26,1923,Preston North End,Arsenal,0-2,0,2,1,1,2,-2,A
1924-04-26,1923,Sheffield United,West Bromwich Albion,2-0,2,0,1,1,2,2,H
1924-04-26,1923,West Ham United,Manchester City,1-2,1,2,1,1,3,-1,A
1924-04-28,1923,Burnley,Arsenal,4-1,4,1,1,1,5,3,H
1924-04-30,1923,Aston Villa,Huddersfield Town,3-1,3,1,1,1,4,2,H
1924-04-30,1923,Chelsea,Manchester City,3-1,3,1,1,1,4,2,H
1924-05-03,1923,Arsenal,Preston North End,1-2,1,2,1,1,3,-1,A
1924-05-03,1923,Birmingham City,Cardiff City,0-0,0,0,1,1,0,0,D
1924-05-03,1923,Huddersfield Town,Nottingham Forest,3-0,3,0,1,1,3,3,H
1924-05-03,1923,Manchester City,West Ham United,2-1,2,1,1,1,3,1,H
1924-05-03,1923,Notts County,Liverpool,1-2,1,2,1,1,3,-1,A
1924-05-03,1923,Tottenham Hotspur,Burnley,1-0,1,0,1,1,1,1,H
1924-05-03,1923,West Bromwich Albion,Sheffield United,3-1,3,1,1,1,4,2,H
1924-08-30,1924,Birmingham City,Everton,2-2,2,2,1,1,4,0,D
1924-08-30,1924,Burnley,Cardiff City,0-0,0,0,1,1,0,0,D
1924-08-30,1924,Bury,Manchester City,0-2,0,2,1,1,2,-2,A
1924-08-30,1924,Leeds United,Sunderland,1-1,1,1,1,1,2,0,D
1924-08-30,1924,Liverpool,Aston Villa,2-4,2,4,1,1,6,-2,A
1924-08-30,1924,Newcastle United,Huddersfield Town,1-3,1,3,1,1,4,-2,A
1924-08-30,1924,Nottingham Forest,Arsenal,0-2,0,2,1,1,2,-2,A
1924-08-30,1924,Sheffield United,Blackburn Rovers,2-3,2,3,1,1,5,-1,A
1924-08-30,1924,Tottenham Hotspur,Bolton Wanderers,3-0,3,0,1,1,3,3,H
1924-08-30,1924,West Bromwich Albion,Notts County,1-2,1,2,1,1,3,-1,A
1924-08-30,1924,West Ham United,Preston North End,1-0,1,0,1,1,1,1,H
1924-09-01,1924,Arsenal,Manchester City,1-0,1,0,1,1,1,1,H
1924-09-01,1924,Aston Villa,Bury,3-3,3,3,1,1,6,0,D
1924-09-01,1924,Blackburn Rovers,Newcastle United,1-1,1,1,1,1,2,0,D
1924-09-01,1924,Bolton Wanderers,West Bromwich Albion,1-1,1,1,1,1,2,0,D
1924-09-01,1924,Cardiff City,Sheffield United,1-1,1,1,1,1,2,0,D
1924-09-01,1924,Notts County,Leeds United,1-0,1,0,1,1,1,1,H
1924-09-02,1924,Huddersfield Town,Nottingham Forest,3-0,3,0,1,1,3,3,H
1924-09-03,1924,Birmingham City,Tottenham Hotspur,0-2,0,2,1,1,2,-2,A
1924-09-03,1924,Sunderland,Preston North End,2-0,2,0,1,1,2,2,H
1924-09-06,1924,Arsenal,Liverpool,2-0,2,0,1,1,2,2,H
1924-09-06,1924,Aston Villa,Newcastle United,0-0,0,0,1,1,0,0,D
1924-09-06,1924,Blackburn Rovers,West Ham United,0-1,0,1,1,1,1,-1,A
1924-09-06,1924,Bolton Wanderers,Bury,3-3,3,3,1,1,6,0,D
1924-09-06,1924,Cardiff City,Leeds United,3-0,3,0,1,1,3,3,H
1924-09-06,1924,Everton,West Bromwich Albion,1-0,1,0,1,1,1,1,H
1924-09-06,1924,Huddersfield Town,Sheffield United,2-1,2,1,1,1,3,1,H
1924-09-06,1924,Manchester City,Nottingham Forest,4-2,4,2,1,1,6,2,H
1924-09-06,1924,Notts County,Tottenham Hotspur,0-0,0,0,1,1,0,0,D
1924-09-06,1924,Preston North End,Burnley,0-2,0,2,1,1,2,-2,A
1924-09-06,1924,Sunderland,Birmingham City,4-0,4,0,1,1,4,4,H
1924-09-08,1924,Birmingham City,Bolton Wanderers,1-0,1,0,1,1,1,1,H
1924-09-08,1924,Burnley,Everton,0-0,0,0,1,1,0,0,D
1924-09-08,1924,Bury,Aston Villa,4-3,4,3,1,1,7,1,H
1924-09-08,1924,Nottingham Forest,Huddersfield Town,0-1,0,1,1,1,1,-1,A
1924-09-08,1924,Sheffield United,Cardiff City,1-0,1,0,1,1,1,1,H
1924-09-08,1924,West Bromwich Albion,Tottenham Hotspur,2-0,2,0,1,1,2,2,H
1924-09-08,1924,West Ham United,Newcastle United,0-0,0,0,1,1,0,0,D
1924-09-10,1924,Leeds United,Notts County,1-1,1,1,1,1,2,0,D
1924-09-10,1924,Newcastle United,Blackburn Rovers,4-0,4,0,1,1,4,4,H
1924-09-13,1924,Birmingham City,Cardiff City,2-1,2,1,1,1,3,1,H
1924-09-13,1924,Bolton Wanderers,Notts County,1-0,1,0,1,1,1,1,H
1924-09-13,1924,Burnley,Blackburn Rovers,3-5,3,5,1,1,8,-2,A
1924-09-13,1924,Leeds United,Preston North End,4-0,4,0,1,1,4,4,H
1924-09-13,1924,Liverpool,Manchester City,5-3,5,3,1,1,8,2,H
1924-09-13,1924,Newcastle United,Arsenal,2-2,2,2,1,1,4,0,D
1924-09-13,1924,Nottingham Forest,Bury,2-0,2,0,1,1,2,2,H
1924-09-13,1924,Sheffield United,Aston Villa,2-2,2,2,1,1,4,0,D
1924-09-13,1924,Tottenham Hotspur,Everton,0-0,0,0,1,1,0,0,D
1924-09-13,1924,West Bromwich Albion,Sunderland,2-1,2,1,1,1,3,1,H
1924-09-13,1924,West Ham United,Huddersfield Town,0-0,0,0,1,1,0,0,D
1924-09-15,1924,Birmingham City,Notts County,1-0,1,0,1,1,1,1,H
1924-09-15,1924,Blackburn Rovers,Liverpool,3-1,3,1,1,1,4,2,H
1924-09-15,1924,Preston North End,Cardiff City,1-3,1,3,1,1,4,-2,A
1924-09-17,1924,Leeds United,Everton,1-0,1,0,1,1,1,1,H
1924-09-17,1924,Manchester City,Arsenal,2-0,2,0,1,1,2,2,H
1924-09-17,1924,Newcastle United,West Ham United,4-1,4,1,1,1,5,3,H
1924-09-20,1924,Arsenal,Sheffield United,2-0,2,0,1,1,2,2,H
1924-09-20,1924,Aston Villa,West Ham United,1-1,1,1,1,1,2,0,D
1924-09-20,1924,Burnley,Leeds United,1-1,1,1,1,1,2,0,D
1924-09-20,1924,Bury,Liverpool,0-0,0,0,1,1,0,0,D
1924-09-20,1924,Cardiff City,West Bromwich Albion,0-1,0,1,1,1,1,-1,A
1924-09-20,1924,Everton,Bolton Wanderers,2-2,2,2,1,1,4,0,D
1924-09-20,1924,Huddersfield Town,Blackburn Rovers,0-0,0,0,1,1,0,0,D
1924-09-20,1924,Manchester City,Newcastle United,3-1,3,1,1,1,4,2,H
1924-09-20,1924,Notts County,Nottingham Forest,0-0,0,0,1,1,0,0,D
1924-09-20,1924,Preston North End,Birmingham City,1-0,1,0,1,1,1,1,H
1924-09-20,1924,Sunderland,Tottenham Hotspur,4-1,4,1,1,1,5,3,H
1924-09-22,1924,Sheffield United,West Ham United,1-1,1,1,1,1,2,0,D
1924-09-22,1924,Tottenham Hotspur,West Bromwich Albion,0-1,0,1,1,1,1,-1,A
1924-09-27,1924,Birmingham City,Burnley,1-0,1,0,1,1,1,1,H
1924-09-27,1924,Blackburn Rovers,Aston Villa,1-1,1,1,1,1,2,0,D
1924-09-27,1924,Bolton Wanderers,Sunderland,1-2,1,2,1,1,3,-1,A
1924-09-27,1924,Leeds United,Huddersfield Town,1-1,1,1,1,1,2,0,D
1924-09-27,1924,Liverpool,Nottingham Forest,3-0,3,0,1,1,3,3,H
1924-09-27,1924,Newcastle United,Bury,2-2,2,2,1,1,4,0,D
1924-09-27,1924,Notts County,Everton,3-1,3,1,1,1,4,2,H
1924-09-27,1924,Sheffield United,Manchester City,0-5,0,5,1,1,5,-5,A
1924-09-27,1924,Tottenham Hotspur,Cardiff City,1-1,1,1,1,1,2,0,D
1924-09-27,1924,West Bromwich Albion,Preston North End,1-1,1,1,1,1,2,0,D
1924-09-27,1924,West Ham United,Arsenal,1-0,1,0,1,1,1,1,H
1924-09-29,1924,Burnley,Sunderland,1-2,1,2,1,1,3,-1,A
1924-10-02,1924,Nottingham Forest,Aston Villa,0-2,0,2,1,1,2,-2,A
1924-10-04,1924,Arsenal,Blackburn Rovers,1-0,1,0,1,1,1,1,H
1924-10-04,1924,Aston Villa,Huddersfield Town,1-1,1,1,1,1,2,0,D
1924-10-04,1924,Burnley,West Bromwich Albion,0-1,0,1,1,1,1,-1,A
1924-10-04,1924,Bury,Sheffield United,1-0,1,0,1,1,1,1,H
1924-10-04,1924,Cardiff City,Bolton Wanderers,1-2,1,2,1,1,3,-1,A
1924-10-04,1924,Everton,Liverpool,0-1,0,1,1,1,1,-1,A
1924-10-04,1924,Leeds United,Birmingham City,0-1,0,1,1,1,1,-1,A
1924-10-04,1924,Manchester City,West Ham United,3-1,3,1,1,1,4,2,H
1924-10-04,1924,Nottingham Forest,Newcastle United,1-1,1,1,1,1,2,0,D
1924-10-04,1924,Preston North End,Tottenham Hotspur,0-3,0,3,1,1,3,-3,A
1924-10-04,1924,Sunderland,Notts County,0-1,0,1,1,1,1,-1,A
1924-10-11,1924,Birmingham City,Aston Villa,1-0,1,0,1,1,1,1,H
1924-10-11,1924,Blackburn Rovers,Manchester City,3-1,3,1,1,1,4,2,H
1924-10-11,1924,Bolton Wanderers,Preston North End,6-1,6,1,1,1,7,5,H
1924-10-11,1924,Everton,Sunderland,0-3,0,3,1,1,3,-3,A
1924-10-11,1924,Huddersfield Town,Arsenal,4-0,4,0,1,1,4,4,H
1924-10-11,1924,Newcastle United,Liverpool,0-0,0,0,1,1,0,0,D
1924-10-11,1924,Notts County,Cardiff City,3-0,3,0,1,1,3,3,H
1924-10-11,1924,Sheffield United,Nottingham Forest,1-2,1,2,1,1,3,-1,A
1924-10-11,1924,Tottenham Hotspur,Burnley,1-1,1,1,1,1,2,0,D
1924-10-11,1924,West Bromwich Albion,Leeds United,3-1,3,1,1,1,4,2,H
1924-10-11,1924,West Ham United,Bury,1-1,1,1,1,1,2,0,D
1924-10-13,1924,Arsenal,Bury,0-1,0,1,1,1,1,-1,A
1924-10-15,1924,Liverpool,Blackburn Rovers,0-0,0,0,1,1,0,0,D
1924-10-18,1924,Arsenal,Aston Villa,1-1,1,1,1,1,2,0,D
1924-10-18,1924,Burnley,Bolton Wanderers,0-0,0,0,1,1,0,0,D
1924-10-18,1924,Bury,Blackburn Rovers,1-1,1,1,1,1,2,0,D
1924-10-18,1924,Cardiff City,Everton,2-1,2,1,1,1,3,1,H
1924-10-18,1924,Leeds United,Tottenham Hotspur,1-0,1,0,1,1,1,1,H
1924-10-18,1924,Liverpool,Sheffield United,4-1,4,1,1,1,5,3,H
1924-10-18,1924,Manchester City,Huddersfield Town,1-1,1,1,1,1,2,0,D
1924-10-18,1924,Nottingham Forest,West Ham United,2-1,2,1,1,1,3,1,H
1924-10-18,1924,Preston North End,Notts County,0-1,0,1,1,1,1,-1,A
1924-10-18,1924,Sunderland,Newcastle United,1-1,1,1,1,1,2,0,D
1924-10-18,1924,West Bromwich Albion,Birmingham City,1-1,1,1,1,1,2,0,D
1924-10-25,1924,Arsenal,Tottenham Hotspur,1-0,1,0,1,1,1,1,H
1924-10-25,1924,Aston Villa,West Bromwich Albion,1-0,1,0,1,1,1,1,H
1924-10-25,1924,Blackburn Rovers,Leeds United,2-3,2,3,1,1,5,-1,A
1924-10-25,1924,Bury,Notts County,2-1,2,1,1,1,3,1,H
1924-10-25,1924,Huddersfield Town,Birmingham City,0-1,0,1,1,1,1,-1,A
1924-10-25,1924,Liverpool,Sunderland,3-1,3,1,1,1,4,2,H
1924-10-25,1924,Manchester City,Bolton Wanderers,2-2,2,2,1,1,4,0,D
1924-10-25,1924,Newcastle United,Cardiff City,1-2,1,2,1,1,3,-1,A
1924-10-25,1924,Nottingham Forest,Everton,0-1,0,1,1,1,1,-1,A
1924-10-25,1924,Sheffield United,Preston North End,3-0,3,0,1,1,3,3,H
1924-10-25,1924,West Ham United,Burnley,2-0,2,0,1,1,2,2,H
1924-10-29,1924,Everton,Manchester City,3-1,3,1,1,1,4,2,H
1924-11-01,1924,Birmingham City,Blackburn Rovers,1-1,1,1,1,1,2,0,D
1924-11-01,1924,Bolton Wanderers,Arsenal,4-1,4,1,1,1,5,3,H
1924-11-01,1924,Burnley,Sheffield United,1-1,1,1,1,1,2,0,D
1924-11-01,1924,Everton,Bury,0-0,0,0,1,1,0,0,D
1924-11-01,1924,Leeds United,West Ham United,2-1,2,1,1,1,3,1,H
1924-11-01,1924,Notts County,Manchester City,2-0,2,0,1,1,2,2,H
1924-11-01,1924,Preston North End,Newcastle United,0-1,0,1,1,1,1,-1,A
1924-11-01,1924,Sunderland,Nottingham Forest,3-1,3,1,1,1,4,2,H
1924-11-01,1924,Tottenham Hotspur,Aston Villa,1-3,1,3,1,1,4,-2,A
1924-11-01,1924,West Bromwich Albion,Huddersfield Town,1-0,1,0,1,1,1,1,H
1924-11-08,1924,Arsenal,Notts County,0-1,0,1,1,1,1,-1,A
1924-11-08,1924,Aston Villa,Bolton Wanderers,2-2,2,2,1,1,4,0,D
1924-11-08,1924,Blackburn Rovers,West Bromwich Albion,1-0,1,0,1,1,1,1,H
1924-11-08,1924,Bury,Sunderland,3-0,3,0,1,1,3,3,H
1924-11-08,1924,Huddersfield Town,Tottenham Hotspur,1-2,1,2,1,1,3,-1,A
1924-11-08,1924,Liverpool,Preston North End,3-1,3,1,1,1,4,2,H
1924-11-08,1924,Manchester City,Everton,2-2,2,2,1,1,4,0,D
1924-11-08,1924,Newcastle United,Burnley,3-0,3,0,1,1,3,3,H
1924-11-08,1924,Nottingham Forest,Cardiff City,2-1,2,1,1,1,3,1,H
1924-11-08,1924,Sheffield United,Leeds United,1-1,1,1,1,1,2,0,D
1924-11-08,1924,West Ham United,Birmingham City,0-1,0,1,1,1,1,-1,A
1924-11-10,1924,Tottenham Hotspur,Manchester City,1-1,1,1,1,1,2,0,D
1924-11-12,1924,Liverpool,Huddersfield Town,2-3,2,3,1,1,5,-1,A
1924-11-15,1924,Birmingham City,Sheffield United,1-1,1,1,1,1,2,0,D
1924-11-15,1924,Bolton Wanderers,Huddersfield Town,1-0,1,0,1,1,1,1,H
1924-11-15,1924,Burnley,Liverpool,2-1,2,1,1,1,3,1,H
1924-11-15,1924,Cardiff City,Bury,4-1,4,1,1,1,5,3,H
1924-11-15,1924,Everton,Arsenal,2-3,2,3,1,1,5,-1,A
1924-11-15,1924,Leeds United,Newcastle United,1-1,1,1,1,1,2,0,D
1924-11-15,1924,Notts County,Aston Villa,0-0,0,0,1,1,0,0,D
1924-11-15,1924,Preston North End,Nottingham Forest,3-1,3,1,1,1,4,2,H
1924-11-15,1924,Sunderland,Manchester City,3-2,3,2,1,1,5,1,H
1924-11-15,1924,Tottenham Hotspur,Blackburn Rovers,5-0,5,0,1,1,5,5,H
1924-11-15,1924,West Bromwich Albion,West Ham United,4-1,4,1,1,1,5,3,H
1924-11-20,1924,Preston North End,Sunderland,1-2,1,2,1,1,3,-1,A
1924-11-22,1924,Arsenal,Sunderland,0-0,0,0,1,1,0,0,D
1924-11-22,1924,Aston Villa,Everton,3-1,3,1,1,1,4,2,H
1924-11-22,1924,Blackburn Rovers,Bolton Wanderers,0-2,0,2,1,1,2,-2,A
1924-11-22,1924,Bury,Preston North End,1-1,1,1,1,1,2,0,D
1924-11-22,1924,Huddersfield Town,Notts County,0-0,0,0,1,1,0,0,D
1924-11-22,1924,Liverpool,Leeds United,1-0,1,0,1,1,1,1,H
1924-11-22,1924,Manchester City,Cardiff City,2-2,2,2,1,1,4,0,D
1924-11-22,1924,Newcastle United,Birmingham City,4-0,4,0,1,1,4,4,H
1924-11-22,1924,Nottingham Forest,Burnley,0-0,0,0,1,1,0,0,D
1924-11-22,1924,Sheffield United,West Bromwich Albion,2-0,2,0,1,1,2,2,H
1924-11-22,1924,West Ham United,Tottenham Hotspur,1-1,1,1,1,1,2,0,D
1924-11-29,1924,Birmingham City,Liverpool,5-2,5,2,1,1,7,3,H
1924-11-29,1924,Bolton Wanderers,West Ham United,5-0,5,0,1,1,5,5,H
1924-11-29,1924,Burnley,Bury,4-0,4,0,1,1,4,4,H
1924-11-29,1924,Cardiff City,Arsenal,1-1,1,1,1,1,2,0,D
1924-11-29,1924,Everton,Huddersfield Town,0-2,0,2,1,1,2,-2,A
1924-11-29,1924,Leeds United,Nottingham Forest,1-1,1,1,1,1,2,0,D
1924-11-29,1924,Notts County,Blackburn Rovers,0-0,0,0,1,1,0,0,D
1924-11-29,1924,Preston North End,Manchester City,2-3,2,3,1,1,5,-1,A
1924-11-29,1924,Sunderland,Aston Villa,1-1,1,1,1,1,2,0,D
1924-11-29,1924,Tottenham Hotspur,Sheffield United,4-1,4,1,1,1,5,3,H
1924-11-29,1924,West Bromwich Albion,Newcastle United,2-0,2,0,1,1,2,2,H
1924-12-06,1924,Arsenal,Preston North End,4-0,4,0,1,1,4,4,H
1924-12-06,1924,Aston Villa,Cardiff City,1-2,1,2,1,1,3,-1,A
1924-12-06,1924,Blackburn Rovers,Everton,3-0,3,0,1,1,3,3,H
1924-12-06,1924,Bury,Leeds United,1-0,1,0,1,1,1,1,H
1924-12-06,1924,Huddersfield Town,Sunderland,4-0,4,0,1,1,4,4,H
1924-12-06,1924,Liverpool,West Bromwich Albion,1-1,1,1,1,1,2,0,D
1924-12-06,1924,Manchester City,Burnley,3-3,3,3,1,1,6,0,D
1924-12-06,1924,Newcastle United,Tottenham Hotspur,1-1,1,1,1,1,2,0,D
1924-12-06,1924,Nottingham Forest,Birmingham City,1-1,1,1,1,1,2,0,D
1924-12-06,1924,Sheffield United,Bolton Wanderers,2-0,2,0,1,1,2,2,H
1924-12-06,1924,West Ham United,Notts County,3-0,3,0,1,1,3,3,H
1924-12-13,1924,Birmingham City,Bury,0-1,0,1,1,1,1,-1,A
1924-12-13,1924,Bolton Wanderers,Newcastle United,3-2,3,2,1,1,5,1,H
1924-12-13,1924,Burnley,Arsenal,1-0,1,0,1,1,1,1,H
1924-12-13,1924,Cardiff City,Huddersfield Town,2-2,2,2,1,1,4,0,D
1924-12-13,1924,Everton,West Ham United,1-0,1,0,1,1,1,1,H
1924-12-13,1924,Leeds United,Manchester City,0-3,0,3,1,1,3,-3,A
1924-12-13,1924,Notts County,Sheffield United,2-0,2,0,1,1,2,2,H
1924-12-13,1924,Preston North End,Aston Villa,3-2,3,2,1,1,5,1,H
1924-12-13,1924,Sunderland,Blackburn Rovers,1-0,1,0,1,1,1,1,H
1924-12-13,1924,Tottenham Hotspur,Liverpool,1-1,1,1,1,1,2,0,D
1924-12-13,1924,West Bromwich Albion,Nottingham Forest,5-1,5,1,1,1,6,4,H
1924-12-15,1924,Cardiff City,Liverpool,1-3,1,3,1,1,4,-2,A
1924-12-20,1924,Arsenal,Leeds United,6-1,6,1,1,1,7,5,H
1924-12-20,1924,Aston Villa,Burnley,3-0,3,0,1,1,3,3,H
1924-12-20,1924,Blackburn Rovers,Cardiff City,3-1,3,1,1,1,4,2,H
1924-12-20,1924,Bury,West Bromwich Albion,0-2,0,2,1,1,2,-2,A
1924-12-20,1924,Huddersfield Town,Preston North End,1-0,1,0,1,1,1,1,H
1924-12-20,1924,Liverpool,Bolton Wanderers,0-0,0,0,1,1,0,0,D
1924-12-20,1924,Manchester City,Birmingham City,2-2,2,2,1,1,4,0,D
1924-12-20,1924,Newcastle United,Notts County,1-0,1,0,1,1,1,1,H
1924-12-20,1924,Nottingham Forest,Tottenham Hotspur,1-0,1,0,1,1,1,1,H
1924-12-20,1924,Sheffield United,Everton,1-1,1,1,1,1,2,0,D
1924-12-20,1924,West Ham United,Sunderland,4-1,4,1,1,1,5,3,H
1924-12-25,1924,Birmingham City,Arsenal,2-1,2,1,1,1,3,1,H
1924-12-25,1924,Blackburn Rovers,Preston North End,0-1,0,1,1,1,1,-1,A
1924-12-25,1924,Bolton Wanderers,Nottingham Forest,1-0,1,0,1,1,1,1,H
1924-12-25,1924,Burnley,Huddersfield Town,1-5,1,5,1,1,6,-4,A
1924-12-25,1924,Everton,Newcastle United,0-1,0,1,1,1,1,-1,A
1924-12-25,1924,Leeds United,Aston Villa,6-0,6,0,1,1,6,6,H
1924-12-25,1924,Manchester City,West Bromwich Albion,1-2,1,2,1,1,3,-1,A
1924-12-25,1924,Notts County,Liverpool,1-2,1,2,1,1,3,-1,A
1924-12-25,1924,Sunderland,Sheffield United,0-1,0,1,1,1,1,-1,A
1924-12-25,1924,Tottenham Hotspur,Bury,1-1,1,1,1,1,2,0,D
1924-12-25,1924,West Ham United,Cardiff City,3-2,3,2,1,1,5,1,H
1924-12-26,1924,Arsenal,Birmingham City,0-1,0,1,1,1,1,-1,A
1924-12-26,1924,Aston Villa,Leeds United,2-1,2,1,1,1,3,1,H
1924-12-26,1924,Cardiff City,West Ham United,2-1,2,1,1,1,3,1,H
1924-12-26,1924,Huddersfield Town,Burnley,2-0,2,0,1,1,2,2,H
1924-12-26,1924,Liverpool,Notts County,1-0,1,0,1,1,1,1,H
1924-12-26,1924,Newcastle United,Everton,1-1,1,1,1,1,2,0,D
1924-12-26,1924,Nottingham Forest,Bolton Wanderers,1-1,1,1,1,1,2,0,D
1924-12-26,1924,Preston North End,Blackburn Rovers,3-2,3,2,1,1,5,1,H
1924-12-26,1924,Sheffield United,Sunderland,2-1,2,1,1,1,3,1,H
1924-12-26,1924,West Bromwich Albion,Manchester City,3-1,3,1,1,1,4,2,H
1924-12-27,1924,Arsenal,Nottingham Forest,2-1,2,1,1,1,3,1,H
1924-12-27,1924,Blackburn Rovers,Sheffield United,2-2,2,2,1,1,4,0,D
1924-12-27,1924,Bolton Wanderers,Tottenham Hotspur,3-0,3,0,1,1,3,3,H
1924-12-27,1924,Everton,Birmingham City,2-1,2,1,1,1,3,1,H
1924-12-27,1924,Huddersfield Town,Newcastle United,0-0,0,0,1,1,0,0,D
1924-12-27,1924,Notts County,West Bromwich Albion,0-2,0,2,1,1,2,-2,A
1924-12-27,1924,Preston North End,West Ham United,3-2,3,2,1,1,5,1,H
1924-12-27,1924,Sunderland,Leeds United,2-1,2,1,1,1,3,1,H
1925-01-01,1924,Bolton Wanderers,Birmingham City,3-0,3,0,1,1,3,3,H
1925-01-01,1924,Bury,Tottenham Hotspur,5-2,5,2,1,1,7,3,H
1925-01-01,1924,Everton,Burnley,3-2,3,2,1,1,5,1,H
1925-01-01,1924,Newcastle United,Sheffield United,0-0,0,0,1,1,0,0,D
1925-01-01,1924,Sunderland,Cardiff City,1-0,1,0,1,1,1,1,H
1925-01-03,1924,Birmingham City,Sunderland,2-1,2,1,1,1,3,1,H
1925-01-03,1924,Burnley,Preston North End,1-0,1,0,1,1,1,1,H
1925-01-03,1924,Bury,Bolton Wanderers,1-0,1,0,1,1,1,1,H
1925-01-03,1924,Leeds United,Cardiff City,0-0,0,0,1,1,0,0,D
1925-01-03,1924,Liverpool,Arsenal,2-1,2,1,1,1,3,1,H
1925-01-03,1924,Newcastle United,Aston Villa,4-1,4,1,1,1,5,3,H
1925-01-03,1924,Nottingham Forest,Manchester City,0-3,0,3,1,1,3,-3,A
1925-01-03,1924,Sheffield United,Huddersfield Town,1-1,1,1,1,1,2,0,D
1925-01-03,1924,Tottenham Hotspur,Notts County,1-1,1,1,1,1,2,0,D
1925-01-03,1924,West Bromwich Albion,Everton,3-0,3,0,1,1,3,3,H
1925-01-03,1924,West Ham United,Blackburn Rovers,2-0,2,0,1,1,2,2,H
1925-01-17,1924,Arsenal,Newcastle United,0-2,0,2,1,1,2,-2,A
1925-01-17,1924,Aston Villa,Sheffield United,1-1,1,1,1,1,2,0,D
1925-01-17,1924,Blackburn Rovers,Burnley,0-3,0,3,1,1,3,-3,A
1925-01-17,1924,Bury,Nottingham Forest,3-0,3,0,1,1,3,3,H
1925-01-17,1924,Cardiff City,Birmingham City,1-0,1,0,1,1,1,1,H
1925-01-17,1924,Everton,Tottenham Hotspur,1-0,1,0,1,1,1,1,H
1925-01-17,1924,Huddersfield Town,West Ham United,1-2,1,2,1,1,3,-1,A
1925-01-17,1924,Manchester City,Liverpool,5-0,5,0,1,1,5,5,H
1925-01-17,1924,Notts County,Bolton Wanderers,0-1,0,1,1,1,1,-1,A
1925-01-17,1924,Preston North End,Leeds United,1-4,1,4,1,1,5,-3,A
1925-01-17,1924,Sunderland,West Bromwich Albion,3-0,3,0,1,1,3,3,H
1925-01-21,1924,Aston Villa,Liverpool,1-4,1,4,1,1,5,-3,A
1925-01-24,1924,Birmingham City,Preston North End,3-0,3,0,1,1,3,3,H
1925-01-24,1924,Blackburn Rovers,Huddersfield Town,2-3,2,3,1,1,5,-1,A
1925-01-24,1924,Bolton Wanderers,Everton,1-0,1,0,1,1,1,1,H
1925-01-24,1924,Leeds United,Burnley,0-2,0,2,1,1,2,-2,A
1925-01-24,1924,Liverpool,Bury,4-0,4,0,1,1,4,4,H
1925-01-24,1924,Newcastle United,Manchester City,2-0,2,0,1,1,2,2,H
1925-01-24,1924,Nottingham Forest,Notts County,0-0,0,0,1,1,0,0,D
1925-01-24,1924,Sheffield United,Arsenal,2-1,2,1,1,1,3,1,H
1925-01-24,1924,Tottenham Hotspur,Sunderland,1-0,1,0,1,1,1,1,H
1925-01-24,1924,West Bromwich Albion,Cardiff City,1-0,1,0,1,1,1,1,H
1925-01-24,1924,West Ham United,Aston Villa,2-0,2,0,1,1,2,2,H
1925-01-31,1924,Huddersfield Town,Leeds United,2-0,2,0,1,1,2,2,H
1925-01-31,1924,Manchester City,Bury,0-0,0,0,1,1,0,0,D
1925-02-02,1924,Burnley,Birmingham City,3-2,3,2,1,1,5,1,H
1925-02-04,1924,Nottingham Forest,Liverpool,0-1,0,1,1,1,1,-1,A
1925-02-07,1924,Birmingham City,Leeds United,0-0,0,0,1,1,0,0,D
1925-02-07,1924,Blackburn Rovers,Arsenal,1-0,1,0,1,1,1,1,H
1925-02-07,1924,Bolton Wanderers,Cardiff City,3-0,3,0,1,1,3,3,H
1925-02-07,1924,Huddersfield Town,Aston Villa,4-1,4,1,1,1,5,3,H
1925-02-07,1924,Liverpool,Everton,3-1,3,1,1,1,4,2,H
1925-02-07,1924,Newcastle United,Nottingham Forest,4-1,4,1,1,1,5,3,H
1925-02-07,1924,Notts County,Sunderland,4-1,4,1,1,1,5,3,H
1925-02-07,1924,Sheffield United,Bury,0-1,0,1,1,1,1,-1,A
1925-02-07,1924,Tottenham Hotspur,Preston North End,2-0,2,0,1,1,2,2,H
1925-02-07,1924,West Bromwich Albion,Burnley,1-4,1,4,1,1,5,-3,A
1925-02-07,1924,West Ham United,Manchester City,4-0,4,0,1,1,4,4,H
1925-02-11,1924,Bury,Newcastle United,0-0,0,0,1,1,0,0,D
1925-02-11,1924,Cardiff City,Burnley,4-0,4,0,1,1,4,4,H
1925-02-11,1924,Sunderland,Bolton Wanderers,1-0,1,0,1,1,1,1,H
1925-02-12,1924,Preston North End,West Bromwich Albion,1-2,1,2,1,1,3,-1,A
1925-02-14,1924,Arsenal,Huddersfield Town,0-5,0,5,1,1,5,-5,A
1925-02-14,1924,Aston Villa,Birmingham City,1-0,1,0,1,1,1,1,H
1925-02-14,1924,Burnley,Tottenham Hotspur,1-4,1,4,1,1,5,-3,A
1925-02-14,1924,Bury,West Ham United,4-2,4,2,1,1,6,2,H
1925-02-14,1924,Cardiff City,Notts County,1-1,1,1,1,1,2,0,D
1925-02-14,1924,Leeds United,West Bromwich Albion,0-1,0,1,1,1,1,-1,A
1925-02-14,1924,Liverpool,Newcastle United,1-1,1,1,1,1,2,0,D
1925-02-14,1924,Manchester City,Blackburn Rovers,1-3,1,3,1,1,4,-2,A
1925-02-14,1924,Nottingham Forest,Sheffield United,2-3,2,3,1,1,5,-1,A
1925-02-14,1924,Preston North End,Bolton Wanderers,1-0,1,0,1,1,1,1,H
1925-02-14,1924,Sunderland,Everton,4-1,4,1,1,1,5,3,H
1925-02-21,1924,Bolton Wanderers,Burnley,5-0,5,0,1,1,5,5,H
1925-02-21,1924,Huddersfield Town,Manchester City,1-1,1,1,1,1,2,0,D
1925-02-21,1924,Newcastle United,Sunderland,2-0,2,0,1,1,2,2,H
1925-02-23,1924,Manchester City,Sheffield United,2-1,2,1,1,1,3,1,H
1925-02-25,1924,Everton,Cardiff City,1-2,1,2,1,1,3,-1,A
1925-02-28,1924,Birmingham City,Huddersfield Town,0-1,0,1,1,1,1,-1,A
1925-02-28,1924,Bolton Wanderers,Manchester City,4-2,4,2,1,1,6,2,H
1925-02-28,1924,Burnley,West Ham United,5-4,5,4,1,1,9,1,H
1925-02-28,1924,Cardiff City,Newcastle United,3-0,3,0,1,1,3,3,H
1925-02-28,1924,Everton,Nottingham Forest,3-1,3,1,1,1,4,2,H
1925-02-28,1924,Leeds United,Blackburn Rovers,1-1,1,1,1,1,2,0,D
1925-02-28,1924,Notts County,Bury,1-1,1,1,1,1,2,0,D
1925-02-28,1924,Preston North End,Sheffield United,0-1,0,1,1,1,1,-1,A
1925-02-28,1924,Sunderland,Liverpool,3-0,3,0,1,1,3,3,H
1925-02-28,1924,Tottenham Hotspur,Arsenal,2-0,2,0,1,1,2,2,H
1925-02-28,1924,West Bromwich Albion,Aston Villa,4-1,4,1,1,1,5,3,H
1925-03-07,1924,Arsenal,Bolton Wanderers,1-0,1,0,1,1,1,1,H
1925-03-07,1924,Aston Villa,Tottenham Hotspur,0-1,0,1,1,1,1,-1,A
1925-03-07,1924,Bury,Everton,1-0,1,0,1,1,1,1,H
1925-03-07,1924,Manchester City,Notts County,2-1,2,1,1,1,3,1,H
1925-03-07,1924,Newcastle United,Preston North End,3-1,3,1,1,1,4,2,H
1925-03-07,1924,Nottingham Forest,Sunderland,1-1,1,1,1,1,2,0,D
1925-03-07,1924,West Ham United,Leeds United,0-0,0,0,1,1,0,0,D
1925-03-09,1924,Tottenham Hotspur,Leeds United,2-1,2,1,1,1,3,1,H
1925-03-11,1924,Huddersfield Town,West Bromwich Albion,1-1,1,1,1,1,2,0,D
1925-03-14,1924,Birmingham City,West Ham United,1-1,1,1,1,1,2,0,D
1925-03-14,1924,Bolton Wanderers,Aston Villa,4-0,4,0,1,1,4,4,H
1925-03-14,1924,Burnley,Newcastle United,1-3,1,3,1,1,4,-2,A
1925-03-14,1924,Cardiff City,Nottingham Forest,2-0,2,0,1,1,2,2,H
1925-03-14,1924,Leeds United,Sheffield United,1-1,1,1,1,1,2,0,D
1925-03-14,1924,Notts County,Arsenal,2-1,2,1,1,1,3,1,H
1925-03-14,1924,Preston North End,Liverpool,4-0,4,0,1,1,4,4,H
1925-03-14,1924,Sunderland,Bury,1-1,1,1,1,1,2,0,D
1925-03-14,1924,Tottenham Hotspur,Huddersfield Town,1-2,1,2,1,1,3,-1,A
1925-03-14,1924,West Bromwich Albion,Blackburn Rovers,1-1,1,1,1,1,2,0,D
1925-03-16,1924,Birmingham City,West Bromwich Albion,0-0,0,0,1,1,0,0,D
1925-03-16,1924,Sheffield United,Liverpool,0-1,0,1,1,1,1,-1,A
1925-03-18,1924,Cardiff City,Tottenham Hotspur,0-2,0,2,1,1,2,-2,A
1925-03-18,1924,Everton,Notts County,1-0,1,0,1,1,1,1,H
1925-03-19,1924,Blackburn Rovers,Bury,0-1,0,1,1,1,1,-1,A
1925-03-21,1924,Arsenal,Everton,3-1,3,1,1,1,4,2,H
1925-03-21,1924,Aston Villa,Notts County,0-0,0,0,1,1,0,0,D
1925-03-21,1924,Blackburn Rovers,Tottenham Hotspur,1-1,1,1,1,1,2,0,D
1925-03-21,1924,Bury,Cardiff City,4-1,4,1,1,1,5,3,H
1925-03-21,1924,Huddersfield Town,Bolton Wanderers,0-0,0,0,1,1,0,0,D
1925-03-21,1924,Liverpool,Burnley,3-0,3,0,1,1,3,3,H
1925-03-21,1924,Manchester City,Sunderland,1-3,1,3,1,1,4,-2,A
1925-03-21,1924,Newcastle United,Leeds United,4-1,4,1,1,1,5,3,H
1925-03-21,1924,Nottingham Forest,Preston North End,0-1,0,1,1,1,1,-1,A
1925-03-21,1924,Sheffield United,Birmingham City,4-3,4,3,1,1,7,1,H
1925-03-21,1924,West Ham United,West Bromwich Albion,2-1,2,1,1,1,3,1,H
1925-03-23,1924,Arsenal,West Ham United,1-2,1,2,1,1,3,-1,A
1925-03-28,1924,Birmingham City,Newcastle United,1-1,1,1,1,1,2,0,D
1925-03-28,1924,Burnley,Nottingham Forest,0-0,0,0,1,1,0,0,D
1925-03-28,1924,Everton,Aston Villa,2-0,2,0,1,1,2,2,H
1925-03-28,1924,Leeds United,Liverpool,4-1,4,1,1,1,5,3,H
1925-03-28,1924,Preston North End,Bury,1-1,1,1,1,1,2,0,D
1925-03-28,1924,Sunderland,Arsenal,2-0,2,0,1,1,2,2,H
1925-03-28,1924,Tottenham Hotspur,West Ham United,1-1,1,1,1,1,2,0,D
1925-03-30,1924,West Bromwich Albion,Sheffield United,2-1,2,1,1,1,3,1,H
1925-04-01,1924,Aston Villa,Arsenal,4-0,4,0,1,1,4,4,H
1925-04-01,1924,Cardiff City,Manchester City,0-2,0,2,1,1,2,-2,A
1925-04-01,1924,Notts County,Preston North End,1-0,1,0,1,1,1,1,H
1925-04-02,1924,Blackburn Rovers,Birmingham City,7-1,7,1,1,1,8,6,H
1925-04-02,1924,West Ham United,Nottingham Forest,0-0,0,0,1,1,0,0,D
1925-04-04,1924,Arsenal,Cardiff City,1-1,1,1,1,1,2,0,D
1925-04-04,1924,Aston Villa,Sunderland,1-4,1,4,1,1,5,-3,A
1925-04-04,1924,Blackburn Rovers,Notts County,0-2,0,2,1,1,2,-2,A
1925-04-04,1924,Bury,Burnley,1-0,1,0,1,1,1,1,H
1925-04-04,1924,Huddersfield Town,Everton,2-0,2,0,1,1,2,2,H
1925-04-04,1924,Liverpool,Birmingham City,1-1,1,1,1,1,2,0,D
1925-04-04,1924,Manchester City,Preston North End,2-1,2,1,1,1,3,1,H
1925-04-04,1924,Newcastle United,West Bromwich Albion,0-1,0,1,1,1,1,-1,A
1925-04-04,1924,Nottingham Forest,Leeds United,4-0,4,0,1,1,4,4,H
1925-04-04,1924,Sheffield United,Tottenham Hotspur,2-0,2,0,1,1,2,2,H
1925-04-04,1924,West Ham United,Bolton Wanderers,1-1,1,1,1,1,2,0,D
1925-04-06,1924,Sheffield United,Burnley,4-0,4,0,1,1,4,4,H
1925-04-10,1924,Aston Villa,Manchester City,2-1,2,1,1,1,3,1,H
1925-04-10,1924,Bolton Wanderers,Leeds United,1-0,1,0,1,1,1,1,H
1925-04-10,1924,Burnley,Notts County,1-1,1,1,1,1,2,0,D
1925-04-10,1924,Bury,Huddersfield Town,0-1,0,1,1,1,1,-1,A
1925-04-10,1924,Liverpool,West Ham United,2-0,2,0,1,1,2,2,H
1925-04-10,1924,Nottingham Forest,Blackburn Rovers,0-2,0,2,1,1,2,-2,A
1925-04-10,1924,Preston North End,Everton,1-1,1,1,1,1,2,0,D
1925-04-10,1924,Tottenham Hotspur,Birmingham City,0-1,0,1,1,1,1,-1,A
1925-04-11,1924,Birmingham City,Nottingham Forest,1-1,1,1,1,1,2,0,D
1925-04-11,1924,Bolton Wanderers,Sheffield United,3-1,3,1,1,1,4,2,H
1925-04-11,1924,Burnley,Manchester City,1-0,1,0,1,1,1,1,H
1925-04-11,1924,Cardiff City,Aston Villa,2-1,2,1,1,1,3,1,H
1925-04-11,1924,Everton,Blackburn Rovers,1-0,1,0,1,1,1,1,H
1925-04-11,1924,Leeds United,Bury,1-0,1,0,1,1,1,1,H
1925-04-11,1924,Notts County,West Ham United,4-1,4,1,1,1,5,3,H
1925-04-11,1924,Preston North End,Arsenal,2-0,2,0,1,1,2,2,H
1925-04-11,1924,Sunderland,Huddersfield Town,1-1,1,1,1,1,2,0,D
1925-04-11,1924,Tottenham Hotspur,Newcastle United,3-0,3,0,1,1,3,3,H
1925-04-11,1924,West Bromwich Albion,Liverpool,0-0,0,0,1,1,0,0,D
1925-04-13,1924,Blackburn Rovers,Nottingham Forest,0-0,0,0,1,1,0,0,D
1925-04-13,1924,Cardiff City,Sunderland,2-0,2,0,1,1,2,2,H
1925-04-13,1924,Everton,Preston North End,0-0,0,0,1,1,0,0,D
1925-04-13,1924,Manchester City,Aston Villa,1-0,1,0,1,1,1,1,H
1925-04-13,1924,Notts County,Burnley,2-0,2,0,1,1,2,2,H
1925-04-13,1924,Sheffield United,Newcastle United,1-2,1,2,1,1,3,-1,A
1925-04-13,1924,West Bromwich Albion,Arsenal,2-0,2,0,1,1,2,2,H
1925-04-13,1924,West Ham United,Liverpool,0-1,0,1,1,1,1,-1,A
1925-04-14,1924,Arsenal,West Bromwich Albion,2-0,2,0,1,1,2,2,H
1925-04-14,1924,Huddersfield Town,Bury,2-0,2,0,1,1,2,2,H
1925-04-14,1924,Leeds United,Bolton Wanderers,2-1,2,1,1,1,3,1,H
1925-04-14,1924,West Ham United,Sheffield United,6-2,6,2,1,1,8,4,H
1925-04-15,1924,Cardiff City,Blackburn Rovers,3-0,3,0,1,1,3,3,H
1925-04-18,1924,Arsenal,Burnley,5-0,5,0,1,1,5,5,H
1925-04-18,1924,Aston Villa,Preston North End,1-0,1,0,1,1,1,1,H
1925-04-18,1924,Blackburn Rovers,Sunderland,1-1,1,1,1,1,2,0,D
1925-04-18,1924,Bury,Birmingham City,1-4,1,4,1,1,5,-3,A
1925-04-18,1924,Huddersfield Town,Cardiff City,0-0,0,0,1,1,0,0,D
1925-04-18,1924,Liverpool,Tottenham Hotspur,1-0,1,0,1,1,1,1,H
1925-04-18,1924,Manchester City,Leeds United,4-2,4,2,1,1,6,2,H
1925-04-18,1924,Newcastle United,Bolton Wanderers,0-1,0,1,1,1,1,-1,A
1925-04-18,1924,Nottingham Forest,West Bromwich Albion,0-1,0,1,1,1,1,-1,A
1925-04-18,1924,Sheffield United,Notts County,2-0,2,0,1,1,2,2,H
1925-04-18,1924,West Ham United,Everton,4-1,4,1,1,1,5,3,H
1925-04-22,1924,Bolton Wanderers,Blackburn Rovers,6-0,6,0,1,1,6,6,H
1925-04-25,1924,Birmingham City,Manchester City,2-1,2,1,1,1,3,1,H
1925-04-25,1924,Bolton Wanderers,Liverpool,2-0,2,0,1,1,2,2,H
1925-04-25,1924,Burnley,Aston Villa,1-1,1,1,1,1,2,0,D
1925-04-25,1924,Leeds United,Arsenal,1-0,1,0,1,1,1,1,H
1925-04-25,1924,Notts County,Newcastle United,2-0,2,0,1,1,2,2,H
1925-04-25,1924,Preston North End,Huddersfield Town,1-4,1,4,1,1,5,-3,A
1925-04-25,1924,Sunderland,West Ham United,1-1,1,1,1,1,2,0,D
1925-04-25,1924,Tottenham Hotspur,Nottingham Forest,1-0,1,0,1,1,1,1,H
1925-04-25,1924,West Bromwich Albion,Bury,1-1,1,1,1,1,2,0,D
1925-04-27,1924,Everton,Sheffield United,1-1,1,1,1,1,2,0,D
1925-04-29,1924,Aston Villa,Blackburn Rovers,4-3,4,3,1,1,7,1,H
1925-04-29,1924,Liverpool,Cardiff City,1-2,1,2,1,1,3,-1,A
1925-04-29,1924,Notts County,Huddersfield Town,1-1,1,1,1,1,2,0,D
1925-05-02,1924,Aston Villa,Nottingham Forest,2-0,2,0,1,1,2,2,H
1925-05-02,1924,Bury,Arsenal,2-0,2,0,1,1,2,2,H
1925-05-02,1924,Cardiff City,Preston North End,0-0,0,0,1,1,0,0,D
1925-05-02,1924,Everton,Leeds United,1-0,1,0,1,1,1,1,H
1925-05-02,1924,Huddersfield Town,Liverpool,1-1,1,1,1,1,2,0,D
1925-05-02,1924,Manchester City,Tottenham Hotspur,1-0,1,0,1,1,1,1,H
1925-05-02,1924,Notts County,Birmingham City,0-1,0,1,1,1,1,-1,A
1925-05-02,1924,Sunderland,Burnley,1-1,1,1,1,1,2,0,D
1925-05-02,1924,West Bromwich Albion,Bolton Wanderers,0-0,0,0,1,1,0,0,D
1925-08-29,1925,Arsenal,Tottenham Hotspur,0-1,0,1,1,1,1,-1,A
1925-08-29,1925,Aston Villa,Burnley,10-0,10,0,1,1,10,10,H
1925-08-29,1925,Blackburn Rovers,Bury,1-2,1,2,1,1,3,-1,A
1925-08-29,1925,Bolton Wanderers,Newcastle United,2-2,2,2,1,1,4,0,D
1925-08-29,1925,Everton,Sheffield United,2-2,2,2,1,1,4,0,D
1925-08-29,1925,Huddersfield Town,West Bromwich Albion,1-1,1,1,1,1,2,0,D
1925-08-29,1925,Leicester City,Liverpool,3-1,3,1,1,1,4,2,H
1925-08-29,1925,Manchester City,Cardiff City,3-2,3,2,1,1,5,1,H
1925-08-29,1925,Notts County,Leeds United,1-0,1,0,1,1,1,1,H
1925-08-29,1925,Sunderland,Birmingham City,3-1,3,1,1,1,4,2,H
1925-08-29,1925,West Ham United,Manchester United,1-0,1,0,1,1,1,1,H
1925-08-31,1925,Arsenal,Leicester City,2-2,2,2,1,1,4,0,D
1925-08-31,1925,Birmingham City,Manchester City,1-0,1,0,1,1,1,1,H
1925-08-31,1925,Leeds United,Bolton Wanderers,2-1,2,1,1,1,3,1,H
1925-08-31,1925,Sheffield United,Tottenham Hotspur,2-3,2,3,1,1,5,-1,A
1925-08-31,1925,West Ham United,Cardiff City,3-1,3,1,1,1,4,2,H
1925-09-02,1925,Liverpool,Notts County,2-0,2,0,1,1,2,2,H
1925-09-02,1925,Manchester United,Aston Villa,3-0,3,0,1,1,3,3,H
1925-09-02,1925,Sunderland,Blackburn Rovers,6-2,6,2,1,1,8,4,H
1925-09-02,1925,West Bromwich Albion,Everton,1-1,1,1,1,1,2,0,D
1925-09-05,1925,Birmingham City,Blackburn Rovers,2-0,2,0,1,1,2,2,H
1925-09-05,1925,Burnley,Leicester City,4-0,4,0,1,1,4,4,H
1925-09-05,1925,Bury,Bolton Wanderers,0-5,0,5,1,1,5,-5,A
1925-09-05,1925,Cardiff City,Everton,2-1,2,1,1,1,3,1,H
1925-09-05,1925,Leeds United,Aston Villa,2-2,2,2,1,1,4,0,D
1925-09-05,1925,Liverpool,West Ham United,0-0,0,0,1,1,0,0,D
1925-09-05,1925,Manchester United,Arsenal,0-1,0,1,1,1,1,-1,A
1925-09-05,1925,Newcastle United,Notts County,6-3,6,3,1,1,9,3,H
1925-09-05,1925,Sheffield United,Huddersfield Town,2-3,2,3,1,1,5,-1,A
1925-09-05,1925,Tottenham Hotspur,Manchester City,1-0,1,0,1,1,1,1,H
1925-09-05,1925,West Bromwich Albion,Sunderland,2-5,2,5,1,1,7,-3,A
1925-09-07,1925,Aston Villa,Manchester United,2-2,2,2,1,1,4,0,D
1925-09-07,1925,Bolton Wanderers,Leeds United,1-0,1,0,1,1,1,1,H
1925-09-07,1925,Burnley,Notts County,0-0,0,0,1,1,0,0,D
1925-09-07,1925,Cardiff City,West Ham United,0-1,0,1,1,1,1,-1,A
1925-09-07,1925,Leicester City,Arsenal,0-1,0,1,1,1,1,-1,A
1925-09-07,1925,Tottenham Hotspur,Sheffield United,3-2,3,2,1,1,5,1,H
1925-09-08,1925,Huddersfield Town,Bury,2-1,2,1,1,1,3,1,H
1925-09-09,1925,Burnley,Bolton Wanderers,1-1,1,1,1,1,2,0,D
1925-09-09,1925,Everton,Birmingham City,2-2,2,2,1,1,4,0,D
1925-09-09,1925,Newcastle United,Blackburn Rovers,1-7,1,7,1,1,8,-6,A
1925-09-12,1925,Arsenal,Liverpool,1-1,1,1,1,1,2,0,D
1925-09-12,1925,Aston Villa,Newcastle United,2-2,2,2,1,1,4,0,D
1925-09-12,1925,Blackburn Rovers,West Bromwich Albion,1-2,1,2,1,1,3,-1,A
1925-09-12,1925,Bury,Birmingham City,2-1,2,1,1,1,3,1,H
1925-09-12,1925,Everton,Tottenham Hotspur,1-1,1,1,1,1,2,0,D
1925-09-12,1925,Huddersfield Town,Cardiff City,1-1,1,1,1,1,2,0,D
1925-09-12,1925,Leicester City,Leeds United,1-3,1,3,1,1,4,-2,A
1925-09-12,1925,Manchester City,Manchester United,1-1,1,1,1,1,2,0,D
1925-09-12,1925,Notts County,Bolton Wanderers,3-0,3,0,1,1,3,3,H
1925-09-12,1925,Sunderland,Sheffield United,6-1,6,1,1,1,7,5,H
1925-09-12,1925,West Ham United,Burnley,2-0,2,0,1,1,2,2,H
1925-09-14,1925,Tottenham Hotspur,Cardiff City,1-2,1,2,1,1,3,-1,A
1925-09-16,1925,Birmingham City,Huddersfield Town,1-3,1,3,1,1,4,-2,A
1925-09-16,1925,Bolton Wanderers,Burnley,4-2,4,2,1,1,6,2,H
1925-09-16,1925,Everton,West Bromwich Albion,4-0,4,0,1,1,4,4,H
1925-09-16,1925,Leeds United,Newcastle United,2-0,2,0,1,1,2,2,H
1925-09-16,1925,Manchester United,Leicester City,3-2,3,2,1,1,5,1,H
1925-09-19,1925,Birmingham City,Notts County,0-1,0,1,1,1,1,-1,A
1925-09-19,1925,Bolton Wanderers,Aston Villa,1-3,1,3,1,1,4,-2,A
1925-09-19,1925,Burnley,Arsenal,2-2,2,2,1,1,4,0,D
1925-09-19,1925,Leeds United,West Ham United,5-2,5,2,1,1,7,3,H
1925-09-19,1925,Liverpool,Manchester United,5-0,5,0,1,1,5,5,H
1925-09-19,1925,Manchester City,Everton,4-4,4,4,1,1,8,0,D
1925-09-19,1925,Newcastle United,Leicester City,3-2,3,2,1,1,5,1,H
1925-09-19,1925,Sheffield United,Blackburn Rovers,1-1,1,1,1,1,2,0,D
1925-09-19,1925,Tottenham Hotspur,Huddersfield Town,5-5,5,5,1,1,10,0,D
1925-09-21,1925,Arsenal,West Ham United,3-2,3,2,1,1,5,1,H
1925-09-21,1925,Birmingham City,Everton,3-1,3,1,1,1,4,2,H
1925-09-21,1925,Blackburn Rovers,Sunderland,3-0,3,0,1,1,3,3,H
1925-09-21,1925,Cardiff City,Tottenham Hotspur,0-1,0,1,1,1,1,-1,A
1925-09-21,1925,Notts County,Burnley,0-1,0,1,1,1,1,-1,A
1925-09-23,1925,Cardiff City,Sunderland,0-1,0,1,1,1,1,-1,A
1925-09-23,1925,West Bromwich Albion,Manchester City,4-1,4,1,1,1,5,3,H
1925-09-26,1925,Arsenal,Leeds United,4-1,4,1,1,1,5,3,H
1925-09-26,1925,Aston Villa,Notts County,2-1,2,1,1,1,3,1,H
1925-09-26,1925,Birmingham City,West Bromwich Albion,3-0,3,0,1,1,3,3,H
1925-09-26,1925,Blackburn Rovers,Cardiff City,6-3,6,3,1,1,9,3,H
1925-09-26,1925,Bury,Sheffield United,7-4,7,4,1,1,11,3,H
1925-09-26,1925,Huddersfield Town,Manchester City,2-2,2,2,1,1,4,0,D
1925-09-26,1925,Leicester City,Bolton Wanderers,5-2,5,2,1,1,7,3,H
1925-09-26,1925,Liverpool,Everton,5-1,5,1,1,1,6,4,H
1925-09-26,1925,Manchester United,Burnley,6-1,6,1,1,1,7,5,H
1925-09-26,1925,Sunderland,Tottenham Hotspur,3-0,3,0,1,1,3,3,H
1925-09-26,1925,West Ham United,Newcastle United,1-0,1,0,1,1,1,1,H
1925-10-01,1925,Notts County,Liverpool,1-2,1,2,1,1,3,-1,A
1925-10-03,1925,Bolton Wanderers,West Ham United,1-0,1,0,1,1,1,1,H
1925-10-03,1925,Burnley,Liverpool,2-1,2,1,1,1,3,1,H
1925-10-03,1925,Cardiff City,Bury,3-2,3,2,1,1,5,1,H
1925-10-03,1925,Everton,Huddersfield Town,2-3,2,3,1,1,5,-1,A
1925-10-03,1925,Leeds United,Manchester United,2-0,2,0,1,1,2,2,H
1925-10-03,1925,Manchester City,Sunderland,4-1,4,1,1,1,5,3,H
1925-10-03,1925,Newcastle United,Arsenal,7-0,7,0,1,1,7,7,H
1925-10-03,1925,Notts County,Leicester City,2-2,2,2,1,1,4,0,D
1925-10-03,1925,Sheffield United,Birmingham City,4-1,4,1,1,1,5,3,H
1925-10-03,1925,Tottenham Hotspur,Blackburn Rovers,4-2,4,2,1,1,6,2,H
1925-10-03,1925,West Bromwich Albion,Aston Villa,1-1,1,1,1,1,2,0,D
1925-10-05,1925,Aston Villa,Sunderland,4-2,4,2,1,1,6,2,H
1925-10-05,1925,West Ham United,Arsenal,0-4,0,4,1,1,4,-4,A
1925-10-10,1925,Arsenal,Bolton Wanderers,2-3,2,3,1,1,5,-1,A
1925-10-10,1925,Birmingham City,Cardiff City,3-2,3,2,1,1,5,1,H
1925-10-10,1925,Blackburn Rovers,Manchester City,3-3,3,3,1,1,6,0,D
1925-10-10,1925,Bury,Tottenham Hotspur,3-0,3,0,1,1,3,3,H
1925-10-10,1925,Huddersfield Town,Burnley,2-1,2,1,1,1,3,1,H
1925-10-10,1925,Leicester City,Aston Villa,1-2,1,2,1,1,3,-1,A
1925-10-10,1925,Liverpool,Leeds United,1-1,1,1,1,1,2,0,D
1925-10-10,1925,Manchester United,Newcastle United,2-1,2,1,1,1,3,1,H
1925-10-10,1925,Sunderland,Everton,7-3,7,3,1,1,10,4,H
1925-10-10,1925,West Bromwich Albion,Sheffield United,2-0,2,0,1,1,2,2,H
1925-10-10,1925,West Ham United,Notts County,1-0,1,0,1,1,1,1,H
1925-10-12,1925,Blackburn Rovers,Newcastle United,1-2,1,2,1,1,3,-1,A
1925-10-14,1925,Sunderland,Bury,1-0,1,0,1,1,1,1,H
1925-10-17,1925,Arsenal,Cardiff City,5-0,5,0,1,1,5,5,H
1925-10-17,1925,Aston Villa,Birmingham City,3-3,3,3,1,1,6,0,D
1925-10-17,1925,Bolton Wanderers,Blackburn Rovers,2-2,2,2,1,1,4,0,D
1925-10-17,1925,Burnley,Everton,1-3,1,3,1,1,4,-2,A
1925-10-17,1925,Leeds United,Huddersfield Town,0-4,0,4,1,1,4,-4,A
1925-10-17,1925,Leicester City,West Bromwich Albion,3-0,3,0,1,1,3,3,H
1925-10-17,1925,Liverpool,Manchester City,2-1,2,1,1,1,3,1,H
1925-10-17,1925,Manchester United,Tottenham Hotspur,0-0,0,0,1,1,0,0,D
1925-10-17,1925,Newcastle United,Sunderland,0-0,0,0,1,1,0,0,D
1925-10-17,1925,Notts County,Bury,4-1,4,1,1,1,5,3,H
1925-10-17,1925,West Ham United,Sheffield United,1-3,1,3,1,1,4,-2,A
1925-10-24,1925,Birmingham City,Leicester City,1-1,1,1,1,1,2,0,D
1925-10-24,1925,Blackburn Rovers,Notts County,4-1,4,1,1,1,5,3,H
1925-10-24,1925,Bury,Aston Villa,2-3,2,3,1,1,5,-1,A
1925-10-24,1925,Cardiff City,Manchester United,0-2,0,2,1,1,2,-2,A
1925-10-24,1925,Everton,Leeds United,4-2,4,2,1,1,6,2,H
1925-10-24,1925,Huddersfield Town,Newcastle United,0-1,0,1,1,1,1,-1,A
1925-10-24,1925,Manchester City,Burnley,8-3,8,3,1,1,11,5,H
1925-10-24,1925,Sheffield United,Arsenal,4-0,4,0,1,1,4,4,H
1925-10-24,1925,Sunderland,Bolton Wanderers,2-1,2,1,1,1,3,1,H
1925-10-24,1925,Tottenham Hotspur,Liverpool,3-1,3,1,1,1,4,2,H
1925-10-24,1925,West Bromwich Albion,West Ham United,7-1,7,1,1,1,8,6,H
1925-10-26,1925,Sheffield United,Manchester City,8-3,8,3,1,1,11,5,H
1925-10-28,1925,Bury,Sunderland,2-2,2,2,1,1,4,0,D
1925-10-31,1925,Arsenal,Everton,4-1,4,1,1,1,5,3,H
1925-10-31,1925,Aston Villa,Cardiff City,0-2,0,2,1,1,2,-2,A
1925-10-31,1925,Bolton Wanderers,West Bromwich Albion,2-2,2,2,1,1,4,0,D
1925-10-31,1925,Burnley,Blackburn Rovers,1-3,1,3,1,1,4,-2,A
1925-10-31,1925,Leeds United,Bury,2-3,2,3,1,1,5,-1,A
1925-10-31,1925,Leicester City,Tottenham Hotspur,5-3,5,3,1,1,8,2,H
1925-10-31,1925,Liverpool,Sunderland,2-2,2,2,1,1,4,0,D
1925-10-31,1925,Manchester United,Huddersfield Town,1-1,1,1,1,1,2,0,D
1925-10-31,1925,Newcastle United,Birmingham City,1-3,1,3,1,1,4,-2,A
1925-10-31,1925,Notts County,Sheffield United,2-0,2,0,1,1,2,2,H
1925-10-31,1925,West Ham United,Manchester City,3-1,3,1,1,1,4,2,H
1925-11-04,1925,Manchester City,Sheffield United,2-4,2,4,1,1,6,-2,A
1925-11-07,1925,Birmingham City,Bolton Wanderers,0-1,0,1,1,1,1,-1,A
1925-11-07,1925,Blackburn Rovers,Leeds United,2-2,2,2,1,1,4,0,D
1925-11-07,1925,Bury,Newcastle United,1-1,1,1,1,1,2,0,D
1925-11-07,1925,Cardiff City,Leicester City,5-2,5,2,1,1,7,3,H
1925-11-07,1925,Everton,Manchester United,1-3,1,3,1,1,4,-2,A
1925-11-07,1925,Manchester City,Arsenal,2-5,2,5,1,1,7,-3,A
1925-11-07,1925,Sheffield United,Aston Villa,4-1,4,1,1,1,5,3,H
1925-11-07,1925,Sunderland,Burnley,2-2,2,2,1,1,4,0,D
1925-11-07,1925,Tottenham Hotspur,West Ham United,4-2,4,2,1,1,6,2,H
1925-11-07,1925,West Bromwich Albion,Notts County,4-4,4,4,1,1,8,0,D
1925-11-09,1925,West Bromwich Albion,Bury,4-0,4,0,1,1,4,4,H
1925-11-14,1925,Arsenal,Bury,6-1,6,1,1,1,7,5,H
1925-11-14,1925,Aston Villa,Huddersfield Town,3-0,3,0,1,1,3,3,H
1925-11-14,1925,Bolton Wanderers,Manchester City,5-1,5,1,1,1,6,4,H
1925-11-14,1925,Burnley,Sheffield United,1-1,1,1,1,1,2,0,D
1925-11-14,1925,Leeds United,Cardiff City,1-0,1,0,1,1,1,1,H
1925-11-14,1925,Leicester City,Sunderland,4-1,4,1,1,1,5,3,H
1925-11-14,1925,Liverpool,West Bromwich Albion,2-0,2,0,1,1,2,2,H
1925-11-14,1925,Manchester United,Birmingham City,3-1,3,1,1,1,4,2,H
1925-11-14,1925,Newcastle United,Tottenham Hotspur,3-1,3,1,1,1,4,2,H
1925-11-14,1925,Notts County,Everton,0-3,0,3,1,1,3,-3,A
1925-11-14,1925,West Ham United,Blackburn Rovers,2-1,2,1,1,1,3,1,H
1925-11-21,1925,Birmingham City,Liverpool,2-0,2,0,1,1,2,2,H
1925-11-21,1925,Blackburn Rovers,Arsenal,2-3,2,3,1,1,5,-1,A
1925-11-21,1925,Bury,Manchester United,1-3,1,3,1,1,4,-2,A
1925-11-21,1925,Cardiff City,Newcastle United,0-0,0,0,1,1,0,0,D
1925-11-21,1925,Everton,Aston Villa,1-1,1,1,1,1,2,0,D
1925-11-21,1925,Huddersfield Town,Leicester City,3-0,3,0,1,1,3,3,H
1925-11-21,1925,Manchester City,Notts County,1-1,1,1,1,1,2,0,D
1925-11-21,1925,Sheffield United,Leeds United,2-0,2,0,1,1,2,2,H
1925-11-21,1925,Sunderland,West Ham United,4-1,4,1,1,1,5,3,H
1925-11-21,1925,Tottenham Hotspur,Bolton Wanderers,2-3,2,3,1,1,5,-1,A
1925-11-21,1925,West Bromwich Albion,Burnley,5-3,5,3,1,1,8,2,H
1925-11-25,1925,Huddersfield Town,Liverpool,0-0,0,0,1,1,0,0,D
1925-11-28,1925,Arsenal,Sunderland,2-0,2,0,1,1,2,2,H
1925-11-28,1925,Aston Villa,Manchester City,3-1,3,1,1,1,4,2,H
1925-11-28,1925,Bolton Wanderers,Cardiff City,0-1,0,1,1,1,1,-1,A
1925-11-28,1925,Leeds United,West Bromwich Albion,0-1,0,1,1,1,1,-1,A
1925-11-28,1925,Leicester City,Everton,1-1,1,1,1,1,2,0,D
1925-11-28,1925,Liverpool,Bury,0-1,0,1,1,1,1,-1,A
1925-11-28,1925,Manchester United,Blackburn Rovers,2-0,2,0,1,1,2,2,H
1925-11-28,1925,Notts County,Tottenham Hotspur,4-2,4,2,1,1,6,2,H
1925-11-28,1925,West Ham United,Huddersfield Town,2-3,2,3,1,1,5,-1,A
1925-12-05,1925,Birmingham City,Leeds United,2-1,2,1,1,1,3,1,H
1925-12-05,1925,Blackburn Rovers,Liverpool,1-1,1,1,1,1,2,0,D
1925-12-05,1925,Cardiff City,Notts County,2-1,2,1,1,1,3,1,H
1925-12-05,1925,Everton,West Ham United,2-0,2,0,1,1,2,2,H
1925-12-05,1925,Huddersfield Town,Arsenal,2-2,2,2,1,1,4,0,D
1925-12-05,1925,Manchester City,Leicester City,5-1,5,1,1,1,6,4,H
1925-12-05,1925,Sheffield United,Bolton Wanderers,2-0,2,0,1,1,2,2,H
1925-12-05,1925,Sunderland,Manchester United,2-1,2,1,1,1,3,1,H
1925-12-05,1925,Tottenham Hotspur,Aston Villa,2-2,2,2,1,1,4,0,D
1925-12-05,1925,West Bromwich Albion,Newcastle United,4-0,4,0,1,1,4,4,H
1925-12-07,1925,Burnley,Birmingham City,3-1,3,1,1,1,4,2,H
1925-12-09,1925,Newcastle United,Sheffield United,3-1,3,1,1,1,4,2,H
1925-12-12,1925,Arsenal,West Bromwich Albion,1-0,1,0,1,1,1,1,H
1925-12-12,1925,Aston Villa,Blackburn Rovers,1-2,1,2,1,1,3,-1,A
1925-12-12,1925,Bolton Wanderers,Huddersfield Town,6-1,6,1,1,1,7,5,H
1925-12-12,1925,Burnley,Tottenham Hotspur,1-2,1,2,1,1,3,-1,A
1925-12-12,1925,Leeds United,Manchester City,3-4,3,4,1,1,7,-1,A
1925-12-12,1925,Leicester City,Bury,0-2,0,2,1,1,2,-2,A
1925-12-12,1925,Liverpool,Cardiff City,0-2,0,2,1,1,2,-2,A
1925-12-12,1925,Manchester United,Sheffield United,1-2,1,2,1,1,3,-1,A
1925-12-12,1925,Newcastle United,Everton,3-3,3,3,1,1,6,0,D
1925-12-12,1925,Notts County,Sunderland,2-0,2,0,1,1,2,2,H
1925-12-12,1925,West Ham United,Birmingham City,2-2,2,2,1,1,4,0,D
1925-12-16,1925,Bury,Burnley,8-1,8,1,1,1,9,7,H
1925-12-19,1925,Birmingham City,Arsenal,1-0,1,0,1,1,1,1,H
1925-12-19,1925,Blackburn Rovers,Leicester City,0-0,0,0,1,1,0,0,D
1925-12-19,1925,Bury,West Ham United,4-1,4,1,1,1,5,3,H
1925-12-19,1925,Cardiff City,Burnley,2-3,2,3,1,1,5,-1,A
1925-12-19,1925,Everton,Bolton Wanderers,2-1,2,1,1,1,3,1,H
1925-12-19,1925,Huddersfield Town,Notts County,2-0,2,0,1,1,2,2,H
1925-12-19,1925,Manchester City,Newcastle United,2-2,2,2,1,1,4,0,D
1925-12-19,1925,Sheffield United,Liverpool,3-1,3,1,1,1,4,2,H
1925-12-19,1925,Sunderland,Aston Villa,3-2,3,2,1,1,5,1,H
1925-12-19,1925,Tottenham Hotspur,Leeds United,3-2,3,2,1,1,5,1,H
1925-12-19,1925,West Bromwich Albion,Manchester United,5-1,5,1,1,1,6,4,H
1925-12-25,1925,Arsenal,Notts County,3-0,3,0,1,1,3,3,H
1925-12-25,1925,Birmingham City,Tottenham Hotspur,3-1,3,1,1,1,4,2,H
1925-12-25,1925,Blackburn Rovers,Everton,2-2,2,2,1,1,4,0,D
1925-12-25,1925,Bury,Manchester City,6-5,6,5,1,1,11,1,H
1925-12-25,1925,Cardiff City,West Bromwich Albion,3-2,3,2,1,1,5,1,H
1925-12-25,1925,Leeds United,Burnley,2-2,2,2,1,1,4,0,D
1925-12-25,1925,Liverpool,Newcastle United,6-3,6,3,1,1,9,3,H
1925-12-25,1925,Manchester United,Bolton Wanderers,2-1,2,1,1,1,3,1,H
1925-12-25,1925,Sheffield United,Leicester City,2-4,2,4,1,1,6,-2,A
1925-12-25,1925,West Ham United,Aston Villa,5-2,5,2,1,1,7,3,H
1925-12-26,1925,Aston Villa,West Ham United,2-0,2,0,1,1,2,2,H
1925-12-26,1925,Burnley,Leeds United,6-3,6,3,1,1,9,3,H
1925-12-26,1925,Everton,Blackburn Rovers,3-0,3,0,1,1,3,3,H
1925-12-26,1925,Huddersfield Town,Sunderland,1-1,1,1,1,1,2,0,D
1925-12-26,1925,Leicester City,Sheffield United,2-2,2,2,1,1,4,0,D
1925-12-26,1925,Manchester City,Bury,0-2,0,2,1,1,2,-2,A
1925-12-26,1925,Newcastle United,Liverpool,3-0,3,0,1,1,3,3,H
1925-12-26,1925,Notts County,Arsenal,4-1,4,1,1,1,5,3,H
1925-12-26,1925,Tottenham Hotspur,Birmingham City,2-1,2,1,1,1,3,1,H
1925-12-26,1925,West Bromwich Albion,Cardiff City,3-0,3,0,1,1,3,3,H
1925-12-28,1925,Huddersfield Town,Birmingham City,4-1,4,1,1,1,5,3,H
1925-12-28,1925,Leicester City,Manchester United,1-3,1,3,1,1,4,-2,A
1926-01-01,1925,Bolton Wanderers,Birmingham City,5-3,5,3,1,1,8,2,H
1926-01-01,1925,Bury,Everton,1-0,1,0,1,1,1,1,H
1926-01-01,1925,Liverpool,Aston Villa,3-1,3,1,1,1,4,2,H
1926-01-01,1925,Manchester City,West Bromwich Albion,3-1,3,1,1,1,4,2,H
1926-01-01,1925,Newcastle United,Burnley,1-3,1,3,1,1,4,-2,A
1926-01-01,1925,Sheffield United,Cardiff City,11-2,11,2,1,1,13,9,H
1926-01-01,1925,Sunderland,Leeds United,1-3,1,3,1,1,4,-2,A
1926-01-02,1925,Birmingham City,Sunderland,2-1,2,1,1,1,3,1,H
1926-01-02,1925,Burnley,Aston Villa,2-3,2,3,1,1,5,-1,A
1926-01-02,1925,Bury,Blackburn Rovers,3-1,3,1,1,1,4,2,H
1926-01-02,1925,Cardiff City,Manchester City,2-2,2,2,1,1,4,0,D
1926-01-02,1925,Leeds United,Notts County,2-1,2,1,1,1,3,1,H
1926-01-02,1925,Liverpool,Leicester City,0-3,0,3,1,1,3,-3,A
1926-01-02,1925,Manchester United,West Ham United,2-1,2,1,1,1,3,1,H
1926-01-02,1925,Newcastle United,Bolton Wanderers,5-1,5,1,1,1,6,4,H
1926-01-02,1925,Sheffield United,Everton,1-1,1,1,1,1,2,0,D
1926-01-02,1925,Tottenham Hotspur,Arsenal,1-1,1,1,1,1,2,0,D
1926-01-02,1925,West Bromwich Albion,Huddersfield Town,2-2,2,2,1,1,4,0,D
1926-01-16,1925,Arsenal,Manchester United,3-2,3,2,1,1,5,1,H
1926-01-16,1925,Blackburn Rovers,Birmingham City,4-4,4,4,1,1,8,0,D
1926-01-16,1925,Bolton Wanderers,Bury,3-2,3,2,1,1,5,1,H
1926-01-16,1925,Everton,Cardiff City,1-1,1,1,1,1,2,0,D
1926-01-16,1925,Huddersfield Town,Sheffield United,4-1,4,1,1,1,5,3,H
1926-01-16,1925,Leicester City,Burnley,3-2,3,2,1,1,5,1,H
1926-01-16,1925,Manchester City,Tottenham Hotspur,0-0,0,0,1,1,0,0,D
1926-01-16,1925,Notts County,Newcastle United,1-3,1,3,1,1,4,-2,A
1926-01-16,1925,Sunderland,West Bromwich Albion,4-0,4,0,1,1,4,4,H
1926-01-16,1925,West Ham United,Liverpool,1-2,1,2,1,1,3,-1,A
1926-01-20,1925,Sunderland,Huddersfield Town,4-1,4,1,1,1,5,3,H
1926-01-23,1925,Birmingham City,Bury,2-3,2,3,1,1,5,-1,A
1926-01-23,1925,Bolton Wanderers,Notts County,2-1,2,1,1,1,3,1,H
1926-01-23,1925,Burnley,West Ham United,2-2,2,2,1,1,4,0,D
1926-01-23,1925,Cardiff City,Huddersfield Town,1-2,1,2,1,1,3,-1,A
1926-01-23,1925,Leeds United,Leicester City,1-0,1,0,1,1,1,1,H
1926-01-23,1925,Liverpool,Arsenal,3-0,3,0,1,1,3,3,H
1926-01-23,1925,Manchester United,Manchester City,1-6,1,6,1,1,7,-5,A
1926-01-23,1925,Newcastle United,Aston Villa,2-2,2,2,1,1,4,0,D
1926-01-23,1925,Sheffield United,Sunderland,4-1,4,1,1,1,5,3,H
1926-01-23,1925,Tottenham Hotspur,Everton,1-1,1,1,1,1,2,0,D
1926-01-23,1925,West Bromwich Albion,Blackburn Rovers,1-1,1,1,1,1,2,0,D
1926-01-30,1925,Everton,Leicester City,1-0,1,0,1,1,1,1,H
1926-01-30,1925,West Ham United,Leeds United,4-2,4,2,1,1,6,2,H
1926-02-03,1925,Arsenal,Burnley,1-2,1,2,1,1,3,-1,A
1926-02-03,1925,Aston Villa,Leeds United,3-1,3,1,1,1,4,2,H
1926-02-06,1925,Bolton Wanderers,Leicester City,2-2,2,2,1,1,4,0,D
1926-02-06,1925,Burnley,Manchester United,0-1,0,1,1,1,1,-1,A
1926-02-06,1925,Cardiff City,Blackburn Rovers,4-1,4,1,1,1,5,3,H
1926-02-06,1925,Everton,Liverpool,3-3,3,3,1,1,6,0,D
1926-02-06,1925,Leeds United,Arsenal,4-2,4,2,1,1,6,2,H
1926-02-06,1925,Manchester City,Huddersfield Town,1-5,1,5,1,1,6,-4,A
1926-02-06,1925,Newcastle United,West Ham United,4-1,4,1,1,1,5,3,H
1926-02-06,1925,Notts County,Aston Villa,1-0,1,0,1,1,1,1,H
1926-02-06,1925,Sheffield United,Bury,3-1,3,1,1,1,4,2,H
1926-02-06,1925,Tottenham Hotspur,Sunderland,0-2,0,2,1,1,2,-2,A
1926-02-06,1925,West Bromwich Albion,Birmingham City,5-1,5,1,1,1,6,4,H
1926-02-10,1925,Everton,Manchester City,1-1,1,1,1,1,2,0,D
1926-02-11,1925,Blackburn Rovers,Huddersfield Town,2-1,2,1,1,1,3,1,H
1926-02-13,1925,Arsenal,Newcastle United,3-0,3,0,1,1,3,3,H
1926-02-13,1925,Aston Villa,West Bromwich Albion,2-1,2,1,1,1,3,1,H
1926-02-13,1925,Birmingham City,Sheffield United,2-0,2,0,1,1,2,2,H
1926-02-13,1925,Blackburn Rovers,Tottenham Hotspur,4-2,4,2,1,1,6,2,H
1926-02-13,1925,Bury,Cardiff City,4-1,4,1,1,1,5,3,H
1926-02-13,1925,Huddersfield Town,Everton,3-0,3,0,1,1,3,3,H
1926-02-13,1925,Leicester City,Notts County,1-0,1,0,1,1,1,1,H
1926-02-13,1925,Liverpool,Burnley,3-2,3,2,1,1,5,1,H
1926-02-13,1925,Manchester United,Leeds United,2-1,2,1,1,1,3,1,H
1926-02-13,1925,Sunderland,Manchester City,5-3,5,3,1,1,8,2,H
1926-02-13,1925,West Ham United,Bolton Wanderers,6-0,6,0,1,1,6,6,H
1926-02-20,1925,Burnley,Huddersfield Town,1-1,1,1,1,1,2,0,D
1926-02-20,1925,Cardiff City,Birmingham City,2-0,2,0,1,1,2,2,H
1926-02-20,1925,Leeds United,Liverpool,1-1,1,1,1,1,2,0,D
1926-02-20,1925,Leicester City,Blackburn Rovers,2-1,2,1,1,1,3,1,H
1926-02-20,1925,Sheffield United,West Bromwich Albion,3-2,3,2,1,1,5,1,H
1926-02-20,1925,Tottenham Hotspur,Bury,4-2,4,2,1,1,6,2,H
1926-02-22,1925,Leicester City,Newcastle United,3-2,3,2,1,1,5,1,H
1926-02-24,1925,Bury,West Bromwich Albion,2-0,2,0,1,1,2,2,H
1926-02-27,1925,Birmingham City,Aston Villa,2-1,2,1,1,1,3,1,H
1926-02-27,1925,Blackburn Rovers,Bolton Wanderers,3-0,3,0,1,1,3,3,H
1926-02-27,1925,Bury,Notts County,3-1,3,1,1,1,4,2,H
1926-02-27,1925,Cardiff City,Arsenal,0-0,0,0,1,1,0,0,D
1926-02-27,1925,Everton,Burnley,1-1,1,1,1,1,2,0,D
1926-02-27,1925,Huddersfield Town,Leeds United,3-1,3,1,1,1,4,2,H
1926-02-27,1925,Manchester City,Liverpool,1-1,1,1,1,1,2,0,D
1926-02-27,1925,Sheffield United,West Ham United,1-1,1,1,1,1,2,0,D
1926-02-27,1925,Sunderland,Newcastle United,2-2,2,2,1,1,4,0,D
1926-02-27,1925,Tottenham Hotspur,Manchester United,0-1,0,1,1,1,1,-1,A
1926-02-27,1925,West Bromwich Albion,Leicester City,3-1,3,1,1,1,4,2,H
1926-03-01,1925,Blackburn Rovers,Sheffield United,3-1,3,1,1,1,4,2,H
1926-03-03,1925,Huddersfield Town,Tottenham Hotspur,2-1,2,1,1,1,3,1,H
1926-03-03,1925,Notts County,Birmingham City,3-0,3,0,1,1,3,3,H
1926-03-06,1925,Aston Villa,Bury,1-1,1,1,1,1,2,0,D
1926-03-06,1925,Leeds United,Everton,1-1,1,1,1,1,2,0,D
1926-03-06,1925,Leicester City,Birmingham City,1-0,1,0,1,1,1,1,H
1926-03-06,1925,Liverpool,Tottenham Hotspur,0-0,0,0,1,1,0,0,D
1926-03-06,1925,Newcastle United,Huddersfield Town,0-2,0,2,1,1,2,-2,A
1926-03-06,1925,Notts County,Blackburn Rovers,1-1,1,1,1,1,2,0,D
1926-03-06,1925,West Ham United,West Bromwich Albion,3-0,3,0,1,1,3,3,H
1926-03-10,1925,Aston Villa,Leicester City,2-2,2,2,1,1,4,0,D
1926-03-10,1925,Manchester United,Liverpool,3-3,3,3,1,1,6,0,D
1926-03-13,1925,Birmingham City,Newcastle United,1-1,1,1,1,1,2,0,D
1926-03-13,1925,Blackburn Rovers,Burnley,6-3,6,3,1,1,9,3,H
1926-03-13,1925,Bury,Leeds United,0-2,0,2,1,1,2,-2,A
1926-03-13,1925,Cardiff City,Aston Villa,2-0,2,0,1,1,2,2,H
1926-03-13,1925,Everton,Arsenal,2-3,2,3,1,1,5,-1,A
1926-03-13,1925,Huddersfield Town,Manchester United,5-0,5,0,1,1,5,5,H
1926-03-13,1925,Manchester City,West Ham United,2-0,2,0,1,1,2,2,H
1926-03-13,1925,Sheffield United,Notts County,3-0,3,0,1,1,3,3,H
1926-03-13,1925,Sunderland,Liverpool,3-2,3,2,1,1,5,1,H
1926-03-13,1925,Tottenham Hotspur,Leicester City,1-3,1,3,1,1,4,-2,A
1926-03-13,1925,West Bromwich Albion,Bolton Wanderers,0-3,0,3,1,1,3,-3,A
1926-03-17,1925,Arsenal,Sheffield United,4-0,4,0,1,1,4,4,H
1926-03-17,1925,Bolton Wanderers,Manchester United,3-1,3,1,1,1,4,2,H
1926-03-17,1925,Everton,Sunderland,2-1,2,1,1,1,3,1,H
1926-03-17,1925,Manchester City,Blackburn Rovers,0-1,0,1,1,1,1,-1,A
1926-03-20,1925,Arsenal,Manchester City,1-0,1,0,1,1,1,1,H
1926-03-20,1925,Aston Villa,Sheffield United,2-2,2,2,1,1,4,0,D
1926-03-20,1925,Burnley,Sunderland,5-2,5,2,1,1,7,3,H
1926-03-20,1925,Leeds United,Blackburn Rovers,2-1,2,1,1,1,3,1,H
1926-03-20,1925,Leicester City,Cardiff City,1-2,1,2,1,1,3,-1,A
1926-03-20,1925,Liverpool,Huddersfield Town,1-2,1,2,1,1,3,-1,A
1926-03-20,1925,Manchester United,Everton,0-0,0,0,1,1,0,0,D
1926-03-20,1925,Newcastle United,Bury,4-0,4,0,1,1,4,4,H
1926-03-20,1925,Notts County,West Bromwich Albion,0-0,0,0,1,1,0,0,D
1926-03-20,1925,West Ham United,Tottenham Hotspur,3-1,3,1,1,1,4,2,H
1926-03-22,1925,Notts County,West Ham United,1-1,1,1,1,1,2,0,D
1926-03-25,1925,Tottenham Hotspur,Newcastle United,1-0,1,0,1,1,1,1,H
1926-03-27,1925,Blackburn Rovers,West Ham United,1-0,1,0,1,1,1,1,H
1926-03-27,1925,Bury,Arsenal,2-2,2,2,1,1,4,0,D
1926-03-27,1925,Cardiff City,Leeds United,0-0,0,0,1,1,0,0,D
1926-03-27,1925,Everton,Notts County,3-0,3,0,1,1,3,3,H
1926-03-27,1925,Huddersfield Town,Aston Villa,5-1,5,1,1,1,6,4,H
1926-03-27,1925,Sunderland,Leicester City,3-0,3,0,1,1,3,3,H
1926-03-27,1925,West Bromwich Albion,Liverpool,0-3,0,3,1,1,3,-3,A
1926-03-29,1925,Manchester City,Bolton Wanderers,1-1,1,1,1,1,2,0,D
1926-03-31,1925,Sunderland,Cardiff City,1-3,1,3,1,1,4,-2,A
1926-04-02,1925,Aston Villa,Arsenal,3-0,3,0,1,1,3,3,H
1926-04-02,1925,Bolton Wanderers,Liverpool,0-1,0,1,1,1,1,-1,A
1926-04-02,1925,Burnley,Newcastle United,1-0,1,0,1,1,1,1,H
1926-04-02,1925,Everton,Bury,1-1,1,1,1,1,2,0,D
1926-04-02,1925,Manchester City,Birmingham City,2-4,2,4,1,1,6,-2,A
1926-04-02,1925,Notts County,Manchester United,0-3,0,3,1,1,3,-3,A
1926-04-02,1925,Tottenham Hotspur,West Bromwich Albion,3-2,3,2,1,1,5,1,H
1926-04-02,1925,West Ham United,Leicester City,1-1,1,1,1,1,2,0,D
1926-04-03,1925,Arsenal,Blackburn Rovers,4-2,4,2,1,1,6,2,H
1926-04-03,1925,Aston Villa,Everton,3-1,3,1,1,1,4,2,H
1926-04-03,1925,Bolton Wanderers,Tottenham Hotspur,1-1,1,1,1,1,2,0,D
1926-04-03,1925,Burnley,West Bromwich Albion,3-4,3,4,1,1,7,-1,A
1926-04-03,1925,Leeds United,Sheffield United,2-0,2,0,1,1,2,2,H
1926-04-03,1925,Leicester City,Huddersfield Town,2-0,2,0,1,1,2,2,H
1926-04-03,1925,Liverpool,Birmingham City,2-2,2,2,1,1,4,0,D
1926-04-03,1925,Manchester United,Bury,0-1,0,1,1,1,1,-1,A
1926-04-03,1925,Newcastle United,Cardiff City,0-1,0,1,1,1,1,-1,A
1926-04-03,1925,Notts County,Manchester City,1-0,1,0,1,1,1,1,H
1926-04-03,1925,West Ham United,Sunderland,3-2,3,2,1,1,5,1,H
1926-04-05,1925,Arsenal,Aston Villa,2-0,2,0,1,1,2,2,H
1926-04-05,1925,Bury,Huddersfield Town,0-0,0,0,1,1,0,0,D
1926-04-05,1925,Cardiff City,Sheffield United,0-1,0,1,1,1,1,-1,A
1926-04-05,1925,Leicester City,West Ham United,1-1,1,1,1,1,2,0,D
1926-04-05,1925,Liverpool,Bolton Wanderers,2-2,2,2,1,1,4,0,D
1926-04-05,1925,Manchester United,Notts County,0-1,0,1,1,1,1,-1,A
1926-04-05,1925,Newcastle United,Leeds United,3-0,3,0,1,1,3,3,H
1926-04-05,1925,West Bromwich Albion,Tottenham Hotspur,1-0,1,0,1,1,1,1,H
1926-04-06,1925,Aston Villa,Liverpool,3-0,3,0,1,1,3,3,H
1926-04-06,1925,Burnley,Manchester City,1-2,1,2,1,1,3,-1,A
1926-04-06,1925,Huddersfield Town,Blackburn Rovers,3-1,3,1,1,1,4,2,H
1926-04-06,1925,Leeds United,Sunderland,0-2,0,2,1,1,2,-2,A
1926-04-07,1925,Bolton Wanderers,Sunderland,3-2,3,2,1,1,5,1,H
1926-04-10,1925,Birmingham City,Burnley,1-7,1,7,1,1,8,-6,A
1926-04-10,1925,Blackburn Rovers,Manchester United,7-0,7,0,1,1,7,7,H
1926-04-10,1925,Bury,Liverpool,0-1,0,1,1,1,1,-1,A
1926-04-10,1925,Cardiff City,Bolton Wanderers,0-1,0,1,1,1,1,-1,A
1926-04-10,1925,Huddersfield Town,West Ham United,2-1,2,1,1,1,3,1,H
1926-04-10,1925,Manchester City,Aston Villa,4-2,4,2,1,1,6,2,H
1926-04-10,1925,Sheffield United,Newcastle United,4-3,4,3,1,1,7,1,H
1926-04-10,1925,Sunderland,Arsenal,2-1,2,1,1,1,3,1,H
1926-04-10,1925,Tottenham Hotspur,Notts County,4-0,4,0,1,1,4,4,H
1926-04-10,1925,West Bromwich Albion,Leeds United,3-0,3,0,1,1,3,3,H
1926-04-12,1925,Huddersfield Town,Bolton Wanderers,3-0,3,0,1,1,3,3,H
1926-04-14,1925,Newcastle United,Manchester United,4-1,4,1,1,1,5,3,H
1926-04-17,1925,Arsenal,Huddersfield Town,3-1,3,1,1,1,4,2,H
1926-04-17,1925,Aston Villa,Tottenham Hotspur,3-0,3,0,1,1,3,3,H
1926-04-17,1925,Bolton Wanderers,Sheffield United,2-1,2,1,1,1,3,1,H
1926-04-17,1925,Burnley,Bury,2-2,2,2,1,1,4,0,D
1926-04-17,1925,Leeds United,Birmingham City,0-0,0,0,1,1,0,0,D
1926-04-17,1925,Leicester City,Manchester City,2-3,2,3,1,1,5,-1,A
1926-04-17,1925,Liverpool,Blackburn Rovers,2-2,2,2,1,1,4,0,D
1926-04-17,1925,Newcastle United,West Bromwich Albion,3-0,3,0,1,1,3,3,H
1926-04-17,1925,Notts County,Cardiff City,2-4,2,4,1,1,6,-2,A
1926-04-17,1925,West Ham United,Everton,1-0,1,0,1,1,1,1,H
1926-04-19,1925,Birmingham City,Manchester United,2-1,2,1,1,1,3,1,H
1926-04-19,1925,Sheffield United,Burnley,6-1,6,1,1,1,7,5,H
1926-04-21,1925,Manchester United,Sunderland,5-1,5,1,1,1,6,4,H
1926-04-24,1925,Birmingham City,West Ham United,1-0,1,0,1,1,1,1,H
1926-04-24,1925,Blackburn Rovers,Aston Villa,3-1,3,1,1,1,4,2,H
1926-04-24,1925,Bury,Leicester City,4-0,4,0,1,1,4,4,H
1926-04-24,1925,Cardiff City,Liverpool,2-2,2,2,1,1,4,0,D
1926-04-24,1925,Everton,Newcastle United,3-0,3,0,1,1,3,3,H
1926-04-24,1925,Sheffield United,Manchester United,2-0,2,0,1,1,2,2,H
1926-04-24,1925,Sunderland,Notts County,3-1,3,1,1,1,4,2,H
1926-04-24,1925,Tottenham Hotspur,Burnley,0-2,0,2,1,1,2,-2,A
1926-04-24,1925,West Bromwich Albion,Arsenal,2-1,2,1,1,1,3,1,H
1926-04-26,1925,Aston Villa,Bolton Wanderers,2-2,2,2,1,1,4,0,D
1926-04-27,1925,Manchester City,Leeds United,2-1,2,1,1,1,3,1,H
1926-04-28,1925,Bolton Wanderers,Arsenal,1-1,1,1,1,1,2,0,D
1926-04-28,1925,Manchester United,Cardiff City,1-0,1,0,1,1,1,1,H
1926-05-01,1925,Arsenal,Birmingham City,3-0,3,0,1,1,3,3,H
1926-05-01,1925,Bolton Wanderers,Everton,0-2,0,2,1,1,2,-2,A
1926-05-01,1925,Burnley,Cardiff City,4-1,4,1,1,1,5,3,H
1926-05-01,1925,Leeds United,Tottenham Hotspur,4-1,4,1,1,1,5,3,H
1926-05-01,1925,Liverpool,Sheffield United,2-2,2,2,1,1,4,0,D
1926-05-01,1925,Manchester United,West Bromwich Albion,3-2,3,2,1,1,5,1,H
1926-05-01,1925,Newcastle United,Manchester City,3-2,3,2,1,1,5,1,H
1926-05-01,1925,Notts County,Huddersfield Town,4-2,4,2,1,1,6,2,H
1926-05-01,1925,West Ham United,Bury,0-2,0,2,1,1,2,-2,A
1926-08-28,1926,Arsenal,Derby County,2-1,2,1,1,1,3,1,H
1926-08-28,1926,Birmingham City,Blackburn Rovers,3-1,3,1,1,1,4,2,H
1926-08-28,1926,Burnley,Cardiff City,4-3,4,3,1,1,7,1,H
1926-08-28,1926,Bury,Huddersfield Town,2-2,2,2,1,1,4,0,D
1926-08-28,1926,Leeds United,Bolton Wanderers,2-5,2,5,1,1,7,-3,A
1926-08-28,1926,Liverpool,Manchester United,4-2,4,2,1,1,6,2,H
1926-08-28,1926,Newcastle United,Aston Villa,4-0,4,0,1,1,4,4,H
1926-08-28,1926,Sheffield Wednesday,Sheffield United,2-3,2,3,1,1,5,-1,A
1926-08-28,1926,Tottenham Hotspur,Everton,2-1,2,1,1,1,3,1,H
1926-08-28,1926,West Bromwich Albion,Sunderland,3-0,3,0,1,1,3,3,H
1926-08-28,1926,West Ham United,Leicester City,3-3,3,3,1,1,6,0,D
1926-08-30,1926,Aston Villa,Liverpool,1-1,1,1,1,1,2,0,D
1926-08-30,1926,Huddersfield Town,West Bromwich Albion,4-1,4,1,1,1,5,3,H
1926-08-30,1926,Leeds United,Cardiff City,0-0,0,0,1,1,0,0,D
1926-08-30,1926,Leicester City,Birmingham City,5-2,5,2,1,1,7,3,H
1926-08-30,1926,Sheffield United,Manchester United,2-2,2,2,1,1,4,0,D
1926-08-30,1926,Tottenham Hotspur,Sheffield Wednesday,7-3,7,3,1,1,10,4,H
1926-09-01,1926,Arsenal,Bolton Wanderers,2-1,2,1,1,1,3,1,H
1926-09-01,1926,Bury,Everton,5-2,5,2,1,1,7,3,H
1926-09-01,1926,Newcastle United,Burnley,1-5,1,5,1,1,6,-4,A
1926-09-04,1926,Aston Villa,Burnley,1-1,1,1,1,1,2,0,D
1926-09-04,1926,Blackburn Rovers,Tottenham Hotspur,1-0,1,0,1,1,1,1,H
1926-09-04,1926,Bolton Wanderers,Newcastle United,2-1,2,1,1,1,3,1,H
1926-09-04,1926,Cardiff City,West Bromwich Albion,1-1,1,1,1,1,2,0,D
1926-09-04,1926,Derby County,Liverpool,2-1,2,1,1,1,3,1,H
1926-09-04,1926,Everton,West Ham United,0-3,0,3,1,1,3,-3,A
1926-09-04,1926,Huddersfield Town,Birmingham City,0-2,0,2,1,1,2,-2,A
1926-09-04,1926,Leicester City,Sheffield Wednesday,5-3,5,3,1,1,8,2,H
1926-09-04,1926,Manchester United,Leeds United,2-2,2,2,1,1,4,0,D
1926-09-04,1926,Sheffield United,Arsenal,4-0,4,0,1,1,4,4,H
1926-09-04,1926,Sunderland,Bury,3-0,3,0,1,1,3,3,H
1926-09-06,1926,Bolton Wanderers,Arsenal,2-2,2,2,1,1,4,0,D
1926-09-06,1926,Burnley,Newcastle United,3-3,3,3,1,1,6,0,D
1926-09-06,1926,Cardiff City,Leeds United,3-1,3,1,1,1,4,2,H
1926-09-06,1926,Sheffield Wednesday,West Ham United,1-0,1,0,1,1,1,1,H
1926-09-06,1926,Tottenham Hotspur,Leicester City,2-2,2,2,1,1,4,0,D
1926-09-06,1926,West Bromwich Albion,Everton,3-2,3,2,1,1,5,1,H
1926-09-08,1926,Liverpool,Aston Villa,2-1,2,1,1,1,3,1,H
1926-09-08,1926,Sunderland,Huddersfield Town,1-1,1,1,1,1,2,0,D
1926-09-11,1926,Arsenal,Leicester City,2-2,2,2,1,1,4,0,D
1926-09-11,1926,Birmingham City,Sunderland,2-0,2,0,1,1,2,2,H
1926-09-11,1926,Burnley,Bolton Wanderers,4-3,4,3,1,1,7,1,H
1926-09-11,1926,Bury,West Bromwich Albion,7-3,7,3,1,1,10,4,H
1926-09-11,1926,Cardiff City,Aston Villa,2-3,2,3,1,1,5,-1,A
1926-09-11,1926,Leeds United,Derby County,1-0,1,0,1,1,1,1,H
1926-09-11,1926,Liverpool,Sheffield United,5-1,5,1,1,1,6,4,H
1926-09-11,1926,Newcastle United,Manchester United,4-2,4,2,1,1,6,2,H
1926-09-11,1926,Sheffield Wednesday,Everton,4-0,4,0,1,1,4,4,H
1926-09-11,1926,Tottenham Hotspur,Huddersfield Town,3-3,3,3,1,1,6,0,D
1926-09-11,1926,West Ham United,Blackburn Rovers,1-5,1,5,1,1,6,-4,A
1926-09-13,1926,Birmingham City,Sheffield Wednesday,0-0,0,0,1,1,0,0,D
1926-09-13,1926,Leicester City,Tottenham Hotspur,2-2,2,2,1,1,4,0,D
1926-09-13,1926,Sheffield United,Derby County,1-0,1,0,1,1,1,1,H
1926-09-14,1926,Huddersfield Town,Sunderland,0-0,0,0,1,1,0,0,D
1926-09-15,1926,Bury,Blackburn Rovers,0-2,0,2,1,1,2,-2,A
1926-09-15,1926,Everton,West Bromwich Albion,0-0,0,0,1,1,0,0,D
1926-09-15,1926,Leeds United,Aston Villa,3-1,3,1,1,1,4,2,H
1926-09-15,1926,Manchester United,Arsenal,2-2,2,2,1,1,4,0,D
1926-09-18,1926,Arsenal,Liverpool,2-0,2,0,1,1,2,2,H
1926-09-18,1926,Aston Villa,Bury,1-2,1,2,1,1,3,-1,A
1926-09-18,1926,Blackburn Rovers,Sheffield Wednesday,2-2,2,2,1,1,4,0,D
1926-09-18,1926,Bolton Wanderers,Cardiff City,2-0,2,0,1,1,2,2,H
1926-09-18,1926,Derby County,Newcastle United,1-1,1,1,1,1,2,0,D
1926-09-18,1926,Everton,Leicester City,3-4,3,4,1,1,7,-1,A
1926-09-18,1926,Huddersfield Town,West Ham United,2-1,2,1,1,1,3,1,H
1926-09-18,1926,Manchester United,Burnley,2-1,2,1,1,1,3,1,H
1926-09-18,1926,Sheffield United,Leeds United,1-0,1,0,1,1,1,1,H
1926-09-18,1926,Sunderland,Tottenham Hotspur,3-2,3,2,1,1,5,1,H
1926-09-18,1926,West Bromwich Albion,Birmingham City,1-2,1,2,1,1,3,-1,A
1926-09-20,1926,Birmingham City,Everton,1-0,1,0,1,1,1,1,H
1926-09-20,1926,Blackburn Rovers,Sunderland,0-2,0,2,1,1,2,-2,A
1926-09-20,1926,Cardiff City,Newcastle United,1-1,1,1,1,1,2,0,D
1926-09-25,1926,Aston Villa,Bolton Wanderers,3-4,3,4,1,1,7,-1,A
1926-09-25,1926,Birmingham City,Bury,2-2,2,2,1,1,4,0,D
1926-09-25,1926,Burnley,Derby County,1-0,1,0,1,1,1,1,H
1926-09-25,1926,Cardiff City,Manchester United,0-2,0,2,1,1,2,-2,A
1926-09-25,1926,Everton,Liverpool,1-0,1,0,1,1,1,1,H
1926-09-25,1926,Leeds United,Arsenal,4-1,4,1,1,1,5,3,H
1926-09-25,1926,Leicester City,Blackburn Rovers,4-0,4,0,1,1,4,4,H
1926-09-25,1926,Newcastle United,Sheffield United,2-0,2,0,1,1,2,2,H
1926-09-25,1926,Sheffield Wednesday,Huddersfield Town,1-1,1,1,1,1,2,0,D
1926-09-25,1926,Tottenham Hotspur,West Bromwich Albion,3-0,3,0,1,1,3,3,H
1926-09-25,1926,West Ham United,Sunderland,1-2,1,2,1,1,3,-1,A
1926-09-27,1926,Derby County,Sheffield United,1-0,1,0,1,1,1,1,H
1926-09-29,1926,Everton,Bury,2-2,2,2,1,1,4,0,D
1926-10-02,1926,Arsenal,Newcastle United,2-2,2,2,1,1,4,0,D
1926-10-02,1926,Blackburn Rovers,Everton,3-3,3,3,1,1,6,0,D
1926-10-02,1926,Bolton Wanderers,Birmingham City,1-0,1,0,1,1,1,1,H
1926-10-02,1926,Bury,Tottenham Hotspur,0-0,0,0,1,1,0,0,D
1926-10-02,1926,Derby County,Cardiff City,6-3,6,3,1,1,9,3,H
1926-10-02,1926,Huddersfield Town,Leicester City,5-3,5,3,1,1,8,2,H
1926-10-02,1926,Liverpool,Leeds United,2-4,2,4,1,1,6,-2,A
1926-10-02,1926,Manchester United,Aston Villa,2-1,2,1,1,1,3,1,H
1926-10-02,1926,Sheffield United,Burnley,2-2,2,2,1,1,4,0,D
1926-10-02,1926,Sunderland,Sheffield Wednesday,4-1,4,1,1,1,5,3,H
1926-10-02,1926,West Bromwich Albion,West Ham United,1-3,1,3,1,1,4,-2,A
1926-10-04,1926,Blackburn Rovers,Bury,2-2,2,2,1,1,4,0,D
1926-10-04,1926,West Ham United,Sheffield Wednesday,1-1,1,1,1,1,2,0,D
1926-10-06,1926,Sunderland,Burnley,7-1,7,1,1,1,8,6,H
1926-10-09,1926,Aston Villa,Derby County,3-1,3,1,1,1,4,2,H
1926-10-09,1926,Bolton Wanderers,Manchester United,4-0,4,0,1,1,4,4,H
1926-10-09,1926,Burnley,Arsenal,2-0,2,0,1,1,2,2,H
1926-10-09,1926,Cardiff City,Sheffield United,3-0,3,0,1,1,3,3,H
1926-10-09,1926,Everton,Huddersfield Town,0-0,0,0,1,1,0,0,D
1926-10-09,1926,Leeds United,Blackburn Rovers,4-1,4,1,1,1,5,3,H
1926-10-09,1926,Leicester City,Sunderland,2-1,2,1,1,1,3,1,H
1926-10-09,1926,Newcastle United,Liverpool,1-0,1,0,1,1,1,1,H
1926-10-09,1926,Sheffield Wednesday,West Bromwich Albion,2-1,2,1,1,1,3,1,H
1926-10-09,1926,Tottenham Hotspur,Birmingham City,6-1,6,1,1,1,7,5,H
1926-10-09,1926,West Ham United,Bury,1-2,1,2,1,1,3,-1,A
1926-10-12,1926,Burnley,Sunderland,4-2,4,2,1,1,6,2,H
1926-10-16,1926,Arsenal,West Ham United,2-2,2,2,1,1,4,0,D
1926-10-16,1926,Birmingham City,Derby County,1-0,1,0,1,1,1,1,H
1926-10-16,1926,Blackburn Rovers,Burnley,1-5,1,5,1,1,6,-4,A
1926-10-16,1926,Bury,Manchester United,0-3,0,3,1,1,3,-3,A
1926-10-16,1926,Everton,Newcastle United,1-3,1,3,1,1,4,-2,A
1926-10-16,1926,Huddersfield Town,Cardiff City,0-0,0,0,1,1,0,0,D
1926-10-16,1926,Leicester City,Leeds United,3-2,3,2,1,1,5,1,H
1926-10-16,1926,Sheffield Wednesday,Liverpool,3-2,3,2,1,1,5,1,H
1926-10-16,1926,Sunderland,Aston Villa,1-1,1,1,1,1,2,0,D
1926-10-16,1926,Tottenham Hotspur,Sheffield United,3-1,3,1,1,1,4,2,H
1926-10-16,1926,West Bromwich Albion,Bolton Wanderers,1-1,1,1,1,1,2,0,D
1926-10-23,1926,Arsenal,Sheffield Wednesday,6-2,6,2,1,1,8,4,H
1926-10-23,1926,Aston Villa,West Bromwich Albion,2-0,2,0,1,1,2,2,H
1926-10-23,1926,Bolton Wanderers,Bury,2-2,2,2,1,1,4,0,D
1926-10-23,1926,Burnley,Huddersfield Town,2-2,2,2,1,1,4,0,D
1926-10-23,1926,Cardiff City,Sunderland,3-0,3,0,1,1,3,3,H
1926-10-23,1926,Derby County,Tottenham Hotspur,4-1,4,1,1,1,5,3,H
1926-10-23,1926,Leeds United,Everton,1-3,1,3,1,1,4,-2,A
1926-10-23,1926,Liverpool,Leicester City,1-0,1,0,1,1,1,1,H
1926-10-23,1926,Manchester United,Birmingham City,0-1,0,1,1,1,1,-1,A
1926-10-23,1926,Newcastle United,Blackburn Rovers,6-1,6,1,1,1,7,5,H
1926-10-23,1926,Sheffield United,West Ham United,0-2,0,2,1,1,2,-2,A
1926-10-30,1926,Birmingham City,Aston Villa,1-2,1,2,1,1,3,-1,A
1926-10-30,1926,Blackburn Rovers,Liverpool,2-1,2,1,1,1,3,1,H
1926-10-30,1926,Bury,Cardiff City,2-3,2,3,1,1,5,-1,A
1926-10-30,1926,Everton,Arsenal,3-1,3,1,1,1,4,2,H
1926-10-30,1926,Huddersfield Town,Leeds United,4-1,4,1,1,1,5,3,H
1926-10-30,1926,Leicester City,Sheffield United,2-2,2,2,1,1,4,0,D
1926-10-30,1926,Sheffield Wednesday,Derby County,2-1,2,1,1,1,3,1,H
1926-10-30,1926,Sunderland,Newcastle United,2-0,2,0,1,1,2,2,H
1926-10-30,1926,Tottenham Hotspur,Bolton Wanderers,1-0,1,0,1,1,1,1,H
1926-10-30,1926,West Bromwich Albion,Burnley,4-2,4,2,1,1,6,2,H
1926-10-30,1926,West Ham United,Manchester United,4-0,4,0,1,1,4,4,H
1926-11-06,1926,Arsenal,Blackburn Rovers,2-2,2,2,1,1,4,0,D
1926-11-06,1926,Aston Villa,Tottenham Hotspur,2-3,2,3,1,1,5,-1,A
1926-11-06,1926,Bolton Wanderers,West Ham United,2-0,2,0,1,1,2,2,H
1926-11-06,1926,Burnley,Bury,0-0,0,0,1,1,0,0,D
1926-11-06,1926,Cardiff City,Birmingham City,1-0,1,0,1,1,1,1,H
1926-11-06,1926,Derby County,Leicester City,4-1,4,1,1,1,5,3,H
1926-11-06,1926,Leeds United,Sunderland,2-2,2,2,1,1,4,0,D
1926-11-06,1926,Liverpool,Huddersfield Town,2-3,2,3,1,1,5,-1,A
1926-11-06,1926,Manchester United,Sheffield Wednesday,0-0,0,0,1,1,0,0,D
1926-11-06,1926,Newcastle United,West Bromwich Albion,5-2,5,2,1,1,7,3,H
1926-11-06,1926,Sheffield United,Everton,3-3,3,3,1,1,6,0,D
1926-11-13,1926,Birmingham City,Burnley,1-0,1,0,1,1,1,1,H
1926-11-13,1926,Blackburn Rovers,Sheffield United,3-4,3,4,1,1,7,-1,A
1926-11-13,1926,Bury,Newcastle United,3-2,3,2,1,1,5,1,H
1926-11-13,1926,Everton,Derby County,3-2,3,2,1,1,5,1,H
1926-11-13,1926,Huddersfield Town,Arsenal,3-3,3,3,1,1,6,0,D
1926-11-13,1926,Leicester City,Manchester United,2-3,2,3,1,1,5,-1,A
1926-11-13,1926,Sheffield Wednesday,Bolton Wanderers,2-1,2,1,1,1,3,1,H
1926-11-13,1926,Sunderland,Liverpool,2-1,2,1,1,1,3,1,H
1926-11-13,1926,Tottenham Hotspur,Cardiff City,4-1,4,1,1,1,5,3,H
1926-11-13,1926,West Bromwich Albion,Leeds United,2-4,2,4,1,1,6,-2,A
1926-11-13,1926,West Ham United,Aston Villa,5-1,5,1,1,1,6,4,H
1926-11-20,1926,Arsenal,Sunderland,2-3,2,3,1,1,5,-1,A
1926-11-20,1926,Aston Villa,Sheffield Wednesday,2-2,2,2,1,1,4,0,D
1926-11-20,1926,Bolton Wanderers,Leicester City,2-0,2,0,1,1,2,2,H
1926-11-20,1926,Burnley,Tottenham Hotspur,5-0,5,0,1,1,5,5,H
1926-11-20,1926,Cardiff City,West Ham United,1-2,1,2,1,1,3,-1,A
1926-11-20,1926,Derby County,Blackburn Rovers,4-5,4,5,1,1,9,-1,A
1926-11-20,1926,Leeds United,Bury,4-1,4,1,1,1,5,3,H
1926-11-20,1926,Liverpool,West Bromwich Albion,2-1,2,1,1,1,3,1,H
1926-11-20,1926,Manchester United,Everton,2-1,2,1,1,1,3,1,H
1926-11-20,1926,Newcastle United,Birmingham City,5-1,5,1,1,1,6,4,H
1926-11-20,1926,Sheffield United,Huddersfield Town,3-3,3,3,1,1,6,0,D
1926-11-27,1926,Birmingham City,Leeds United,2-0,2,0,1,1,2,2,H
1926-11-27,1926,Blackburn Rovers,Manchester United,2-1,2,1,1,1,3,1,H
1926-11-27,1926,Bury,Liverpool,0-2,0,2,1,1,2,-2,A
1926-11-27,1926,Everton,Bolton Wanderers,1-1,1,1,1,1,2,0,D
1926-11-27,1926,Huddersfield Town,Derby County,4-2,4,2,1,1,6,2,H
1926-11-27,1926,Leicester City,Aston Villa,5-1,5,1,1,1,6,4,H
1926-11-27,1926,Sunderland,Sheffield United,3-0,3,0,1,1,3,3,H
1926-11-27,1926,Tottenham Hotspur,Newcastle United,1-3,1,3,1,1,4,-2,A
1926-11-27,1926,West Bromwich Albion,Arsenal,1-3,1,3,1,1,4,-2,A
1926-11-27,1926,West Ham United,Burnley,2-1,2,1,1,1,3,1,H
1926-11-29,1926,Sheffield Wednesday,Cardiff City,3-0,3,0,1,1,3,3,H
1926-12-04,1926,Arsenal,Bury,1-0,1,0,1,1,1,1,H
1926-12-04,1926,Aston Villa,Everton,5-3,5,3,1,1,8,2,H
1926-12-04,1926,Bolton Wanderers,Blackburn Rovers,5-1,5,1,1,1,6,4,H
1926-12-04,1926,Burnley,Sheffield Wednesday,1-0,1,0,1,1,1,1,H
1926-12-04,1926,Cardiff City,Leicester City,0-1,0,1,1,1,1,-1,A
1926-12-04,1926,Derby County,Sunderland,4-2,4,2,1,1,6,2,H
1926-12-04,1926,Leeds United,Tottenham Hotspur,1-1,1,1,1,1,2,0,D
1926-12-04,1926,Liverpool,Birmingham City,2-1,2,1,1,1,3,1,H
1926-12-04,1926,Manchester United,Huddersfield Town,0-0,0,0,1,1,0,0,D
1926-12-04,1926,Newcastle United,West Ham United,2-0,2,0,1,1,2,2,H
1926-12-04,1926,Sheffield United,West Bromwich Albion,2-1,2,1,1,1,3,1,H
1926-12-11,1926,Birmingham City,Arsenal,0-0,0,0,1,1,0,0,D
1926-12-11,1926,Blackburn Rovers,Aston Villa,0-2,0,2,1,1,2,-2,A
1926-12-11,1926,Bury,Sheffield United,4-4,4,4,1,1,8,0,D
1926-12-11,1926,Everton,Cardiff City,0-1,0,1,1,1,1,-1,A
1926-12-11,1926,Huddersfield Town,Bolton Wanderers,1-0,1,0,1,1,1,1,H
1926-12-11,1926,Leicester City,Burnley,0-3,0,3,1,1,3,-3,A
1926-12-11,1926,Sheffield Wednesday,Newcastle United,3-2,3,2,1,1,5,1,H
1926-12-11,1926,Sunderland,Manchester United,6-0,6,0,1,1,6,6,H
1926-12-11,1926,Tottenham Hotspur,Liverpool,1-2,1,2,1,1,3,-1,A
1926-12-11,1926,West Bromwich Albion,Derby County,3-1,3,1,1,1,4,2,H
1926-12-11,1926,West Ham United,Leeds United,3-2,3,2,1,1,5,1,H
1926-12-18,1926,Arsenal,Tottenham Hotspur,2-4,2,4,1,1,6,-2,A
1926-12-18,1926,Aston Villa,Huddersfield Town,3-0,3,0,1,1,3,3,H
1926-12-18,1926,Bolton Wanderers,Sunderland,2-2,2,2,1,1,4,0,D
1926-12-18,1926,Burnley,Everton,5-1,5,1,1,1,6,4,H
1926-12-18,1926,Cardiff City,Blackburn Rovers,0-1,0,1,1,1,1,-1,A
1926-12-18,1926,Derby County,Bury,2-0,2,0,1,1,2,2,H
1926-12-18,1926,Leeds United,Sheffield Wednesday,4-1,4,1,1,1,5,3,H
1926-12-18,1926,Liverpool,West Ham United,0-0,0,0,1,1,0,0,D
1926-12-18,1926,Manchester United,West Bromwich Albion,2-0,2,0,1,1,2,2,H
1926-12-18,1926,Newcastle United,Leicester City,1-1,1,1,1,1,2,0,D
1926-12-18,1926,Sheffield United,Birmingham City,4-3,4,3,1,1,7,1,H
1926-12-25,1926,Aston Villa,Sheffield United,4-0,4,0,1,1,4,4,H
1926-12-25,1926,Blackburn Rovers,Huddersfield Town,4-2,4,2,1,1,6,2,H
1926-12-25,1926,Bolton Wanderers,Derby County,3-1,3,1,1,1,4,2,H
1926-12-25,1926,Burnley,Liverpool,4-0,4,0,1,1,4,4,H
1926-12-25,1926,Bury,Sheffield Wednesday,2-0,2,0,1,1,2,2,H
1926-12-25,1926,Everton,Sunderland,5-4,5,4,1,1,9,1,H
1926-12-25,1926,Leicester City,West Bromwich Albion,5-0,5,0,1,1,5,5,H
1926-12-25,1926,Newcastle United,Cardiff City,5-0,5,0,1,1,5,5,H
1926-12-25,1926,Tottenham Hotspur,Manchester United,1-1,1,1,1,1,2,0,D
1926-12-25,1926,West Ham United,Birmingham City,1-0,1,0,1,1,1,1,H
1926-12-27,1926,Birmingham City,West Ham United,0-2,0,2,1,1,2,-2,A
1926-12-27,1926,Cardiff City,Arsenal,2-0,2,0,1,1,2,2,H
1926-12-27,1926,Derby County,Bolton Wanderers,2-0,2,0,1,1,2,2,H
1926-12-27,1926,Huddersfield Town,Blackburn Rovers,5-0,5,0,1,1,5,5,H
1926-12-27,1926,Leeds United,Newcastle United,1-2,1,2,1,1,3,-1,A
1926-12-27,1926,Liverpool,Burnley,2-2,2,2,1,1,4,0,D
1926-12-27,1926,Manchester United,Tottenham Hotspur,2-1,2,1,1,1,3,1,H
1926-12-27,1926,Sheffield United,Aston Villa,3-1,3,1,1,1,4,2,H
1926-12-27,1926,Sunderland,Everton,3-2,3,2,1,1,5,1,H
1926-12-27,1926,West Bromwich Albion,Leicester City,0-1,0,1,1,1,1,-1,A
1926-12-28,1926,Arsenal,Manchester United,1-0,1,0,1,1,1,1,H
1926-12-28,1926,Aston Villa,Leeds United,5-1,5,1,1,1,6,4,H
1926-12-28,1926,Derby County,West Ham United,3-0,3,0,1,1,3,3,H
1926-12-28,1926,Liverpool,Bolton Wanderers,3-2,3,2,1,1,5,1,H
1926-12-28,1926,Sheffield Wednesday,Tottenham Hotspur,3-1,3,1,1,1,4,2,H
1927-01-01,1926,Arsenal,Cardiff City,3-2,3,2,1,1,5,1,H
1927-01-01,1926,Birmingham City,Leicester City,2-1,2,1,1,1,3,1,H
1927-01-01,1926,Bolton Wanderers,Liverpool,2-1,2,1,1,1,3,1,H
1927-01-01,1926,Everton,Burnley,3-2,3,2,1,1,5,1,H
1927-01-01,1926,Manchester United,Sheffield United,5-0,5,0,1,1,5,5,H
1927-01-01,1926,Newcastle United,Leeds United,1-0,1,0,1,1,1,1,H
1927-01-01,1926,Sheffield Wednesday,Bury,1-3,1,3,1,1,4,-2,A
1927-01-01,1926,Sunderland,Blackburn Rovers,2-5,2,5,1,1,7,-3,A
1927-01-01,1926,West Bromwich Albion,Huddersfield Town,2-2,2,2,1,1,4,0,D
1927-01-01,1926,West Ham United,Derby County,1-2,1,2,1,1,3,-1,A
1927-01-15,1926,Aston Villa,Newcastle United,1-2,1,2,1,1,3,-1,A
1927-01-15,1926,Blackburn Rovers,Birmingham City,3-2,3,2,1,1,5,1,H
1927-01-15,1926,Bolton Wanderers,Leeds United,3-0,3,0,1,1,3,3,H
1927-01-15,1926,Cardiff City,Burnley,0-0,0,0,1,1,0,0,D
1927-01-15,1926,Derby County,Arsenal,0-2,0,2,1,1,2,-2,A
1927-01-15,1926,Everton,Tottenham Hotspur,1-2,1,2,1,1,3,-1,A
1927-01-15,1926,Huddersfield Town,Bury,3-1,3,1,1,1,4,2,H
1927-01-15,1926,Leicester City,West Ham United,3-0,3,0,1,1,3,3,H
1927-01-15,1926,Manchester United,Liverpool,0-1,0,1,1,1,1,-1,A
1927-01-15,1926,Sheffield United,Sheffield Wednesday,2-0,2,0,1,1,2,2,H
1927-01-15,1926,Sunderland,West Bromwich Albion,4-1,4,1,1,1,5,3,H
1927-01-22,1926,Arsenal,Sheffield United,1-1,1,1,1,1,2,0,D
1927-01-22,1926,Birmingham City,Huddersfield Town,1-3,1,3,1,1,4,-2,A
1927-01-22,1926,Burnley,Aston Villa,6-3,6,3,1,1,9,3,H
1927-01-22,1926,Leeds United,Manchester United,2-3,2,3,1,1,5,-1,A
1927-01-22,1926,Liverpool,Derby County,3-2,3,2,1,1,5,1,H
1927-01-22,1926,Newcastle United,Bolton Wanderers,1-0,1,0,1,1,1,1,H
1927-01-22,1926,Sheffield Wednesday,Leicester City,2-2,2,2,1,1,4,0,D
1927-01-22,1926,Tottenham Hotspur,Blackburn Rovers,1-1,1,1,1,1,2,0,D
1927-01-22,1926,West Ham United,Everton,2-1,2,1,1,1,3,1,H
1927-01-29,1926,Aston Villa,Blackburn Rovers,4-3,4,3,1,1,7,1,H
1927-01-29,1926,Huddersfield Town,Tottenham Hotspur,2-0,2,0,1,1,2,2,H
1927-01-29,1926,Sunderland,Leicester City,3-0,3,0,1,1,3,3,H
1927-01-29,1926,West Bromwich Albion,Bury,3-1,3,1,1,1,4,2,H
1927-01-31,1926,Aston Villa,Cardiff City,0-0,0,0,1,1,0,0,D
1927-02-05,1926,Birmingham City,West Bromwich Albion,1-0,1,0,1,1,1,1,H
1927-02-05,1926,Burnley,Manchester United,1-0,1,0,1,1,1,1,H
1927-02-05,1926,Bury,Aston Villa,0-1,0,1,1,1,1,-1,A
1927-02-05,1926,Cardiff City,Bolton Wanderers,1-0,1,0,1,1,1,1,H
1927-02-05,1926,Leeds United,Sheffield United,1-1,1,1,1,1,2,0,D
1927-02-05,1926,Leicester City,Everton,6-2,6,2,1,1,8,4,H
1927-02-05,1926,Liverpool,Arsenal,3-0,3,0,1,1,3,3,H
1927-02-05,1926,Newcastle United,Derby County,3-0,3,0,1,1,3,3,H
1927-02-05,1926,Sheffield Wednesday,Blackburn Rovers,0-3,0,3,1,1,3,-3,A
1927-02-05,1926,Tottenham Hotspur,Sunderland,0-2,0,2,1,1,2,-2,A
1927-02-05,1926,West Ham United,Huddersfield Town,3-2,3,2,1,1,5,1,H
1927-02-07,1926,Sheffield United,Liverpool,1-4,1,4,1,1,5,-3,A
1927-02-09,1926,Manchester United,Newcastle United,3-1,3,1,1,1,4,2,H
1927-02-10,1926,Leicester City,Arsenal,2-1,2,1,1,1,3,1,H
1927-02-12,1926,Arsenal,Leeds United,1-0,1,0,1,1,1,1,H
1927-02-12,1926,Blackburn Rovers,Leicester City,2-1,2,1,1,1,3,1,H
1927-02-12,1926,Bolton Wanderers,Aston Villa,0-2,0,2,1,1,2,-2,A
1927-02-12,1926,Bury,Birmingham City,3-1,3,1,1,1,4,2,H
1927-02-12,1926,Derby County,Burnley,4-1,4,1,1,1,5,3,H
1927-02-12,1926,Huddersfield Town,Sheffield Wednesday,4-3,4,3,1,1,7,1,H
1927-02-12,1926,Liverpool,Everton,1-0,1,0,1,1,1,1,H
1927-02-12,1926,Manchester United,Cardiff City,1-1,1,1,1,1,2,0,D
1927-02-12,1926,Sheffield United,Newcastle United,2-1,2,1,1,1,3,1,H
1927-02-12,1926,Sunderland,West Ham United,2-3,2,3,1,1,5,-1,A
1927-02-12,1926,West Bromwich Albion,Tottenham Hotspur,5-0,5,0,1,1,5,5,H
1927-02-14,1926,Blackburn Rovers,West Ham United,4-1,4,1,1,1,5,3,H
1927-02-16,1926,Sunderland,Birmingham City,4-1,4,1,1,1,5,3,H
1927-02-19,1926,Aston Villa,Manchester United,2-0,2,0,1,1,2,2,H
1927-02-19,1926,Derby County,Leeds United,1-0,1,0,1,1,1,1,H
1927-02-19,1926,Everton,Blackburn Rovers,1-0,1,0,1,1,1,1,H
1927-02-19,1926,Leicester City,Huddersfield Town,2-4,2,4,1,1,6,-2,A
1927-02-19,1926,Sheffield Wednesday,Sunderland,4-1,4,1,1,1,5,3,H
1927-02-19,1926,Tottenham Hotspur,Bury,1-0,1,0,1,1,1,1,H
1927-02-19,1926,West Ham United,West Bromwich Albion,1-2,1,2,1,1,3,-1,A
1927-02-21,1926,West Bromwich Albion,Cardiff City,1-2,1,2,1,1,3,-1,A
1927-02-23,1926,Leeds United,Liverpool,0-0,0,0,1,1,0,0,D
1927-02-26,1926,Arsenal,Burnley,6-2,6,2,1,1,8,4,H
1927-02-26,1926,Birmingham City,Tottenham Hotspur,1-0,1,0,1,1,1,1,H
1927-02-26,1926,Blackburn Rovers,Leeds United,4-1,4,1,1,1,5,3,H
1927-02-26,1926,Bury,West Ham United,1-2,1,2,1,1,3,-1,A
1927-02-26,1926,Derby County,Aston Villa,2-3,2,3,1,1,5,-1,A
1927-02-26,1926,Huddersfield Town,Everton,0-0,0,0,1,1,0,0,D
1927-02-26,1926,Liverpool,Newcastle United,1-2,1,2,1,1,3,-1,A
1927-02-26,1926,Manchester United,Bolton Wanderers,0-0,0,0,1,1,0,0,D
1927-02-26,1926,Sheffield United,Cardiff City,3-1,3,1,1,1,4,2,H
1927-02-26,1926,West Bromwich Albion,Sheffield Wednesday,2-2,2,2,1,1,4,0,D
1927-03-02,1926,Everton,Sheffield Wednesday,2-1,2,1,1,1,3,1,H
1927-03-05,1926,Aston Villa,Sunderland,3-1,3,1,1,1,4,2,H
1927-03-05,1926,Bolton Wanderers,West Bromwich Albion,1-1,1,1,1,1,2,0,D
1927-03-05,1926,Burnley,Blackburn Rovers,3-1,3,1,1,1,4,2,H
1927-03-05,1926,Derby County,Birmingham City,4-1,4,1,1,1,5,3,H
1927-03-05,1926,Leeds United,Leicester City,1-1,1,1,1,1,2,0,D
1927-03-05,1926,Liverpool,Sheffield Wednesday,3-0,3,0,1,1,3,3,H
1927-03-05,1926,Manchester United,Bury,1-2,1,2,1,1,3,-1,A
1927-03-05,1926,Newcastle United,Everton,7-3,7,3,1,1,10,4,H
1927-03-05,1926,Sheffield United,Tottenham Hotspur,3-3,3,3,1,1,6,0,D
1927-03-07,1926,West Ham United,Arsenal,7-0,7,0,1,1,7,7,H
1927-03-09,1926,Bolton Wanderers,Burnley,3-1,3,1,1,1,4,2,H
1927-03-12,1926,Birmingham City,Manchester United,4-0,4,0,1,1,4,4,H
1927-03-12,1926,Blackburn Rovers,Newcastle United,1-2,1,2,1,1,3,-1,A
1927-03-12,1926,Bury,Bolton Wanderers,2-0,2,0,1,1,2,2,H
1927-03-12,1926,Everton,Leeds United,2-1,2,1,1,1,3,1,H
1927-03-12,1926,Huddersfield Town,Burnley,2-0,2,0,1,1,2,2,H
1927-03-12,1926,Leicester City,Liverpool,3-2,3,2,1,1,5,1,H
1927-03-12,1926,Sheffield Wednesday,Arsenal,4-2,4,2,1,1,6,2,H
1927-03-12,1926,Sunderland,Cardiff City,2-2,2,2,1,1,4,0,D
1927-03-12,1926,Tottenham Hotspur,Derby County,3-2,3,2,1,1,5,1,H
1927-03-12,1926,West Bromwich Albion,Aston Villa,6-2,6,2,1,1,8,4,H
1927-03-12,1926,West Ham United,Sheffield United,3-0,3,0,1,1,3,3,H
1927-03-16,1926,Cardiff City,Derby County,2-0,2,0,1,1,2,2,H
1927-03-19,1926,Arsenal,Everton,1-2,1,2,1,1,3,-1,A
1927-03-19,1926,Aston Villa,Birmingham City,4-2,4,2,1,1,6,2,H
1927-03-19,1926,Bolton Wanderers,Tottenham Hotspur,2-2,2,2,1,1,4,0,D
1927-03-19,1926,Burnley,West Bromwich Albion,2-1,2,1,1,1,3,1,H
1927-03-19,1926,Cardiff City,Bury,2-1,2,1,1,1,3,1,H
1927-03-19,1926,Derby County,Sheffield Wednesday,8-0,8,0,1,1,8,8,H
1927-03-19,1926,Leeds United,Huddersfield Town,1-1,1,1,1,1,2,0,D
1927-03-19,1926,Liverpool,Blackburn Rovers,2-2,2,2,1,1,4,0,D
1927-03-19,1926,Manchester United,West Ham United,0-3,0,3,1,1,3,-3,A
1927-03-19,1926,Newcastle United,Sunderland,1-0,1,0,1,1,1,1,H
1927-03-19,1926,Sheffield United,Leicester City,0-3,0,3,1,1,3,-3,A
1927-03-21,1926,Cardiff City,Huddersfield Town,2-0,2,0,1,1,2,2,H
1927-03-26,1926,Bury,Burnley,3-3,3,3,1,1,6,0,D
1927-03-26,1926,Everton,Sheffield United,2-0,2,0,1,1,2,2,H
1927-03-26,1926,Huddersfield Town,Liverpool,1-0,1,0,1,1,1,1,H
1927-03-26,1926,Leicester City,Derby County,1-1,1,1,1,1,2,0,D
1927-03-26,1926,Sheffield Wednesday,Manchester United,2-0,2,0,1,1,2,2,H
1927-03-26,1926,Sunderland,Leeds United,6-2,6,2,1,1,8,4,H
1927-03-26,1926,Tottenham Hotspur,Aston Villa,0-1,0,1,1,1,1,-1,A
1927-03-26,1926,West Bromwich Albion,Newcastle United,4-2,4,2,1,1,6,2,H
1927-03-26,1926,West Ham United,Bolton Wanderers,4-4,4,4,1,1,8,0,D
1927-03-29,1926,Burnley,Sheffield United,2-5,2,5,1,1,7,-3,A
1927-03-30,1926,Bury,Sunderland,1-2,1,2,1,1,3,-1,A
1927-04-02,1926,Arsenal,Huddersfield Town,0-2,0,2,1,1,2,-2,A
1927-04-02,1926,Aston Villa,West Ham United,1-5,1,5,1,1,6,-4,A
1927-04-02,1926,Bolton Wanderers,Sheffield Wednesday,3-2,3,2,1,1,5,1,H
1927-04-02,1926,Burnley,Birmingham City,0-2,0,2,1,1,2,-2,A
1927-04-02,1926,Cardiff City,Tottenham Hotspur,1-2,1,2,1,1,3,-1,A
1927-04-02,1926,Derby County,Everton,0-0,0,0,1,1,0,0,D
1927-04-02,1926,Leeds United,West Bromwich Albion,3-1,3,1,1,1,4,2,H
1927-04-02,1926,Liverpool,Sunderland,1-2,1,2,1,1,3,-1,A
1927-04-02,1926,Manchester United,Leicester City,1-0,1,0,1,1,1,1,H
1927-04-02,1926,Newcastle United,Bury,3-1,3,1,1,1,4,2,H
1927-04-02,1926,Sheffield United,Blackburn Rovers,5-3,5,3,1,1,8,2,H
1927-04-04,1926,Birmingham City,Bolton Wanderers,6-1,6,1,1,1,7,5,H
1927-04-06,1926,Newcastle United,Arsenal,6-1,6,1,1,1,7,5,H
1927-04-07,1926,Leicester City,Cardiff City,3-1,3,1,1,1,4,2,H
1927-04-09,1926,Birmingham City,Newcastle United,2-0,2,0,1,1,2,2,H
1927-04-09,1926,Blackburn Rovers,Derby County,4-4,4,4,1,1,8,0,D
1927-04-09,1926,Bury,Leeds United,4-2,4,2,1,1,6,2,H
1927-04-09,1926,Everton,Manchester United,0-0,0,0,1,1,0,0,D
1927-04-09,1926,Huddersfield Town,Sheffield United,0-2,0,2,1,1,2,-2,A
1927-04-09,1926,Leicester City,Bolton Wanderers,0-1,0,1,1,1,1,-1,A
1927-04-09,1926,Sheffield Wednesday,Aston Villa,3-1,3,1,1,1,4,2,H
1927-04-09,1926,Sunderland,Arsenal,5-1,5,1,1,1,6,4,H
1927-04-09,1926,Tottenham Hotspur,Burnley,4-1,4,1,1,1,5,3,H
1927-04-09,1926,West Bromwich Albion,Liverpool,0-1,0,1,1,1,1,-1,A
1927-04-09,1926,West Ham United,Cardiff City,2-2,2,2,1,1,4,0,D
1927-04-15,1926,Arsenal,Aston Villa,2-1,2,1,1,1,3,1,H
1927-04-15,1926,Bolton Wanderers,Sheffield United,4-1,4,1,1,1,5,3,H
1927-04-15,1926,Burnley,Leeds United,3-2,3,2,1,1,5,1,H
1927-04-15,1926,Bury,Leicester City,0-0,0,0,1,1,0,0,D
1927-04-15,1926,Liverpool,Cardiff City,5-0,5,0,1,1,5,5,H
1927-04-15,1926,Manchester United,Derby County,2-2,2,2,1,1,4,0,D
1927-04-15,1926,Newcastle United,Huddersfield Town,1-0,1,0,1,1,1,1,H
1927-04-15,1926,Tottenham Hotspur,West Ham United,1-3,1,3,1,1,4,-2,A
1927-04-16,1926,Arsenal,West Bromwich Albion,4-1,4,1,1,1,5,3,H
1927-04-16,1926,Aston Villa,Leicester City,2-0,2,0,1,1,2,2,H
1927-04-16,1926,Bolton Wanderers,Everton,5-0,5,0,1,1,5,5,H
1927-04-16,1926,Burnley,West Ham United,2-1,2,1,1,1,3,1,H
1927-04-16,1926,Cardiff City,Sheffield Wednesday,3-2,3,2,1,1,5,1,H
1927-04-16,1926,Derby County,Huddersfield Town,4-4,4,4,1,1,8,0,D
1927-04-16,1926,Leeds United,Birmingham City,2-1,2,1,1,1,3,1,H
1927-04-16,1926,Liverpool,Bury,2-2,2,2,1,1,4,0,D
1927-04-16,1926,Manchester United,Blackburn Rovers,2-0,2,0,1,1,2,2,H
1927-04-16,1926,Newcastle United,Tottenham Hotspur,3-2,3,2,1,1,5,1,H
1927-04-16,1926,Sheffield United,Sunderland,2-0,2,0,1,1,2,2,H
1927-04-18,1926,Aston Villa,Arsenal,2-3,2,3,1,1,5,-1,A
1927-04-18,1926,Cardiff City,Liverpool,2-0,2,0,1,1,2,2,H
1927-04-18,1926,Derby County,Manchester United,2-2,2,2,1,1,4,0,D
1927-04-18,1926,Everton,Birmingham City,3-1,3,1,1,1,4,2,H
1927-04-18,1926,Leicester City,Bury,1-1,1,1,1,1,2,0,D
1927-04-18,1926,Sheffield United,Bolton Wanderers,1-1,1,1,1,1,2,0,D
1927-04-18,1926,West Bromwich Albion,Blackburn Rovers,2-0,2,0,1,1,2,2,H
1927-04-18,1926,West Ham United,Tottenham Hotspur,1-2,1,2,1,1,3,-1,A
1927-04-19,1926,Blackburn Rovers,West Bromwich Albion,0-0,0,0,1,1,0,0,D
1927-04-19,1926,Huddersfield Town,Newcastle United,1-0,1,0,1,1,1,1,H
1927-04-19,1926,Leeds United,Burnley,0-2,0,2,1,1,2,-2,A
1927-04-19,1926,Sheffield Wednesday,Birmingham City,4-4,4,4,1,1,8,0,D
1927-04-19,1926,Sunderland,Bolton Wanderers,6-2,6,2,1,1,8,4,H
1927-04-23,1926,Birmingham City,Liverpool,3-0,3,0,1,1,3,3,H
1927-04-23,1926,Blackburn Rovers,Bolton Wanderers,0-3,0,3,1,1,3,-3,A
1927-04-23,1926,Everton,Aston Villa,2-2,2,2,1,1,4,0,D
1927-04-23,1926,Huddersfield Town,Manchester United,0-0,0,0,1,1,0,0,D
1927-04-23,1926,Sheffield Wednesday,Burnley,2-1,2,1,1,1,3,1,H
1927-04-23,1926,Sunderland,Derby County,1-2,1,2,1,1,3,-1,A
1927-04-23,1926,Tottenham Hotspur,Leeds United,4-1,4,1,1,1,5,3,H
1927-04-23,1926,West Bromwich Albion,Sheffield United,1-0,1,0,1,1,1,1,H
1927-04-23,1926,West Ham United,Newcastle United,1-1,1,1,1,1,2,0,D
1927-04-27,1926,Birmingham City,Cardiff City,1-2,1,2,1,1,3,-1,A
1927-04-28,1926,Blackburn Rovers,Arsenal,1-2,1,2,1,1,3,-1,A
1927-04-30,1926,Arsenal,Birmingham City,3-0,3,0,1,1,3,3,H
1927-04-30,1926,Bolton Wanderers,Huddersfield Town,4-0,4,0,1,1,4,4,H
1927-04-30,1926,Burnley,Leicester City,1-1,1,1,1,1,2,0,D
1927-04-30,1926,Cardiff City,Everton,1-0,1,0,1,1,1,1,H
1927-04-30,1926,Derby County,West Bromwich Albion,2-1,2,1,1,1,3,1,H
1927-04-30,1926,Leeds United,West Ham United,6-3,6,3,1,1,9,3,H
1927-04-30,1926,Liverpool,Tottenham Hotspur,1-0,1,0,1,1,1,1,H
1927-04-30,1926,Manchester United,Sunderland,0-0,0,0,1,1,0,0,D
1927-04-30,1926,Newcastle United,Sheffield Wednesday,2-1,2,1,1,1,3,1,H
1927-05-04,1926,Bury,Arsenal,3-2,3,2,1,1,5,1,H
1927-05-05,1926,Sheffield United,Bury,2-0,2,0,1,1,2,2,H
1927-05-07,1926,Birmingham City,Sheffield United,2-3,2,3,1,1,5,-1,A
1927-05-07,1926,Blackburn Rovers,Cardiff City,1-0,1,0,1,1,1,1,H
1927-05-07,1926,Bury,Derby County,1-2,1,2,1,1,3,-1,A
1927-05-07,1926,Huddersfield Town,Aston Villa,0-0,0,0,1,1,0,0,D
1927-05-07,1926,Leicester City,Newcastle United,2-1,2,1,1,1,3,1,H
1927-05-07,1926,Sheffield Wednesday,Leeds United,1-0,1,0,1,1,1,1,H
1927-05-07,1926,Tottenham Hotspur,Arsenal,0-4,0,4,1,1,4,-4,A
1927-05-07,1926,West Bromwich Albion,Manchester United,2-2,2,2,1,1,4,0,D
1927-05-07,1926,West Ham United,Liverpool,3-3,3,3,1,1,6,0,D
1927-08-27,1927,Aston Villa,Leicester City,0-3,0,3,1,1,3,-3,A
1927-08-27,1927,Blackburn Rovers,Burnley,2-1,2,1,1,1,3,1,H
1927-08-27,1927,Bury,Arsenal,5-1,5,1,1,1,6,4,H
1927-08-27,1927,Cardiff City,Bolton Wanderers,2-1,2,1,1,1,3,1,H
1927-08-27,1927,Derby County,West Ham United,2-3,2,3,1,1,5,-1,A
1927-08-27,1927,Everton,Sheffield Wednesday,4-0,4,0,1,1,4,4,H
1927-08-27,1927,Huddersfield Town,Newcastle United,1-3,1,3,1,1,4,-2,A
1927-08-27,1927,Manchester United,Middlesbrough,3-0,3,0,1,1,3,3,H
1927-08-27,1927,Sheffield United,Liverpool,1-1,1,1,1,1,2,0,D
1927-08-27,1927,Sunderland,Portsmouth,3-3,3,3,1,1,6,0,D
1927-08-27,1927,Tottenham Hotspur,Birmingham City,1-0,1,0,1,1,1,1,H
1927-08-29,1927,Birmingham City,Huddersfield Town,3-1,3,1,1,1,4,2,H
1927-08-29,1927,Leicester City,Sheffield United,3-1,3,1,1,1,4,2,H
1927-08-29,1927,Sheffield Wednesday,Manchester United,0-2,0,2,1,1,2,-2,A
1927-08-31,1927,Arsenal,Burnley,4-1,4,1,1,1,5,3,H
1927-08-31,1927,Liverpool,Bury,5-1,5,1,1,1,6,4,H
1927-08-31,1927,Middlesbrough,Tottenham Hotspur,3-1,3,1,1,1,4,2,H
1927-08-31,1927,Portsmouth,Aston Villa,3-1,3,1,1,1,4,2,H
1927-09-01,1927,West Ham United,Sunderland,2-4,2,4,1,1,6,-2,A
1927-09-03,1927,Arsenal,Sheffield United,6-1,6,1,1,1,7,5,H
1927-09-03,1927,Birmingham City,Manchester United,0-0,0,0,1,1,0,0,D
1927-09-03,1927,Bolton Wanderers,Blackburn Rovers,3-1,3,1,1,1,4,2,H
1927-09-03,1927,Burnley,Bury,2-3,2,3,1,1,5,-1,A
1927-09-03,1927,Leicester City,Sunderland,3-3,3,3,1,1,6,0,D
1927-09-03,1927,Liverpool,Aston Villa,0-0,0,0,1,1,0,0,D
1927-09-03,1927,Middlesbrough,Everton,4-2,4,2,1,1,6,2,H
1927-09-03,1927,Newcastle United,Tottenham Hotspur,4-1,4,1,1,1,5,3,H
1927-09-03,1927,Portsmouth,Derby County,2-2,2,2,1,1,4,0,D
1927-09-03,1927,Sheffield Wednesday,Cardiff City,3-3,3,3,1,1,6,0,D
1927-09-03,1927,West Ham United,Huddersfield Town,4-2,4,2,1,1,6,2,H
1927-09-05,1927,Aston Villa,Portsmouth,7-2,7,2,1,1,9,5,H
1927-09-05,1927,Blackburn Rovers,Cardiff City,0-0,0,0,1,1,0,0,D
1927-09-05,1927,Bolton Wanderers,Everton,1-1,1,1,1,1,2,0,D
1927-09-05,1927,Burnley,Arsenal,1-2,1,2,1,1,3,-1,A
1927-09-05,1927,Derby County,Newcastle United,1-1,1,1,1,1,2,0,D
1927-09-05,1927,Sheffield United,Leicester City,1-1,1,1,1,1,2,0,D
1927-09-07,1927,Manchester United,Sheffield Wednesday,1-1,1,1,1,1,2,0,D
1927-09-07,1927,Sunderland,Birmingham City,4-2,4,2,1,1,6,2,H
1927-09-10,1927,Aston Villa,Arsenal,2-2,2,2,1,1,4,0,D
1927-09-10,1927,Blackburn Rovers,Sheffield Wednesday,3-1,3,1,1,1,4,2,H
1927-09-10,1927,Bury,Bolton Wanderers,1-0,1,0,1,1,1,1,H
1927-09-10,1927,Cardiff City,Middlesbrough,1-1,1,1,1,1,2,0,D
1927-09-10,1927,Derby County,Leicester City,2-1,2,1,1,1,3,1,H
1927-09-10,1927,Everton,Birmingham City,5-2,5,2,1,1,7,3,H
1927-09-10,1927,Manchester United,Newcastle United,1-7,1,7,1,1,8,-6,A
1927-09-10,1927,Sheffield United,Burnley,5-2,5,2,1,1,7,3,H
1927-09-10,1927,Sunderland,Liverpool,2-1,2,1,1,1,3,1,H
1927-09-10,1927,Tottenham Hotspur,Huddersfield Town,2-2,2,2,1,1,4,0,D
1927-09-10,1927,West Ham United,Portsmouth,4-2,4,2,1,1,6,2,H
1927-09-12,1927,Cardiff City,Blackburn Rovers,1-1,1,1,1,1,2,0,D
1927-09-12,1927,Tottenham Hotspur,Middlesbrough,4-2,4,2,1,1,6,2,H
1927-09-14,1927,Everton,Bolton Wanderers,2-2,2,2,1,1,4,0,D
1927-09-14,1927,Newcastle United,Derby County,4-3,4,3,1,1,7,1,H
1927-09-17,1927,Arsenal,Sunderland,2-1,2,1,1,1,3,1,H
1927-09-17,1927,Birmingham City,Cardiff City,1-3,1,3,1,1,4,-2,A
1927-09-17,1927,Burnley,Aston Villa,4-2,4,2,1,1,6,2,H
1927-09-17,1927,Bury,Sheffield United,1-0,1,0,1,1,1,1,H
1927-09-17,1927,Huddersfield Town,Manchester United,4-2,4,2,1,1,6,2,H
1927-09-17,1927,Leicester City,West Ham United,2-3,2,3,1,1,5,-1,A
1927-09-17,1927,Liverpool,Derby County,5-2,5,2,1,1,7,3,H
1927-09-17,1927,Middlesbrough,Blackburn Rovers,2-0,2,0,1,1,2,2,H
1927-09-17,1927,Newcastle United,Everton,2-2,2,2,1,1,4,0,D
1927-09-17,1927,Portsmouth,Tottenham Hotspur,3-0,3,0,1,1,3,3,H
1927-09-17,1927,Sheffield Wednesday,Bolton Wanderers,3-0,3,0,1,1,3,3,H
1927-09-19,1927,Blackburn Rovers,Manchester United,3-0,3,0,1,1,3,3,H
1927-09-19,1927,Bury,Liverpool,5-2,5,2,1,1,7,3,H
1927-09-22,1927,Tottenham Hotspur,Leicester City,2-1,2,1,1,1,3,1,H
1927-09-24,1927,Aston Villa,Bury,1-0,1,0,1,1,1,1,H
1927-09-24,1927,Blackburn Rovers,Birmingham City,4-4,4,4,1,1,8,0,D
1927-09-24,1927,Bolton Wanderers,Middlesbrough,0-0,0,0,1,1,0,0,D
1927-09-24,1927,Cardiff City,Newcastle United,3-1,3,1,1,1,4,2,H
1927-09-24,1927,Derby County,Arsenal,4-0,4,0,1,1,4,4,H
1927-09-24,1927,Everton,Huddersfield Town,2-2,2,2,1,1,4,0,D
1927-09-24,1927,Manchester United,Tottenham Hotspur,3-0,3,0,1,1,3,3,H
1927-09-24,1927,Portsmouth,Leicester City,2-0,2,0,1,1,2,2,H
1927-09-24,1927,Sheffield United,Sheffield Wednesday,1-1,1,1,1,1,2,0,D
1927-09-24,1927,Sunderland,Burnley,2-3,2,3,1,1,5,-1,A
1927-09-24,1927,West Ham United,Liverpool,3-1,3,1,1,1,4,2,H
1927-10-01,1927,Arsenal,West Ham United,2-2,2,2,1,1,4,0,D
1927-10-01,1927,Birmingham City,Bolton Wanderers,1-1,1,1,1,1,2,0,D
1927-10-01,1927,Burnley,Derby County,4-2,4,2,1,1,6,2,H
1927-10-01,1927,Bury,Sunderland,5-3,5,3,1,1,8,2,H
1927-10-01,1927,Huddersfield Town,Cardiff City,8-2,8,2,1,1,10,6,H
1927-10-01,1927,Leicester City,Manchester United,1-0,1,0,1,1,1,1,H
1927-10-01,1927,Liverpool,Portsmouth,8-2,8,2,1,1,10,6,H
1927-10-01,1927,Middlesbrough,Sheffield Wednesday,3-3,3,3,1,1,6,0,D
1927-10-01,1927,Newcastle United,Blackburn Rovers,0-1,0,1,1,1,1,-1,A
1927-10-01,1927,Sheffield United,Aston Villa,0-3,0,3,1,1,3,-3,A
1927-10-01,1927,Tottenham Hotspur,Everton,1-3,1,3,1,1,4,-2,A
1927-10-08,1927,Aston Villa,Middlesbrough,5-1,5,1,1,1,6,4,H
1927-10-08,1927,Blackburn Rovers,Huddersfield Town,1-1,1,1,1,1,2,0,D
1927-10-08,1927,Bolton Wanderers,Newcastle United,1-2,1,2,1,1,3,-1,A
1927-10-08,1927,Cardiff City,Tottenham Hotspur,2-1,2,1,1,1,3,1,H
1927-10-08,1927,Derby County,Bury,5-2,5,2,1,1,7,3,H
1927-10-08,1927,Everton,Manchester United,5-2,5,2,1,1,7,3,H
1927-10-08,1927,Leicester City,Liverpool,1-1,1,1,1,1,2,0,D
1927-10-08,1927,Portsmouth,Arsenal,2-3,2,3,1,1,5,-1,A
1927-10-08,1927,Sheffield Wednesday,Birmingham City,2-3,2,3,1,1,5,-1,A
1927-10-08,1927,Sunderland,Sheffield United,0-1,0,1,1,1,1,-1,A
1927-10-08,1927,West Ham United,Burnley,2-0,2,0,1,1,2,2,H
1927-10-15,1927,Arsenal,Leicester City,2-2,2,2,1,1,4,0,D
1927-10-15,1927,Aston Villa,Sunderland,4-2,4,2,1,1,6,2,H
1927-10-15,1927,Birmingham City,Middlesbrough,3-2,3,2,1,1,5,1,H
1927-10-15,1927,Burnley,Portsmouth,2-0,2,0,1,1,2,2,H
1927-10-15,1927,Bury,West Ham United,3-1,3,1,1,1,4,2,H
1927-10-15,1927,Everton,Liverpool,1-1,1,1,1,1,2,0,D
1927-10-15,1927,Huddersfield Town,Bolton Wanderers,1-0,1,0,1,1,1,1,H
1927-10-15,1927,Manchester United,Cardiff City,2-2,2,2,1,1,4,0,D
1927-10-15,1927,Newcastle United,Sheffield Wednesday,4-3,4,3,1,1,7,1,H
1927-10-15,1927,Sheffield United,Derby County,1-0,1,0,1,1,1,1,H
1927-10-15,1927,Tottenham Hotspur,Blackburn Rovers,1-1,1,1,1,1,2,0,D
1927-10-22,1927,Birmingham City,Bury,2-2,2,2,1,1,4,0,D
1927-10-22,1927,Blackburn Rovers,Leicester City,0-0,0,0,1,1,0,0,D
1927-10-22,1927,Bolton Wanderers,Liverpool,2-1,2,1,1,1,3,1,H
1927-10-22,1927,Cardiff City,Portsmouth,3-1,3,1,1,1,4,2,H
1927-10-22,1927,Everton,West Ham United,7-0,7,0,1,1,7,7,H
1927-10-22,1927,Huddersfield Town,Aston Villa,1-1,1,1,1,1,2,0,D
1927-10-22,1927,Manchester United,Derby County,5-0,5,0,1,1,5,5,H
1927-10-22,1927,Middlesbrough,Burnley,2-3,2,3,1,1,5,-1,A
1927-10-22,1927,Newcastle United,Sheffield United,1-0,1,0,1,1,1,1,H
1927-10-22,1927,Sheffield Wednesday,Arsenal,1-1,1,1,1,1,2,0,D
1927-10-22,1927,Tottenham Hotspur,Sunderland,3-1,3,1,1,1,4,2,H
1927-10-29,1927,Arsenal,Bolton Wanderers,1-2,1,2,1,1,3,-1,A
1927-10-29,1927,Aston Villa,Newcastle United,3-0,3,0,1,1,3,3,H
1927-10-29,1927,Burnley,Sheffield Wednesday,3-1,3,1,1,1,4,2,H
1927-10-29,1927,Bury,Middlesbrough,1-4,1,4,1,1,5,-3,A
1927-10-29,1927,Derby County,Tottenham Hotspur,1-1,1,1,1,1,2,0,D
1927-10-29,1927,Leicester City,Cardiff City,4-1,4,1,1,1,5,3,H
1927-10-29,1927,Liverpool,Blackburn Rovers,4-2,4,2,1,1,6,2,H
1927-10-29,1927,Portsmouth,Everton,1-3,1,3,1,1,4,-2,A
1927-10-29,1927,Sheffield United,Birmingham City,3-1,3,1,1,1,4,2,H
1927-10-29,1927,Sunderland,Huddersfield Town,3-0,3,0,1,1,3,3,H
1927-10-29,1927,West Ham United,Manchester United,1-2,1,2,1,1,3,-1,A
1927-11-05,1927,Birmingham City,Aston Villa,1-1,1,1,1,1,2,0,D
1927-11-05,1927,Blackburn Rovers,Arsenal,4-1,4,1,1,1,5,3,H
1927-11-05,1927,Bolton Wanderers,Burnley,7-1,7,1,1,1,8,6,H
1927-11-05,1927,Cardiff City,Liverpool,1-1,1,1,1,1,2,0,D
1927-11-05,1927,Everton,Leicester City,7-1,7,1,1,1,8,6,H
1927-11-05,1927,Huddersfield Town,Derby County,2-1,2,1,1,1,3,1,H
1927-11-05,1927,Manchester United,Portsmouth,2-0,2,0,1,1,2,2,H
1927-11-05,1927,Middlesbrough,Sheffield United,3-0,3,0,1,1,3,3,H
1927-11-05,1927,Newcastle United,Sunderland,3-1,3,1,1,1,4,2,H
1927-11-05,1927,Sheffield Wednesday,Bury,4-0,4,0,1,1,4,4,H
1927-11-05,1927,Tottenham Hotspur,West Ham United,5-3,5,3,1,1,8,2,H
1927-11-12,1927,Arsenal,Middlesbrough,3-1,3,1,1,1,4,2,H
1927-11-12,1927,Aston Villa,Tottenham Hotspur,1-2,1,2,1,1,3,-1,A
1927-11-12,1927,Burnley,Birmingham City,2-1,2,1,1,1,3,1,H
1927-11-12,1927,Bury,Newcastle United,1-4,1,4,1,1,5,-3,A
1927-11-12,1927,Derby County,Everton,0-3,0,3,1,1,3,-3,A
1927-11-12,1927,Leicester City,Bolton Wanderers,4-2,4,2,1,1,6,2,H
1927-11-12,1927,Liverpool,Sheffield Wednesday,5-2,5,2,1,1,7,3,H
1927-11-12,1927,Portsmouth,Blackburn Rovers,2-2,2,2,1,1,4,0,D
1927-11-12,1927,Sheffield United,Huddersfield Town,1-7,1,7,1,1,8,-6,A
1927-11-12,1927,Sunderland,Manchester United,4-1,4,1,1,1,5,3,H
1927-11-12,1927,West Ham United,Cardiff City,2-0,2,0,1,1,2,2,H
1927-11-19,1927,Birmingham City,Arsenal,1-1,1,1,1,1,2,0,D
1927-11-19,1927,Blackburn Rovers,West Ham United,1-0,1,0,1,1,1,1,H
1927-11-19,1927,Bolton Wanderers,Portsmouth,3-1,3,1,1,1,4,2,H
1927-11-19,1927,Cardiff City,Derby County,4-4,4,4,1,1,8,0,D
1927-11-19,1927,Everton,Sunderland,0-1,0,1,1,1,1,-1,A
1927-11-19,1927,Huddersfield Town,Bury,3-0,3,0,1,1,3,3,H
1927-11-19,1927,Manchester United,Aston Villa,5-1,5,1,1,1,6,4,H
1927-11-19,1927,Middlesbrough,Liverpool,1-1,1,1,1,1,2,0,D
1927-11-19,1927,Newcastle United,Burnley,1-1,1,1,1,1,2,0,D
1927-11-19,1927,Sheffield Wednesday,Leicester City,1-2,1,2,1,1,3,-1,A
1927-11-19,1927,Tottenham Hotspur,Sheffield United,2-2,2,2,1,1,4,0,D
1927-11-26,1927,Aston Villa,Blackburn Rovers,2-0,2,0,1,1,2,2,H
1927-11-26,1927,Burnley,Manchester United,4-0,4,0,1,1,4,4,H
1927-11-26,1927,Bury,Everton,2-3,2,3,1,1,5,-1,A
1927-11-26,1927,Derby County,Sheffield Wednesday,4-6,4,6,1,1,10,-2,A
1927-11-26,1927,Leicester City,Newcastle United,3-0,3,0,1,1,3,3,H
1927-11-26,1927,Liverpool,Huddersfield Town,4-2,4,2,1,1,6,2,H
1927-11-26,1927,Portsmouth,Birmingham City,2-2,2,2,1,1,4,0,D
1927-11-26,1927,Sheffield United,Cardiff City,3-4,3,4,1,1,7,-1,A
1927-11-26,1927,Sunderland,Bolton Wanderers,1-1,1,1,1,1,2,0,D
1927-11-26,1927,West Ham United,Middlesbrough,4-5,4,5,1,1,9,-1,A
1927-12-03,1927,Birmingham City,Leicester City,0-2,0,2,1,1,2,-2,A
1927-12-03,1927,Blackburn Rovers,Sunderland,0-0,0,0,1,1,0,0,D
1927-12-03,1927,Cardiff City,Aston Villa,2-1,2,1,1,1,3,1,H
1927-12-03,1927,Everton,Sheffield United,0-0,0,0,1,1,0,0,D
1927-12-03,1927,Huddersfield Town,Arsenal,2-1,2,1,1,1,3,1,H
1927-12-03,1927,Manchester United,Bury,0-1,0,1,1,1,1,-1,A
1927-12-03,1927,Middlesbrough,Portsmouth,5-1,5,1,1,1,6,4,H
1927-12-03,1927,Newcastle United,Liverpool,1-1,1,1,1,1,2,0,D
1927-12-03,1927,Sheffield Wednesday,West Ham United,2-0,2,0,1,1,2,2,H
1927-12-03,1927,Tottenham Hotspur,Burnley,5-0,5,0,1,1,5,5,H
1927-12-10,1927,Arsenal,Newcastle United,4-1,4,1,1,1,5,3,H
1927-12-10,1927,Aston Villa,Everton,2-3,2,3,1,1,5,-1,A
1927-12-10,1927,Burnley,Huddersfield Town,0-1,0,1,1,1,1,-1,A
1927-12-10,1927,Bury,Tottenham Hotspur,1-2,1,2,1,1,3,-1,A
1927-12-10,1927,Derby County,Blackburn Rovers,6-0,6,0,1,1,6,6,H
1927-12-10,1927,Leicester City,Middlesbrough,3-3,3,3,1,1,6,0,D
1927-12-10,1927,Liverpool,Birmingham City,2-3,2,3,1,1,5,-1,A
1927-12-10,1927,Portsmouth,Sheffield Wednesday,0-0,0,0,1,1,0,0,D
1927-12-10,1927,Sheffield United,Manchester United,2-1,2,1,1,1,3,1,H
1927-12-10,1927,Sunderland,Cardiff City,0-2,0,2,1,1,2,-2,A
1927-12-10,1927,West Ham United,Bolton Wanderers,2-0,2,0,1,1,2,2,H
1927-12-17,1927,Birmingham City,West Ham United,1-2,1,2,1,1,3,-1,A
1927-12-17,1927,Blackburn Rovers,Sheffield United,1-0,1,0,1,1,1,1,H
1927-12-17,1927,Bolton Wanderers,Aston Villa,3-1,3,1,1,1,4,2,H
1927-12-17,1927,Cardiff City,Bury,0-1,0,1,1,1,1,-1,A
1927-12-17,1927,Everton,Burnley,4-1,4,1,1,1,5,3,H
1927-12-17,1927,Huddersfield Town,Leicester City,3-1,3,1,1,1,4,2,H
1927-12-17,1927,Manchester United,Arsenal,4-1,4,1,1,1,5,3,H
1927-12-17,1927,Middlesbrough,Derby County,3-3,3,3,1,1,6,0,D
1927-12-17,1927,Newcastle United,Portsmouth,1-3,1,3,1,1,4,-2,A
1927-12-17,1927,Sheffield Wednesday,Sunderland,0-0,0,0,1,1,0,0,D
1927-12-17,1927,Tottenham Hotspur,Liverpool,3-1,3,1,1,1,4,2,H
1927-12-24,1927,Arsenal,Everton,3-2,3,2,1,1,5,1,H
1927-12-24,1927,Aston Villa,Sheffield Wednesday,5-4,5,4,1,1,9,1,H
1927-12-24,1927,Burnley,Cardiff City,2-1,2,1,1,1,3,1,H
1927-12-24,1927,Bury,Blackburn Rovers,2-3,2,3,1,1,5,-1,A
1927-12-24,1927,Derby County,Birmingham City,4-1,4,1,1,1,5,3,H
1927-12-24,1927,Leicester City,Tottenham Hotspur,6-1,6,1,1,1,7,5,H
1927-12-24,1927,Liverpool,Manchester United,2-0,2,0,1,1,2,2,H
1927-12-24,1927,Portsmouth,Huddersfield Town,2-1,2,1,1,1,3,1,H
1927-12-24,1927,Sheffield United,Bolton Wanderers,4-3,4,3,1,1,7,1,H
1927-12-24,1927,Sunderland,Middlesbrough,1-0,1,0,1,1,1,1,H
1927-12-24,1927,West Ham United,Newcastle United,5-2,5,2,1,1,7,3,H
1927-12-26,1927,Birmingham City,Sunderland,1-1,1,1,1,1,2,0,D
1927-12-26,1927,Bolton Wanderers,Tottenham Hotspur,4-1,4,1,1,1,5,3,H
1927-12-26,1927,Bury,Portsmouth,4-0,4,0,1,1,4,4,H
1927-12-26,1927,Derby County,Aston Villa,5-0,5,0,1,1,5,5,H
1927-12-26,1927,Everton,Cardiff City,2-1,2,1,1,1,3,1,H
1927-12-26,1927,Huddersfield Town,Sheffield Wednesday,1-0,1,0,1,1,1,1,H
1927-12-26,1927,Leicester City,Burnley,5-0,5,0,1,1,5,5,H
1927-12-26,1927,Manchester United,Blackburn Rovers,1-1,1,1,1,1,2,0,D
1927-12-26,1927,Middlesbrough,Newcastle United,1-1,1,1,1,1,2,0,D
1927-12-26,1927,Sheffield United,West Ham United,6-2,6,2,1,1,8,4,H
1927-12-27,1927,Aston Villa,Derby County,0-1,0,1,1,1,1,-1,A
1927-12-27,1927,Burnley,Leicester City,5-1,5,1,1,1,6,4,H
1927-12-27,1927,Cardiff City,Everton,2-0,2,0,1,1,2,2,H
1927-12-27,1927,Liverpool,Arsenal,0-2,0,2,1,1,2,-2,A
1927-12-27,1927,Newcastle United,Middlesbrough,3-3,3,3,1,1,6,0,D
1927-12-27,1927,Portsmouth,Bury,1-0,1,0,1,1,1,1,H
1927-12-27,1927,Sheffield Wednesday,Huddersfield Town,0-5,0,5,1,1,5,-5,A
1927-12-27,1927,West Ham United,Sheffield United,1-1,1,1,1,1,2,0,D
1927-12-31,1927,Arsenal,Bury,3-1,3,1,1,1,4,2,H
1927-12-31,1927,Birmingham City,Tottenham Hotspur,3-2,3,2,1,1,5,1,H
1927-12-31,1927,Bolton Wanderers,Cardiff City,2-1,2,1,1,1,3,1,H
1927-12-31,1927,Burnley,Blackburn Rovers,3-1,3,1,1,1,4,2,H
1927-12-31,1927,Leicester City,Aston Villa,3-0,3,0,1,1,3,3,H
1927-12-31,1927,Liverpool,Sheffield United,2-1,2,1,1,1,3,1,H
1927-12-31,1927,Middlesbrough,Manchester United,1-2,1,2,1,1,3,-1,A
1927-12-31,1927,Newcastle United,Huddersfield Town,2-3,2,3,1,1,5,-1,A
1927-12-31,1927,Sheffield Wednesday,Everton,1-2,1,2,1,1,3,-1,A
1927-12-31,1927,West Ham United,Derby County,2-2,2,2,1,1,4,0,D
1928-01-02,1927,Arsenal,Tottenham Hotspur,1-1,1,1,1,1,2,0,D
1928-01-02,1927,Blackburn Rovers,Everton,4-2,4,2,1,1,6,2,H
1928-01-02,1927,Bolton Wanderers,Derby County,1-3,1,3,1,1,4,-2,A
1928-01-02,1927,Bury,Leicester City,2-1,2,1,1,1,3,1,H
1928-01-02,1927,Liverpool,Burnley,2-2,2,2,1,1,4,0,D
1928-01-02,1927,Middlesbrough,Huddersfield Town,3-1,3,1,1,1,4,2,H
1928-01-02,1927,Newcastle United,Birmingham City,1-1,1,1,1,1,2,0,D
1928-01-02,1927,Sheffield United,Portsmouth,3-1,3,1,1,1,4,2,H
1928-01-02,1927,Sunderland,West Ham United,3-2,3,2,1,1,5,1,H
1928-01-07,1927,Aston Villa,Liverpool,3-4,3,4,1,1,7,-1,A
1928-01-07,1927,Blackburn Rovers,Bolton Wanderers,1-6,1,6,1,1,7,-5,A
1928-01-07,1927,Bury,Burnley,2-0,2,0,1,1,2,2,H
1928-01-07,1927,Cardiff City,Sheffield Wednesday,1-1,1,1,1,1,2,0,D
1928-01-07,1927,Derby County,Portsmouth,2-2,2,2,1,1,4,0,D
1928-01-07,1927,Everton,Middlesbrough,3-1,3,1,1,1,4,2,H
1928-01-07,1927,Huddersfield Town,West Ham United,5-2,5,2,1,1,7,3,H
1928-01-07,1927,Manchester United,Birmingham City,1-1,1,1,1,1,2,0,D
1928-01-07,1927,Sheffield United,Arsenal,6-4,6,4,1,1,10,2,H
1928-01-07,1927,Sunderland,Leicester City,2-2,2,2,1,1,4,0,D
1928-01-07,1927,Tottenham Hotspur,Newcastle United,5-2,5,2,1,1,7,3,H
1928-01-21,1927,Arsenal,Aston Villa,0-3,0,3,1,1,3,-3,A
1928-01-21,1927,Birmingham City,Everton,2-2,2,2,1,1,4,0,D
1928-01-21,1927,Bolton Wanderers,Bury,2-1,2,1,1,1,3,1,H
1928-01-21,1927,Burnley,Sheffield United,5-3,5,3,1,1,8,2,H
1928-01-21,1927,Huddersfield Town,Tottenham Hotspur,4-2,4,2,1,1,6,2,H
1928-01-21,1927,Leicester City,Derby County,4-0,4,0,1,1,4,4,H
1928-01-21,1927,Liverpool,Sunderland,2-5,2,5,1,1,7,-3,A
1928-01-21,1927,Middlesbrough,Cardiff City,1-2,1,2,1,1,3,-1,A
1928-01-21,1927,Newcastle United,Manchester United,4-1,4,1,1,1,5,3,H
1928-01-21,1927,Portsmouth,West Ham United,2-1,2,1,1,1,3,1,H
1928-01-21,1927,Sheffield Wednesday,Blackburn Rovers,4-1,4,1,1,1,5,3,H
1928-02-04,1927,Arsenal,Derby County,3-4,3,4,1,1,7,-1,A
1928-02-04,1927,Birmingham City,Blackburn Rovers,2-1,2,1,1,1,3,1,H
1928-02-04,1927,Burnley,Sunderland,3-0,3,0,1,1,3,3,H
1928-02-04,1927,Bury,Aston Villa,0-0,0,0,1,1,0,0,D
1928-02-04,1927,Huddersfield Town,Everton,4-1,4,1,1,1,5,3,H
1928-02-04,1927,Leicester City,Portsmouth,6-2,6,2,1,1,8,4,H
1928-02-04,1927,Liverpool,West Ham United,1-3,1,3,1,1,4,-2,A
1928-02-04,1927,Middlesbrough,Bolton Wanderers,2-5,2,5,1,1,7,-3,A
1928-02-04,1927,Newcastle United,Cardiff City,2-0,2,0,1,1,2,2,H
1928-02-04,1927,Sheffield Wednesday,Sheffield United,3-3,3,3,1,1,6,0,D
1928-02-04,1927,Tottenham Hotspur,Manchester United,4-1,4,1,1,1,5,3,H
1928-02-06,1927,Tottenham Hotspur,Bolton Wanderers,1-2,1,2,1,1,3,-1,A
1928-02-08,1927,Aston Villa,Burnley,3-1,3,1,1,1,4,2,H
1928-02-11,1927,Aston Villa,Sheffield United,1-0,1,0,1,1,1,1,H
1928-02-11,1927,Blackburn Rovers,Newcastle United,1-0,1,0,1,1,1,1,H
1928-02-11,1927,Bolton Wanderers,Birmingham City,3-2,3,2,1,1,5,1,H
1928-02-11,1927,Cardiff City,Huddersfield Town,4-0,4,0,1,1,4,4,H
1928-02-11,1927,Derby County,Burnley,3-4,3,4,1,1,7,-1,A
1928-02-11,1927,Everton,Tottenham Hotspur,2-5,2,5,1,1,7,-3,A
1928-02-11,1927,Manchester United,Leicester City,5-2,5,2,1,1,7,3,H
1928-02-11,1927,Portsmouth,Liverpool,1-0,1,0,1,1,1,1,H
1928-02-11,1927,Sheffield Wednesday,Middlesbrough,2-3,2,3,1,1,5,-1,A
1928-02-11,1927,Sunderland,Bury,1-0,1,0,1,1,1,1,H
1928-02-11,1927,West Ham United,Arsenal,2-2,2,2,1,1,4,0,D
1928-02-15,1927,Derby County,Liverpool,2-3,2,3,1,1,5,-1,A
1928-02-18,1927,Burnley,West Ham United,0-0,0,0,1,1,0,0,D
1928-02-18,1927,Bury,Derby County,3-0,3,0,1,1,3,3,H
1928-02-18,1927,Newcastle United,Bolton Wanderers,2-2,2,2,1,1,4,0,D
1928-02-18,1927,Portsmouth,Sunderland,3-5,3,5,1,1,8,-2,A
1928-02-22,1927,Cardiff City,Birmingham City,2-1,2,1,1,1,3,1,H
1928-02-23,1927,Blackburn Rovers,Middlesbrough,3-0,3,0,1,1,3,3,H
1928-02-25,1927,Blackburn Rovers,Tottenham Hotspur,2-1,2,1,1,1,3,1,H
1928-02-25,1927,Bolton Wanderers,Huddersfield Town,0-1,0,1,1,1,1,-1,A
1928-02-25,1927,Cardiff City,Manchester United,2-0,2,0,1,1,2,2,H
1928-02-25,1927,Derby County,Sheffield United,2-1,2,1,1,1,3,1,H
1928-02-25,1927,Leicester City,Arsenal,3-2,3,2,1,1,5,1,H
1928-02-25,1927,Liverpool,Everton,3-3,3,3,1,1,6,0,D
1928-02-25,1927,Middlesbrough,Birmingham City,1-1,1,1,1,1,2,0,D
1928-02-25,1927,Portsmouth,Burnley,1-0,1,0,1,1,1,1,H
1928-02-25,1927,Sheffield Wednesday,Newcastle United,0-0,0,0,1,1,0,0,D
1928-02-25,1927,Sunderland,Aston Villa,2-3,2,3,1,1,5,-1,A
1928-02-25,1927,West Ham United,Bury,1-2,1,2,1,1,3,-1,A
1928-02-29,1927,Bolton Wanderers,Sheffield Wednesday,2-0,2,0,1,1,2,2,H
1928-03-03,1927,Burnley,Middlesbrough,1-1,1,1,1,1,2,0,D
1928-03-03,1927,Bury,Birmingham City,2-3,2,3,1,1,5,-1,A
1928-03-03,1927,Liverpool,Bolton Wanderers,4-2,4,2,1,1,6,2,H
1928-03-03,1927,Portsmouth,Cardiff City,3-0,3,0,1,1,3,3,H
1928-03-03,1927,West Ham United,Everton,0-0,0,0,1,1,0,0,D
1928-03-05,1927,Tottenham Hotspur,Cardiff City,1-0,1,0,1,1,1,1,H
1928-03-07,1927,Arsenal,Liverpool,6-3,6,3,1,1,9,3,H
1928-03-07,1927,Birmingham City,Sheffield Wednesday,1-0,1,0,1,1,1,1,H
1928-03-07,1927,Manchester United,Huddersfield Town,0-0,0,0,1,1,0,0,D
1928-03-10,1927,Birmingham City,Sheffield United,4-1,4,1,1,1,5,3,H
1928-03-10,1927,Blackburn Rovers,Liverpool,2-1,2,1,1,1,3,1,H
1928-03-10,1927,Bolton Wanderers,Arsenal,1-1,1,1,1,1,2,0,D
1928-03-10,1927,Cardiff City,Leicester City,3-0,3,0,1,1,3,3,H
1928-03-10,1927,Everton,Portsmouth,0-0,0,0,1,1,0,0,D
1928-03-10,1927,Huddersfield Town,Sunderland,4-2,4,2,1,1,6,2,H
1928-03-10,1927,Manchester United,West Ham United,1-1,1,1,1,1,2,0,D
1928-03-10,1927,Middlesbrough,Bury,6-1,6,1,1,1,7,5,H
1928-03-10,1927,Newcastle United,Aston Villa,7-5,7,5,1,1,12,2,H
1928-03-10,1927,Sheffield Wednesday,Burnley,5-0,5,0,1,1,5,5,H
1928-03-10,1927,Tottenham Hotspur,Derby County,1-2,1,2,1,1,3,-1,A
1928-03-12,1927,Sheffield United,Bury,3-1,3,1,1,1,4,2,H
1928-03-12,1927,West Ham United,Leicester City,4-0,4,0,1,1,4,4,H
1928-03-14,1927,Huddersfield Town,Blackburn Rovers,3-1,3,1,1,1,4,2,H
1928-03-14,1927,Manchester United,Everton,1-0,1,0,1,1,1,1,H
1928-03-14,1927,Sunderland,Arsenal,5-1,5,1,1,1,6,4,H
1928-03-17,1927,Arsenal,Blackburn Rovers,3-2,3,2,1,1,5,1,H
1928-03-17,1927,Aston Villa,Birmingham City,1-1,1,1,1,1,2,0,D
1928-03-17,1927,Burnley,Bolton Wanderers,2-2,2,2,1,1,4,0,D
1928-03-17,1927,Bury,Sheffield Wednesday,4-2,4,2,1,1,6,2,H
1928-03-17,1927,Derby County,Huddersfield Town,0-0,0,0,1,1,0,0,D
1928-03-17,1927,Leicester City,Everton,1-0,1,0,1,1,1,1,H
1928-03-17,1927,Liverpool,Cardiff City,1-2,1,2,1,1,3,-1,A
1928-03-17,1927,Portsmouth,Manchester United,1-0,1,0,1,1,1,1,H
1928-03-17,1927,Sheffield United,Middlesbrough,4-1,4,1,1,1,5,3,H
1928-03-17,1927,Sunderland,Newcastle United,1-1,1,1,1,1,2,0,D
1928-03-17,1927,West Ham United,Tottenham Hotspur,1-1,1,1,1,1,2,0,D
1928-03-19,1927,Tottenham Hotspur,Portsmouth,0-3,0,3,1,1,3,-3,A
1928-03-21,1927,Middlesbrough,Aston Villa,0-0,0,0,1,1,0,0,D
1928-03-24,1927,Birmingham City,Burnley,4-0,4,0,1,1,4,4,H
1928-03-24,1927,Bolton Wanderers,Leicester City,3-3,3,3,1,1,6,0,D
1928-03-24,1927,Cardiff City,West Ham United,1-5,1,5,1,1,6,-4,A
1928-03-24,1927,Everton,Derby County,2-2,2,2,1,1,4,0,D
1928-03-24,1927,Newcastle United,Bury,2-3,2,3,1,1,5,-1,A
1928-03-24,1927,Sheffield Wednesday,Liverpool,4-0,4,0,1,1,4,4,H
1928-03-24,1927,Tottenham Hotspur,Aston Villa,2-1,2,1,1,1,3,1,H
1928-03-28,1927,Arsenal,Portsmouth,0-2,0,2,1,1,2,-2,A
1928-03-28,1927,Derby County,Manchester United,5-0,5,0,1,1,5,5,H
1928-03-28,1927,Sunderland,Tottenham Hotspur,0-0,0,0,1,1,0,0,D
1928-03-31,1927,Arsenal,Birmingham City,2-2,2,2,1,1,4,0,D
1928-03-31,1927,Aston Villa,Manchester United,3-1,3,1,1,1,4,2,H
1928-03-31,1927,Burnley,Newcastle United,5-1,5,1,1,1,6,4,H
1928-03-31,1927,Bury,Huddersfield Town,2-3,2,3,1,1,5,-1,A
1928-03-31,1927,Derby County,Cardiff City,7-1,7,1,1,1,8,6,H
1928-03-31,1927,Leicester City,Sheffield Wednesday,2-2,2,2,1,1,4,0,D
1928-03-31,1927,Liverpool,Middlesbrough,1-1,1,1,1,1,2,0,D
1928-03-31,1927,Portsmouth,Bolton Wanderers,1-0,1,0,1,1,1,1,H
1928-03-31,1927,Sheffield United,Tottenham Hotspur,3-1,3,1,1,1,4,2,H
1928-03-31,1927,Sunderland,Everton,0-2,0,2,1,1,2,-2,A
1928-03-31,1927,West Ham United,Blackburn Rovers,4-3,4,3,1,1,7,1,H
1928-04-06,1927,Arsenal,Cardiff City,3-0,3,0,1,1,3,3,H
1928-04-06,1927,Bolton Wanderers,Manchester United,3-2,3,2,1,1,5,1,H
1928-04-06,1927,Burnley,Liverpool,2-2,2,2,1,1,4,0,D
1928-04-06,1927,Everton,Blackburn Rovers,4-1,4,1,1,1,5,3,H
1928-04-06,1927,Sunderland,Derby County,0-1,0,1,1,1,1,-1,A
1928-04-06,1927,Tottenham Hotspur,Sheffield Wednesday,1-3,1,3,1,1,4,-2,A
1928-04-06,1927,West Ham United,Aston Villa,0-0,0,0,1,1,0,0,D
1928-04-07,1927,Birmingham City,Portsmouth,2-0,2,0,1,1,2,2,H
1928-04-07,1927,Blackburn Rovers,Aston Villa,0-1,0,1,1,1,1,-1,A
1928-04-07,1927,Bolton Wanderers,Sunderland,1-2,1,2,1,1,3,-1,A
1928-04-07,1927,Cardiff City,Sheffield United,2-2,2,2,1,1,4,0,D
1928-04-07,1927,Everton,Bury,1-1,1,1,1,1,2,0,D
1928-04-07,1927,Huddersfield Town,Liverpool,2-4,2,4,1,1,6,-2,A
1928-04-07,1927,Manchester United,Burnley,4-3,4,3,1,1,7,1,H
1928-04-07,1927,Middlesbrough,West Ham United,2-2,2,2,1,1,4,0,D
1928-04-07,1927,Newcastle United,Leicester City,1-5,1,5,1,1,6,-4,A
1928-04-07,1927,Sheffield Wednesday,Derby County,2-2,2,2,1,1,4,0,D
1928-04-07,1927,Tottenham Hotspur,Arsenal,2-0,2,0,1,1,2,2,H
1928-04-09,1927,Aston Villa,West Ham United,1-0,1,0,1,1,1,1,H
1928-04-09,1927,Cardiff City,Arsenal,2-2,2,2,1,1,4,0,D
1928-04-09,1927,Derby County,Sunderland,1-0,1,0,1,1,1,1,H
1928-04-09,1927,Huddersfield Town,Birmingham City,2-0,2,0,1,1,2,2,H
1928-04-09,1927,Leicester City,Bury,2-2,2,2,1,1,4,0,D
1928-04-09,1927,Manchester United,Bolton Wanderers,2-1,2,1,1,1,3,1,H
1928-04-09,1927,Portsmouth,Sheffield United,4-1,4,1,1,1,5,3,H
1928-04-10,1927,Birmingham City,Newcastle United,0-2,0,2,1,1,2,-2,A
1928-04-10,1927,Huddersfield Town,Middlesbrough,2-4,2,4,1,1,6,-2,A
1928-04-10,1927,Sheffield Wednesday,Tottenham Hotspur,4-2,4,2,1,1,6,2,H
1928-04-14,1927,Arsenal,Huddersfield Town,0-0,0,0,1,1,0,0,D
1928-04-14,1927,Aston Villa,Cardiff City,3-1,3,1,1,1,4,2,H
1928-04-14,1927,Burnley,Tottenham Hotspur,2-2,2,2,1,1,4,0,D
1928-04-14,1927,Bury,Manchester United,4-3,4,3,1,1,7,1,H
1928-04-14,1927,Derby County,Bolton Wanderers,1-0,1,0,1,1,1,1,H
1928-04-14,1927,Leicester City,Birmingham City,3-0,3,0,1,1,3,3,H
1928-04-14,1927,Liverpool,Newcastle United,0-0,0,0,1,1,0,0,D
1928-04-14,1927,Portsmouth,Middlesbrough,4-1,4,1,1,1,5,3,H
1928-04-14,1927,Sheffield United,Everton,1-3,1,3,1,1,4,-2,A
1928-04-14,1927,Sunderland,Blackburn Rovers,1-0,1,0,1,1,1,1,H
1928-04-14,1927,West Ham United,Sheffield Wednesday,1-2,1,2,1,1,3,-1,A
1928-04-16,1927,Sheffield United,Sunderland,5-1,5,1,1,1,6,4,H
1928-04-18,1927,Everton,Newcastle United,3-0,3,0,1,1,3,3,H
1928-04-18,1927,Middlesbrough,Arsenal,2-2,2,2,1,1,4,0,D
1928-04-21,1927,Birmingham City,Liverpool,2-0,2,0,1,1,2,2,H
1928-04-21,1927,Bolton Wanderers,West Ham United,4-0,4,0,1,1,4,4,H
1928-04-21,1927,Cardiff City,Sunderland,3-1,3,1,1,1,4,2,H
1928-04-21,1927,Everton,Aston Villa,3-2,3,2,1,1,5,1,H
1928-04-21,1927,Manchester United,Sheffield United,2-3,2,3,1,1,5,-1,A
1928-04-21,1927,Middlesbrough,Leicester City,1-1,1,1,1,1,2,0,D
1928-04-21,1927,Newcastle United,Arsenal,1-1,1,1,1,1,2,0,D
1928-04-21,1927,Sheffield Wednesday,Portsmouth,2-0,2,0,1,1,2,2,H
1928-04-21,1927,Tottenham Hotspur,Bury,1-4,1,4,1,1,5,-3,A
1928-04-23,1927,Sheffield United,Newcastle United,1-1,1,1,1,1,2,0,D
1928-04-24,1927,Blackburn Rovers,Portsmouth,6-0,6,0,1,1,6,6,H
1928-04-25,1927,Huddersfield Town,Burnley,1-2,1,2,1,1,3,-1,A
1928-04-25,1927,Liverpool,Leicester City,1-1,1,1,1,1,2,0,D
1928-04-25,1927,Manchester United,Sunderland,2-1,2,1,1,1,3,1,H
1928-04-26,1927,Blackburn Rovers,Derby County,3-2,3,2,1,1,5,1,H
1928-04-28,1927,Arsenal,Manchester United,0-1,0,1,1,1,1,-1,A
1928-04-28,1927,Aston Villa,Bolton Wanderers,2-2,2,2,1,1,4,0,D
1928-04-28,1927,Burnley,Everton,3-5,3,5,1,1,8,-2,A
1928-04-28,1927,Bury,Cardiff City,3-0,3,0,1,1,3,3,H
1928-04-28,1927,Derby County,Middlesbrough,2-1,2,1,1,1,3,1,H
1928-04-28,1927,Leicester City,Huddersfield Town,1-2,1,2,1,1,3,-1,A
1928-04-28,1927,Liverpool,Tottenham Hotspur,2-0,2,0,1,1,2,2,H
1928-04-28,1927,Portsmouth,Newcastle United,0-1,0,1,1,1,1,-1,A
1928-04-28,1927,Sheffield United,Blackburn Rovers,2-3,2,3,1,1,5,-1,A
1928-04-28,1927,Sunderland,Sheffield Wednesday,2-3,2,3,1,1,5,-1,A
1928-04-28,1927,West Ham United,Birmingham City,3-3,3,3,1,1,6,0,D
1928-04-30,1927,Huddersfield Town,Sheffield United,0-1,0,1,1,1,1,-1,A
1928-04-30,1927,Leicester City,Blackburn Rovers,6-0,6,0,1,1,6,6,H
1928-05-02,1927,Arsenal,Sheffield Wednesday,1-1,1,1,1,1,2,0,D
1928-05-02,1927,Aston Villa,Huddersfield Town,3-0,3,0,1,1,3,3,H
1928-05-05,1927,Birmingham City,Derby County,2-1,2,1,1,1,3,1,H
1928-05-05,1927,Blackburn Rovers,Bury,0-1,0,1,1,1,1,-1,A
1928-05-05,1927,Bolton Wanderers,Sheffield United,1-1,1,1,1,1,2,0,D
1928-05-05,1927,Cardiff City,Burnley,3-2,3,2,1,1,5,1,H
1928-05-05,1927,Everton,Arsenal,3-3,3,3,1,1,6,0,D
1928-05-05,1927,Huddersfield Town,Portsmouth,4-1,4,1,1,1,5,3,H
1928-05-05,1927,Manchester United,Liverpool,6-1,6,1,1,1,7,5,H
1928-05-05,1927,Middlesbrough,Sunderland,0-3,0,3,1,1,3,-3,A
1928-05-05,1927,Newcastle United,West Ham United,3-1,3,1,1,1,4,2,H
1928-05-05,1927,Sheffield Wednesday,Aston Villa,2-0,2,0,1,1,2,2,H
1928-08-25,1928,Birmingham City,Manchester City,4-1,4,1,1,1,5,3,H
1928-08-25,1928,Bolton Wanderers,Everton,2-3,2,3,1,1,5,-1,A
1928-08-25,1928,Burnley,Sunderland,3-1,3,1,1,1,4,2,H
1928-08-25,1928,Derby County,Blackburn Rovers,5-1,5,1,1,1,6,4,H
1928-08-25,1928,Leeds United,Aston Villa,4-1,4,1,1,1,5,3,H
1928-08-25,1928,Liverpool,Bury,3-0,3,0,1,1,3,3,H
1928-08-25,1928,Manchester United,Leicester City,1-1,1,1,1,1,2,0,D
1928-08-25,1928,Newcastle United,Cardiff City,1-1,1,1,1,1,2,0,D
1928-08-25,1928,Portsmouth,Huddersfield Town,1-0,1,0,1,1,1,1,H
1928-08-25,1928,Sheffield Wednesday,Arsenal,3-2,3,2,1,1,5,1,H
1928-08-25,1928,West Ham United,Sheffield United,4-0,4,0,1,1,4,4,H
1928-08-27,1928,Aston Villa,Manchester United,0-0,0,0,1,1,0,0,D
1928-08-27,1928,Huddersfield Town,Bolton Wanderers,4-1,4,1,1,1,5,3,H
1928-08-27,1928,Leeds United,Bury,3-1,3,1,1,1,4,2,H
1928-08-27,1928,Leicester City,Birmingham City,5-3,5,3,1,1,8,2,H
1928-08-29,1928,Arsenal,Derby County,1-3,1,3,1,1,4,-2,A
1928-08-29,1928,Everton,Sheffield Wednesday,0-0,0,0,1,1,0,0,D
1928-08-29,1928,Newcastle United,Burnley,2-7,2,7,1,1,9,-5,A
1928-08-29,1928,Sunderland,Blackburn Rovers,3-1,3,1,1,1,4,2,H
1928-09-01,1928,Arsenal,Bolton Wanderers,2-0,2,0,1,1,2,2,H
1928-09-01,1928,Aston Villa,Liverpool,3-1,3,1,1,1,4,2,H
1928-09-01,1928,Blackburn Rovers,Sheffield Wednesday,4-1,4,1,1,1,5,3,H
1928-09-01,1928,Bury,West Ham United,0-3,0,3,1,1,3,-3,A
1928-09-01,1928,Cardiff City,Burnley,7-0,7,0,1,1,7,7,H
1928-09-01,1928,Everton,Portsmouth,4-0,4,0,1,1,4,4,H
1928-09-01,1928,Huddersfield Town,Birmingham City,0-0,0,0,1,1,0,0,D
1928-09-01,1928,Leicester City,Leeds United,4-4,4,4,1,1,8,0,D
1928-09-01,1928,Manchester City,Manchester United,2-2,2,2,1,1,4,0,D
1928-09-01,1928,Sheffield United,Newcastle United,3-1,3,1,1,1,4,2,H
1928-09-01,1928,Sunderland,Derby County,4-0,4,0,1,1,4,4,H
1928-09-03,1928,Bolton Wanderers,Huddersfield Town,1-1,1,1,1,1,2,0,D
1928-09-03,1928,Burnley,West Ham United,3-3,3,3,1,1,6,0,D
1928-09-03,1928,Sheffield Wednesday,Everton,1-0,1,0,1,1,1,1,H
1928-09-05,1928,Liverpool,Sheffield United,1-2,1,2,1,1,3,-1,A
1928-09-05,1928,Portsmouth,Manchester City,1-0,1,0,1,1,1,1,H
1928-09-08,1928,Birmingham City,Everton,1-3,1,3,1,1,4,-2,A
1928-09-08,1928,Bolton Wanderers,Blackburn Rovers,0-3,0,3,1,1,3,-3,A
1928-09-08,1928,Burnley,Sheffield United,2-1,2,1,1,1,3,1,H
1928-09-08,1928,Derby County,Cardiff City,2-0,2,0,1,1,2,2,H
1928-09-08,1928,Leeds United,Manchester United,3-2,3,2,1,1,5,1,H
1928-09-08,1928,Liverpool,Leicester City,6-3,6,3,1,1,9,3,H
1928-09-08,1928,Manchester City,Huddersfield Town,3-2,3,2,1,1,5,1,H
1928-09-08,1928,Newcastle United,Bury,2-1,2,1,1,1,3,1,H
1928-09-08,1928,Portsmouth,Arsenal,2-0,2,0,1,1,2,2,H
1928-09-08,1928,Sheffield Wednesday,Sunderland,2-1,2,1,1,1,3,1,H
1928-09-08,1928,West Ham United,Aston Villa,4-1,4,1,1,1,5,3,H
1928-09-10,1928,Birmingham City,Leicester City,1-0,1,0,1,1,1,1,H
1928-09-10,1928,Burnley,Newcastle United,4-3,4,3,1,1,7,1,H
1928-09-10,1928,Cardiff City,West Ham United,3-2,3,2,1,1,5,1,H
1928-09-10,1928,Sheffield United,Liverpool,1-3,1,3,1,1,4,-2,A
1928-09-15,1928,Arsenal,Birmingham City,0-0,0,0,1,1,0,0,D
1928-09-15,1928,Aston Villa,Newcastle United,1-1,1,1,1,1,2,0,D
1928-09-15,1928,Blackburn Rovers,Portsmouth,4-0,4,0,1,1,4,4,H
1928-09-15,1928,Bury,Burnley,2-1,2,1,1,1,3,1,H
1928-09-15,1928,Derby County,Sheffield Wednesday,6-0,6,0,1,1,6,6,H
1928-09-15,1928,Everton,Manchester City,2-6,2,6,1,1,8,-4,A
1928-09-15,1928,Huddersfield Town,Leeds United,6-1,6,1,1,1,7,5,H
1928-09-15,1928,Leicester City,West Ham United,5-0,5,0,1,1,5,5,H
1928-09-15,1928,Manchester United,Liverpool,2-2,2,2,1,1,4,0,D
1928-09-15,1928,Sheffield United,Cardiff City,3-1,3,1,1,1,4,2,H
1928-09-15,1928,Sunderland,Bolton Wanderers,4-0,4,0,1,1,4,4,H
1928-09-17,1928,Blackburn Rovers,Sunderland,2-0,2,0,1,1,2,2,H
1928-09-17,1928,West Ham United,Cardiff City,1-1,1,1,1,1,2,0,D
1928-09-22,1928,Birmingham City,Blackburn Rovers,4-0,4,0,1,1,4,4,H
1928-09-22,1928,Bolton Wanderers,Derby County,3-0,3,0,1,1,3,3,H
1928-09-22,1928,Burnley,Aston Villa,4-1,4,1,1,1,5,3,H
1928-09-22,1928,Cardiff City,Bury,4-0,4,0,1,1,4,4,H
1928-09-22,1928,Huddersfield Town,Everton,3-1,3,1,1,1,4,2,H
1928-09-22,1928,Liverpool,Leeds United,1-1,1,1,1,1,2,0,D
1928-09-22,1928,Manchester City,Arsenal,4-1,4,1,1,1,5,3,H
1928-09-22,1928,Newcastle United,Leicester City,1-0,1,0,1,1,1,1,H
1928-09-22,1928,Portsmouth,Sunderland,4-0,4,0,1,1,4,4,H
1928-09-22,1928,Sheffield Wednesday,Sheffield United,5-2,5,2,1,1,7,3,H
1928-09-22,1928,West Ham United,Manchester United,3-1,3,1,1,1,4,2,H
1928-09-24,1928,Blackburn Rovers,Newcastle United,2-0,2,0,1,1,2,2,H
1928-09-26,1928,Derby County,Arsenal,0-0,0,0,1,1,0,0,D
1928-09-29,1928,Arsenal,Huddersfield Town,2-0,2,0,1,1,2,2,H
1928-09-29,1928,Aston Villa,Cardiff City,1-0,1,0,1,1,1,1,H
1928-09-29,1928,Blackburn Rovers,Manchester City,2-2,2,2,1,1,4,0,D
1928-09-29,1928,Bury,Sheffield United,4-0,4,0,1,1,4,4,H
1928-09-29,1928,Derby County,Portsmouth,1-0,1,0,1,1,1,1,H
1928-09-29,1928,Everton,Liverpool,1-0,1,0,1,1,1,1,H
1928-09-29,1928,Leeds United,West Ham United,4-1,4,1,1,1,5,3,H
1928-09-29,1928,Leicester City,Burnley,1-1,1,1,1,1,2,0,D
1928-09-29,1928,Manchester United,Newcastle United,5-0,5,0,1,1,5,5,H
1928-09-29,1928,Sheffield Wednesday,Bolton Wanderers,0-0,0,0,1,1,0,0,D
1928-09-29,1928,Sunderland,Birmingham City,3-4,3,4,1,1,7,-1,A
1928-10-01,1928,Manchester City,Portsmouth,2-1,2,1,1,1,3,1,H
1928-10-06,1928,Birmingham City,Derby County,1-4,1,4,1,1,5,-3,A
1928-10-06,1928,Bolton Wanderers,Bury,0-1,0,1,1,1,1,-1,A
1928-10-06,1928,Burnley,Manchester United,3-4,3,4,1,1,7,-1,A
1928-10-06,1928,Cardiff City,Leicester City,1-2,1,2,1,1,3,-1,A
1928-10-06,1928,Everton,Arsenal,4-2,4,2,1,1,6,2,H
1928-10-06,1928,Huddersfield Town,Blackburn Rovers,0-2,0,2,1,1,2,-2,A
1928-10-06,1928,Manchester City,Sunderland,5-3,5,3,1,1,8,2,H
1928-10-06,1928,Newcastle United,Leeds United,3-2,3,2,1,1,5,1,H
1928-10-06,1928,Portsmouth,Sheffield Wednesday,3-2,3,2,1,1,5,1,H
1928-10-06,1928,Sheffield United,Aston Villa,1-3,1,3,1,1,4,-2,A
1928-10-06,1928,West Ham United,Liverpool,1-1,1,1,1,1,2,0,D
1928-10-13,1928,Arsenal,West Ham United,2-3,2,3,1,1,5,-1,A
1928-10-13,1928,Aston Villa,Bury,7-1,7,1,1,1,8,6,H
1928-10-13,1928,Blackburn Rovers,Everton,2-1,2,1,1,1,3,1,H
1928-10-13,1928,Bolton Wanderers,Portsmouth,4-2,4,2,1,1,6,2,H
1928-10-13,1928,Derby County,Manchester City,1-1,1,1,1,1,2,0,D
1928-10-13,1928,Leeds United,Burnley,2-1,2,1,1,1,3,1,H
1928-10-13,1928,Leicester City,Sheffield United,3-1,3,1,1,1,4,2,H
1928-10-13,1928,Liverpool,Newcastle United,2-1,2,1,1,1,3,1,H
1928-10-13,1928,Manchester United,Cardiff City,1-1,1,1,1,1,2,0,D
1928-10-13,1928,Sheffield Wednesday,Birmingham City,3-0,3,0,1,1,3,3,H
1928-10-13,1928,Sunderland,Huddersfield Town,4-1,4,1,1,1,5,3,H
1928-10-20,1928,Aston Villa,Bolton Wanderers,3-5,3,5,1,1,8,-2,A
1928-10-20,1928,Burnley,Blackburn Rovers,2-2,2,2,1,1,4,0,D
1928-10-20,1928,Bury,Sheffield Wednesday,0-4,0,4,1,1,4,-4,A
1928-10-20,1928,Cardiff City,Sunderland,0-1,0,1,1,1,1,-1,A
1928-10-20,1928,Leeds United,Manchester City,4-1,4,1,1,1,5,3,H
1928-10-20,1928,Leicester City,Portsmouth,10-0,10,0,1,1,10,10,H
1928-10-20,1928,Liverpool,Huddersfield Town,2-3,2,3,1,1,5,-1,A
1928-10-20,1928,Manchester United,Birmingham City,1-0,1,0,1,1,1,1,H
1928-10-20,1928,Newcastle United,Arsenal,0-3,0,3,1,1,3,-3,A
1928-10-20,1928,Sheffield United,Derby County,2-1,2,1,1,1,3,1,H
1928-10-20,1928,West Ham United,Everton,2-4,2,4,1,1,6,-2,A
1928-10-27,1928,Arsenal,Liverpool,4-4,4,4,1,1,8,0,D
1928-10-27,1928,Birmingham City,Aston Villa,2-4,2,4,1,1,6,-2,A
1928-10-27,1928,Blackburn Rovers,West Ham United,2-0,2,0,1,1,2,2,H
1928-10-27,1928,Bolton Wanderers,Sheffield United,3-1,3,1,1,1,4,2,H
1928-10-27,1928,Derby County,Burnley,4-0,4,0,1,1,4,4,H
1928-10-27,1928,Everton,Leeds United,0-1,0,1,1,1,1,-1,A
1928-10-27,1928,Huddersfield Town,Manchester United,1-2,1,2,1,1,3,-1,A
1928-10-27,1928,Manchester City,Leicester City,2-3,2,3,1,1,5,-1,A
1928-10-27,1928,Portsmouth,Bury,4-1,4,1,1,1,5,3,H
1928-10-27,1928,Sheffield Wednesday,Cardiff City,1-0,1,0,1,1,1,1,H
1928-10-27,1928,Sunderland,Newcastle United,5-2,5,2,1,1,7,3,H
1928-11-03,1928,Aston Villa,Derby County,2-3,2,3,1,1,5,-1,A
1928-11-03,1928,Burnley,Everton,2-0,2,0,1,1,2,2,H
1928-11-03,1928,Bury,Sunderland,1-3,1,3,1,1,4,-2,A
1928-11-03,1928,Cardiff City,Arsenal,1-1,1,1,1,1,2,0,D
1928-11-03,1928,Leeds United,Portsmouth,3-2,3,2,1,1,5,1,H
1928-11-03,1928,Leicester City,Sheffield Wednesday,1-1,1,1,1,1,2,0,D
1928-11-03,1928,Liverpool,Birmingham City,1-2,1,2,1,1,3,-1,A
1928-11-03,1928,Manchester United,Bolton Wanderers,1-1,1,1,1,1,2,0,D
1928-11-03,1928,Newcastle United,Huddersfield Town,4-1,4,1,1,1,5,3,H
1928-11-03,1928,Sheffield United,Blackburn Rovers,2-1,2,1,1,1,3,1,H
1928-11-03,1928,West Ham United,Manchester City,3-0,3,0,1,1,3,3,H
1928-11-10,1928,Arsenal,Sheffield United,2-0,2,0,1,1,2,2,H
1928-11-10,1928,Birmingham City,West Ham United,2-2,2,2,1,1,4,0,D
1928-11-10,1928,Blackburn Rovers,Bury,1-1,1,1,1,1,2,0,D
1928-11-10,1928,Bolton Wanderers,Leeds United,4-1,4,1,1,1,5,3,H
1928-11-10,1928,Derby County,Leicester City,5-2,5,2,1,1,7,3,H
1928-11-10,1928,Everton,Cardiff City,1-0,1,0,1,1,1,1,H
1928-11-10,1928,Huddersfield Town,Burnley,7-1,7,1,1,1,8,6,H
1928-11-10,1928,Manchester City,Newcastle United,2-4,2,4,1,1,6,-2,A
1928-11-10,1928,Portsmouth,Liverpool,0-1,0,1,1,1,1,-1,A
1928-11-10,1928,Sheffield Wednesday,Manchester United,2-1,2,1,1,1,3,1,H
1928-11-10,1928,Sunderland,Aston Villa,1-3,1,3,1,1,4,-2,A
1928-11-17,1928,Aston Villa,Blackburn Rovers,2-1,2,1,1,1,3,1,H
1928-11-17,1928,Burnley,Manchester City,2-3,2,3,1,1,5,-1,A
1928-11-17,1928,Bury,Arsenal,1-0,1,0,1,1,1,1,H
1928-11-17,1928,Cardiff City,Huddersfield Town,0-0,0,0,1,1,0,0,D
1928-11-17,1928,Leeds United,Sheffield Wednesday,0-2,0,2,1,1,2,-2,A
1928-11-17,1928,Leicester City,Sunderland,1-0,1,0,1,1,1,1,H
1928-11-17,1928,Liverpool,Bolton Wanderers,3-0,3,0,1,1,3,3,H
1928-11-17,1928,Manchester United,Derby County,0-1,0,1,1,1,1,-1,A
1928-11-17,1928,Newcastle United,Birmingham City,1-0,1,0,1,1,1,1,H
1928-11-17,1928,Sheffield United,Everton,2-1,2,1,1,1,3,1,H
1928-11-17,1928,West Ham United,Portsmouth,0-1,0,1,1,1,1,-1,A
1928-11-24,1928,Arsenal,Aston Villa,2-5,2,5,1,1,7,-3,A
1928-11-24,1928,Birmingham City,Burnley,3-6,3,6,1,1,9,-3,A
1928-11-24,1928,Blackburn Rovers,Leicester City,1-1,1,1,1,1,2,0,D
1928-11-24,1928,Bolton Wanderers,West Ham United,4-1,4,1,1,1,5,3,H
1928-11-24,1928,Derby County,Leeds United,3-4,3,4,1,1,7,-1,A
1928-11-24,1928,Everton,Bury,1-0,1,0,1,1,1,1,H
1928-11-24,1928,Huddersfield Town,Sheffield United,6-1,6,1,1,1,7,5,H
1928-11-24,1928,Manchester City,Cardiff City,1-1,1,1,1,1,2,0,D
1928-11-24,1928,Portsmouth,Newcastle United,0-1,0,1,1,1,1,-1,A
1928-11-24,1928,Sheffield Wednesday,Liverpool,3-2,3,2,1,1,5,1,H
1928-11-24,1928,Sunderland,Manchester United,5-1,5,1,1,1,6,4,H
1928-12-01,1928,Aston Villa,Everton,2-0,2,0,1,1,2,2,H
1928-12-01,1928,Burnley,Portsmouth,4-1,4,1,1,1,5,3,H
1928-12-01,1928,Bury,Huddersfield Town,2-1,2,1,1,1,3,1,H
1928-12-01,1928,Cardiff City,Birmingham City,1-4,1,4,1,1,5,-3,A
1928-12-01,1928,Leeds United,Sunderland,0-3,0,3,1,1,3,-3,A
1928-12-01,1928,Leicester City,Arsenal,1-1,1,1,1,1,2,0,D
1928-12-01,1928,Liverpool,Derby County,3-0,3,0,1,1,3,3,H
1928-12-01,1928,Manchester United,Blackburn Rovers,1-4,1,4,1,1,5,-3,A
1928-12-01,1928,Newcastle United,Bolton Wanderers,4-1,4,1,1,1,5,3,H
1928-12-01,1928,Sheffield United,Manchester City,1-3,1,3,1,1,4,-2,A
1928-12-01,1928,West Ham United,Sheffield Wednesday,3-2,3,2,1,1,5,1,H
1928-12-08,1928,Arsenal,Manchester United,3-1,3,1,1,1,4,2,H
1928-12-08,1928,Birmingham City,Sheffield United,2-2,2,2,1,1,4,0,D
1928-12-08,1928,Blackburn Rovers,Leeds United,0-1,0,1,1,1,1,-1,A
1928-12-08,1928,Bolton Wanderers,Burnley,0-1,0,1,1,1,1,-1,A
1928-12-08,1928,Derby County,West Ham United,6-0,6,0,1,1,6,6,H
1928-12-08,1928,Everton,Leicester City,3-1,3,1,1,1,4,2,H
1928-12-08,1928,Huddersfield Town,Aston Villa,3-0,3,0,1,1,3,3,H
1928-12-08,1928,Portsmouth,Cardiff City,0-1,0,1,1,1,1,-1,A
1928-12-08,1928,Sheffield Wednesday,Newcastle United,3-1,3,1,1,1,4,2,H
1928-12-08,1928,Sunderland,Liverpool,2-1,2,1,1,1,3,1,H
1928-12-15,1928,Burnley,Sheffield Wednesday,0-2,0,2,1,1,2,-2,A
1928-12-15,1928,Cardiff City,Bolton Wanderers,1-1,1,1,1,1,2,0,D
1928-12-15,1928,Leeds United,Arsenal,1-1,1,1,1,1,2,0,D
1928-12-15,1928,Leicester City,Huddersfield Town,4-1,4,1,1,1,5,3,H
1928-12-15,1928,Liverpool,Blackburn Rovers,1-1,1,1,1,1,2,0,D
1928-12-15,1928,Manchester United,Everton,1-1,1,1,1,1,2,0,D
1928-12-15,1928,Newcastle United,Derby County,4-1,4,1,1,1,5,3,H
1928-12-15,1928,Sheffield United,Portsmouth,3-0,3,0,1,1,3,3,H
1928-12-15,1928,West Ham United,Sunderland,3-3,3,3,1,1,6,0,D
1928-12-19,1928,Aston Villa,Manchester City,5-1,5,1,1,1,6,4,H
1928-12-22,1928,Arsenal,Burnley,3-1,3,1,1,1,4,2,H
1928-12-22,1928,Birmingham City,Leeds United,5-1,5,1,1,1,6,4,H
1928-12-22,1928,Blackburn Rovers,Cardiff City,2-0,2,0,1,1,2,2,H
1928-12-22,1928,Bolton Wanderers,Leicester City,5-0,5,0,1,1,5,5,H
1928-12-22,1928,Derby County,Bury,3-1,3,1,1,1,4,2,H
1928-12-22,1928,Everton,Newcastle United,5-2,5,2,1,1,7,3,H
1928-12-22,1928,Huddersfield Town,West Ham United,4-0,4,0,1,1,4,4,H
1928-12-22,1928,Manchester City,Liverpool,2-3,2,3,1,1,5,-1,A
1928-12-22,1928,Portsmouth,Manchester United,3-0,3,0,1,1,3,3,H
1928-12-22,1928,Sheffield Wednesday,Aston Villa,4-1,4,1,1,1,5,3,H
1928-12-22,1928,Sunderland,Sheffield United,4-4,4,4,1,1,8,0,D
1928-12-25,1928,Birmingham City,Bolton Wanderers,0-2,0,2,1,1,2,-2,A
1928-12-25,1928,Blackburn Rovers,Arsenal,5-2,5,2,1,1,7,3,H
1928-12-25,1928,Burnley,Liverpool,3-2,3,2,1,1,5,1,H
1928-12-25,1928,Bury,Leicester City,3-1,3,1,1,1,4,2,H
1928-12-25,1928,Everton,Sunderland,0-0,0,0,1,1,0,0,D
1928-12-25,1928,Huddersfield Town,Derby County,0-0,0,0,1,1,0,0,D
1928-12-25,1928,Leeds United,Cardiff City,3-0,3,0,1,1,3,3,H
1928-12-25,1928,Manchester United,Sheffield United,1-1,1,1,1,1,2,0,D
1928-12-25,1928,Portsmouth,Aston Villa,3-2,3,2,1,1,5,1,H
1928-12-25,1928,Sheffield Wednesday,Manchester City,4-0,4,0,1,1,4,4,H
1928-12-25,1928,West Ham United,Newcastle United,1-0,1,0,1,1,1,1,H
1928-12-26,1928,Arsenal,Sunderland,1-1,1,1,1,1,2,0,D
1928-12-26,1928,Aston Villa,Portsmouth,3-2,3,2,1,1,5,1,H
1928-12-26,1928,Bolton Wanderers,Birmingham City,6-2,6,2,1,1,8,4,H
1928-12-26,1928,Cardiff City,Leeds United,2-1,2,1,1,1,3,1,H
1928-12-26,1928,Derby County,Huddersfield Town,1-2,1,2,1,1,3,-1,A
1928-12-26,1928,Leicester City,Bury,5-2,5,2,1,1,7,3,H
1928-12-26,1928,Liverpool,Burnley,8-0,8,0,1,1,8,8,H
1928-12-26,1928,Manchester City,Sheffield Wednesday,2-2,2,2,1,1,4,0,D
1928-12-26,1928,Newcastle United,West Ham United,1-0,1,0,1,1,1,1,H
1928-12-26,1928,Sheffield United,Manchester United,6-1,6,1,1,1,7,5,H
1928-12-29,1928,Arsenal,Sheffield Wednesday,2-2,2,2,1,1,4,0,D
1928-12-29,1928,Aston Villa,Leeds United,1-0,1,0,1,1,1,1,H
1928-12-29,1928,Blackburn Rovers,Derby County,3-1,3,1,1,1,4,2,H
1928-12-29,1928,Bury,Liverpool,2-2,2,2,1,1,4,0,D
1928-12-29,1928,Cardiff City,Newcastle United,2-0,2,0,1,1,2,2,H
1928-12-29,1928,Everton,Bolton Wanderers,3-0,3,0,1,1,3,3,H
1928-12-29,1928,Huddersfield Town,Portsmouth,3-1,3,1,1,1,4,2,H
1928-12-29,1928,Leicester City,Manchester United,2-1,2,1,1,1,3,1,H
1928-12-29,1928,Manchester City,Birmingham City,2-3,2,3,1,1,5,-1,A
1928-12-29,1928,Sheffield United,West Ham United,3-3,3,3,1,1,6,0,D
1928-12-29,1928,Sunderland,Burnley,2-1,2,1,1,1,3,1,H
1929-01-01,1928,Bolton Wanderers,Cardiff City,1-0,1,0,1,1,1,1,H
1929-01-01,1928,Bury,Leeds United,2-2,2,2,1,1,4,0,D
1929-01-01,1928,Everton,Derby County,4-0,4,0,1,1,4,4,H
1929-01-01,1928,Manchester United,Aston Villa,2-2,2,2,1,1,4,0,D
1929-01-01,1928,Newcastle United,Blackburn Rovers,0-2,0,2,1,1,2,-2,A
1929-01-01,1928,Sheffield Wednesday,Huddersfield Town,1-1,1,1,1,1,2,0,D
1929-01-01,1928,Sunderland,Arsenal,5-1,5,1,1,1,6,4,H
1929-01-05,1928,Birmingham City,Huddersfield Town,1-2,1,2,1,1,3,-1,A
1929-01-05,1928,Bolton Wanderers,Arsenal,1-2,1,2,1,1,3,-1,A
1929-01-05,1928,Burnley,Cardiff City,3-0,3,0,1,1,3,3,H
1929-01-05,1928,Derby County,Sunderland,0-0,0,0,1,1,0,0,D
1929-01-05,1928,Leeds United,Leicester City,4-3,4,3,1,1,7,1,H
1929-01-05,1928,Liverpool,Aston Villa,4-0,4,0,1,1,4,4,H
1929-01-05,1928,Manchester United,Manchester City,1-2,1,2,1,1,3,-1,A
1929-01-05,1928,Newcastle United,Sheffield United,4-2,4,2,1,1,6,2,H
1929-01-05,1928,Portsmouth,Everton,3-0,3,0,1,1,3,3,H
1929-01-05,1928,Sheffield Wednesday,Blackburn Rovers,1-0,1,0,1,1,1,1,H
1929-01-05,1928,West Ham United,Bury,2-3,2,3,1,1,5,-1,A
1929-01-19,1928,Arsenal,Portsmouth,4-0,4,0,1,1,4,4,H
1929-01-19,1928,Aston Villa,West Ham United,5-2,5,2,1,1,7,3,H
1929-01-19,1928,Blackburn Rovers,Bolton Wanderers,1-3,1,3,1,1,4,-2,A
1929-01-19,1928,Bury,Newcastle United,2-0,2,0,1,1,2,2,H
1929-01-19,1928,Cardiff City,Derby County,3-0,3,0,1,1,3,3,H
1929-01-19,1928,Everton,Birmingham City,0-2,0,2,1,1,2,-2,A
1929-01-19,1928,Huddersfield Town,Manchester City,2-2,2,2,1,1,4,0,D
1929-01-19,1928,Leicester City,Liverpool,2-0,2,0,1,1,2,2,H
1929-01-19,1928,Manchester United,Leeds United,1-2,1,2,1,1,3,-1,A
1929-01-19,1928,Sheffield United,Burnley,10-0,10,0,1,1,10,10,H
1929-01-19,1928,Sunderland,Sheffield Wednesday,4-3,4,3,1,1,7,1,H
1929-01-26,1928,Cardiff City,Sheffield United,0-0,0,0,1,1,0,0,D
1929-01-26,1928,Manchester City,Everton,5-1,5,1,1,1,6,4,H
1929-01-30,1928,Manchester City,Bury,6-4,6,4,1,1,10,2,H
1929-02-02,1928,Arsenal,Manchester City,0-0,0,0,1,1,0,0,D
1929-02-02,1928,Aston Villa,Burnley,4-2,4,2,1,1,6,2,H
1929-02-02,1928,Blackburn Rovers,Birmingham City,4-1,4,1,1,1,5,3,H
1929-02-02,1928,Bury,Cardiff City,4-1,4,1,1,1,5,3,H
1929-02-02,1928,Derby County,Bolton Wanderers,2-1,2,1,1,1,3,1,H
1929-02-02,1928,Everton,Huddersfield Town,0-3,0,3,1,1,3,-3,A
1929-02-02,1928,Leeds United,Liverpool,2-2,2,2,1,1,4,0,D
1929-02-02,1928,Leicester City,Newcastle United,1-1,1,1,1,1,2,0,D
1929-02-02,1928,Manchester United,West Ham United,2-3,2,3,1,1,5,-1,A
1929-02-02,1928,Sheffield United,Sheffield Wednesday,1-1,1,1,1,1,2,0,D
1929-02-02,1928,Sunderland,Portsmouth,5-0,5,0,1,1,5,5,H
1929-02-09,1928,Birmingham City,Sunderland,1-0,1,0,1,1,1,1,H
1929-02-09,1928,Bolton Wanderers,Sheffield Wednesday,2-2,2,2,1,1,4,0,D
1929-02-09,1928,Burnley,Leicester City,0-1,0,1,1,1,1,-1,A
1929-02-09,1928,Cardiff City,Aston Villa,0-2,0,2,1,1,2,-2,A
1929-02-09,1928,Huddersfield Town,Arsenal,0-1,0,1,1,1,1,-1,A
1929-02-09,1928,Liverpool,Everton,1-2,1,2,1,1,3,-1,A
1929-02-09,1928,Manchester City,Blackburn Rovers,1-2,1,2,1,1,3,-1,A
1929-02-09,1928,Newcastle United,Manchester United,5-0,5,0,1,1,5,5,H
1929-02-09,1928,Portsmouth,Derby County,1-5,1,5,1,1,6,-4,A
1929-02-09,1928,Sheffield United,Bury,6-1,6,1,1,1,7,5,H
1929-02-09,1928,West Ham United,Leeds United,8-2,8,2,1,1,10,6,H
1929-02-13,1928,Liverpool,Manchester United,2-3,2,3,1,1,5,-1,A
1929-02-16,1928,Derby County,Birmingham City,2-2,2,2,1,1,4,0,D
1929-02-16,1928,Leeds United,Newcastle United,0-0,0,0,1,1,0,0,D
1929-02-16,1928,Manchester United,Burnley,1-0,1,0,1,1,1,1,H
1929-02-16,1928,Sunderland,Manchester City,3-1,3,1,1,1,4,2,H
1929-02-18,1928,Burnley,Bury,0-0,0,0,1,1,0,0,D
1929-02-18,1928,Sheffield Wednesday,Derby County,5-0,5,0,1,1,5,5,H
1929-02-20,1928,Aston Villa,Sheffield United,3-2,3,2,1,1,5,1,H
1929-02-20,1928,Bolton Wanderers,Sunderland,2-2,2,2,1,1,4,0,D
1929-02-21,1928,Leicester City,Cardiff City,2-0,2,0,1,1,2,2,H
1929-02-23,1928,Birmingham City,Sheffield Wednesday,4-1,4,1,1,1,5,3,H
1929-02-23,1928,Burnley,Leeds United,5-0,5,0,1,1,5,5,H
1929-02-23,1928,Bury,Aston Villa,2-2,2,2,1,1,4,0,D
1929-02-23,1928,Cardiff City,Manchester United,2-2,2,2,1,1,4,0,D
1929-02-23,1928,Everton,Blackburn Rovers,5-2,5,2,1,1,7,3,H
1929-02-23,1928,Huddersfield Town,Sunderland,1-2,1,2,1,1,3,-1,A
1929-02-23,1928,Manchester City,Derby County,2-3,2,3,1,1,5,-1,A
1929-02-23,1928,Newcastle United,Liverpool,2-2,2,2,1,1,4,0,D
1929-02-23,1928,Portsmouth,Bolton Wanderers,4-4,4,4,1,1,8,0,D
1929-02-23,1928,Sheffield United,Leicester City,1-4,1,4,1,1,5,-3,A
1929-02-23,1928,West Ham United,Arsenal,3-4,3,4,1,1,7,-1,A
1929-03-02,1928,Birmingham City,Manchester United,1-1,1,1,1,1,2,0,D
1929-03-02,1928,Derby County,Sheffield United,2-2,2,2,1,1,4,0,D
1929-03-02,1928,Manchester City,Leeds United,3-0,3,0,1,1,3,3,H
1929-03-02,1928,Sheffield Wednesday,Bury,3-1,3,1,1,1,4,2,H
1929-03-02,1928,Sunderland,Cardiff City,1-0,1,0,1,1,1,1,H
1929-03-04,1928,Sheffield Wednesday,Portsmouth,2-1,2,1,1,1,3,1,H
1929-03-04,1928,West Ham United,Leicester City,2-1,2,1,1,1,3,1,H
1929-03-09,1928,Aston Villa,Birmingham City,1-2,1,2,1,1,3,-1,A
1929-03-09,1928,Burnley,Derby County,2-2,2,2,1,1,4,0,D
1929-03-09,1928,Bury,Portsmouth,0-0,0,0,1,1,0,0,D
1929-03-09,1928,Cardiff City,Sheffield Wednesday,3-1,3,1,1,1,4,2,H
1929-03-09,1928,Leeds United,Everton,3-1,3,1,1,1,4,2,H
1929-03-09,1928,Leicester City,Manchester City,3-2,3,2,1,1,5,1,H
1929-03-09,1928,Liverpool,Arsenal,2-4,2,4,1,1,6,-2,A
1929-03-09,1928,Manchester United,Huddersfield Town,1-0,1,0,1,1,1,1,H
1929-03-09,1928,Newcastle United,Sunderland,4-3,4,3,1,1,7,1,H
1929-03-09,1928,Sheffield United,Bolton Wanderers,1-1,1,1,1,1,2,0,D
1929-03-09,1928,West Ham United,Blackburn Rovers,3-3,3,3,1,1,6,0,D
1929-03-13,1928,Birmingham City,Arsenal,1-1,1,1,1,1,2,0,D
1929-03-13,1928,Liverpool,West Ham United,2-1,2,1,1,1,3,1,H
1929-03-13,1928,Newcastle United,Aston Villa,2-1,2,1,1,1,3,1,H
1929-03-13,1928,Portsmouth,Blackburn Rovers,2-2,2,2,1,1,4,0,D
1929-03-16,1928,Arsenal,Cardiff City,2-1,2,1,1,1,3,1,H
1929-03-16,1928,Birmingham City,Liverpool,0-0,0,0,1,1,0,0,D
1929-03-16,1928,Blackburn Rovers,Sheffield United,1-1,1,1,1,1,2,0,D
1929-03-16,1928,Bolton Wanderers,Manchester United,1-1,1,1,1,1,2,0,D
1929-03-16,1928,Derby County,Aston Villa,1-0,1,0,1,1,1,1,H
1929-03-16,1928,Everton,Burnley,2-0,2,0,1,1,2,2,H
1929-03-16,1928,Huddersfield Town,Newcastle United,2-1,2,1,1,1,3,1,H
1929-03-16,1928,Manchester City,West Ham United,4-2,4,2,1,1,6,2,H
1929-03-16,1928,Portsmouth,Leeds United,0-2,0,2,1,1,2,-2,A
1929-03-16,1928,Sheffield Wednesday,Leicester City,1-0,1,0,1,1,1,1,H
1929-03-16,1928,Sunderland,Bury,3-1,3,1,1,1,4,2,H
1929-03-20,1928,Bury,Birmingham City,3-1,3,1,1,1,4,2,H
1929-03-23,1928,Bury,Blackburn Rovers,1-0,1,0,1,1,1,1,H
1929-03-23,1928,Cardiff City,Everton,0-2,0,2,1,1,2,-2,A
1929-03-23,1928,Leicester City,Derby County,1-0,1,0,1,1,1,1,H
1929-03-23,1928,Manchester United,Sheffield Wednesday,2-1,2,1,1,1,3,1,H
1929-03-23,1928,Newcastle United,Manchester City,4-0,4,0,1,1,4,4,H
1929-03-23,1928,Sheffield United,Arsenal,2-2,2,2,1,1,4,0,D
1929-03-23,1928,West Ham United,Birmingham City,2-1,2,1,1,1,3,1,H
1929-03-25,1928,Aston Villa,Sunderland,3-1,3,1,1,1,4,2,H
1929-03-29,1928,Arsenal,Blackburn Rovers,1-0,1,0,1,1,1,1,H
1929-03-29,1928,Bury,Manchester United,1-3,1,3,1,1,4,-2,A
1929-03-29,1928,Liverpool,Cardiff City,2-0,2,0,1,1,2,2,H
1929-03-29,1928,Manchester City,Bolton Wanderers,5-1,5,1,1,1,6,4,H
1929-03-29,1928,Portsmouth,Birmingham City,3-1,3,1,1,1,4,2,H
1929-03-29,1928,Sunderland,Everton,2-2,2,2,1,1,4,0,D
1929-03-29,1928,West Ham United,Burnley,4-0,4,0,1,1,4,4,H
1929-03-30,1928,Arsenal,Bury,7-1,7,1,1,1,8,6,H
1929-03-30,1928,Birmingham City,Newcastle United,0-0,0,0,1,1,0,0,D
1929-03-30,1928,Blackburn Rovers,Aston Villa,2-5,2,5,1,1,7,-3,A
1929-03-30,1928,Bolton Wanderers,Liverpool,0-0,0,0,1,1,0,0,D
1929-03-30,1928,Derby County,Manchester United,6-1,6,1,1,1,7,5,H
1929-03-30,1928,Everton,Sheffield United,1-3,1,3,1,1,4,-2,A
1929-03-30,1928,Huddersfield Town,Cardiff City,1-1,1,1,1,1,2,0,D
1929-03-30,1928,Manchester City,Burnley,4-1,4,1,1,1,5,3,H
1929-03-30,1928,Portsmouth,West Ham United,3-0,3,0,1,1,3,3,H
1929-03-30,1928,Sheffield Wednesday,Leeds United,4-2,4,2,1,1,6,2,H
1929-03-30,1928,Sunderland,Leicester City,1-2,1,2,1,1,3,-1,A
1929-04-01,1928,Birmingham City,Portsmouth,1-0,1,0,1,1,1,1,H
1929-04-01,1928,Blackburn Rovers,Huddersfield Town,1-1,1,1,1,1,2,0,D
1929-04-01,1928,Bolton Wanderers,Manchester City,1-1,1,1,1,1,2,0,D
1929-04-01,1928,Cardiff City,Liverpool,1-2,1,2,1,1,3,-1,A
1929-04-01,1928,Leicester City,Aston Villa,4-1,4,1,1,1,5,3,H
1929-04-01,1928,Manchester United,Bury,1-0,1,0,1,1,1,1,H
1929-04-01,1928,Sheffield United,Leeds United,1-1,1,1,1,1,2,0,D
1929-04-02,1928,Arsenal,Newcastle United,1-2,1,2,1,1,3,-1,A
1929-04-02,1928,Aston Villa,Leicester City,4-2,4,2,1,1,6,2,H
1929-04-02,1928,Derby County,Everton,3-0,3,0,1,1,3,3,H
1929-04-02,1928,Huddersfield Town,Sheffield Wednesday,0-0,0,0,1,1,0,0,D
1929-04-02,1928,Leeds United,Sheffield United,2-0,2,0,1,1,2,2,H
1929-04-06,1928,Aston Villa,Arsenal,4-2,4,2,1,1,6,2,H
1929-04-06,1928,Burnley,Birmingham City,4-0,4,0,1,1,4,4,H
1929-04-06,1928,Bury,Everton,1-2,1,2,1,1,3,-1,A
1929-04-06,1928,Cardiff City,Manchester City,1-3,1,3,1,1,4,-2,A
1929-04-06,1928,Leeds United,Derby County,1-1,1,1,1,1,2,0,D
1929-04-06,1928,Leicester City,Blackburn Rovers,2-1,2,1,1,1,3,1,H
1929-04-06,1928,Liverpool,Sheffield Wednesday,3-2,3,2,1,1,5,1,H
1929-04-06,1928,Manchester United,Sunderland,3-0,3,0,1,1,3,3,H
1929-04-06,1928,Newcastle United,Portsmouth,0-1,0,1,1,1,1,-1,A
1929-04-06,1928,Sheffield United,Huddersfield Town,1-0,1,0,1,1,1,1,H
1929-04-06,1928,West Ham United,Bolton Wanderers,3-0,3,0,1,1,3,3,H
1929-04-10,1928,Everton,West Ham United,0-4,0,4,1,1,4,-4,A
1929-04-10,1928,Huddersfield Town,Liverpool,1-3,1,3,1,1,4,-2,A
1929-04-10,1928,Portsmouth,Leicester City,1-0,1,0,1,1,1,1,H
1929-04-13,1928,Arsenal,Leicester City,1-1,1,1,1,1,2,0,D
1929-04-13,1928,Birmingham City,Cardiff City,0-0,0,0,1,1,0,0,D
1929-04-13,1928,Blackburn Rovers,Manchester United,0-3,0,3,1,1,3,-3,A
1929-04-13,1928,Bolton Wanderers,Newcastle United,1-0,1,0,1,1,1,1,H
1929-04-13,1928,Derby County,Liverpool,2-5,2,5,1,1,7,-3,A
1929-04-13,1928,Everton,Aston Villa,0-1,0,1,1,1,1,-1,A
1929-04-13,1928,Huddersfield Town,Bury,0-2,0,2,1,1,2,-2,A
1929-04-13,1928,Manchester City,Sheffield United,3-1,3,1,1,1,4,2,H
1929-04-13,1928,Portsmouth,Burnley,3-1,3,1,1,1,4,2,H
1929-04-13,1928,Sheffield Wednesday,West Ham United,6-0,6,0,1,1,6,6,H
1929-04-13,1928,Sunderland,Leeds United,2-1,2,1,1,1,3,1,H
1929-04-16,1928,Burnley,Huddersfield Town,3-2,3,2,1,1,5,1,H
1929-04-17,1928,Bolton Wanderers,Aston Villa,3-1,3,1,1,1,4,2,H
1929-04-17,1928,Liverpool,Portsmouth,0-0,0,0,1,1,0,0,D
1929-04-20,1928,Aston Villa,Huddersfield Town,4-1,4,1,1,1,5,3,H
1929-04-20,1928,Burnley,Bolton Wanderers,3-1,3,1,1,1,4,2,H
1929-04-20,1928,Bury,Manchester City,1-2,1,2,1,1,3,-1,A
1929-04-20,1928,Cardiff City,Portsmouth,1-1,1,1,1,1,2,0,D
1929-04-20,1928,Leeds United,Blackburn Rovers,0-1,0,1,1,1,1,-1,A
1929-04-20,1928,Leicester City,Everton,4-1,4,1,1,1,5,3,H
1929-04-20,1928,Liverpool,Sunderland,5-2,5,2,1,1,7,3,H
1929-04-20,1928,Manchester United,Arsenal,4-1,4,1,1,1,5,3,H
1929-04-20,1928,Newcastle United,Sheffield Wednesday,2-1,2,1,1,1,3,1,H
1929-04-20,1928,Sheffield United,Birmingham City,3-2,3,2,1,1,5,1,H
1929-04-20,1928,West Ham United,Derby County,2-2,2,2,1,1,4,0,D
1929-04-22,1928,Arsenal,Everton,2-0,2,0,1,1,2,2,H
1929-04-27,1928,Arsenal,Leeds United,1-0,1,0,1,1,1,1,H
1929-04-27,1928,Birmingham City,Bury,3-2,3,2,1,1,5,1,H
1929-04-27,1928,Blackburn Rovers,Liverpool,2-1,2,1,1,1,3,1,H
1929-04-27,1928,Derby County,Newcastle United,1-2,1,2,1,1,3,-1,A
1929-04-27,1928,Everton,Manchester United,2-4,2,4,1,1,6,-2,A
1929-04-27,1928,Huddersfield Town,Leicester City,1-1,1,1,1,1,2,0,D
1929-04-27,1928,Manchester City,Aston Villa,3-0,3,0,1,1,3,3,H
1929-04-27,1928,Sheffield Wednesday,Burnley,1-1,1,1,1,1,2,0,D
1929-04-27,1928,Sunderland,West Ham United,4-1,4,1,1,1,5,3,H
1929-04-29,1928,Leeds United,Bolton Wanderers,2-2,2,2,1,1,4,0,D
1929-04-29,1928,Portsmouth,Sheffield United,2-3,2,3,1,1,5,-1,A
1929-05-01,1928,Bury,Bolton Wanderers,3-4,3,4,1,1,7,-1,A
1929-05-01,1928,Leeds United,Huddersfield Town,1-2,1,2,1,1,3,-1,A
1929-05-02,1928,Blackburn Rovers,Burnley,1-1,1,1,1,1,2,0,D
1929-05-04,1928,Aston Villa,Sheffield Wednesday,4-1,4,1,1,1,5,3,H
1929-05-04,1928,Burnley,Arsenal,3-3,3,3,1,1,6,0,D
1929-05-04,1928,Bury,Derby County,3-3,3,3,1,1,6,0,D
1929-05-04,1928,Cardiff City,Blackburn Rovers,1-1,1,1,1,1,2,0,D
1929-05-04,1928,Leeds United,Birmingham City,0-1,0,1,1,1,1,-1,A
1929-05-04,1928,Leicester City,Bolton Wanderers,6-1,6,1,1,1,7,5,H
1929-05-04,1928,Liverpool,Manchester City,1-1,1,1,1,1,2,0,D
1929-05-04,1928,Manchester United,Portsmouth,0-0,0,0,1,1,0,0,D
1929-05-04,1928,Newcastle United,Everton,2-0,2,0,1,1,2,2,H
1929-05-04,1928,Sheffield United,Sunderland,4-0,4,0,1,1,4,4,H
1929-05-04,1928,West Ham United,Huddersfield Town,1-1,1,1,1,1,2,0,D
1929-08-31,1929,Arsenal,Leeds United,4-0,4,0,1,1,4,4,H
1929-08-31,1929,Aston Villa,Birmingham City,2-1,2,1,1,1,3,1,H
1929-08-31,1929,Blackburn Rovers,West Ham United,3-3,3,3,1,1,6,0,D
1929-08-31,1929,Derby County,Sunderland,3-0,3,0,1,1,3,3,H
1929-08-31,1929,Everton,Bolton Wanderers,3-3,3,3,1,1,6,0,D
1929-08-31,1929,Huddersfield Town,Leicester City,3-2,3,2,1,1,5,1,H
1929-08-31,1929,Manchester City,Burnley,2-2,2,2,1,1,4,0,D
1929-08-31,1929,Middlesbrough,Liverpool,5-0,5,0,1,1,5,5,H
1929-08-31,1929,Newcastle United,Manchester United,4-1,4,1,1,1,5,3,H
1929-08-31,1929,Portsmouth,Sheffield Wednesday,0-4,0,4,1,1,4,-4,A
1929-08-31,1929,Sheffield United,Grimsby Town,2-3,2,3,1,1,5,-1,A
1929-09-02,1929,Burnley,Everton,1-1,1,1,1,1,2,0,D
1929-09-02,1929,Leicester City,Manchester United,4-1,4,1,1,1,5,3,H
1929-09-02,1929,Sheffield Wednesday,Bolton Wanderers,1-0,1,0,1,1,1,1,H
1929-09-04,1929,Birmingham City,West Ham United,4-2,4,2,1,1,6,2,H
1929-09-04,1929,Derby County,Aston Villa,4-0,4,0,1,1,4,4,H
1929-09-04,1929,Grimsby Town,Portsmouth,1-1,1,1,1,1,2,0,D
1929-09-04,1929,Liverpool,Huddersfield Town,3-0,3,0,1,1,3,3,H
1929-09-04,1929,Manchester City,Arsenal,3-1,3,1,1,1,4,2,H
1929-09-04,1929,Middlesbrough,Sheffield United,3-1,3,1,1,1,4,2,H
1929-09-04,1929,Newcastle United,Blackburn Rovers,5-1,5,1,1,1,6,4,H
1929-09-07,1929,Birmingham City,Huddersfield Town,4-1,4,1,1,1,5,3,H
1929-09-07,1929,Bolton Wanderers,Derby County,1-2,1,2,1,1,3,-1,A
1929-09-07,1929,Burnley,Portsmouth,4-0,4,0,1,1,4,4,H
1929-09-07,1929,Grimsby Town,Newcastle United,4-0,4,0,1,1,4,4,H
1929-09-07,1929,Leeds United,Aston Villa,4-1,4,1,1,1,5,3,H
1929-09-07,1929,Leicester City,Sheffield United,3-3,3,3,1,1,6,0,D
1929-09-07,1929,Liverpool,Everton,0-3,0,3,1,1,3,-3,A
1929-09-07,1929,Manchester United,Blackburn Rovers,1-0,1,0,1,1,1,1,H
1929-09-07,1929,Sheffield Wednesday,Arsenal,0-2,0,2,1,1,2,-2,A
1929-09-07,1929,Sunderland,Manchester City,5-2,5,2,1,1,7,3,H
1929-09-07,1929,West Ham United,Middlesbrough,5-3,5,3,1,1,8,2,H
1929-09-09,1929,Aston Villa,Derby County,2-2,2,2,1,1,4,0,D
1929-09-09,1929,Sheffield United,Middlesbrough,1-3,1,3,1,1,4,-2,A
1929-09-09,1929,West Ham United,Newcastle United,5-1,5,1,1,1,6,4,H
1929-09-10,1929,Burnley,Sunderland,2-0,2,0,1,1,2,2,H
1929-09-11,1929,Arsenal,Manchester City,3-2,3,2,1,1,5,1,H
1929-09-11,1929,Everton,Leeds United,1-1,1,1,1,1,2,0,D
1929-09-11,1929,Manchester United,Leicester City,2-1,2,1,1,1,3,1,H
1929-09-11,1929,Portsmouth,Grimsby Town,1-1,1,1,1,1,2,0,D
1929-09-14,1929,Arsenal,Burnley,6-1,6,1,1,1,7,5,H
1929-09-14,1929,Aston Villa,Sheffield Wednesday,1-3,1,3,1,1,4,-2,A
1929-09-14,1929,Blackburn Rovers,Grimsby Town,4-1,4,1,1,1,5,3,H
1929-09-14,1929,Derby County,Everton,2-1,2,1,1,1,3,1,H
1929-09-14,1929,Huddersfield Town,Leeds United,1-0,1,0,1,1,1,1,H
1929-09-14,1929,Liverpool,West Ham United,3-1,3,1,1,1,4,2,H
1929-09-14,1929,Manchester City,Bolton Wanderers,2-0,2,0,1,1,2,2,H
1929-09-14,1929,Middlesbrough,Manchester United,2-3,2,3,1,1,5,-1,A
1929-09-14,1929,Newcastle United,Leicester City,2-1,2,1,1,1,3,1,H
1929-09-14,1929,Portsmouth,Sunderland,1-1,1,1,1,1,2,0,D
1929-09-14,1929,Sheffield United,Birmingham City,4-2,4,2,1,1,6,2,H
1929-09-16,1929,Blackburn Rovers,Newcastle United,4-2,4,2,1,1,6,2,H
1929-09-16,1929,Huddersfield Town,Liverpool,3-0,3,0,1,1,3,3,H
1929-09-16,1929,Leeds United,Everton,2-1,2,1,1,1,3,1,H
1929-09-16,1929,West Ham United,Birmingham City,0-1,0,1,1,1,1,-1,A
1929-09-18,1929,Bolton Wanderers,Middlesbrough,2-2,2,2,1,1,4,0,D
1929-09-21,1929,Birmingham City,Newcastle United,5-1,5,1,1,1,6,4,H
1929-09-21,1929,Bolton Wanderers,Portsmouth,2-1,2,1,1,1,3,1,H
1929-09-21,1929,Burnley,Aston Villa,1-4,1,4,1,1,5,-3,A
1929-09-21,1929,Everton,Manchester City,2-3,2,3,1,1,5,-1,A
1929-09-21,1929,Grimsby Town,Middlesbrough,0-3,0,3,1,1,3,-3,A
1929-09-21,1929,Huddersfield Town,Sheffield United,2-2,2,2,1,1,4,0,D
1929-09-21,1929,Leicester City,Blackburn Rovers,1-1,1,1,1,1,2,0,D
1929-09-21,1929,Manchester United,Liverpool,1-2,1,2,1,1,3,-1,A
1929-09-21,1929,Sheffield Wednesday,Leeds United,1-2,1,2,1,1,3,-1,A
1929-09-21,1929,Sunderland,Arsenal,0-1,0,1,1,1,1,-1,A
1929-09-21,1929,West Ham United,Derby County,2-0,2,0,1,1,2,2,H
1929-09-23,1929,Leeds United,Portsmouth,1-0,1,0,1,1,1,1,H
1929-09-24,1929,Grimsby Town,Huddersfield Town,4-2,4,2,1,1,6,2,H
1929-09-25,1929,Aston Villa,Arsenal,5-2,5,2,1,1,7,3,H
1929-09-25,1929,Bolton Wanderers,Sheffield Wednesday,1-3,1,3,1,1,4,-2,A
1929-09-25,1929,Derby County,Burnley,1-3,1,3,1,1,4,-2,A
1929-09-28,1929,Arsenal,Bolton Wanderers,1-2,1,2,1,1,3,-1,A
1929-09-28,1929,Aston Villa,Sunderland,2-1,2,1,1,1,3,1,H
1929-09-28,1929,Blackburn Rovers,Birmingham City,7-5,7,5,1,1,12,2,H
1929-09-28,1929,Leeds United,Burnley,3-0,3,0,1,1,3,3,H
1929-09-28,1929,Liverpool,Grimsby Town,2-0,2,0,1,1,2,2,H
1929-09-28,1929,Manchester City,Derby County,3-0,3,0,1,1,3,3,H
1929-09-28,1929,Middlesbrough,Leicester City,0-2,0,2,1,1,2,-2,A
1929-09-28,1929,Newcastle United,Huddersfield Town,5-2,5,2,1,1,7,3,H
1929-09-28,1929,Portsmouth,Everton,1-4,1,4,1,1,5,-3,A
1929-09-28,1929,Sheffield United,Sheffield Wednesday,2-2,2,2,1,1,4,0,D
1929-09-28,1929,West Ham United,Manchester United,2-1,2,1,1,1,3,1,H
1929-10-02,1929,Sunderland,Everton,2-2,2,2,1,1,4,0,D
1929-10-05,1929,Birmingham City,Middlesbrough,1-1,1,1,1,1,2,0,D
1929-10-05,1929,Bolton Wanderers,Aston Villa,3-0,3,0,1,1,3,3,H
1929-10-05,1929,Burnley,Sheffield Wednesday,2-4,2,4,1,1,6,-2,A
1929-10-05,1929,Derby County,Portsmouth,3-2,3,2,1,1,5,1,H
1929-10-05,1929,Everton,Arsenal,1-1,1,1,1,1,2,0,D
1929-10-05,1929,Grimsby Town,West Ham United,2-2,2,2,1,1,4,0,D
1929-10-05,1929,Huddersfield Town,Blackburn Rovers,0-0,0,0,1,1,0,0,D
1929-10-05,1929,Leicester City,Liverpool,2-1,2,1,1,1,3,1,H
1929-10-05,1929,Manchester United,Manchester City,1-3,1,3,1,1,4,-2,A
1929-10-05,1929,Sheffield United,Newcastle United,1-0,1,0,1,1,1,1,H
1929-10-05,1929,Sunderland,Leeds United,1-4,1,4,1,1,5,-3,A
1929-10-07,1929,Sheffield United,Manchester United,3-1,3,1,1,1,4,2,H
1929-10-09,1929,Liverpool,Blackburn Rovers,1-1,1,1,1,1,2,0,D
1929-10-12,1929,Arsenal,Derby County,1-1,1,1,1,1,2,0,D
1929-10-12,1929,Aston Villa,Everton,5-2,5,2,1,1,7,3,H
1929-10-12,1929,Blackburn Rovers,Sheffield United,0-1,0,1,1,1,1,-1,A
1929-10-12,1929,Leeds United,Bolton Wanderers,2-1,2,1,1,1,3,1,H
1929-10-12,1929,Liverpool,Birmingham City,1-1,1,1,1,1,2,0,D
1929-10-12,1929,Manchester United,Grimsby Town,2-5,2,5,1,1,7,-3,A
1929-10-12,1929,Middlesbrough,Huddersfield Town,1-3,1,3,1,1,4,-2,A
1929-10-12,1929,Newcastle United,Burnley,2-1,2,1,1,1,3,1,H
1929-10-12,1929,Portsmouth,Manchester City,2-2,2,2,1,1,4,0,D
1929-10-12,1929,Sheffield Wednesday,Sunderland,1-1,1,1,1,1,2,0,D
1929-10-12,1929,West Ham United,Leicester City,1-2,1,2,1,1,3,-1,A
1929-10-17,1929,Leicester City,Birmingham City,2-1,2,1,1,1,3,1,H
1929-10-19,1929,Arsenal,Grimsby Town,4-1,4,1,1,1,5,3,H
1929-10-19,1929,Aston Villa,Leicester City,3-0,3,0,1,1,3,3,H
1929-10-19,1929,Bolton Wanderers,Blackburn Rovers,2-1,2,1,1,1,3,1,H
1929-10-19,1929,Burnley,Sheffield United,5-0,5,0,1,1,5,5,H
1929-10-19,1929,Derby County,Liverpool,2-2,2,2,1,1,4,0,D
1929-10-19,1929,Everton,Middlesbrough,3-2,3,2,1,1,5,1,H
1929-10-19,1929,Leeds United,Birmingham City,1-0,1,0,1,1,1,1,H
1929-10-19,1929,Manchester City,West Ham United,4-3,4,3,1,1,7,1,H
1929-10-19,1929,Portsmouth,Manchester United,3-0,3,0,1,1,3,3,H
1929-10-19,1929,Sheffield Wednesday,Huddersfield Town,3-1,3,1,1,1,4,2,H
1929-10-19,1929,Sunderland,Newcastle United,1-0,1,0,1,1,1,1,H
1929-10-26,1929,Birmingham City,Sheffield Wednesday,1-0,1,0,1,1,1,1,H
1929-10-26,1929,Blackburn Rovers,Everton,3-1,3,1,1,1,4,2,H
1929-10-26,1929,Grimsby Town,Aston Villa,0-2,0,2,1,1,2,-2,A
1929-10-26,1929,Huddersfield Town,Burnley,3-0,3,0,1,1,3,3,H
1929-10-26,1929,Leicester City,Leeds United,2-2,2,2,1,1,4,0,D
1929-10-26,1929,Liverpool,Manchester City,1-6,1,6,1,1,7,-5,A
1929-10-26,1929,Manchester United,Arsenal,1-0,1,0,1,1,1,1,H
1929-10-26,1929,Middlesbrough,Derby County,4-0,4,0,1,1,4,4,H
1929-10-26,1929,Newcastle United,Bolton Wanderers,2-3,2,3,1,1,5,-1,A
1929-10-26,1929,Sheffield United,Sunderland,4-2,4,2,1,1,6,2,H
1929-10-26,1929,West Ham United,Portsmouth,0-1,0,1,1,1,1,-1,A
1929-11-02,1929,Arsenal,West Ham United,0-1,0,1,1,1,1,-1,A
1929-11-02,1929,Aston Villa,Manchester United,1-0,1,0,1,1,1,1,H
1929-11-02,1929,Bolton Wanderers,Sheffield United,2-1,2,1,1,1,3,1,H
1929-11-02,1929,Burnley,Birmingham City,3-1,3,1,1,1,4,2,H
1929-11-02,1929,Derby County,Blackburn Rovers,4-3,4,3,1,1,7,1,H
1929-11-02,1929,Everton,Newcastle United,5-2,5,2,1,1,7,3,H
1929-11-02,1929,Leeds United,Grimsby Town,6-0,6,0,1,1,6,6,H
1929-11-02,1929,Manchester City,Middlesbrough,3-1,3,1,1,1,4,2,H
1929-11-02,1929,Portsmouth,Liverpool,3-3,3,3,1,1,6,0,D
1929-11-02,1929,Sheffield Wednesday,Leicester City,4-0,4,0,1,1,4,4,H
1929-11-02,1929,Sunderland,Huddersfield Town,1-0,1,0,1,1,1,1,H
1929-11-09,1929,Birmingham City,Arsenal,2-3,2,3,1,1,5,-1,A
1929-11-09,1929,Blackburn Rovers,Burnley,8-3,8,3,1,1,11,5,H
1929-11-09,1929,Grimsby Town,Manchester City,2-2,2,2,1,1,4,0,D
1929-11-09,1929,Huddersfield Town,Aston Villa,1-1,1,1,1,1,2,0,D
1929-11-09,1929,Leicester City,Portsmouth,0-5,0,5,1,1,5,-5,A
1929-11-09,1929,Liverpool,Bolton Wanderers,3-0,3,0,1,1,3,3,H
1929-11-09,1929,Manchester United,Derby County,3-2,3,2,1,1,5,1,H
1929-11-09,1929,Middlesbrough,Sunderland,3-0,3,0,1,1,3,3,H
1929-11-09,1929,Newcastle United,Sheffield Wednesday,1-3,1,3,1,1,4,-2,A
1929-11-09,1929,Sheffield United,Leeds United,3-2,3,2,1,1,5,1,H
1929-11-09,1929,West Ham United,Everton,3-1,3,1,1,1,4,2,H
1929-11-16,1929,Aston Villa,Liverpool,2-3,2,3,1,1,5,-1,A
1929-11-16,1929,Bolton Wanderers,Birmingham City,0-0,0,0,1,1,0,0,D
1929-11-16,1929,Burnley,Grimsby Town,3-1,3,1,1,1,4,2,H
1929-11-16,1929,Derby County,Sheffield United,2-1,2,1,1,1,3,1,H
1929-11-16,1929,Everton,Huddersfield Town,0-2,0,2,1,1,2,-2,A
1929-11-16,1929,Leeds United,West Ham United,1-3,1,3,1,1,4,-2,A
1929-11-16,1929,Manchester City,Newcastle United,3-0,3,0,1,1,3,3,H
1929-11-16,1929,Portsmouth,Blackburn Rovers,4-0,4,0,1,1,4,4,H
1929-11-16,1929,Sheffield Wednesday,Manchester United,7-2,7,2,1,1,9,5,H
1929-11-16,1929,Sunderland,Leicester City,2-1,2,1,1,1,3,1,H
1929-11-23,1929,Birmingham City,Everton,0-0,0,0,1,1,0,0,D
1929-11-23,1929,Blackburn Rovers,Arsenal,1-1,1,1,1,1,2,0,D
1929-11-23,1929,Grimsby Town,Sunderland,0-1,0,1,1,1,1,-1,A
1929-11-23,1929,Huddersfield Town,Derby County,0-1,0,1,1,1,1,-1,A
1929-11-23,1929,Leicester City,Bolton Wanderers,5-2,5,2,1,1,7,3,H
1929-11-23,1929,Liverpool,Leeds United,1-0,1,0,1,1,1,1,H
1929-11-23,1929,Manchester United,Burnley,1-0,1,0,1,1,1,1,H
1929-11-23,1929,Middlesbrough,Aston Villa,2-3,2,3,1,1,5,-1,A
1929-11-23,1929,Newcastle United,Portsmouth,4-1,4,1,1,1,5,3,H
1929-11-23,1929,Sheffield United,Manchester City,1-2,1,2,1,1,3,-1,A
1929-11-23,1929,West Ham United,Sheffield Wednesday,1-1,1,1,1,1,2,0,D
1929-11-27,1929,Arsenal,Middlesbrough,1-2,1,2,1,1,3,-1,A
1929-11-30,1929,Arsenal,Newcastle United,0-1,0,1,1,1,1,-1,A
1929-11-30,1929,Aston Villa,Blackburn Rovers,3-0,3,0,1,1,3,3,H
1929-11-30,1929,Bolton Wanderers,Grimsby Town,2-3,2,3,1,1,5,-1,A
1929-11-30,1929,Burnley,West Ham United,1-1,1,1,1,1,2,0,D
1929-11-30,1929,Derby County,Birmingham City,3-1,3,1,1,1,4,2,H
1929-11-30,1929,Everton,Leicester City,4-5,4,5,1,1,9,-1,A
1929-11-30,1929,Leeds United,Middlesbrough,1-2,1,2,1,1,3,-1,A
1929-11-30,1929,Manchester City,Huddersfield Town,1-1,1,1,1,1,2,0,D
1929-11-30,1929,Portsmouth,Sheffield United,3-1,3,1,1,1,4,2,H
1929-11-30,1929,Sheffield Wednesday,Liverpool,2-1,2,1,1,1,3,1,H
1929-11-30,1929,Sunderland,Manchester United,2-4,2,4,1,1,6,-2,A
1929-12-07,1929,Birmingham City,Manchester City,3-0,3,0,1,1,3,3,H
1929-12-07,1929,Blackburn Rovers,Leeds United,2-1,2,1,1,1,3,1,H
1929-12-07,1929,Grimsby Town,Everton,0-3,0,3,1,1,3,-3,A
1929-12-07,1929,Huddersfield Town,Portsmouth,2-1,2,1,1,1,3,1,H
1929-12-07,1929,Leicester City,Derby County,0-0,0,0,1,1,0,0,D
1929-12-07,1929,Liverpool,Burnley,1-3,1,3,1,1,4,-2,A
1929-12-07,1929,Manchester United,Bolton Wanderers,1-1,1,1,1,1,2,0,D
1929-12-07,1929,Middlesbrough,Sheffield Wednesday,4-1,4,1,1,1,5,3,H
1929-12-07,1929,Newcastle United,Aston Villa,2-2,2,2,1,1,4,0,D
1929-12-07,1929,West Ham United,Sunderland,1-1,1,1,1,1,2,0,D
1929-12-14,1929,Arsenal,Huddersfield Town,2-0,2,0,1,1,2,2,H
1929-12-14,1929,Aston Villa,Sheffield United,5-1,5,1,1,1,6,4,H
1929-12-14,1929,Bolton Wanderers,West Ham United,4-1,4,1,1,1,5,3,H
1929-12-14,1929,Burnley,Middlesbrough,4-1,4,1,1,1,5,3,H
1929-12-14,1929,Derby County,Grimsby Town,5-4,5,4,1,1,9,1,H
1929-12-14,1929,Everton,Manchester United,0-0,0,0,1,1,0,0,D
1929-12-14,1929,Leeds United,Newcastle United,5-2,5,2,1,1,7,3,H
1929-12-14,1929,Manchester City,Leicester City,3-2,3,2,1,1,5,1,H
1929-12-14,1929,Portsmouth,Birmingham City,2-1,2,1,1,1,3,1,H
1929-12-14,1929,Sheffield Wednesday,Blackburn Rovers,4-0,4,0,1,1,4,4,H
1929-12-14,1929,Sunderland,Liverpool,2-3,2,3,1,1,5,-1,A
1929-12-16,1929,Sheffield United,Arsenal,4-1,4,1,1,1,5,3,H
1929-12-21,1929,Birmingham City,Sunderland,3-1,3,1,1,1,4,2,H
1929-12-21,1929,Blackburn Rovers,Manchester City,1-3,1,3,1,1,4,-2,A
1929-12-21,1929,Huddersfield Town,Bolton Wanderers,0-2,0,2,1,1,2,-2,A
1929-12-21,1929,Leicester City,Burnley,4-3,4,3,1,1,7,1,H
1929-12-21,1929,Liverpool,Arsenal,1-0,1,0,1,1,1,1,H
1929-12-21,1929,Manchester United,Leeds United,3-1,3,1,1,1,4,2,H
1929-12-21,1929,Middlesbrough,Portsmouth,2-0,2,0,1,1,2,2,H
1929-12-21,1929,Newcastle United,Derby County,2-3,2,3,1,1,5,-1,A
1929-12-21,1929,Sheffield United,Everton,2-0,2,0,1,1,2,2,H
1929-12-21,1929,West Ham United,Aston Villa,5-2,5,2,1,1,7,3,H
1929-12-25,1929,Aston Villa,Manchester City,0-2,0,2,1,1,2,-2,A
1929-12-25,1929,Blackburn Rovers,Sunderland,5-3,5,3,1,1,8,2,H
1929-12-25,1929,Bolton Wanderers,Burnley,1-1,1,1,1,1,2,0,D
1929-12-25,1929,Everton,Sheffield Wednesday,1-4,1,4,1,1,5,-3,A
1929-12-25,1929,Grimsby Town,Leicester City,1-4,1,4,1,1,5,-3,A
1929-12-25,1929,Leeds United,Derby County,2-1,2,1,1,1,3,1,H
1929-12-25,1929,Manchester United,Birmingham City,0-0,0,0,1,1,0,0,D
1929-12-25,1929,Newcastle United,Middlesbrough,3-2,3,2,1,1,5,1,H
1929-12-25,1929,Portsmouth,Arsenal,0-1,0,1,1,1,1,-1,A
1929-12-25,1929,Sheffield United,Liverpool,4-0,4,0,1,1,4,4,H
1929-12-25,1929,West Ham United,Huddersfield Town,2-3,2,3,1,1,5,-1,A
1929-12-26,1929,Arsenal,Portsmouth,1-2,1,2,1,1,3,-1,A
1929-12-26,1929,Birmingham City,Manchester United,0-1,0,1,1,1,1,-1,A
1929-12-26,1929,Burnley,Bolton Wanderers,2-2,2,2,1,1,4,0,D
1929-12-26,1929,Derby County,Leeds United,3-0,3,0,1,1,3,3,H
1929-12-26,1929,Huddersfield Town,West Ham United,3-0,3,0,1,1,3,3,H
1929-12-26,1929,Leicester City,Grimsby Town,1-0,1,0,1,1,1,1,H
1929-12-26,1929,Liverpool,Sheffield United,2-0,2,0,1,1,2,2,H
1929-12-26,1929,Manchester City,Aston Villa,1-2,1,2,1,1,3,-1,A
1929-12-26,1929,Middlesbrough,Newcastle United,2-2,2,2,1,1,4,0,D
1929-12-26,1929,Sheffield Wednesday,Everton,4-0,4,0,1,1,4,4,H
1929-12-26,1929,Sunderland,Blackburn Rovers,3-1,3,1,1,1,4,2,H
1929-12-28,1929,Birmingham City,Aston Villa,1-1,1,1,1,1,2,0,D
1929-12-28,1929,Bolton Wanderers,Everton,5-0,5,0,1,1,5,5,H
1929-12-28,1929,Burnley,Manchester City,4-2,4,2,1,1,6,2,H
1929-12-28,1929,Grimsby Town,Sheffield United,4-1,4,1,1,1,5,3,H
1929-12-28,1929,Leeds United,Arsenal,2-0,2,0,1,1,2,2,H
1929-12-28,1929,Leicester City,Huddersfield Town,1-2,1,2,1,1,3,-1,A
1929-12-28,1929,Liverpool,Middlesbrough,5-2,5,2,1,1,7,3,H
1929-12-28,1929,Manchester United,Newcastle United,5-0,5,0,1,1,5,5,H
1929-12-28,1929,Sheffield Wednesday,Portsmouth,1-1,1,1,1,1,2,0,D
1929-12-28,1929,Sunderland,Derby County,3-1,3,1,1,1,4,2,H
1929-12-28,1929,West Ham United,Blackburn Rovers,2-3,2,3,1,1,5,-1,A
1930-01-01,1929,Blackburn Rovers,Middlesbrough,7-0,7,0,1,1,7,7,H
1930-01-01,1929,Bolton Wanderers,Huddersfield Town,7-1,7,1,1,1,8,6,H
1930-01-01,1929,Manchester City,Sheffield Wednesday,3-3,3,3,1,1,6,0,D
1930-01-01,1929,Sheffield United,West Ham United,4-2,4,2,1,1,6,2,H
1930-01-01,1929,Sunderland,Burnley,3-3,3,3,1,1,6,0,D
1930-01-04,1929,Arsenal,Sheffield Wednesday,2-3,2,3,1,1,5,-1,A
1930-01-04,1929,Aston Villa,Leeds United,3-4,3,4,1,1,7,-1,A
1930-01-04,1929,Blackburn Rovers,Manchester United,5-4,5,4,1,1,9,1,H
1930-01-04,1929,Derby County,Bolton Wanderers,2-1,2,1,1,1,3,1,H
1930-01-04,1929,Everton,Liverpool,3-3,3,3,1,1,6,0,D
1930-01-04,1929,Huddersfield Town,Birmingham City,1-1,1,1,1,1,2,0,D
1930-01-04,1929,Manchester City,Sunderland,2-2,2,2,1,1,4,0,D
1930-01-04,1929,Middlesbrough,West Ham United,2-0,2,0,1,1,2,2,H
1930-01-04,1929,Newcastle United,Grimsby Town,3-1,3,1,1,1,4,2,H
1930-01-04,1929,Portsmouth,Burnley,7-1,7,1,1,1,8,6,H
1930-01-04,1929,Sheffield United,Leicester City,7-1,7,1,1,1,8,6,H
1930-01-18,1929,Birmingham City,Sheffield United,2-1,2,1,1,1,3,1,H
1930-01-18,1929,Bolton Wanderers,Manchester City,1-2,1,2,1,1,3,-1,A
1930-01-18,1929,Burnley,Arsenal,2-2,2,2,1,1,4,0,D
1930-01-18,1929,Everton,Derby County,4-0,4,0,1,1,4,4,H
1930-01-18,1929,Grimsby Town,Blackburn Rovers,5-3,5,3,1,1,8,2,H
1930-01-18,1929,Leeds United,Huddersfield Town,0-1,0,1,1,1,1,-1,A
1930-01-18,1929,Leicester City,Newcastle United,6-1,6,1,1,1,7,5,H
1930-01-18,1929,Manchester United,Middlesbrough,0-3,0,3,1,1,3,-3,A
1930-01-18,1929,Sheffield Wednesday,Aston Villa,3-0,3,0,1,1,3,3,H
1930-01-18,1929,Sunderland,Portsmouth,1-1,1,1,1,1,2,0,D
1930-01-18,1929,West Ham United,Liverpool,4-1,4,1,1,1,5,3,H
1930-01-25,1929,Liverpool,Manchester United,1-0,1,0,1,1,1,1,H
1930-01-27,1929,Blackburn Rovers,Leicester City,3-1,3,1,1,1,4,2,H
1930-02-01,1929,Birmingham City,Blackburn Rovers,1-2,1,2,1,1,3,-1,A
1930-02-01,1929,Bolton Wanderers,Arsenal,0-0,0,0,1,1,0,0,D
1930-02-01,1929,Burnley,Leeds United,0-3,0,3,1,1,3,-3,A
1930-02-01,1929,Derby County,Manchester City,4-2,4,2,1,1,6,2,H
1930-02-01,1929,Everton,Portsmouth,1-1,1,1,1,1,2,0,D
1930-02-01,1929,Grimsby Town,Liverpool,3-2,3,2,1,1,5,1,H
1930-02-01,1929,Huddersfield Town,Newcastle United,2-0,2,0,1,1,2,2,H
1930-02-01,1929,Leicester City,Middlesbrough,4-1,4,1,1,1,5,3,H
1930-02-01,1929,Manchester United,West Ham United,4-2,4,2,1,1,6,2,H
1930-02-01,1929,Sheffield Wednesday,Sheffield United,1-1,1,1,1,1,2,0,D
1930-02-01,1929,Sunderland,Aston Villa,4-1,4,1,1,1,5,3,H
1930-02-05,1929,Aston Villa,Burnley,1-2,1,2,1,1,3,-1,A
1930-02-05,1929,Derby County,West Ham United,4-3,4,3,1,1,7,1,H
1930-02-05,1929,Grimsby Town,Sheffield Wednesday,0-5,0,5,1,1,5,-5,A
1930-02-05,1929,Manchester City,Everton,1-2,1,2,1,1,3,-1,A
1930-02-05,1929,Portsmouth,Bolton Wanderers,3-0,3,0,1,1,3,3,H
1930-02-08,1929,Arsenal,Everton,4-0,4,0,1,1,4,4,H
1930-02-08,1929,Aston Villa,Bolton Wanderers,2-0,2,0,1,1,2,2,H
1930-02-08,1929,Blackburn Rovers,Huddersfield Town,5-2,5,2,1,1,7,3,H
1930-02-08,1929,Leeds United,Sunderland,5-0,5,0,1,1,5,5,H
1930-02-08,1929,Liverpool,Leicester City,1-1,1,1,1,1,2,0,D
1930-02-08,1929,Manchester City,Manchester United,0-1,0,1,1,1,1,-1,A
1930-02-08,1929,Middlesbrough,Birmingham City,5-1,5,1,1,1,6,4,H
1930-02-08,1929,Newcastle United,Sheffield United,3-5,3,5,1,1,8,-2,A
1930-02-08,1929,Portsmouth,Derby County,3-1,3,1,1,1,4,2,H
1930-02-08,1929,Sheffield Wednesday,Burnley,4-1,4,1,1,1,5,3,H
1930-02-08,1929,West Ham United,Grimsby Town,2-0,2,0,1,1,2,2,H
1930-02-15,1929,Birmingham City,Liverpool,1-0,1,0,1,1,1,1,H
1930-02-15,1929,Bolton Wanderers,Leeds United,4-2,4,2,1,1,6,2,H
1930-02-15,1929,Burnley,Leicester City,1-1,1,1,1,1,2,0,D
1930-02-15,1929,Grimsby Town,Manchester United,2-2,2,2,1,1,4,0,D
1930-02-17,1929,Sheffield United,Huddersfield Town,0-1,0,1,1,1,1,-1,A
1930-02-19,1929,Derby County,Arsenal,4-1,4,1,1,1,5,3,H
1930-02-20,1929,Leicester City,West Ham United,1-2,1,2,1,1,3,-1,A
1930-02-22,1929,Birmingham City,Leeds United,1-0,1,0,1,1,1,1,H
1930-02-22,1929,Blackburn Rovers,Bolton Wanderers,3-1,3,1,1,1,4,2,H
1930-02-22,1929,Grimsby Town,Arsenal,1-1,1,1,1,1,2,0,D
1930-02-22,1929,Huddersfield Town,Sheffield Wednesday,4-1,4,1,1,1,5,3,H
1930-02-22,1929,Leicester City,Aston Villa,4-3,4,3,1,1,7,1,H
1930-02-22,1929,Liverpool,Derby County,2-2,2,2,1,1,4,0,D
1930-02-22,1929,Manchester United,Portsmouth,3-0,3,0,1,1,3,3,H
1930-02-22,1929,Middlesbrough,Everton,1-2,1,2,1,1,3,-1,A
1930-02-22,1929,Newcastle United,Sunderland,3-0,3,0,1,1,3,3,H
1930-02-22,1929,Sheffield United,Burnley,3-1,3,1,1,1,4,2,H
1930-02-22,1929,West Ham United,Manchester City,3-0,3,0,1,1,3,3,H
1930-02-26,1929,Manchester City,Portsmouth,5-2,5,2,1,1,7,3,H
1930-03-01,1929,Bolton Wanderers,Manchester United,4-1,4,1,1,1,5,3,H
1930-03-01,1929,Derby County,Middlesbrough,3-1,3,1,1,1,4,2,H
1930-03-01,1929,Everton,Blackburn Rovers,2-2,2,2,1,1,4,0,D
1930-03-01,1929,Leeds United,Leicester City,1-2,1,2,1,1,3,-1,A
1930-03-01,1929,Manchester City,Liverpool,4-3,4,3,1,1,7,1,H
1930-03-01,1929,Sunderland,Sheffield United,3-2,3,2,1,1,5,1,H
1930-03-03,1929,Sheffield United,Blackburn Rovers,5-7,5,7,1,1,12,-2,A
1930-03-05,1929,Everton,Aston Villa,3-4,3,4,1,1,7,-1,A
1930-03-05,1929,Middlesbrough,Grimsby Town,1-5,1,5,1,1,6,-4,A
1930-03-08,1929,Birmingham City,Burnley,2-0,2,0,1,1,2,2,H
1930-03-08,1929,Blackburn Rovers,Derby County,0-3,0,3,1,1,3,-3,A
1930-03-08,1929,Grimsby Town,Leeds United,1-2,1,2,1,1,3,-1,A
1930-03-08,1929,Huddersfield Town,Sunderland,0-2,0,2,1,1,2,-2,A
1930-03-08,1929,Leicester City,Sheffield Wednesday,2-1,2,1,1,1,3,1,H
1930-03-08,1929,Liverpool,Portsmouth,2-0,2,0,1,1,2,2,H
1930-03-08,1929,Manchester United,Aston Villa,2-3,2,3,1,1,5,-1,A
1930-03-08,1929,Middlesbrough,Manchester City,1-0,1,0,1,1,1,1,H
1930-03-08,1929,Newcastle United,Everton,1-0,1,0,1,1,1,1,H
1930-03-08,1929,Sheffield United,Bolton Wanderers,2-3,2,3,1,1,5,-1,A
1930-03-08,1929,West Ham United,Arsenal,3-2,3,2,1,1,5,1,H
1930-03-11,1929,Burnley,Newcastle United,0-3,0,3,1,1,3,-3,A
1930-03-12,1929,Arsenal,Manchester United,4-2,4,2,1,1,6,2,H
1930-03-12,1929,Portsmouth,West Ham United,3-1,3,1,1,1,4,2,H
1930-03-15,1929,Arsenal,Birmingham City,1-0,1,0,1,1,1,1,H
1930-03-15,1929,Aston Villa,Huddersfield Town,5-3,5,3,1,1,8,2,H
1930-03-15,1929,Bolton Wanderers,Liverpool,0-2,0,2,1,1,2,-2,A
1930-03-15,1929,Burnley,Blackburn Rovers,3-2,3,2,1,1,5,1,H
1930-03-15,1929,Derby County,Manchester United,1-1,1,1,1,1,2,0,D
1930-03-15,1929,Everton,West Ham United,1-2,1,2,1,1,3,-1,A
1930-03-15,1929,Leeds United,Sheffield United,2-2,2,2,1,1,4,0,D
1930-03-15,1929,Manchester City,Grimsby Town,3-1,3,1,1,1,4,2,H
1930-03-15,1929,Portsmouth,Leicester City,3-0,3,0,1,1,3,3,H
1930-03-15,1929,Sheffield Wednesday,Newcastle United,4-2,4,2,1,1,6,2,H
1930-03-15,1929,Sunderland,Middlesbrough,3-2,3,2,1,1,5,1,H
1930-03-22,1929,Birmingham City,Bolton Wanderers,3-1,3,1,1,1,4,2,H
1930-03-22,1929,Blackburn Rovers,Portsmouth,1-0,1,0,1,1,1,1,H
1930-03-22,1929,Grimsby Town,Burnley,4-0,4,0,1,1,4,4,H
1930-03-22,1929,Leicester City,Sunderland,1-2,1,2,1,1,3,-1,A
1930-03-22,1929,Liverpool,Aston Villa,2-0,2,0,1,1,2,2,H
1930-03-22,1929,Newcastle United,Manchester City,2-2,2,2,1,1,4,0,D
1930-03-22,1929,Sheffield United,Derby County,2-0,2,0,1,1,2,2,H
1930-03-22,1929,West Ham United,Leeds United,3-0,3,0,1,1,3,3,H
1930-03-26,1929,Huddersfield Town,Middlesbrough,1-0,1,0,1,1,1,1,H
1930-03-29,1929,Arsenal,Blackburn Rovers,4-0,4,0,1,1,4,4,H
1930-03-29,1929,Aston Villa,Middlesbrough,4-2,4,2,1,1,6,2,H
1930-03-29,1929,Bolton Wanderers,Leicester City,1-0,1,0,1,1,1,1,H
1930-03-29,1929,Burnley,Manchester United,4-0,4,0,1,1,4,4,H
1930-03-29,1929,Derby County,Huddersfield Town,2-2,2,2,1,1,4,0,D
1930-03-29,1929,Everton,Birmingham City,2-4,2,4,1,1,6,-2,A
1930-03-29,1929,Leeds United,Liverpool,1-1,1,1,1,1,2,0,D
1930-03-29,1929,Manchester City,Sheffield United,2-1,2,1,1,1,3,1,H
1930-03-29,1929,Portsmouth,Newcastle United,2-0,2,0,1,1,2,2,H
1930-03-29,1929,Sheffield Wednesday,West Ham United,2-1,2,1,1,1,3,1,H
1930-03-29,1929,Sunderland,Grimsby Town,2-0,2,0,1,1,2,2,H
1930-04-01,1929,Burnley,Huddersfield Town,1-3,1,3,1,1,4,-2,A
1930-04-02,1929,Arsenal,Liverpool,0-1,0,1,1,1,1,-1,A
1930-04-02,1929,Aston Villa,Grimsby Town,4-1,4,1,1,1,5,3,H
1930-04-02,1929,Newcastle United,Birmingham City,1-1,1,1,1,1,2,0,D
1930-04-05,1929,Birmingham City,Derby County,2-4,2,4,1,1,6,-2,A
1930-04-05,1929,Blackburn Rovers,Aston Villa,2-0,2,0,1,1,2,2,H
1930-04-05,1929,Grimsby Town,Bolton Wanderers,1-1,1,1,1,1,2,0,D
1930-04-05,1929,Huddersfield Town,Manchester City,1-1,1,1,1,1,2,0,D
1930-04-05,1929,Leicester City,Everton,5-4,5,4,1,1,9,1,H
1930-04-05,1929,Liverpool,Sheffield Wednesday,1-3,1,3,1,1,4,-2,A
1930-04-05,1929,Manchester United,Sunderland,2-1,2,1,1,1,3,1,H
1930-04-05,1929,Middlesbrough,Leeds United,1-1,1,1,1,1,2,0,D
1930-04-05,1929,Newcastle United,Arsenal,1-1,1,1,1,1,2,0,D
1930-04-05,1929,Sheffield United,Portsmouth,2-3,2,3,1,1,5,-1,A
1930-04-05,1929,West Ham United,Burnley,1-0,1,0,1,1,1,1,H
1930-04-09,1929,Bolton Wanderers,Newcastle United,1-1,1,1,1,1,2,0,D
1930-04-09,1929,Leeds United,Sheffield Wednesday,3-0,3,0,1,1,3,3,H
1930-04-09,1929,Middlesbrough,Arsenal,1-1,1,1,1,1,2,0,D
1930-04-12,1929,Arsenal,Sheffield United,8-1,8,1,1,1,9,7,H
1930-04-12,1929,Aston Villa,Newcastle United,2-0,2,0,1,1,2,2,H
1930-04-12,1929,Burnley,Liverpool,4-1,4,1,1,1,5,3,H
1930-04-12,1929,Derby County,Leicester City,2-2,2,2,1,1,4,0,D
1930-04-12,1929,Everton,Grimsby Town,2-4,2,4,1,1,6,-2,A
1930-04-12,1929,Leeds United,Blackburn Rovers,4-2,4,2,1,1,6,2,H
1930-04-12,1929,Manchester City,Birmingham City,1-4,1,4,1,1,5,-3,A
1930-04-12,1929,Portsmouth,Huddersfield Town,0-1,0,1,1,1,1,-1,A
1930-04-12,1929,Sheffield Wednesday,Middlesbrough,1-0,1,0,1,1,1,1,H
1930-04-12,1929,Sunderland,West Ham United,4-2,4,2,1,1,6,2,H
1930-04-14,1929,Manchester United,Sheffield Wednesday,2-2,2,2,1,1,4,0,D
1930-04-18,1929,Arsenal,Leicester City,1-1,1,1,1,1,2,0,D
1930-04-18,1929,Bolton Wanderers,Sunderland,3-0,3,0,1,1,3,3,H
1930-04-18,1929,Everton,Burnley,3-0,3,0,1,1,3,3,H
1930-04-18,1929,Grimsby Town,Birmingham City,2-1,2,1,1,1,3,1,H
1930-04-18,1929,Manchester United,Huddersfield Town,1-0,1,0,1,1,1,1,H
1930-04-18,1929,Newcastle United,Liverpool,3-1,3,1,1,1,4,2,H
1930-04-18,1929,Portsmouth,Aston Villa,1-2,1,2,1,1,3,-1,A
1930-04-18,1929,West Ham United,Sheffield United,1-0,1,0,1,1,1,1,H
1930-04-19,1929,Birmingham City,Portsmouth,1-0,1,0,1,1,1,1,H
1930-04-19,1929,Blackburn Rovers,Sheffield Wednesday,0-1,0,1,1,1,1,-1,A
1930-04-19,1929,Grimsby Town,Derby County,2-1,2,1,1,1,3,1,H
1930-04-19,1929,Huddersfield Town,Arsenal,2-2,2,2,1,1,4,0,D
1930-04-19,1929,Leicester City,Manchester City,3-1,3,1,1,1,4,2,H
1930-04-19,1929,Liverpool,Sunderland,0-6,0,6,1,1,6,-6,A
1930-04-19,1929,Manchester United,Everton,3-3,3,3,1,1,6,0,D
1930-04-19,1929,Middlesbrough,Burnley,3-1,3,1,1,1,4,2,H
1930-04-19,1929,Newcastle United,Leeds United,2-1,2,1,1,1,3,1,H
1930-04-19,1929,Sheffield United,Aston Villa,3-3,3,3,1,1,6,0,D
1930-04-19,1929,West Ham United,Bolton Wanderers,5-3,5,3,1,1,8,2,H
1930-04-21,1929,Aston Villa,Portsmouth,0-1,0,1,1,1,1,-1,A
1930-04-21,1929,Derby County,Sheffield Wednesday,4-1,4,1,1,1,5,3,H
1930-04-21,1929,Leicester City,Arsenal,6-6,6,6,1,1,12,0,D
1930-04-21,1929,Liverpool,Newcastle United,0-0,0,0,1,1,0,0,D
1930-04-21,1929,Manchester City,Leeds United,4-1,4,1,1,1,5,3,H
1930-04-21,1929,Middlesbrough,Blackburn Rovers,2-4,2,4,1,1,6,-2,A
1930-04-21,1929,Sunderland,Bolton Wanderers,4-1,4,1,1,1,5,3,H
1930-04-22,1929,Birmingham City,Grimsby Town,0-2,0,2,1,1,2,-2,A
1930-04-22,1929,Huddersfield Town,Manchester United,2-2,2,2,1,1,4,0,D
1930-04-22,1929,Leeds United,Manchester City,3-2,3,2,1,1,5,1,H
1930-04-22,1929,Sheffield Wednesday,Derby County,6-3,6,3,1,1,9,3,H
1930-04-26,1929,Aston Villa,West Ham United,2-3,2,3,1,1,5,-1,A
1930-04-26,1929,Derby County,Newcastle United,3-1,3,1,1,1,4,2,H
1930-04-26,1929,Everton,Sheffield United,3-2,3,2,1,1,5,1,H
1930-04-26,1929,Leeds United,Manchester United,3-1,3,1,1,1,4,2,H
1930-04-26,1929,Manchester City,Blackburn Rovers,1-1,1,1,1,1,2,0,D
1930-04-26,1929,Portsmouth,Middlesbrough,1-1,1,1,1,1,2,0,D
1930-04-26,1929,Sheffield Wednesday,Grimsby Town,1-0,1,0,1,1,1,1,H
1930-04-26,1929,Sunderland,Birmingham City,2-0,2,0,1,1,2,2,H
1930-04-28,1929,Arsenal,Sunderland,0-1,0,1,1,1,1,-1,A
1930-04-28,1929,Huddersfield Town,Everton,1-2,1,2,1,1,3,-1,A
1930-04-28,1929,Sheffield Wednesday,Birmingham City,1-1,1,1,1,1,2,0,D
1930-04-30,1929,Sunderland,Sheffield Wednesday,2-4,2,4,1,1,6,-2,A
1930-05-03,1929,Arsenal,Aston Villa,2-4,2,4,1,1,6,-2,A
1930-05-03,1929,Birmingham City,Leicester City,3-0,3,0,1,1,3,3,H
1930-05-03,1929,Blackburn Rovers,Liverpool,1-0,1,0,1,1,1,1,H
1930-05-03,1929,Burnley,Derby County,6-2,6,2,1,1,8,4,H
1930-05-03,1929,Everton,Sunderland,4-1,4,1,1,1,5,3,H
1930-05-03,1929,Huddersfield Town,Grimsby Town,0-1,0,1,1,1,1,-1,A
1930-05-03,1929,Manchester United,Sheffield United,1-5,1,5,1,1,6,-4,A
1930-05-03,1929,Middlesbrough,Bolton Wanderers,3-1,3,1,1,1,4,2,H
1930-05-03,1929,Newcastle United,West Ham United,1-0,1,0,1,1,1,1,H
1930-05-03,1929,Portsmouth,Leeds United,0-0,0,0,1,1,0,0,D
1930-05-03,1929,Sheffield Wednesday,Manchester City,5-1,5,1,1,1,6,4,H
1930-08-30,1930,Birmingham City,Sheffield United,3-1,3,1,1,1,4,2,H
1930-08-30,1930,Blackpool,Arsenal,1-4,1,4,1,1,5,-3,A
1930-08-30,1930,Bolton Wanderers,Middlesbrough,3-0,3,0,1,1,3,3,H
1930-08-30,1930,Grimsby Town,Chelsea,0-1,0,1,1,1,1,-1,A
1930-08-30,1930,Leeds United,Portsmouth,2-2,2,2,1,1,4,0,D
1930-08-30,1930,Leicester City,Derby County,1-1,1,1,1,1,2,0,D
1930-08-30,1930,Liverpool,Blackburn Rovers,2-1,2,1,1,1,3,1,H
1930-08-30,1930,Manchester United,Aston Villa,3-4,3,4,1,1,7,-1,A
1930-08-30,1930,Sheffield Wednesday,Newcastle United,2-1,2,1,1,1,3,1,H
1930-08-30,1930,Sunderland,Manchester City,3-3,3,3,1,1,6,0,D
1930-08-30,1930,West Ham United,Huddersfield Town,2-1,2,1,1,1,3,1,H
1930-09-01,1930,Aston Villa,Sheffield Wednesday,2-0,2,0,1,1,2,2,H
1930-09-01,1930,Blackburn Rovers,Portsmouth,1-2,1,2,1,1,3,-1,A
1930-09-01,1930,Bolton Wanderers,Arsenal,1-4,1,4,1,1,5,-3,A
1930-09-01,1930,Huddersfield Town,Grimsby Town,2-2,2,2,1,1,4,0,D
1930-09-01,1930,Leicester City,Birmingham City,2-1,2,1,1,1,3,1,H
1930-09-01,1930,West Ham United,Liverpool,7-0,7,0,1,1,7,7,H
1930-09-03,1930,Derby County,Leeds United,4-1,4,1,1,1,5,3,H
1930-09-03,1930,Manchester City,Blackpool,2-4,2,4,1,1,6,-2,A
1930-09-03,1930,Middlesbrough,Manchester United,3-1,3,1,1,1,4,2,H
1930-09-03,1930,Newcastle United,Chelsea,1-0,1,0,1,1,1,1,H
1930-09-03,1930,Sheffield United,Sunderland,3-3,3,3,1,1,6,0,D
1930-09-06,1930,Arsenal,Leeds United,3-1,3,1,1,1,4,2,H
1930-09-06,1930,Aston Villa,West Ham United,6-1,6,1,1,1,7,5,H
1930-09-06,1930,Blackburn Rovers,Blackpool,5-0,5,0,1,1,5,5,H
1930-09-06,1930,Chelsea,Manchester United,6-2,6,2,1,1,8,4,H
1930-09-06,1930,Derby County,Birmingham City,0-0,0,0,1,1,0,0,D
1930-09-06,1930,Huddersfield Town,Bolton Wanderers,3-2,3,2,1,1,5,1,H
1930-09-06,1930,Manchester City,Leicester City,0-2,0,2,1,1,2,-2,A
1930-09-06,1930,Middlesbrough,Liverpool,3-3,3,3,1,1,6,0,D
1930-09-06,1930,Newcastle United,Grimsby Town,1-2,1,2,1,1,3,-1,A
1930-09-06,1930,Portsmouth,Sunderland,1-1,1,1,1,1,2,0,D
1930-09-06,1930,Sheffield United,Sheffield Wednesday,1-1,1,1,1,1,2,0,D
1930-09-08,1930,Leeds United,Manchester City,4-2,4,2,1,1,6,2,H
1930-09-08,1930,Leicester City,Sheffield United,2-2,2,2,1,1,4,0,D
1930-09-08,1930,Sheffield Wednesday,Chelsea,1-1,1,1,1,1,2,0,D
1930-09-08,1930,West Ham United,Middlesbrough,0-3,0,3,1,1,3,-3,A
1930-09-09,1930,Grimsby Town,Aston Villa,1-2,1,2,1,1,3,-1,A
1930-09-10,1930,Arsenal,Blackburn Rovers,3-2,3,2,1,1,5,1,H
1930-09-10,1930,Birmingham City,Newcastle United,1-1,1,1,1,1,2,0,D
1930-09-10,1930,Blackpool,Portsmouth,2-2,2,2,1,1,4,0,D
1930-09-10,1930,Liverpool,Bolton Wanderers,7-2,7,2,1,1,9,5,H
1930-09-10,1930,Manchester United,Huddersfield Town,0-6,0,6,1,1,6,-6,A
1930-09-10,1930,Sunderland,Derby County,1-3,1,3,1,1,4,-2,A
1930-09-13,1930,Birmingham City,Manchester City,3-2,3,2,1,1,5,1,H
1930-09-13,1930,Blackpool,Middlesbrough,3-2,3,2,1,1,5,1,H
1930-09-13,1930,Bolton Wanderers,Aston Villa,1-1,1,1,1,1,2,0,D
1930-09-13,1930,Grimsby Town,Sheffield Wednesday,2-3,2,3,1,1,5,-1,A
1930-09-13,1930,Leeds United,Blackburn Rovers,4-2,4,2,1,1,6,2,H
1930-09-13,1930,Leicester City,Portsmouth,3-1,3,1,1,1,4,2,H
1930-09-13,1930,Liverpool,Huddersfield Town,1-4,1,4,1,1,5,-3,A
1930-09-13,1930,Manchester United,Newcastle United,4-7,4,7,1,1,11,-3,A
1930-09-13,1930,Sheffield United,Derby County,3-3,3,3,1,1,6,0,D
1930-09-13,1930,Sunderland,Arsenal,1-4,1,4,1,1,5,-3,A
1930-09-13,1930,West Ham United,Chelsea,4-1,4,1,1,1,5,3,H
1930-09-15,1930,Aston Villa,Grimsby Town,2-0,2,0,1,1,2,2,H
1930-09-15,1930,Blackburn Rovers,Arsenal,2-2,2,2,1,1,4,0,D
1930-09-15,1930,Chelsea,Sheffield Wednesday,0-0,0,0,1,1,0,0,D
1930-09-15,1930,Huddersfield Town,Manchester United,3-0,3,0,1,1,3,3,H
1930-09-17,1930,Derby County,Sunderland,4-1,4,1,1,1,5,3,H
1930-09-17,1930,Manchester City,Leeds United,1-0,1,0,1,1,1,1,H
1930-09-17,1930,Middlesbrough,West Ham United,2-2,2,2,1,1,4,0,D
1930-09-17,1930,Newcastle United,Birmingham City,2-2,2,2,1,1,4,0,D
1930-09-17,1930,Portsmouth,Blackpool,4-3,4,3,1,1,7,1,H
1930-09-20,1930,Arsenal,Leicester City,4-1,4,1,1,1,5,3,H
1930-09-20,1930,Aston Villa,Liverpool,4-2,4,2,1,1,6,2,H
1930-09-20,1930,Blackburn Rovers,Sunderland,3-0,3,0,1,1,3,3,H
1930-09-20,1930,Blackpool,Leeds United,3-7,3,7,1,1,10,-4,A
1930-09-20,1930,Chelsea,Bolton Wanderers,0-1,0,1,1,1,1,-1,A
1930-09-20,1930,Derby County,Grimsby Town,1-0,1,0,1,1,1,1,H
1930-09-20,1930,Huddersfield Town,Middlesbrough,2-2,2,2,1,1,4,0,D
1930-09-20,1930,Manchester City,Sheffield United,0-4,0,4,1,1,4,-4,A
1930-09-20,1930,Newcastle United,West Ham United,4-2,4,2,1,1,6,2,H
1930-09-20,1930,Portsmouth,Birmingham City,2-2,2,2,1,1,4,0,D
1930-09-20,1930,Sheffield Wednesday,Manchester United,3-0,3,0,1,1,3,3,H
1930-09-24,1930,Sheffield United,Leicester City,0-2,0,2,1,1,2,-2,A
1930-09-27,1930,Birmingham City,Arsenal,2-4,2,4,1,1,6,-2,A
1930-09-27,1930,Bolton Wanderers,Newcastle United,0-3,0,3,1,1,3,-3,A
1930-09-27,1930,Derby County,Manchester City,1-1,1,1,1,1,2,0,D
1930-09-27,1930,Leeds United,Huddersfield Town,1-2,1,2,1,1,3,-1,A
1930-09-27,1930,Leicester City,Blackburn Rovers,3-1,3,1,1,1,4,2,H
1930-09-27,1930,Liverpool,Chelsea,3-1,3,1,1,1,4,2,H
1930-09-27,1930,Manchester United,Grimsby Town,0-2,0,2,1,1,2,-2,A
1930-09-27,1930,Middlesbrough,Aston Villa,3-1,3,1,1,1,4,2,H
1930-09-27,1930,Sheffield United,Portsmouth,3-1,3,1,1,1,4,2,H
1930-09-27,1930,Sunderland,Blackpool,2-4,2,4,1,1,6,-2,A
1930-09-27,1930,West Ham United,Sheffield Wednesday,3-3,3,3,1,1,6,0,D
1930-10-04,1930,Arsenal,Sheffield United,1-1,1,1,1,1,2,0,D
1930-10-04,1930,Aston Villa,Huddersfield Town,6-1,6,1,1,1,7,5,H
1930-10-04,1930,Blackburn Rovers,Birmingham City,2-1,2,1,1,1,3,1,H
1930-10-04,1930,Blackpool,Leicester City,5-4,5,4,1,1,9,1,H
1930-10-04,1930,Chelsea,Middlesbrough,4-0,4,0,1,1,4,4,H
1930-10-04,1930,Grimsby Town,West Ham United,4-0,4,0,1,1,4,4,H
1930-10-04,1930,Leeds United,Sunderland,0-3,0,3,1,1,3,-3,A
1930-10-04,1930,Manchester City,Manchester United,4-1,4,1,1,1,5,3,H
1930-10-04,1930,Newcastle United,Liverpool,0-4,0,4,1,1,4,-4,A
1930-10-04,1930,Portsmouth,Derby County,2-0,2,0,1,1,2,2,H
1930-10-04,1930,Sheffield Wednesday,Bolton Wanderers,1-0,1,0,1,1,1,1,H
1930-10-11,1930,Birmingham City,Blackpool,1-1,1,1,1,1,2,0,D
1930-10-11,1930,Bolton Wanderers,Grimsby Town,4-2,4,2,1,1,6,2,H
1930-10-11,1930,Derby County,Arsenal,4-2,4,2,1,1,6,2,H
1930-10-11,1930,Huddersfield Town,Chelsea,1-1,1,1,1,1,2,0,D
1930-10-11,1930,Leicester City,Leeds United,4-0,4,0,1,1,4,4,H
1930-10-11,1930,Liverpool,Sheffield Wednesday,1-2,1,2,1,1,3,-1,A
1930-10-11,1930,Manchester City,Portsmouth,1-3,1,3,1,1,4,-2,A
1930-10-11,1930,Middlesbrough,Newcastle United,3-1,3,1,1,1,4,2,H
1930-10-11,1930,Sheffield United,Blackburn Rovers,1-1,1,1,1,1,2,0,D
1930-10-11,1930,Sunderland,Aston Villa,1-1,1,1,1,1,2,0,D
1930-10-11,1930,West Ham United,Manchester United,5-1,5,1,1,1,6,4,H
1930-10-18,1930,Aston Villa,Birmingham City,1-1,1,1,1,1,2,0,D
1930-10-18,1930,Bolton Wanderers,Blackpool,1-0,1,0,1,1,1,1,H
1930-10-18,1930,Chelsea,Sheffield United,1-0,1,0,1,1,1,1,H
1930-10-18,1930,Grimsby Town,Portsmouth,0-3,0,3,1,1,3,-3,A
1930-10-18,1930,Huddersfield Town,Leicester City,4-1,4,1,1,1,5,3,H
1930-10-18,1930,Liverpool,Leeds United,2-0,2,0,1,1,2,2,H
1930-10-18,1930,Manchester United,Arsenal,1-2,1,2,1,1,3,-1,A
1930-10-18,1930,Middlesbrough,Sunderland,1-0,1,0,1,1,1,1,H
1930-10-18,1930,Newcastle United,Derby County,2-5,2,5,1,1,7,-3,A
1930-10-18,1930,Sheffield Wednesday,Manchester City,1-1,1,1,1,1,2,0,D
1930-10-18,1930,West Ham United,Blackburn Rovers,4-3,4,3,1,1,7,1,H
1930-10-25,1930,Arsenal,West Ham United,1-1,1,1,1,1,2,0,D
1930-10-25,1930,Birmingham City,Chelsea,6-2,6,2,1,1,8,4,H
1930-10-25,1930,Blackburn Rovers,Bolton Wanderers,2-2,2,2,1,1,4,0,D
1930-10-25,1930,Blackpool,Liverpool,1-3,1,3,1,1,4,-2,A
1930-10-25,1930,Derby County,Sheffield Wednesday,2-3,2,3,1,1,5,-1,A
1930-10-25,1930,Leeds United,Middlesbrough,7-0,7,0,1,1,7,7,H
1930-10-25,1930,Leicester City,Aston Villa,4-1,4,1,1,1,5,3,H
1930-10-25,1930,Manchester City,Grimsby Town,1-0,1,0,1,1,1,1,H
1930-10-25,1930,Portsmouth,Manchester United,4-1,4,1,1,1,5,3,H
1930-10-25,1930,Sheffield United,Newcastle United,3-1,3,1,1,1,4,2,H
1930-10-25,1930,Sunderland,Huddersfield Town,4-2,4,2,1,1,6,2,H
1930-11-01,1930,Aston Villa,Blackburn Rovers,5-2,5,2,1,1,7,3,H
1930-11-01,1930,Bolton Wanderers,Derby County,1-2,1,2,1,1,3,-1,A
1930-11-01,1930,Chelsea,Blackpool,3-0,3,0,1,1,3,3,H
1930-11-01,1930,Grimsby Town,Leicester City,8-2,8,2,1,1,10,6,H
1930-11-01,1930,Huddersfield Town,Arsenal,1-1,1,1,1,1,2,0,D
1930-11-01,1930,Liverpool,Manchester City,0-2,0,2,1,1,2,-2,A
1930-11-01,1930,Manchester United,Birmingham City,2-0,2,0,1,1,2,2,H
1930-11-01,1930,Middlesbrough,Portsmouth,0-1,0,1,1,1,1,-1,A
1930-11-01,1930,Newcastle United,Leeds United,4-1,4,1,1,1,5,3,H
1930-11-01,1930,Sheffield Wednesday,Sunderland,7-2,7,2,1,1,9,5,H
1930-11-01,1930,West Ham United,Sheffield United,4-1,4,1,1,1,5,3,H
1930-11-08,1930,Arsenal,Aston Villa,5-2,5,2,1,1,7,3,H
1930-11-08,1930,Birmingham City,West Ham United,0-2,0,2,1,1,2,-2,A
1930-11-08,1930,Blackburn Rovers,Chelsea,2-0,2,0,1,1,2,2,H
1930-11-08,1930,Blackpool,Newcastle United,0-0,0,0,1,1,0,0,D
1930-11-08,1930,Derby County,Liverpool,2-2,2,2,1,1,4,0,D
1930-11-08,1930,Leeds United,Sheffield Wednesday,2-3,2,3,1,1,5,-1,A
1930-11-08,1930,Leicester City,Manchester United,5-4,5,4,1,1,9,1,H
1930-11-08,1930,Manchester City,Middlesbrough,4-2,4,2,1,1,6,2,H
1930-11-08,1930,Portsmouth,Huddersfield Town,2-2,2,2,1,1,4,0,D
1930-11-08,1930,Sheffield United,Bolton Wanderers,2-0,2,0,1,1,2,2,H
1930-11-08,1930,Sunderland,Grimsby Town,3-2,3,2,1,1,5,1,H
1930-11-15,1930,Aston Villa,Derby County,4-6,4,6,1,1,10,-2,A
1930-11-15,1930,Bolton Wanderers,Sunderland,2-2,2,2,1,1,4,0,D
1930-11-15,1930,Chelsea,Manchester City,2-0,2,0,1,1,2,2,H
1930-11-15,1930,Grimsby Town,Blackburn Rovers,2-0,2,0,1,1,2,2,H
1930-11-15,1930,Huddersfield Town,Sheffield United,1-1,1,1,1,1,2,0,D
1930-11-15,1930,Liverpool,Leicester City,3-1,3,1,1,1,4,2,H
1930-11-15,1930,Manchester United,Blackpool,0-0,0,0,1,1,0,0,D
1930-11-15,1930,Middlesbrough,Birmingham City,1-1,1,1,1,1,2,0,D
1930-11-15,1930,Newcastle United,Portsmouth,4-7,4,7,1,1,11,-3,A
1930-11-15,1930,Sheffield Wednesday,Arsenal,1-2,1,2,1,1,3,-1,A
1930-11-15,1930,West Ham United,Leeds United,1-1,1,1,1,1,2,0,D
1930-11-22,1930,Arsenal,Middlesbrough,5-3,5,3,1,1,8,2,H
1930-11-22,1930,Birmingham City,Grimsby Town,4-1,4,1,1,1,5,3,H
1930-11-22,1930,Blackburn Rovers,Huddersfield Town,5-3,5,3,1,1,8,2,H
1930-11-22,1930,Blackpool,Aston Villa,2-2,2,2,1,1,4,0,D
1930-11-22,1930,Derby County,West Ham United,1-1,1,1,1,1,2,0,D
1930-11-22,1930,Leeds United,Chelsea,2-3,2,3,1,1,5,-1,A
1930-11-22,1930,Leicester City,Sheffield Wednesday,2-5,2,5,1,1,7,-3,A
1930-11-22,1930,Manchester City,Bolton Wanderers,3-0,3,0,1,1,3,3,H
1930-11-22,1930,Portsmouth,Liverpool,4-0,4,0,1,1,4,4,H
1930-11-22,1930,Sheffield United,Manchester United,3-1,3,1,1,1,4,2,H
1930-11-22,1930,Sunderland,Newcastle United,5-0,5,0,1,1,5,5,H
1930-11-29,1930,Bolton Wanderers,Birmingham City,2-0,2,0,1,1,2,2,H
1930-11-29,1930,Chelsea,Arsenal,1-5,1,5,1,1,6,-4,A
1930-11-29,1930,Grimsby Town,Leeds United,2-0,2,0,1,1,2,2,H
1930-11-29,1930,Huddersfield Town,Manchester City,1-1,1,1,1,1,2,0,D
1930-11-29,1930,Liverpool,Sheffield United,6-1,6,1,1,1,7,5,H
1930-11-29,1930,Manchester United,Sunderland,1-1,1,1,1,1,2,0,D
1930-11-29,1930,Middlesbrough,Derby County,4-1,4,1,1,1,5,3,H
1930-11-29,1930,Newcastle United,Blackburn Rovers,2-3,2,3,1,1,5,-1,A
1930-11-29,1930,Sheffield Wednesday,Blackpool,7-1,7,1,1,1,8,6,H
1930-11-29,1930,West Ham United,Leicester City,2-0,2,0,1,1,2,2,H
1930-12-03,1930,Aston Villa,Portsmouth,2-2,2,2,1,1,4,0,D
1930-12-06,1930,Birmingham City,Huddersfield Town,2-0,2,0,1,1,2,2,H
1930-12-06,1930,Blackburn Rovers,Manchester United,4-1,4,1,1,1,5,3,H
1930-12-06,1930,Blackpool,West Ham United,1-3,1,3,1,1,4,-2,A
1930-12-06,1930,Derby County,Chelsea,6-2,6,2,1,1,8,4,H
1930-12-06,1930,Leeds United,Bolton Wanderers,3-1,3,1,1,1,4,2,H
1930-12-06,1930,Leicester City,Middlesbrough,0-3,0,3,1,1,3,-3,A
1930-12-06,1930,Manchester City,Newcastle United,2-0,2,0,1,1,2,2,H
1930-12-06,1930,Portsmouth,Sheffield Wednesday,2-4,2,4,1,1,6,-2,A
1930-12-06,1930,Sheffield United,Aston Villa,3-4,3,4,1,1,7,-1,A
1930-12-06,1930,Sunderland,Liverpool,6-5,6,5,1,1,11,1,H
1930-12-13,1930,Aston Villa,Leeds United,4-3,4,3,1,1,7,1,H
1930-12-13,1930,Bolton Wanderers,Portsmouth,3-1,3,1,1,1,4,2,H
1930-12-13,1930,Chelsea,Sunderland,5-0,5,0,1,1,5,5,H
1930-12-13,1930,Grimsby Town,Sheffield United,2-1,2,1,1,1,3,1,H
1930-12-13,1930,Huddersfield Town,Blackpool,10-1,10,1,1,1,11,9,H
1930-12-13,1930,Liverpool,Arsenal,1-1,1,1,1,1,2,0,D
1930-12-13,1930,Manchester United,Derby County,2-1,2,1,1,1,3,1,H
1930-12-13,1930,Middlesbrough,Blackburn Rovers,4-1,4,1,1,1,5,3,H
1930-12-13,1930,Newcastle United,Leicester City,5-2,5,2,1,1,7,3,H
1930-12-13,1930,Sheffield Wednesday,Birmingham City,9-1,9,1,1,1,10,8,H
1930-12-13,1930,West Ham United,Manchester City,2-0,2,0,1,1,2,2,H
1930-12-20,1930,Arsenal,Newcastle United,1-2,1,2,1,1,3,-1,A
1930-12-20,1930,Birmingham City,Liverpool,2-0,2,0,1,1,2,2,H
1930-12-20,1930,Blackburn Rovers,Sheffield Wednesday,5-2,5,2,1,1,7,3,H
1930-12-20,1930,Blackpool,Grimsby Town,3-1,3,1,1,1,4,2,H
1930-12-20,1930,Derby County,Huddersfield Town,4-1,4,1,1,1,5,3,H
1930-12-20,1930,Leeds United,Manchester United,5-0,5,0,1,1,5,5,H
1930-12-20,1930,Leicester City,Bolton Wanderers,2-1,2,1,1,1,3,1,H
1930-12-20,1930,Manchester City,Aston Villa,3-1,3,1,1,1,4,2,H
1930-12-20,1930,Portsmouth,Chelsea,1-1,1,1,1,1,2,0,D
1930-12-20,1930,Sheffield United,Middlesbrough,4-2,4,2,1,1,6,2,H
1930-12-20,1930,Sunderland,West Ham United,6-1,6,1,1,1,7,5,H
1930-12-25,1930,Birmingham City,Leeds United,0-1,0,1,1,1,1,-1,A
1930-12-25,1930,Blackburn Rovers,Derby County,1-0,1,0,1,1,1,1,H
1930-12-25,1930,Blackpool,Sheffield United,2-1,2,1,1,1,3,1,H
1930-12-25,1930,Bolton Wanderers,Manchester United,3-1,3,1,1,1,4,2,H
1930-12-25,1930,Chelsea,Aston Villa,0-2,0,2,1,1,2,-2,A
1930-12-25,1930,Grimsby Town,Liverpool,0-0,0,0,1,1,0,0,D
1930-12-25,1930,Manchester City,Arsenal,1-4,1,4,1,1,5,-3,A
1930-12-25,1930,Sunderland,Leicester City,2-5,2,5,1,1,7,-3,A
1930-12-25,1930,West Ham United,Portsmouth,4-3,4,3,1,1,7,1,H
1930-12-26,1930,Arsenal,Manchester City,3-1,3,1,1,1,4,2,H
1930-12-26,1930,Aston Villa,Chelsea,3-3,3,3,1,1,6,0,D
1930-12-26,1930,Derby County,Blackburn Rovers,1-1,1,1,1,1,2,0,D
1930-12-26,1930,Huddersfield Town,Newcastle United,0-3,0,3,1,1,3,-3,A
1930-12-26,1930,Leeds United,Birmingham City,3-1,3,1,1,1,4,2,H
1930-12-26,1930,Leicester City,Sunderland,1-1,1,1,1,1,2,0,D
1930-12-26,1930,Liverpool,Grimsby Town,1-1,1,1,1,1,2,0,D
1930-12-26,1930,Manchester United,Bolton Wanderers,1-1,1,1,1,1,2,0,D
1930-12-26,1930,Middlesbrough,Sheffield Wednesday,2-0,2,0,1,1,2,2,H
1930-12-26,1930,Portsmouth,West Ham United,2-0,2,0,1,1,2,2,H
1930-12-26,1930,Sheffield United,Blackpool,5-1,5,1,1,1,6,4,H
1930-12-27,1930,Arsenal,Blackpool,7-1,7,1,1,1,8,6,H
1930-12-27,1930,Aston Villa,Manchester United,7-0,7,0,1,1,7,7,H
1930-12-27,1930,Blackburn Rovers,Liverpool,3-3,3,3,1,1,6,0,D
1930-12-27,1930,Chelsea,Grimsby Town,5-0,5,0,1,1,5,5,H
1930-12-27,1930,Derby County,Leicester City,1-0,1,0,1,1,1,1,H
1930-12-27,1930,Huddersfield Town,West Ham United,2-0,2,0,1,1,2,2,H
1930-12-27,1930,Manchester City,Sunderland,2-0,2,0,1,1,2,2,H
1930-12-27,1930,Middlesbrough,Bolton Wanderers,3-0,3,0,1,1,3,3,H
1930-12-27,1930,Newcastle United,Sheffield Wednesday,1-2,1,2,1,1,3,-1,A
1930-12-27,1930,Portsmouth,Leeds United,1-1,1,1,1,1,2,0,D
1930-12-27,1930,Sheffield United,Birmingham City,3-1,3,1,1,1,4,2,H
1930-12-29,1930,Sheffield Wednesday,Middlesbrough,3-2,3,2,1,1,5,1,H
1931-01-01,1930,Blackburn Rovers,Manchester City,0-1,0,1,1,1,1,-1,A
1931-01-01,1930,Manchester United,Leeds United,0-0,0,0,1,1,0,0,D
1931-01-01,1930,Middlesbrough,Grimsby Town,2-1,2,1,1,1,3,1,H
1931-01-01,1930,Newcastle United,Aston Villa,2-0,2,0,1,1,2,2,H
1931-01-01,1930,Sheffield Wednesday,Huddersfield Town,2-1,2,1,1,1,3,1,H
1931-01-03,1930,Birmingham City,Derby County,1-2,1,2,1,1,3,-1,A
1931-01-03,1930,Blackpool,Blackburn Rovers,1-1,1,1,1,1,2,0,D
1931-01-03,1930,Bolton Wanderers,Huddersfield Town,1-0,1,0,1,1,1,1,H
1931-01-03,1930,Grimsby Town,Newcastle United,2-2,2,2,1,1,4,0,D
1931-01-03,1930,Leicester City,Manchester City,3-2,3,2,1,1,5,1,H
1931-01-03,1930,Liverpool,Middlesbrough,3-1,3,1,1,1,4,2,H
1931-01-03,1930,Manchester United,Chelsea,1-0,1,0,1,1,1,1,H
1931-01-03,1930,Sheffield Wednesday,Sheffield United,1-3,1,3,1,1,4,-2,A
1931-01-03,1930,Sunderland,Portsmouth,0-0,0,0,1,1,0,0,D
1931-01-03,1930,West Ham United,Aston Villa,5-5,5,5,1,1,10,0,D
1931-01-14,1930,Bolton Wanderers,Liverpool,2-0,2,0,1,1,2,2,H
1931-01-17,1930,Arsenal,Sunderland,1-3,1,3,1,1,4,-2,A
1931-01-17,1930,Aston Villa,Bolton Wanderers,3-1,3,1,1,1,4,2,H
1931-01-17,1930,Blackburn Rovers,Leeds United,3-1,3,1,1,1,4,2,H
1931-01-17,1930,Chelsea,West Ham United,2-1,2,1,1,1,3,1,H
1931-01-17,1930,Derby County,Sheffield United,4-3,4,3,1,1,7,1,H
1931-01-17,1930,Huddersfield Town,Liverpool,2-1,2,1,1,1,3,1,H
1931-01-17,1930,Manchester City,Birmingham City,4-2,4,2,1,1,6,2,H
1931-01-17,1930,Middlesbrough,Blackpool,5-1,5,1,1,1,6,4,H
1931-01-17,1930,Newcastle United,Manchester United,4-3,4,3,1,1,7,1,H
1931-01-17,1930,Portsmouth,Leicester City,2-1,2,1,1,1,3,1,H
1931-01-17,1930,Sheffield Wednesday,Grimsby Town,4-1,4,1,1,1,5,3,H
1931-01-24,1930,Liverpool,Aston Villa,1-1,1,1,1,1,2,0,D
1931-01-24,1930,Middlesbrough,Huddersfield Town,2-3,2,3,1,1,5,-1,A
1931-01-26,1930,West Ham United,Newcastle United,3-2,3,2,1,1,5,1,H
1931-01-28,1930,Arsenal,Grimsby Town,9-1,9,1,1,1,10,8,H
1931-01-28,1930,Birmingham City,Portsmouth,2-1,2,1,1,1,3,1,H
1931-01-28,1930,Leeds United,Blackpool,2-2,2,2,1,1,4,0,D
1931-01-28,1930,Manchester United,Sheffield Wednesday,4-1,4,1,1,1,5,3,H
1931-01-28,1930,Sheffield United,Manchester City,2-2,2,2,1,1,4,0,D
1931-01-31,1930,Arsenal,Birmingham City,1-1,1,1,1,1,2,0,D
1931-01-31,1930,Aston Villa,Middlesbrough,8-1,8,1,1,1,9,7,H
1931-01-31,1930,Blackpool,Sunderland,3-1,3,1,1,1,4,2,H
1931-01-31,1930,Chelsea,Liverpool,2-2,2,2,1,1,4,0,D
1931-01-31,1930,Grimsby Town,Manchester United,2-1,2,1,1,1,3,1,H
1931-01-31,1930,Huddersfield Town,Leeds United,3-0,3,0,1,1,3,3,H
1931-01-31,1930,Manchester City,Derby County,4-3,4,3,1,1,7,1,H
1931-01-31,1930,Newcastle United,Bolton Wanderers,4-0,4,0,1,1,4,4,H
1931-01-31,1930,Portsmouth,Sheffield United,2-3,2,3,1,1,5,-1,A
1931-01-31,1930,Sheffield Wednesday,West Ham United,5-3,5,3,1,1,8,2,H
1931-02-03,1930,Grimsby Town,Derby County,5-3,5,3,1,1,8,2,H
1931-02-04,1930,Bolton Wanderers,Chelsea,1-1,1,1,1,1,2,0,D
1931-02-04,1930,Sunderland,Blackburn Rovers,8-2,8,2,1,1,10,6,H
1931-02-05,1930,Leicester City,Arsenal,2-7,2,7,1,1,9,-5,A
1931-02-07,1930,Birmingham City,Blackburn Rovers,4-1,4,1,1,1,5,3,H
1931-02-07,1930,Bolton Wanderers,Sheffield Wednesday,2-2,2,2,1,1,4,0,D
1931-02-07,1930,Derby County,Portsmouth,5-1,5,1,1,1,6,4,H
1931-02-07,1930,Huddersfield Town,Aston Villa,1-6,1,6,1,1,7,-5,A
1931-02-07,1930,Leicester City,Blackpool,6-0,6,0,1,1,6,6,H
1931-02-07,1930,Liverpool,Newcastle United,4-2,4,2,1,1,6,2,H
1931-02-07,1930,Manchester United,Manchester City,1-3,1,3,1,1,4,-2,A
1931-02-07,1930,Middlesbrough,Chelsea,2-2,2,2,1,1,4,0,D
1931-02-07,1930,Sheffield United,Arsenal,1-1,1,1,1,1,2,0,D
1931-02-07,1930,Sunderland,Leeds United,4-0,4,0,1,1,4,4,H
1931-02-07,1930,West Ham United,Grimsby Town,3-4,3,4,1,1,7,-1,A
1931-02-14,1930,Arsenal,Derby County,6-3,6,3,1,1,9,3,H
1931-02-14,1930,Manchester United,West Ham United,1-0,1,0,1,1,1,1,H
1931-02-14,1930,Newcastle United,Middlesbrough,0-5,0,5,1,1,5,-5,A
1931-02-14,1930,Sheffield Wednesday,Liverpool,3-5,3,5,1,1,8,-2,A
1931-02-17,1930,Grimsby Town,Bolton Wanderers,4-1,4,1,1,1,5,3,H
1931-02-18,1930,Aston Villa,Sunderland,4-2,4,2,1,1,6,2,H
1931-02-18,1930,Blackpool,Birmingham City,0-1,0,1,1,1,1,-1,A
1931-02-18,1930,Chelsea,Huddersfield Town,1-2,1,2,1,1,3,-1,A
1931-02-18,1930,Leeds United,Leicester City,1-3,1,3,1,1,4,-2,A
1931-02-18,1930,Portsmouth,Manchester City,1-1,1,1,1,1,2,0,D
1931-02-19,1930,Blackburn Rovers,Sheffield United,2-1,2,1,1,1,3,1,H
1931-02-21,1930,Arsenal,Manchester United,4-1,4,1,1,1,5,3,H
1931-02-21,1930,Birmingham City,Aston Villa,0-4,0,4,1,1,4,-4,A
1931-02-21,1930,Blackburn Rovers,West Ham United,1-0,1,0,1,1,1,1,H
1931-02-21,1930,Blackpool,Bolton Wanderers,3-3,3,3,1,1,6,0,D
1931-02-21,1930,Derby County,Newcastle United,1-5,1,5,1,1,6,-4,A
1931-02-21,1930,Leeds United,Liverpool,1-2,1,2,1,1,3,-1,A
1931-02-21,1930,Leicester City,Huddersfield Town,1-2,1,2,1,1,3,-1,A
1931-02-21,1930,Manchester City,Sheffield Wednesday,2-0,2,0,1,1,2,2,H
1931-02-21,1930,Portsmouth,Grimsby Town,4-3,4,3,1,1,7,1,H
1931-02-21,1930,Sheffield United,Chelsea,4-0,4,0,1,1,4,4,H
1931-02-21,1930,Sunderland,Middlesbrough,1-1,1,1,1,1,2,0,D
1931-02-28,1930,Aston Villa,Leicester City,4-2,4,2,1,1,6,2,H
1931-02-28,1930,Bolton Wanderers,Blackburn Rovers,1-1,1,1,1,1,2,0,D
1931-02-28,1930,Grimsby Town,Manchester City,3-5,3,5,1,1,8,-2,A
1931-02-28,1930,Liverpool,Blackpool,5-2,5,2,1,1,7,3,H
1931-02-28,1930,Middlesbrough,Leeds United,5-0,5,0,1,1,5,5,H
1931-02-28,1930,Newcastle United,Sheffield United,1-0,1,0,1,1,1,1,H
1931-02-28,1930,West Ham United,Arsenal,2-4,2,4,1,1,6,-2,A
1931-03-02,1930,Blackburn Rovers,Leicester City,3-0,3,0,1,1,3,3,H
1931-03-07,1930,Arsenal,Huddersfield Town,0-0,0,0,1,1,0,0,D
1931-03-07,1930,Birmingham City,Manchester United,0-0,0,0,1,1,0,0,D
1931-03-07,1930,Blackburn Rovers,Aston Villa,0-2,0,2,1,1,2,-2,A
1931-03-07,1930,Blackpool,Chelsea,2-1,2,1,1,1,3,1,H
1931-03-07,1930,Derby County,Bolton Wanderers,4-1,4,1,1,1,5,3,H
1931-03-07,1930,Leeds United,Newcastle United,1-0,1,0,1,1,1,1,H
1931-03-07,1930,Leicester City,Grimsby Town,0-1,0,1,1,1,1,-1,A
1931-03-07,1930,Manchester City,Liverpool,1-1,1,1,1,1,2,0,D
1931-03-07,1930,Portsmouth,Middlesbrough,1-0,1,0,1,1,1,1,H
1931-03-07,1930,Sheffield United,West Ham United,1-2,1,2,1,1,3,-1,A
1931-03-07,1930,Sunderland,Sheffield Wednesday,5-1,5,1,1,1,6,4,H
1931-03-11,1930,Leeds United,Arsenal,1-2,1,2,1,1,3,-1,A
1931-03-14,1930,Aston Villa,Arsenal,5-1,5,1,1,1,6,4,H
1931-03-14,1930,Bolton Wanderers,Sheffield United,6-2,6,2,1,1,8,4,H
1931-03-14,1930,Chelsea,Blackburn Rovers,3-2,3,2,1,1,5,1,H
1931-03-14,1930,Huddersfield Town,Portsmouth,1-3,1,3,1,1,4,-2,A
1931-03-14,1930,Liverpool,Derby County,0-0,0,0,1,1,0,0,D
1931-03-14,1930,Middlesbrough,Manchester City,4-1,4,1,1,1,5,3,H
1931-03-14,1930,Newcastle United,Blackpool,0-2,0,2,1,1,2,-2,A
1931-03-14,1930,Sheffield Wednesday,Leeds United,2-1,2,1,1,1,3,1,H
1931-03-16,1930,Huddersfield Town,Sunderland,2-0,2,0,1,1,2,2,H
1931-03-16,1930,Manchester United,Portsmouth,0-1,0,1,1,1,1,-1,A
1931-03-16,1930,West Ham United,Birmingham City,1-2,1,2,1,1,3,-1,A
1931-03-21,1930,Arsenal,Sheffield Wednesday,2-0,2,0,1,1,2,2,H
1931-03-21,1930,Birmingham City,Middlesbrough,1-2,1,2,1,1,3,-1,A
1931-03-21,1930,Blackburn Rovers,Grimsby Town,5-2,5,2,1,1,7,3,H
1931-03-21,1930,Blackpool,Manchester United,5-1,5,1,1,1,6,4,H
1931-03-21,1930,Derby County,Aston Villa,1-1,1,1,1,1,2,0,D
1931-03-21,1930,Leeds United,West Ham United,3-0,3,0,1,1,3,3,H
1931-03-21,1930,Leicester City,Liverpool,3-2,3,2,1,1,5,1,H
1931-03-21,1930,Manchester City,Chelsea,2-0,2,0,1,1,2,2,H
1931-03-21,1930,Portsmouth,Newcastle United,1-2,1,2,1,1,3,-1,A
1931-03-21,1930,Sheffield United,Huddersfield Town,0-2,0,2,1,1,2,-2,A
1931-03-21,1930,Sunderland,Bolton Wanderers,3-1,3,1,1,1,4,2,H
1931-03-24,1930,Grimsby Town,Sunderland,2-1,2,1,1,1,3,1,H
1931-03-25,1930,Chelsea,Birmingham City,1-0,1,0,1,1,1,1,H
1931-03-25,1930,Manchester United,Leicester City,0-0,0,0,1,1,0,0,D
1931-03-28,1930,Aston Villa,Blackpool,4-1,4,1,1,1,5,3,H
1931-03-28,1930,Bolton Wanderers,Manchester City,1-1,1,1,1,1,2,0,D
1931-03-28,1930,Chelsea,Leeds United,1-0,1,0,1,1,1,1,H
1931-03-28,1930,Grimsby Town,Birmingham City,4-1,4,1,1,1,5,3,H
1931-03-28,1930,Huddersfield Town,Blackburn Rovers,1-1,1,1,1,1,2,0,D
1931-03-28,1930,Liverpool,Portsmouth,3-1,3,1,1,1,4,2,H
1931-03-28,1930,Manchester United,Sheffield United,1-2,1,2,1,1,3,-1,A
1931-03-28,1930,Middlesbrough,Arsenal,2-5,2,5,1,1,7,-3,A
1931-03-28,1930,Newcastle United,Sunderland,2-0,2,0,1,1,2,2,H
1931-03-28,1930,Sheffield Wednesday,Leicester City,4-0,4,0,1,1,4,4,H
1931-03-28,1930,West Ham United,Derby County,0-1,0,1,1,1,1,-1,A
1931-04-03,1930,Blackpool,Derby County,1-0,1,0,1,1,1,1,H
1931-04-03,1930,Grimsby Town,Middlesbrough,4-1,4,1,1,1,5,3,H
1931-04-03,1930,Liverpool,Manchester United,1-1,1,1,1,1,2,0,D
1931-04-03,1930,Manchester City,Blackburn Rovers,3-0,3,0,1,1,3,3,H
1931-04-03,1930,Newcastle United,Huddersfield Town,1-1,1,1,1,1,2,0,D
1931-04-03,1930,Portsmouth,Arsenal,1-1,1,1,1,1,2,0,D
1931-04-03,1930,Sunderland,Birmingham City,1-0,1,0,1,1,1,1,H
1931-04-03,1930,West Ham United,Bolton Wanderers,1-4,1,4,1,1,5,-3,A
1931-04-04,1930,Arsenal,Chelsea,2-1,2,1,1,1,3,1,H
1931-04-04,1930,Birmingham City,Bolton Wanderers,0-2,0,2,1,1,2,-2,A
1931-04-04,1930,Blackburn Rovers,Newcastle United,1-0,1,0,1,1,1,1,H
1931-04-04,1930,Blackpool,Sheffield Wednesday,0-4,0,4,1,1,4,-4,A
1931-04-04,1930,Derby County,Middlesbrough,1-2,1,2,1,1,3,-1,A
1931-04-04,1930,Leeds United,Grimsby Town,0-0,0,0,1,1,0,0,D
1931-04-04,1930,Leicester City,West Ham United,1-1,1,1,1,1,2,0,D
1931-04-04,1930,Manchester City,Huddersfield Town,0-1,0,1,1,1,1,-1,A
1931-04-04,1930,Portsmouth,Aston Villa,5-0,5,0,1,1,5,5,H
1931-04-04,1930,Sheffield United,Liverpool,4-1,4,1,1,1,5,3,H
1931-04-04,1930,Sunderland,Manchester United,1-2,1,2,1,1,3,-1,A
1931-04-06,1930,Arsenal,Portsmouth,1-1,1,1,1,1,2,0,D
1931-04-06,1930,Birmingham City,Sunderland,1-0,1,0,1,1,1,1,H
1931-04-06,1930,Bolton Wanderers,West Ham United,4-2,4,2,1,1,6,2,H
1931-04-06,1930,Chelsea,Leicester City,1-0,1,0,1,1,1,1,H
1931-04-06,1930,Derby County,Blackpool,3-2,3,2,1,1,5,1,H
1931-04-06,1930,Manchester United,Liverpool,4-1,4,1,1,1,5,3,H
1931-04-06,1930,Sheffield United,Leeds United,1-1,1,1,1,1,2,0,D
1931-04-07,1930,Aston Villa,Newcastle United,4-3,4,3,1,1,7,1,H
1931-04-07,1930,Huddersfield Town,Sheffield Wednesday,1-1,1,1,1,1,2,0,D
1931-04-07,1930,Leeds United,Sheffield United,4-0,4,0,1,1,4,4,H
1931-04-07,1930,Leicester City,Chelsea,2-1,2,1,1,1,3,1,H
1931-04-11,1930,Aston Villa,Sheffield United,4-0,4,0,1,1,4,4,H
1931-04-11,1930,Bolton Wanderers,Leeds United,2-0,2,0,1,1,2,2,H
1931-04-11,1930,Chelsea,Derby County,1-1,1,1,1,1,2,0,D
1931-04-11,1930,Grimsby Town,Arsenal,0-1,0,1,1,1,1,-1,A
1931-04-11,1930,Huddersfield Town,Birmingham City,1-0,1,0,1,1,1,1,H
1931-04-11,1930,Liverpool,Sunderland,2-4,2,4,1,1,6,-2,A
1931-04-11,1930,Manchester United,Blackburn Rovers,0-1,0,1,1,1,1,-1,A
1931-04-11,1930,Middlesbrough,Leicester City,2-2,2,2,1,1,4,0,D
1931-04-11,1930,Newcastle United,Manchester City,0-1,0,1,1,1,1,-1,A
1931-04-11,1930,Sheffield Wednesday,Portsmouth,2-2,2,2,1,1,4,0,D
1931-04-11,1930,West Ham United,Blackpool,3-2,3,2,1,1,5,1,H
1931-04-15,1930,Liverpool,Birmingham City,0-0,0,0,1,1,0,0,D
1931-04-18,1930,Arsenal,Liverpool,3-1,3,1,1,1,4,2,H
1931-04-18,1930,Birmingham City,Sheffield Wednesday,2-0,2,0,1,1,2,2,H
1931-04-18,1930,Blackburn Rovers,Middlesbrough,4-5,4,5,1,1,9,-1,A
1931-04-18,1930,Blackpool,Huddersfield Town,1-1,1,1,1,1,2,0,D
1931-04-18,1930,Derby County,Manchester United,6-1,6,1,1,1,7,5,H
1931-04-18,1930,Leeds United,Aston Villa,0-2,0,2,1,1,2,-2,A
1931-04-18,1930,Leicester City,Newcastle United,3-1,3,1,1,1,4,2,H
1931-04-18,1930,Manchester City,West Ham United,1-1,1,1,1,1,2,0,D
1931-04-18,1930,Portsmouth,Bolton Wanderers,1-0,1,0,1,1,1,1,H
1931-04-18,1930,Sheffield United,Grimsby Town,2-1,2,1,1,1,3,1,H
1931-04-18,1930,Sunderland,Chelsea,2-0,2,0,1,1,2,2,H
1931-04-20,1930,Sheffield Wednesday,Derby County,3-2,3,2,1,1,5,1,H
1931-04-25,1930,Aston Villa,Manchester City,4-2,4,2,1,1,6,2,H
1931-04-25,1930,Bolton Wanderers,Leicester City,4-1,4,1,1,1,5,3,H
1931-04-25,1930,Chelsea,Portsmouth,2-0,2,0,1,1,2,2,H
1931-04-25,1930,Grimsby Town,Blackpool,6-2,6,2,1,1,8,4,H
1931-04-25,1930,Huddersfield Town,Derby County,3-0,3,0,1,1,3,3,H
1931-04-25,1930,Middlesbrough,Sheffield United,4-1,4,1,1,1,5,3,H
1931-04-25,1930,Newcastle United,Arsenal,1-3,1,3,1,1,4,-2,A
1931-04-25,1930,Sheffield Wednesday,Blackburn Rovers,1-3,1,3,1,1,4,-2,A
1931-04-25,1930,West Ham United,Sunderland,0-3,0,3,1,1,3,-3,A
1931-05-02,1930,Arsenal,Bolton Wanderers,5-0,5,0,1,1,5,5,H
1931-05-02,1930,Birmingham City,Leicester City,2-1,2,1,1,1,3,1,H
1931-05-02,1930,Blackpool,Manchester City,2-2,2,2,1,1,4,0,D
1931-05-02,1930,Chelsea,Newcastle United,1-1,1,1,1,1,2,0,D
1931-05-02,1930,Grimsby Town,Huddersfield Town,2-1,2,1,1,1,3,1,H
1931-05-02,1930,Leeds United,Derby County,3-1,3,1,1,1,4,2,H
1931-05-02,1930,Liverpool,West Ham United,2-0,2,0,1,1,2,2,H
1931-05-02,1930,Manchester United,Middlesbrough,4-4,4,4,1,1,8,0,D
1931-05-02,1930,Portsmouth,Blackburn Rovers,3-0,3,0,1,1,3,3,H
1931-05-02,1930,Sheffield Wednesday,Aston Villa,3-0,3,0,1,1,3,3,H
1931-05-02,1930,Sunderland,Sheffield United,2-1,2,1,1,1,3,1,H
1931-08-29,1931,Arsenal,West Bromwich Albion,0-1,0,1,1,1,1,-1,A
1931-08-29,1931,Aston Villa,Leicester City,3-2,3,2,1,1,5,1,H
1931-08-29,1931,Blackburn Rovers,Sheffield Wednesday,1-6,1,6,1,1,7,-5,A
1931-08-29,1931,Blackpool,Derby County,2-1,2,1,1,1,3,1,H
1931-08-29,1931,Bolton Wanderers,West Ham United,0-1,0,1,1,1,1,-1,A
1931-08-29,1931,Everton,Birmingham City,3-2,3,2,1,1,5,1,H
1931-08-29,1931,Huddersfield Town,Grimsby Town,1-1,1,1,1,1,2,0,D
1931-08-29,1931,Manchester City,Sunderland,1-1,1,1,1,1,2,0,D
1931-08-29,1931,Middlesbrough,Chelsea,0-2,0,2,1,1,2,-2,A
1931-08-29,1931,Newcastle United,Liverpool,0-1,0,1,1,1,1,-1,A
1931-08-29,1931,Sheffield United,Portsmouth,1-2,1,2,1,1,3,-1,A
1931-08-31,1931,Blackburn Rovers,Arsenal,1-1,1,1,1,1,2,0,D
1931-08-31,1931,Blackpool,Sheffield United,2-0,2,0,1,1,2,2,H
1931-08-31,1931,Huddersfield Town,Aston Villa,1-1,1,1,1,1,2,0,D
1931-08-31,1931,Leicester City,Middlesbrough,2-2,2,2,1,1,4,0,D
1931-08-31,1931,Sheffield Wednesday,Grimsby Town,4-1,4,1,1,1,5,3,H
1931-08-31,1931,West Ham United,Chelsea,3-1,3,1,1,1,4,2,H
1931-09-02,1931,Birmingham City,Newcastle United,4-1,4,1,1,1,5,3,H
1931-09-02,1931,Derby County,Manchester City,2-1,2,1,1,1,3,1,H
1931-09-02,1931,Liverpool,Bolton Wanderers,2-2,2,2,1,1,4,0,D
1931-09-02,1931,Portsmouth,Everton,0-3,0,3,1,1,3,-3,A
1931-09-02,1931,Sunderland,West Bromwich Albion,2-1,2,1,1,1,3,1,H
1931-09-05,1931,Birmingham City,Arsenal,2-2,2,2,1,1,4,0,D
1931-09-05,1931,Chelsea,Huddersfield Town,0-1,0,1,1,1,1,-1,A
1931-09-05,1931,Derby County,Sheffield United,1-3,1,3,1,1,4,-2,A
1931-09-05,1931,Grimsby Town,Newcastle United,1-2,1,2,1,1,3,-1,A
1931-09-05,1931,Leicester City,Manchester City,4-0,4,0,1,1,4,4,H
1931-09-05,1931,Liverpool,Aston Villa,2-0,2,0,1,1,2,2,H
1931-09-05,1931,Portsmouth,Blackburn Rovers,2-0,2,0,1,1,2,2,H
1931-09-05,1931,Sheffield Wednesday,Bolton Wanderers,7-1,7,1,1,1,8,6,H
1931-09-05,1931,Sunderland,Everton,2-3,2,3,1,1,5,-1,A
1931-09-05,1931,West Bromwich Albion,Blackpool,4-0,4,0,1,1,4,4,H
1931-09-05,1931,West Ham United,Middlesbrough,0-2,0,2,1,1,2,-2,A
1931-09-07,1931,Huddersfield Town,Leicester City,2-1,2,1,1,1,3,1,H
1931-09-07,1931,Sheffield United,West Ham United,6-0,6,0,1,1,6,6,H
1931-09-07,1931,West Bromwich Albion,Sunderland,1-0,1,0,1,1,1,1,H
1931-09-09,1931,Arsenal,Portsmouth,3-3,3,3,1,1,6,0,D
1931-09-09,1931,Blackpool,Blackburn Rovers,2-1,2,1,1,1,3,1,H
1931-09-09,1931,Bolton Wanderers,Grimsby Town,5-3,5,3,1,1,8,2,H
1931-09-09,1931,Chelsea,Sheffield Wednesday,2-3,2,3,1,1,5,-1,A
1931-09-09,1931,Manchester City,Derby County,3-0,3,0,1,1,3,3,H
1931-09-09,1931,Middlesbrough,Liverpool,4-1,4,1,1,1,5,3,H
1931-09-12,1931,Arsenal,Sunderland,2-0,2,0,1,1,2,2,H
1931-09-12,1931,Aston Villa,Grimsby Town,7-0,7,0,1,1,7,7,H
1931-09-12,1931,Blackburn Rovers,Derby County,3-2,3,2,1,1,5,1,H
1931-09-12,1931,Blackpool,Birmingham City,1-1,1,1,1,1,2,0,D
1931-09-12,1931,Bolton Wanderers,Portsmouth,4-0,4,0,1,1,4,4,H
1931-09-12,1931,Everton,Manchester City,0-1,0,1,1,1,1,-1,A
1931-09-12,1931,Huddersfield Town,West Ham United,3-1,3,1,1,1,4,2,H
1931-09-12,1931,Leicester City,Liverpool,2-1,2,1,1,1,3,1,H
1931-09-12,1931,Middlesbrough,Sheffield Wednesday,4-0,4,0,1,1,4,4,H
1931-09-12,1931,Newcastle United,Chelsea,4-1,4,1,1,1,5,3,H
1931-09-12,1931,Sheffield United,West Bromwich Albion,1-0,1,0,1,1,1,1,H
1931-09-14,1931,West Bromwich Albion,Manchester City,1-1,1,1,1,1,2,0,D
1931-09-15,1931,Grimsby Town,Bolton Wanderers,2-0,2,0,1,1,2,2,H
1931-09-16,1931,Derby County,Everton,3-0,3,0,1,1,3,3,H
1931-09-16,1931,Liverpool,Middlesbrough,7-2,7,2,1,1,9,5,H
1931-09-16,1931,Portsmouth,Arsenal,0-3,0,3,1,1,3,-3,A
1931-09-16,1931,Sunderland,Birmingham City,2-3,2,3,1,1,5,-1,A
1931-09-19,1931,Birmingham City,Sheffield United,1-3,1,3,1,1,4,-2,A
1931-09-19,1931,Bolton Wanderers,Middlesbrough,4-2,4,2,1,1,6,2,H
1931-09-19,1931,Chelsea,Aston Villa,3-6,3,6,1,1,9,-3,A
1931-09-19,1931,Derby County,Portsmouth,2-1,2,1,1,1,3,1,H
1931-09-19,1931,Grimsby Town,Leicester City,3-0,3,0,1,1,3,3,H
1931-09-19,1931,Liverpool,Everton,1-3,1,3,1,1,4,-2,A
1931-09-19,1931,Manchester City,Arsenal,1-3,1,3,1,1,4,-2,A
1931-09-19,1931,Sheffield Wednesday,Huddersfield Town,4-1,4,1,1,1,5,3,H
1931-09-19,1931,Sunderland,Blackpool,4-0,4,0,1,1,4,4,H
1931-09-19,1931,West Bromwich Albion,Blackburn Rovers,4-1,4,1,1,1,5,3,H
1931-09-19,1931,West Ham United,Newcastle United,2-1,2,1,1,1,3,1,H
1931-09-21,1931,Blackburn Rovers,Blackpool,5-1,5,1,1,1,6,4,H
1931-09-21,1931,Sheffield Wednesday,Chelsea,2-2,2,2,1,1,4,0,D
1931-09-21,1931,West Ham United,Sheffield United,1-2,1,2,1,1,3,-1,A
1931-09-23,1931,Birmingham City,Sunderland,0-0,0,0,1,1,0,0,D
1931-09-23,1931,Everton,Derby County,2-1,2,1,1,1,3,1,H
1931-09-23,1931,Manchester City,West Bromwich Albion,2-5,2,5,1,1,7,-3,A
1931-09-26,1931,Arsenal,Everton,3-2,3,2,1,1,5,1,H
1931-09-26,1931,Aston Villa,West Ham United,5-2,5,2,1,1,7,3,H
1931-09-26,1931,Blackburn Rovers,Birmingham City,1-2,1,2,1,1,3,-1,A
1931-09-26,1931,Blackpool,Manchester City,2-2,2,2,1,1,4,0,D
1931-09-26,1931,Huddersfield Town,Bolton Wanderers,2-0,2,0,1,1,2,2,H
1931-09-26,1931,Leicester City,Chelsea,1-0,1,0,1,1,1,1,H
1931-09-26,1931,Liverpool,Grimsby Town,4-0,4,0,1,1,4,4,H
1931-09-26,1931,Middlesbrough,Derby County,5-2,5,2,1,1,7,3,H
1931-09-26,1931,Newcastle United,Sheffield Wednesday,4-1,4,1,1,1,5,3,H
1931-09-26,1931,Portsmouth,West Bromwich Albion,0-1,0,1,1,1,1,-1,A
1931-09-26,1931,Sheffield United,Sunderland,1-1,1,1,1,1,2,0,D
1931-10-03,1931,Birmingham City,Portsmouth,2-1,2,1,1,1,3,1,H
1931-10-03,1931,Bolton Wanderers,Newcastle United,2-1,2,1,1,1,3,1,H
1931-10-03,1931,Chelsea,Liverpool,2-0,2,0,1,1,2,2,H
1931-10-03,1931,Everton,Blackpool,3-2,3,2,1,1,5,1,H
1931-10-03,1931,Grimsby Town,Arsenal,3-1,3,1,1,1,4,2,H
1931-10-03,1931,Manchester City,Sheffield United,1-1,1,1,1,1,2,0,D
1931-10-03,1931,Middlesbrough,Huddersfield Town,1-0,1,0,1,1,1,1,H
1931-10-03,1931,Sheffield Wednesday,Aston Villa,1-0,1,0,1,1,1,1,H
1931-10-03,1931,Sunderland,Blackburn Rovers,2-2,2,2,1,1,4,0,D
1931-10-03,1931,West Bromwich Albion,Derby County,4-0,4,0,1,1,4,4,H
1931-10-03,1931,West Ham United,Leicester City,1-4,1,4,1,1,5,-3,A
1931-10-10,1931,Aston Villa,Bolton Wanderers,2-1,2,1,1,1,3,1,H
1931-10-10,1931,Blackburn Rovers,Manchester City,2-2,2,2,1,1,4,0,D
1931-10-10,1931,Blackpool,Arsenal,1-5,1,5,1,1,6,-4,A
1931-10-10,1931,Derby County,Birmingham City,2-1,2,1,1,1,3,1,H
1931-10-10,1931,Grimsby Town,Chelsea,1-2,1,2,1,1,3,-1,A
1931-10-10,1931,Huddersfield Town,West Bromwich Albion,2-2,2,2,1,1,4,0,D
1931-10-10,1931,Leicester City,Sheffield Wednesday,3-2,3,2,1,1,5,1,H
1931-10-10,1931,Liverpool,West Ham United,2-2,2,2,1,1,4,0,D
1931-10-10,1931,Newcastle United,Middlesbrough,3-1,3,1,1,1,4,2,H
1931-10-10,1931,Portsmouth,Sunderland,0-0,0,0,1,1,0,0,D
1931-10-10,1931,Sheffield United,Everton,1-5,1,5,1,1,6,-4,A
1931-10-15,1931,Leicester City,Huddersfield Town,2-4,2,4,1,1,6,-2,A
1931-10-17,1931,Arsenal,Bolton Wanderers,1-1,1,1,1,1,2,0,D
1931-10-17,1931,Birmingham City,Grimsby Town,2-1,2,1,1,1,3,1,H
1931-10-17,1931,Blackburn Rovers,Newcastle United,0-3,0,3,1,1,3,-3,A
1931-10-17,1931,Blackpool,Middlesbrough,1-2,1,2,1,1,3,-1,A
1931-10-17,1931,Derby County,Leicester City,1-1,1,1,1,1,2,0,D
1931-10-17,1931,Everton,Sheffield Wednesday,9-3,9,3,1,1,12,6,H
1931-10-17,1931,Manchester City,West Ham United,0-1,0,1,1,1,1,-1,A
1931-10-17,1931,Portsmouth,Aston Villa,0-3,0,3,1,1,3,-3,A
1931-10-17,1931,Sheffield United,Huddersfield Town,0-2,0,2,1,1,2,-2,A
1931-10-17,1931,Sunderland,Chelsea,2-1,2,1,1,1,3,1,H
1931-10-17,1931,West Bromwich Albion,Liverpool,1-2,1,2,1,1,3,-1,A
1931-10-24,1931,Aston Villa,Everton,2-3,2,3,1,1,5,-1,A
1931-10-24,1931,Bolton Wanderers,West Bromwich Albion,1-0,1,0,1,1,1,1,H
1931-10-24,1931,Chelsea,Blackburn Rovers,1-2,1,2,1,1,3,-1,A
1931-10-24,1931,Grimsby Town,Sheffield United,0-2,0,2,1,1,2,-2,A
1931-10-24,1931,Huddersfield Town,Sunderland,4-1,4,1,1,1,5,3,H
1931-10-24,1931,Leicester City,Arsenal,1-2,1,2,1,1,3,-1,A
1931-10-24,1931,Liverpool,Blackpool,3-2,3,2,1,1,5,1,H
1931-10-24,1931,Middlesbrough,Birmingham City,2-0,2,0,1,1,2,2,H
1931-10-24,1931,Newcastle United,Manchester City,2-1,2,1,1,1,3,1,H
1931-10-24,1931,Sheffield Wednesday,Derby County,3-1,3,1,1,1,4,2,H
1931-10-24,1931,West Ham United,Portsmouth,2-1,2,1,1,1,3,1,H
1931-10-31,1931,Arsenal,Aston Villa,1-1,1,1,1,1,2,0,D
1931-10-31,1931,Birmingham City,Bolton Wanderers,2-2,2,2,1,1,4,0,D
1931-10-31,1931,Blackburn Rovers,Grimsby Town,3-2,3,2,1,1,5,1,H
1931-10-31,1931,Blackpool,Leicester City,2-3,2,3,1,1,5,-1,A
1931-10-31,1931,Derby County,West Ham United,5-1,5,1,1,1,6,4,H
1931-10-31,1931,Everton,Newcastle United,8-1,8,1,1,1,9,7,H
1931-10-31,1931,Manchester City,Huddersfield Town,3-0,3,0,1,1,3,3,H
1931-10-31,1931,Portsmouth,Chelsea,1-0,1,0,1,1,1,1,H
1931-10-31,1931,Sheffield United,Liverpool,3-0,3,0,1,1,3,3,H
1931-10-31,1931,Sunderland,Middlesbrough,0-0,0,0,1,1,0,0,D
1931-10-31,1931,West Bromwich Albion,Sheffield Wednesday,1-1,1,1,1,1,2,0,D
1931-11-07,1931,Aston Villa,Blackpool,5-1,5,1,1,1,6,4,H
1931-11-07,1931,Bolton Wanderers,Sunderland,3-1,3,1,1,1,4,2,H
1931-11-07,1931,Chelsea,Derby County,2-1,2,1,1,1,3,1,H
1931-11-07,1931,Grimsby Town,Portsmouth,3-1,3,1,1,1,4,2,H
1931-11-07,1931,Huddersfield Town,Everton,0-0,0,0,1,1,0,0,D
1931-11-07,1931,Leicester City,Sheffield United,4-3,4,3,1,1,7,1,H
1931-11-07,1931,Liverpool,Blackburn Rovers,4-2,4,2,1,1,6,2,H
1931-11-07,1931,Middlesbrough,Manchester City,3-3,3,3,1,1,6,0,D
1931-11-07,1931,Newcastle United,Arsenal,3-2,3,2,1,1,5,1,H
1931-11-07,1931,Sheffield Wednesday,Birmingham City,5-1,5,1,1,1,6,4,H
1931-11-07,1931,West Ham United,West Bromwich Albion,1-5,1,5,1,1,6,-4,A
1931-11-14,1931,Arsenal,West Ham United,4-1,4,1,1,1,5,3,H
1931-11-14,1931,Birmingham City,Leicester City,2-0,2,0,1,1,2,2,H
1931-11-14,1931,Blackburn Rovers,Middlesbrough,4-2,4,2,1,1,6,2,H
1931-11-14,1931,Blackpool,Sheffield Wednesday,1-2,1,2,1,1,3,-1,A
1931-11-14,1931,Derby County,Newcastle United,1-1,1,1,1,1,2,0,D
1931-11-14,1931,Everton,Chelsea,7-2,7,2,1,1,9,5,H
1931-11-14,1931,Manchester City,Grimsby Town,4-1,4,1,1,1,5,3,H
1931-11-14,1931,Portsmouth,Huddersfield Town,3-2,3,2,1,1,5,1,H
1931-11-14,1931,Sheffield United,Bolton Wanderers,4-0,4,0,1,1,4,4,H
1931-11-14,1931,Sunderland,Liverpool,1-3,1,3,1,1,4,-2,A
1931-11-14,1931,West Bromwich Albion,Aston Villa,3-0,3,0,1,1,3,3,H
1931-11-21,1931,Aston Villa,Birmingham City,3-2,3,2,1,1,5,1,H
1931-11-21,1931,Bolton Wanderers,Blackburn Rovers,3-1,3,1,1,1,4,2,H
1931-11-21,1931,Chelsea,Arsenal,2-1,2,1,1,1,3,1,H
1931-11-21,1931,Grimsby Town,Everton,1-2,1,2,1,1,3,-1,A
1931-11-21,1931,Huddersfield Town,Derby County,6-0,6,0,1,1,6,6,H
1931-11-21,1931,Leicester City,Sunderland,5-0,5,0,1,1,5,5,H
1931-11-21,1931,Liverpool,Manchester City,4-3,4,3,1,1,7,1,H
1931-11-21,1931,Middlesbrough,Portsmouth,0-1,0,1,1,1,1,-1,A
1931-11-21,1931,Newcastle United,West Bromwich Albion,5-1,5,1,1,1,6,4,H
1931-11-21,1931,Sheffield Wednesday,Sheffield United,2-1,2,1,1,1,3,1,H
1931-11-21,1931,West Ham United,Blackpool,1-1,1,1,1,1,2,0,D
1931-11-28,1931,Arsenal,Liverpool,6-0,6,0,1,1,6,6,H
1931-11-28,1931,Birmingham City,Huddersfield Town,5-0,5,0,1,1,5,5,H
1931-11-28,1931,Blackburn Rovers,West Ham United,2-4,2,4,1,1,6,-2,A
1931-11-28,1931,Blackpool,Grimsby Town,4-3,4,3,1,1,7,1,H
1931-11-28,1931,Derby County,Bolton Wanderers,5-1,5,1,1,1,6,4,H
1931-11-28,1931,Everton,Leicester City,9-2,9,2,1,1,11,7,H
1931-11-28,1931,Manchester City,Aston Villa,3-3,3,3,1,1,6,0,D
1931-11-28,1931,Portsmouth,Sheffield Wednesday,2-0,2,0,1,1,2,2,H
1931-11-28,1931,Sheffield United,Chelsea,4-2,4,2,1,1,6,2,H
1931-11-28,1931,Sunderland,Newcastle United,1-4,1,4,1,1,5,-3,A
1931-11-28,1931,West Bromwich Albion,Middlesbrough,1-1,1,1,1,1,2,0,D
1931-12-05,1931,Aston Villa,Derby County,2-0,2,0,1,1,2,2,H
1931-12-05,1931,Bolton Wanderers,Blackpool,1-2,1,2,1,1,3,-1,A
1931-12-05,1931,Chelsea,Manchester City,3-2,3,2,1,1,5,1,H
1931-12-05,1931,Grimsby Town,Sunderland,1-3,1,3,1,1,4,-2,A
1931-12-05,1931,Huddersfield Town,Blackburn Rovers,1-1,1,1,1,1,2,0,D
1931-12-05,1931,Leicester City,West Bromwich Albion,2-3,2,3,1,1,5,-1,A
1931-12-05,1931,Liverpool,Birmingham City,4-3,4,3,1,1,7,1,H
1931-12-05,1931,Middlesbrough,Sheffield United,4-3,4,3,1,1,7,1,H
1931-12-05,1931,Newcastle United,Portsmouth,0-0,0,0,1,1,0,0,D
1931-12-05,1931,Sheffield Wednesday,Arsenal,1-3,1,3,1,1,4,-2,A
1931-12-05,1931,West Ham United,Everton,4-2,4,2,1,1,6,2,H
1931-12-12,1931,Arsenal,Huddersfield Town,1-1,1,1,1,1,2,0,D
1931-12-12,1931,Birmingham City,West Ham United,4-1,4,1,1,1,5,3,H
1931-12-12,1931,Blackburn Rovers,Leicester City,6-0,6,0,1,1,6,6,H
1931-12-12,1931,Blackpool,Newcastle United,3-1,3,1,1,1,4,2,H
1931-12-12,1931,Derby County,Grimsby Town,3-3,3,3,1,1,6,0,D
1931-12-12,1931,Everton,Middlesbrough,5-1,5,1,1,1,6,4,H
1931-12-12,1931,Manchester City,Bolton Wanderers,2-1,2,1,1,1,3,1,H
1931-12-12,1931,Portsmouth,Liverpool,2-0,2,0,1,1,2,2,H
1931-12-12,1931,Sheffield United,Aston Villa,5-4,5,4,1,1,9,1,H
1931-12-12,1931,Sunderland,Sheffield Wednesday,3-1,3,1,1,1,4,2,H
1931-12-12,1931,West Bromwich Albion,Chelsea,4-0,4,0,1,1,4,4,H
1931-12-19,1931,Aston Villa,Blackburn Rovers,1-5,1,5,1,1,6,-4,A
1931-12-19,1931,Bolton Wanderers,Everton,2-1,2,1,1,1,3,1,H
1931-12-19,1931,Chelsea,Birmingham City,2-1,2,1,1,1,3,1,H
1931-12-19,1931,Grimsby Town,West Bromwich Albion,0-0,0,0,1,1,0,0,D
1931-12-19,1931,Huddersfield Town,Blackpool,5-0,5,0,1,1,5,5,H
1931-12-19,1931,Liverpool,Derby County,1-1,1,1,1,1,2,0,D
1931-12-19,1931,Middlesbrough,Arsenal,2-5,2,5,1,1,7,-3,A
1931-12-19,1931,Newcastle United,Sheffield United,5-3,5,3,1,1,8,2,H
1931-12-19,1931,Sheffield Wednesday,Manchester City,1-1,1,1,1,1,2,0,D
1931-12-19,1931,West Ham United,Sunderland,2-2,2,2,1,1,4,0,D
1931-12-25,1931,Aston Villa,Middlesbrough,7-1,7,1,1,1,8,6,H
1931-12-25,1931,Blackburn Rovers,Everton,5-3,5,3,1,1,8,2,H
1931-12-25,1931,Blackpool,Chelsea,2-4,2,4,1,1,6,-2,A
1931-12-25,1931,Bolton Wanderers,Leicester City,1-0,1,0,1,1,1,1,H
1931-12-25,1931,Grimsby Town,West Ham United,2-1,2,1,1,1,3,1,H
1931-12-25,1931,Liverpool,Sheffield Wednesday,3-1,3,1,1,1,4,2,H
1931-12-25,1931,Newcastle United,Huddersfield Town,2-1,2,1,1,1,3,1,H
1931-12-25,1931,Sheffield United,Arsenal,4-1,4,1,1,1,5,3,H
1931-12-25,1931,West Bromwich Albion,Birmingham City,0-1,0,1,1,1,1,-1,A
1931-12-26,1931,Arsenal,Sheffield United,0-2,0,2,1,1,2,-2,A
1931-12-26,1931,Birmingham City,West Bromwich Albion,1-0,1,0,1,1,1,1,H
1931-12-26,1931,Chelsea,Blackpool,4-1,4,1,1,1,5,3,H
1931-12-26,1931,Derby County,Sunderland,3-1,3,1,1,1,4,2,H
1931-12-26,1931,Everton,Blackburn Rovers,5-0,5,0,1,1,5,5,H
1931-12-26,1931,Huddersfield Town,Newcastle United,1-2,1,2,1,1,3,-1,A
1931-12-26,1931,Leicester City,Bolton Wanderers,1-3,1,3,1,1,4,-2,A
1931-12-26,1931,Middlesbrough,Aston Villa,1-1,1,1,1,1,2,0,D
1931-12-26,1931,Portsmouth,Manchester City,3-2,3,2,1,1,5,1,H
1931-12-26,1931,Sheffield Wednesday,Liverpool,1-1,1,1,1,1,2,0,D
1931-12-26,1931,West Ham United,Grimsby Town,3-1,3,1,1,1,4,2,H
1931-12-28,1931,Aston Villa,Newcastle United,3-0,3,0,1,1,3,3,H
1932-01-01,1931,Bolton Wanderers,Chelsea,1-0,1,0,1,1,1,1,H
1932-01-01,1931,Manchester City,Portsmouth,3-3,3,3,1,1,6,0,D
1932-01-01,1931,Newcastle United,Aston Villa,3-1,3,1,1,1,4,2,H
1932-01-01,1931,Sheffield United,Blackburn Rovers,3-2,3,2,1,1,5,1,H
1932-01-01,1931,Sunderland,Derby County,0-0,0,0,1,1,0,0,D
1932-01-02,1931,Birmingham City,Everton,4-0,4,0,1,1,4,4,H
1932-01-02,1931,Chelsea,Middlesbrough,4-0,4,0,1,1,4,4,H
1932-01-02,1931,Derby County,Blackpool,5-0,5,0,1,1,5,5,H
1932-01-02,1931,Grimsby Town,Huddersfield Town,1-4,1,4,1,1,5,-3,A
1932-01-02,1931,Leicester City,Aston Villa,3-8,3,8,1,1,11,-5,A
1932-01-02,1931,Liverpool,Newcastle United,4-2,4,2,1,1,6,2,H
1932-01-02,1931,Portsmouth,Sheffield United,2-1,2,1,1,1,3,1,H
1932-01-02,1931,Sheffield Wednesday,Blackburn Rovers,5-1,5,1,1,1,6,4,H
1932-01-02,1931,Sunderland,Manchester City,2-5,2,5,1,1,7,-3,A
1932-01-02,1931,West Bromwich Albion,Arsenal,1-0,1,0,1,1,1,1,H
1932-01-02,1931,West Ham United,Bolton Wanderers,3-1,3,1,1,1,4,2,H
1932-01-16,1931,Arsenal,Birmingham City,3-0,3,0,1,1,3,3,H
1932-01-16,1931,Aston Villa,Liverpool,6-1,6,1,1,1,7,5,H
1932-01-16,1931,Blackburn Rovers,Portsmouth,5-3,5,3,1,1,8,2,H
1932-01-16,1931,Blackpool,West Bromwich Albion,1-2,1,2,1,1,3,-1,A
1932-01-16,1931,Bolton Wanderers,Sheffield Wednesday,2-4,2,4,1,1,6,-2,A
1932-01-16,1931,Everton,Sunderland,4-2,4,2,1,1,6,2,H
1932-01-16,1931,Huddersfield Town,Chelsea,2-1,2,1,1,1,3,1,H
1932-01-16,1931,Manchester City,Leicester City,5-1,5,1,1,1,6,4,H
1932-01-16,1931,Middlesbrough,West Ham United,3-2,3,2,1,1,5,1,H
1932-01-16,1931,Newcastle United,Grimsby Town,2-0,2,0,1,1,2,2,H
1932-01-16,1931,Sheffield United,Derby County,3-1,3,1,1,1,4,2,H
1932-01-25,1931,Sheffield Wednesday,Middlesbrough,1-1,1,1,1,1,2,0,D
1932-01-25,1931,West Bromwich Albion,Sheffield United,0-1,0,1,1,1,1,-1,A
1932-01-27,1931,Derby County,Blackburn Rovers,1-1,1,1,1,1,2,0,D
1932-01-27,1931,Liverpool,Leicester City,3-3,3,3,1,1,6,0,D
1932-01-27,1931,Manchester City,Everton,1-0,1,0,1,1,1,1,H
1932-01-30,1931,Arsenal,Manchester City,4-0,4,0,1,1,4,4,H
1932-01-30,1931,Aston Villa,Chelsea,1-3,1,3,1,1,4,-2,A
1932-01-30,1931,Blackburn Rovers,West Bromwich Albion,2-0,2,0,1,1,2,2,H
1932-01-30,1931,Blackpool,Sunderland,3-2,3,2,1,1,5,1,H
1932-01-30,1931,Everton,Liverpool,2-1,2,1,1,1,3,1,H
1932-01-30,1931,Huddersfield Town,Sheffield Wednesday,6-1,6,1,1,1,7,5,H
1932-01-30,1931,Leicester City,Grimsby Town,1-2,1,2,1,1,3,-1,A
1932-01-30,1931,Middlesbrough,Bolton Wanderers,3-1,3,1,1,1,4,2,H
1932-01-30,1931,Newcastle United,West Ham United,2-2,2,2,1,1,4,0,D
1932-01-30,1931,Portsmouth,Derby County,2-0,2,0,1,1,2,2,H
1932-01-30,1931,Sheffield United,Birmingham City,1-0,1,0,1,1,1,1,H
1932-02-01,1931,West Ham United,Huddersfield Town,1-1,1,1,1,1,2,0,D
1932-02-02,1931,Grimsby Town,Aston Villa,2-2,2,2,1,1,4,0,D
1932-02-03,1931,Birmingham City,Blackpool,3-0,3,0,1,1,3,3,H
1932-02-04,1931,Leicester City,Portsmouth,2-1,2,1,1,1,3,1,H
1932-02-06,1931,Birmingham City,Blackburn Rovers,2-1,2,1,1,1,3,1,H
1932-02-06,1931,Bolton Wanderers,Huddersfield Town,1-2,1,2,1,1,3,-1,A
1932-02-06,1931,Chelsea,Leicester City,1-0,1,0,1,1,1,1,H
1932-02-06,1931,Derby County,Middlesbrough,5-2,5,2,1,1,7,3,H
1932-02-06,1931,Everton,Arsenal,1-3,1,3,1,1,4,-2,A
1932-02-06,1931,Grimsby Town,Liverpool,5-1,5,1,1,1,6,4,H
1932-02-06,1931,Manchester City,Blackpool,7-1,7,1,1,1,8,6,H
1932-02-06,1931,Sheffield Wednesday,Newcastle United,2-0,2,0,1,1,2,2,H
1932-02-06,1931,Sunderland,Sheffield United,1-0,1,0,1,1,1,1,H
1932-02-06,1931,West Bromwich Albion,Portsmouth,3-0,3,0,1,1,3,3,H
1932-02-06,1931,West Ham United,Aston Villa,2-1,2,1,1,1,3,1,H
1932-02-13,1931,Blackburn Rovers,Sunderland,5-2,5,2,1,1,7,3,H
1932-02-13,1931,Blackpool,Everton,2-0,2,0,1,1,2,2,H
1932-02-15,1931,Sheffield United,Manchester City,2-1,2,1,1,1,3,1,H
1932-02-17,1931,Arsenal,Grimsby Town,4-0,4,0,1,1,4,4,H
1932-02-17,1931,Derby County,West Bromwich Albion,3-1,3,1,1,1,4,2,H
1932-02-17,1931,Huddersfield Town,Middlesbrough,1-1,1,1,1,1,2,0,D
1932-02-17,1931,Newcastle United,Bolton Wanderers,3-1,3,1,1,1,4,2,H
1932-02-17,1931,Portsmouth,Birmingham City,2-1,2,1,1,1,3,1,H
1932-02-18,1931,Leicester City,West Ham United,2-1,2,1,1,1,3,1,H
1932-02-20,1931,Arsenal,Blackpool,2-0,2,0,1,1,2,2,H
1932-02-20,1931,Birmingham City,Derby County,1-1,1,1,1,1,2,0,D
1932-02-20,1931,Bolton Wanderers,Aston Villa,2-1,2,1,1,1,3,1,H
1932-02-20,1931,Chelsea,Grimsby Town,4-1,4,1,1,1,5,3,H
1932-02-20,1931,Everton,Sheffield United,5-1,5,1,1,1,6,4,H
1932-02-20,1931,Manchester City,Blackburn Rovers,3-1,3,1,1,1,4,2,H
1932-02-20,1931,Middlesbrough,Newcastle United,2-1,2,1,1,1,3,1,H
1932-02-20,1931,Sheffield Wednesday,Leicester City,3-1,3,1,1,1,4,2,H
1932-02-20,1931,Sunderland,Portsmouth,5-1,5,1,1,1,6,4,H
1932-02-20,1931,West Bromwich Albion,Huddersfield Town,3-2,3,2,1,1,5,1,H
1932-02-20,1931,West Ham United,Liverpool,1-0,1,0,1,1,1,1,H
1932-02-24,1931,Aston Villa,Sheffield Wednesday,3-1,3,1,1,1,4,2,H
1932-02-27,1931,Aston Villa,Portsmouth,0-1,0,1,1,1,1,-1,A
1932-02-27,1931,Grimsby Town,Birmingham City,1-1,1,1,1,1,2,0,D
1932-02-27,1931,Leicester City,Derby County,1-1,1,1,1,1,2,0,D
1932-02-27,1931,Middlesbrough,Blackpool,0-3,0,3,1,1,3,-3,A
1932-02-27,1931,Sheffield Wednesday,Everton,1-3,1,3,1,1,4,-2,A
1932-03-02,1931,Bolton Wanderers,Arsenal,1-0,1,0,1,1,1,1,H
1932-03-02,1931,Chelsea,Sunderland,2-2,2,2,1,1,4,0,D
1932-03-02,1931,Huddersfield Town,Sheffield United,2-2,2,2,1,1,4,0,D
1932-03-02,1931,Liverpool,West Bromwich Albion,4-1,4,1,1,1,5,3,H
1932-03-02,1931,Newcastle United,Blackburn Rovers,5-3,5,3,1,1,8,2,H
1932-03-02,1931,West Ham United,Manchester City,1-1,1,1,1,1,2,0,D
1932-03-05,1931,Arsenal,Leicester City,2-1,2,1,1,1,3,1,H
1932-03-05,1931,Birmingham City,Middlesbrough,3-0,3,0,1,1,3,3,H
1932-03-05,1931,Blackburn Rovers,Chelsea,2-2,2,2,1,1,4,0,D
1932-03-05,1931,Blackpool,Liverpool,2-2,2,2,1,1,4,0,D
1932-03-05,1931,Derby County,Sheffield Wednesday,0-1,0,1,1,1,1,-1,A
1932-03-05,1931,Everton,Aston Villa,4-2,4,2,1,1,6,2,H
1932-03-05,1931,Manchester City,Newcastle United,5-1,5,1,1,1,6,4,H
1932-03-05,1931,Portsmouth,West Ham United,3-0,3,0,1,1,3,3,H
1932-03-05,1931,Sheffield United,Grimsby Town,2-1,2,1,1,1,3,1,H
1932-03-05,1931,Sunderland,Huddersfield Town,1-3,1,3,1,1,4,-2,A
1932-03-05,1931,West Bromwich Albion,Bolton Wanderers,3-0,3,0,1,1,3,3,H
1932-03-09,1931,Portsmouth,Bolton Wanderers,3-2,3,2,1,1,5,1,H
1932-03-12,1931,Bolton Wanderers,Birmingham City,5-1,5,1,1,1,6,4,H
1932-03-12,1931,Grimsby Town,Blackburn Rovers,4-3,4,3,1,1,7,1,H
1932-03-12,1931,Leicester City,Blackpool,2-2,2,2,1,1,4,0,D
1932-03-12,1931,Liverpool,Sheffield United,2-1,2,1,1,1,3,1,H
1932-03-12,1931,Middlesbrough,Sunderland,0-1,0,1,1,1,1,-1,A
1932-03-12,1931,Sheffield Wednesday,West Bromwich Albion,2-5,2,5,1,1,7,-3,A
1932-03-12,1931,West Ham United,Derby County,2-1,2,1,1,1,3,1,H
1932-03-16,1931,Chelsea,Portsmouth,0-0,0,0,1,1,0,0,D
1932-03-19,1931,Arsenal,Newcastle United,1-0,1,0,1,1,1,1,H
1932-03-19,1931,Birmingham City,Sheffield Wednesday,1-2,1,2,1,1,3,-1,A
1932-03-19,1931,Blackburn Rovers,Liverpool,1-3,1,3,1,1,4,-2,A
1932-03-19,1931,Blackpool,Aston Villa,1-3,1,3,1,1,4,-2,A
1932-03-19,1931,Derby County,Chelsea,1-0,1,0,1,1,1,1,H
1932-03-19,1931,Everton,Huddersfield Town,4-1,4,1,1,1,5,3,H
1932-03-19,1931,Manchester City,Middlesbrough,1-2,1,2,1,1,3,-1,A
1932-03-19,1931,Portsmouth,Grimsby Town,2-0,2,0,1,1,2,2,H
1932-03-19,1931,Sheffield United,Leicester City,2-2,2,2,1,1,4,0,D
1932-03-19,1931,Sunderland,Bolton Wanderers,3-0,3,0,1,1,3,3,H
1932-03-19,1931,West Bromwich Albion,West Ham United,3-1,3,1,1,1,4,2,H
1932-03-25,1931,Arsenal,Derby County,2-1,2,1,1,1,3,1,H
1932-03-25,1931,Blackpool,Portsmouth,1-1,1,1,1,1,2,0,D
1932-03-25,1931,Chelsea,Bolton Wanderers,3-0,3,0,1,1,3,3,H
1932-03-25,1931,Everton,West Bromwich Albion,2-1,2,1,1,1,3,1,H
1932-03-25,1931,Grimsby Town,Middlesbrough,2-0,2,0,1,1,2,2,H
1932-03-25,1931,Newcastle United,Leicester City,3-2,3,2,1,1,5,1,H
1932-03-25,1931,Sunderland,Aston Villa,1-1,1,1,1,1,2,0,D
1932-03-25,1931,West Ham United,Sheffield Wednesday,1-2,1,2,1,1,3,-1,A
1932-03-26,1931,Aston Villa,West Bromwich Albion,2-0,2,0,1,1,2,2,H
1932-03-26,1931,Bolton Wanderers,Sheffield United,3-1,3,1,1,1,4,2,H
1932-03-26,1931,Chelsea,Everton,0-0,0,0,1,1,0,0,D
1932-03-26,1931,Grimsby Town,Manchester City,2-1,2,1,1,1,3,1,H
1932-03-26,1931,Huddersfield Town,Portsmouth,1-0,1,0,1,1,1,1,H
1932-03-26,1931,Leicester City,Birmingham City,3-1,3,1,1,1,4,2,H
1932-03-26,1931,Liverpool,Sunderland,1-2,1,2,1,1,3,-1,A
1932-03-26,1931,Middlesbrough,Blackburn Rovers,0-2,0,2,1,1,2,-2,A
1932-03-26,1931,Newcastle United,Derby County,3-3,3,3,1,1,6,0,D
1932-03-26,1931,Sheffield Wednesday,Blackpool,3-0,3,0,1,1,3,3,H
1932-03-26,1931,West Ham United,Arsenal,1-1,1,1,1,1,2,0,D
1932-03-28,1931,Aston Villa,Sunderland,2-0,2,0,1,1,2,2,H
1932-03-28,1931,Blackburn Rovers,Sheffield United,1-2,1,2,1,1,3,-1,A
1932-03-28,1931,Derby County,Arsenal,1-1,1,1,1,1,2,0,D
1932-03-28,1931,Liverpool,Huddersfield Town,0-3,0,3,1,1,3,-3,A
1932-03-28,1931,Manchester City,Birmingham City,2-1,2,1,1,1,3,1,H
1932-03-28,1931,Middlesbrough,Grimsby Town,4-0,4,0,1,1,4,4,H
1932-03-28,1931,Portsmouth,Blackpool,2-2,2,2,1,1,4,0,D
1932-03-28,1931,Sheffield Wednesday,West Ham United,6-1,6,1,1,1,7,5,H
1932-03-28,1931,West Bromwich Albion,Everton,1-1,1,1,1,1,2,0,D
1932-03-29,1931,Birmingham City,Manchester City,1-5,1,5,1,1,6,-4,A
1932-03-29,1931,Huddersfield Town,Liverpool,4-3,4,3,1,1,7,1,H
1932-03-29,1931,Leicester City,Newcastle United,4-2,4,2,1,1,6,2,H
1932-04-02,1931,Arsenal,Chelsea,1-1,1,1,1,1,2,0,D
1932-04-02,1931,Birmingham City,Aston Villa,1-1,1,1,1,1,2,0,D
1932-04-02,1931,Blackburn Rovers,Bolton Wanderers,3-1,3,1,1,1,4,2,H
1932-04-02,1931,Blackpool,West Ham United,7-2,7,2,1,1,9,5,H
1932-04-02,1931,Derby County,Huddersfield Town,3-2,3,2,1,1,5,1,H
1932-04-02,1931,Everton,Grimsby Town,4-2,4,2,1,1,6,2,H
1932-04-02,1931,Manchester City,Liverpool,0-1,0,1,1,1,1,-1,A
1932-04-02,1931,Portsmouth,Middlesbrough,2-0,2,0,1,1,2,2,H
1932-04-02,1931,Sheffield United,Sheffield Wednesday,1-1,1,1,1,1,2,0,D
1932-04-02,1931,Sunderland,Leicester City,4-1,4,1,1,1,5,3,H
1932-04-02,1931,West Bromwich Albion,Newcastle United,2-1,2,1,1,1,3,1,H
1932-04-06,1931,Huddersfield Town,Manchester City,1-0,1,0,1,1,1,1,H
1932-04-06,1931,Liverpool,Chelsea,2-1,2,1,1,1,3,1,H
1932-04-06,1931,Sunderland,Arsenal,2-0,2,0,1,1,2,2,H
1932-04-09,1931,Aston Villa,Manchester City,2-1,2,1,1,1,3,1,H
1932-04-09,1931,Bolton Wanderers,Derby County,1-2,1,2,1,1,3,-1,A
1932-04-09,1931,Chelsea,Sheffield United,1-1,1,1,1,1,2,0,D
1932-04-09,1931,Grimsby Town,Blackpool,0-0,0,0,1,1,0,0,D
1932-04-09,1931,Huddersfield Town,Birmingham City,1-1,1,1,1,1,2,0,D
1932-04-09,1931,Leicester City,Everton,0-1,0,1,1,1,1,-1,A
1932-04-09,1931,Liverpool,Arsenal,2-1,2,1,1,1,3,1,H
1932-04-09,1931,Middlesbrough,West Bromwich Albion,1-0,1,0,1,1,1,1,H
1932-04-09,1931,Newcastle United,Sunderland,1-2,1,2,1,1,3,-1,A
1932-04-09,1931,Sheffield Wednesday,Portsmouth,3-1,3,1,1,1,4,2,H
1932-04-09,1931,West Ham United,Blackburn Rovers,1-3,1,3,1,1,4,-2,A
1932-04-14,1931,Chelsea,Newcastle United,4-1,4,1,1,1,5,3,H
1932-04-16,1931,Arsenal,Sheffield Wednesday,3-1,3,1,1,1,4,2,H
1932-04-16,1931,Birmingham City,Liverpool,3-1,3,1,1,1,4,2,H
1932-04-16,1931,Blackburn Rovers,Huddersfield Town,3-0,3,0,1,1,3,3,H
1932-04-16,1931,Blackpool,Bolton Wanderers,0-3,0,3,1,1,3,-3,A
1932-04-16,1931,Derby County,Aston Villa,3-1,3,1,1,1,4,2,H
1932-04-16,1931,Everton,West Ham United,6-1,6,1,1,1,7,5,H
1932-04-16,1931,Manchester City,Chelsea,1-1,1,1,1,1,2,0,D
1932-04-16,1931,Portsmouth,Newcastle United,6-0,6,0,1,1,6,6,H
1932-04-16,1931,Sheffield United,Middlesbrough,2-1,2,1,1,1,3,1,H
1932-04-16,1931,Sunderland,Grimsby Town,2-0,2,0,1,1,2,2,H
1932-04-16,1931,West Bromwich Albion,Leicester City,1-2,1,2,1,1,3,-1,A
1932-04-23,1931,Aston Villa,Sheffield United,5-0,5,0,1,1,5,5,H
1932-04-23,1931,Bolton Wanderers,Manchester City,1-1,1,1,1,1,2,0,D
1932-04-23,1931,Chelsea,West Bromwich Albion,0-2,0,2,1,1,2,-2,A
1932-04-23,1931,Grimsby Town,Derby County,2-1,2,1,1,1,3,1,H
1932-04-23,1931,Leicester City,Blackburn Rovers,1-0,1,0,1,1,1,1,H
1932-04-23,1931,Liverpool,Portsmouth,1-3,1,3,1,1,4,-2,A
1932-04-23,1931,Middlesbrough,Everton,1-0,1,0,1,1,1,1,H
1932-04-23,1931,Sheffield Wednesday,Sunderland,3-2,3,2,1,1,5,1,H
1932-04-23,1931,West Ham United,Birmingham City,2-4,2,4,1,1,6,-2,A
1932-04-25,1931,Aston Villa,Arsenal,1-1,1,1,1,1,2,0,D
1932-04-27,1931,Huddersfield Town,Arsenal,1-2,1,2,1,1,3,-1,A
1932-04-27,1931,Newcastle United,Blackpool,2-2,2,2,1,1,4,0,D
1932-04-30,1931,Arsenal,Middlesbrough,5-0,5,0,1,1,5,5,H
1932-04-30,1931,Birmingham City,Chelsea,4-0,4,0,1,1,4,4,H
1932-04-30,1931,Blackburn Rovers,Aston Villa,2-0,2,0,1,1,2,2,H
1932-04-30,1931,Blackpool,Huddersfield Town,2-0,2,0,1,1,2,2,H
1932-04-30,1931,Derby County,Liverpool,1-2,1,2,1,1,3,-1,A
1932-04-30,1931,Everton,Bolton Wanderers,1-0,1,0,1,1,1,1,H
1932-04-30,1931,Manchester City,Sheffield Wednesday,1-2,1,2,1,1,3,-1,A
1932-04-30,1931,Portsmouth,Leicester City,0-1,0,1,1,1,1,-1,A
1932-04-30,1931,Sheffield United,Newcastle United,0-3,0,3,1,1,3,-3,A
1932-04-30,1931,Sunderland,West Ham United,2-0,2,0,1,1,2,2,H
1932-04-30,1931,West Bromwich Albion,Grimsby Town,5-6,5,6,1,1,11,-1,A
1932-05-04,1931,Newcastle United,Everton,0-0,0,0,1,1,0,0,D
1932-05-07,1931,Arsenal,Blackburn Rovers,4-0,4,0,1,1,4,4,H
1932-05-07,1931,Aston Villa,Huddersfield Town,2-3,2,3,1,1,5,-1,A
1932-05-07,1931,Bolton Wanderers,Liverpool,8-1,8,1,1,1,9,7,H
1932-05-07,1931,Chelsea,West Ham United,3-2,3,2,1,1,5,1,H
1932-05-07,1931,Everton,Portsmouth,0-1,0,1,1,1,1,-1,A
1932-05-07,1931,Grimsby Town,Sheffield Wednesday,3-1,3,1,1,1,4,2,H
1932-05-07,1931,Middlesbrough,Leicester City,1-1,1,1,1,1,2,0,D
1932-05-07,1931,Newcastle United,Birmingham City,0-3,0,3,1,1,3,-3,A
1932-05-07,1931,Sheffield United,Blackpool,1-3,1,3,1,1,4,-2,A
1932-08-27,1932,Birmingham City,Arsenal,0-1,0,1,1,1,1,-1,A
1932-08-27,1932,Bolton Wanderers,Newcastle United,2-2,2,2,1,1,4,0,D
1932-08-27,1932,Chelsea,Blackburn Rovers,2-2,2,2,1,1,4,0,D
1932-08-27,1932,Leeds United,Derby County,0-2,0,2,1,1,2,-2,A
1932-08-27,1932,Leicester City,Sheffield United,1-1,1,1,1,1,2,0,D
1932-08-27,1932,Liverpool,Wolverhampton Wanderers,5-1,5,1,1,1,6,4,H
1932-08-27,1932,Middlesbrough,Aston Villa,0-2,0,2,1,1,2,-2,A
1932-08-27,1932,Portsmouth,Huddersfield Town,1-0,1,0,1,1,1,1,H
1932-08-27,1932,Sheffield Wednesday,Blackpool,4-1,4,1,1,1,5,3,H
1932-08-27,1932,Sunderland,Manchester City,3-2,3,2,1,1,5,1,H
1932-08-27,1932,West Bromwich Albion,Everton,3-1,3,1,1,1,4,2,H
1932-08-29,1932,Aston Villa,Sunderland,1-0,1,0,1,1,1,1,H
1932-08-29,1932,Blackpool,Leeds United,2-1,2,1,1,1,3,1,H
1932-08-29,1932,Huddersfield Town,Leicester City,4-1,4,1,1,1,5,3,H
1932-08-29,1932,Sheffield United,Liverpool,6-2,6,2,1,1,8,4,H
1932-08-29,1932,Wolverhampton Wanderers,Bolton Wanderers,4-1,4,1,1,1,5,3,H
1932-08-31,1932,Arsenal,West Bromwich Albion,1-2,1,2,1,1,3,-1,A
1932-08-31,1932,Derby County,Blackburn Rovers,2-1,2,1,1,1,3,1,H
1932-08-31,1932,Everton,Sheffield Wednesday,2-1,2,1,1,1,3,1,H
1932-08-31,1932,Manchester City,Birmingham City,1-0,1,0,1,1,1,1,H
1932-08-31,1932,Newcastle United,Middlesbrough,5-1,5,1,1,1,6,4,H
1932-08-31,1932,Portsmouth,Chelsea,2-0,2,0,1,1,2,2,H
1932-09-03,1932,Arsenal,Sunderland,6-1,6,1,1,1,7,5,H
1932-09-03,1932,Aston Villa,Bolton Wanderers,6-1,6,1,1,1,7,5,H
1932-09-03,1932,Blackburn Rovers,Leeds United,1-1,1,1,1,1,2,0,D
1932-09-03,1932,Blackpool,West Bromwich Albion,2-4,2,4,1,1,6,-2,A
1932-09-03,1932,Derby County,Sheffield Wednesday,2-0,2,0,1,1,2,2,H
1932-09-03,1932,Everton,Birmingham City,4-1,4,1,1,1,5,3,H
1932-09-03,1932,Huddersfield Town,Chelsea,2-0,2,0,1,1,2,2,H
1932-09-03,1932,Manchester City,Middlesbrough,2-3,2,3,1,1,5,-1,A
1932-09-03,1932,Newcastle United,Liverpool,4-3,4,3,1,1,7,1,H
1932-09-03,1932,Sheffield United,Portsmouth,2-3,2,3,1,1,5,-1,A
1932-09-03,1932,Wolverhampton Wanderers,Leicester City,1-1,1,1,1,1,2,0,D
1932-09-05,1932,Bolton Wanderers,Wolverhampton Wanderers,2-0,2,0,1,1,2,2,H
1932-09-05,1932,Leeds United,Blackpool,3-1,3,1,1,1,4,2,H
1932-09-05,1932,Leicester City,Huddersfield Town,3-1,3,1,1,1,4,2,H
1932-09-05,1932,Sheffield Wednesday,Everton,3-1,3,1,1,1,4,2,H
1932-09-07,1932,Birmingham City,Manchester City,3-0,3,0,1,1,3,3,H
1932-09-07,1932,Chelsea,Portsmouth,4-4,4,4,1,1,8,0,D
1932-09-07,1932,Liverpool,Sheffield United,2-2,2,2,1,1,4,0,D
1932-09-07,1932,Sunderland,Aston Villa,1-1,1,1,1,1,2,0,D
1932-09-10,1932,Birmingham City,Blackpool,2-1,2,1,1,1,3,1,H
1932-09-10,1932,Bolton Wanderers,Middlesbrough,4-3,4,3,1,1,7,1,H
1932-09-10,1932,Chelsea,Sheffield United,3-0,3,0,1,1,3,3,H
1932-09-10,1932,Leeds United,Huddersfield Town,1-1,1,1,1,1,2,0,D
1932-09-10,1932,Leicester City,Newcastle United,0-3,0,3,1,1,3,-3,A
1932-09-10,1932,Liverpool,Aston Villa,0-0,0,0,1,1,0,0,D
1932-09-10,1932,Manchester City,Arsenal,2-3,2,3,1,1,5,-1,A
1932-09-10,1932,Portsmouth,Wolverhampton Wanderers,2-0,2,0,1,1,2,2,H
1932-09-10,1932,Sheffield Wednesday,Blackburn Rovers,1-1,1,1,1,1,2,0,D
1932-09-10,1932,Sunderland,Everton,3-1,3,1,1,1,4,2,H
1932-09-10,1932,West Bromwich Albion,Derby County,2-0,2,0,1,1,2,2,H
1932-09-14,1932,West Bromwich Albion,Arsenal,1-1,1,1,1,1,2,0,D
1932-09-17,1932,Arsenal,Bolton Wanderers,3-2,3,2,1,1,5,1,H
1932-09-17,1932,Aston Villa,Leicester City,4-2,4,2,1,1,6,2,H
1932-09-17,1932,Blackburn Rovers,West Bromwich Albion,4-4,4,4,1,1,8,0,D
1932-09-17,1932,Blackpool,Sunderland,3-1,3,1,1,1,4,2,H
1932-09-17,1932,Derby County,Birmingham City,2-2,2,2,1,1,4,0,D
1932-09-17,1932,Everton,Manchester City,2-1,2,1,1,1,3,1,H
1932-09-17,1932,Leeds United,Sheffield Wednesday,3-2,3,2,1,1,5,1,H
1932-09-17,1932,Middlesbrough,Liverpool,0-1,0,1,1,1,1,-1,A
1932-09-17,1932,Newcastle United,Portsmouth,1-1,1,1,1,1,2,0,D
1932-09-17,1932,Sheffield United,Huddersfield Town,1-2,1,2,1,1,3,-1,A
1932-09-17,1932,Wolverhampton Wanderers,Chelsea,1-2,1,2,1,1,3,-1,A
1932-09-19,1932,Blackburn Rovers,Derby County,3-3,3,3,1,1,6,0,D
1932-09-24,1932,Arsenal,Everton,2-1,2,1,1,1,3,1,H
1932-09-24,1932,Birmingham City,Blackburn Rovers,3-1,3,1,1,1,4,2,H
1932-09-24,1932,Chelsea,Newcastle United,0-1,0,1,1,1,1,-1,A
1932-09-24,1932,Huddersfield Town,Wolverhampton Wanderers,3-2,3,2,1,1,5,1,H
1932-09-24,1932,Leicester City,Middlesbrough,1-1,1,1,1,1,2,0,D
1932-09-24,1932,Liverpool,Bolton Wanderers,0-1,0,1,1,1,1,-1,A
1932-09-24,1932,Manchester City,Blackpool,5-1,5,1,1,1,6,4,H
1932-09-24,1932,Portsmouth,Aston Villa,2-4,2,4,1,1,6,-2,A
1932-09-24,1932,Sheffield Wednesday,Sheffield United,3-3,3,3,1,1,6,0,D
1932-09-24,1932,Sunderland,Derby County,0-2,0,2,1,1,2,-2,A
1932-09-24,1932,West Bromwich Albion,Leeds United,0-1,0,1,1,1,1,-1,A
1932-10-01,1932,Aston Villa,Chelsea,3-1,3,1,1,1,4,2,H
1932-10-01,1932,Blackburn Rovers,Sunderland,1-3,1,3,1,1,4,-2,A
1932-10-01,1932,Blackpool,Arsenal,1-2,1,2,1,1,3,-1,A
1932-10-01,1932,Bolton Wanderers,Leicester City,5-0,5,0,1,1,5,5,H
1932-10-01,1932,Derby County,Manchester City,4-0,4,0,1,1,4,4,H
1932-10-01,1932,Everton,Liverpool,3-1,3,1,1,1,4,2,H
1932-10-01,1932,Leeds United,Birmingham City,1-1,1,1,1,1,2,0,D
1932-10-01,1932,Middlesbrough,Portsmouth,5-4,5,4,1,1,9,1,H
1932-10-01,1932,Newcastle United,Huddersfield Town,0-4,0,4,1,1,4,-4,A
1932-10-01,1932,Sheffield Wednesday,West Bromwich Albion,3-1,3,1,1,1,4,2,H
1932-10-01,1932,Wolverhampton Wanderers,Sheffield United,5-1,5,1,1,1,6,4,H
1932-10-08,1932,Arsenal,Derby County,3-3,3,3,1,1,6,0,D
1932-10-08,1932,Birmingham City,Sheffield Wednesday,2-1,2,1,1,1,3,1,H
1932-10-08,1932,Chelsea,Middlesbrough,2-1,2,1,1,1,3,1,H
1932-10-08,1932,Everton,Blackpool,2-0,2,0,1,1,2,2,H
1932-10-08,1932,Huddersfield Town,Aston Villa,0-0,0,0,1,1,0,0,D
1932-10-08,1932,Leicester City,Liverpool,1-2,1,2,1,1,3,-1,A
1932-10-08,1932,Manchester City,Blackburn Rovers,2-3,2,3,1,1,5,-1,A
1932-10-08,1932,Portsmouth,Bolton Wanderers,2-1,2,1,1,1,3,1,H
1932-10-08,1932,Sheffield United,Newcastle United,3-1,3,1,1,1,4,2,H
1932-10-08,1932,Sunderland,Leeds United,0-0,0,0,1,1,0,0,D
1932-10-08,1932,West Bromwich Albion,Wolverhampton Wanderers,4-1,4,1,1,1,5,3,H
1932-10-15,1932,Aston Villa,Sheffield United,3-0,3,0,1,1,3,3,H
1932-10-15,1932,Blackburn Rovers,Arsenal,2-3,2,3,1,1,5,-1,A
1932-10-15,1932,Blackpool,Leicester City,2-1,2,1,1,1,3,1,H
1932-10-15,1932,Bolton Wanderers,Chelsea,2-3,2,3,1,1,5,-1,A
1932-10-15,1932,Derby County,Everton,2-0,2,0,1,1,2,2,H
1932-10-15,1932,Leeds United,Manchester City,2-1,2,1,1,1,3,1,H
1932-10-15,1932,Liverpool,Portsmouth,4-3,4,3,1,1,7,1,H
1932-10-15,1932,Middlesbrough,Huddersfield Town,1-1,1,1,1,1,2,0,D
1932-10-15,1932,Newcastle United,Wolverhampton Wanderers,3-2,3,2,1,1,5,1,H
1932-10-15,1932,Sheffield Wednesday,Sunderland,3-1,3,1,1,1,4,2,H
1932-10-15,1932,West Bromwich Albion,Birmingham City,1-0,1,0,1,1,1,1,H
1932-10-22,1932,Aston Villa,Birmingham City,1-0,1,0,1,1,1,1,H
1932-10-22,1932,Bolton Wanderers,Manchester City,2-1,2,1,1,1,3,1,H
1932-10-22,1932,Chelsea,Derby County,1-3,1,3,1,1,4,-2,A
1932-10-22,1932,Huddersfield Town,Blackburn Rovers,0-3,0,3,1,1,3,-3,A
1932-10-22,1932,Leicester City,Everton,2-2,2,2,1,1,4,0,D
1932-10-22,1932,Liverpool,Arsenal,2-3,2,3,1,1,5,-1,A
1932-10-22,1932,Middlesbrough,Sunderland,1-2,1,2,1,1,3,-1,A
1932-10-22,1932,Newcastle United,West Bromwich Albion,3-0,3,0,1,1,3,3,H
1932-10-22,1932,Portsmouth,Blackpool,2-1,2,1,1,1,3,1,H
1932-10-22,1932,Sheffield United,Leeds United,0-0,0,0,1,1,0,0,D
1932-10-22,1932,Wolverhampton Wanderers,Sheffield Wednesday,3-5,3,5,1,1,8,-2,A
1932-10-29,1932,Arsenal,Leicester City,8-2,8,2,1,1,10,6,H
1932-10-29,1932,Birmingham City,Middlesbrough,1-4,1,4,1,1,5,-3,A
1932-10-29,1932,Blackburn Rovers,Sheffield United,3-0,3,0,1,1,3,3,H
1932-10-29,1932,Blackpool,Chelsea,4-0,4,0,1,1,4,4,H
1932-10-29,1932,Derby County,Huddersfield Town,2-3,2,3,1,1,5,-1,A
1932-10-29,1932,Everton,Portsmouth,1-1,1,1,1,1,2,0,D
1932-10-29,1932,Leeds United,Wolverhampton Wanderers,2-0,2,0,1,1,2,2,H
1932-10-29,1932,Manchester City,Liverpool,1-1,1,1,1,1,2,0,D
1932-10-29,1932,Sheffield Wednesday,Newcastle United,2-0,2,0,1,1,2,2,H
1932-10-29,1932,Sunderland,Bolton Wanderers,7-4,7,4,1,1,11,3,H
1932-10-29,1932,West Bromwich Albion,Aston Villa,3-1,3,1,1,1,4,2,H
1932-11-05,1932,Aston Villa,Blackpool,6-2,6,2,1,1,8,4,H
1932-11-05,1932,Bolton Wanderers,Blackburn Rovers,4-2,4,2,1,1,6,2,H
1932-11-05,1932,Chelsea,Birmingham City,4-2,4,2,1,1,6,2,H
1932-11-05,1932,Huddersfield Town,Sunderland,2-1,2,1,1,1,3,1,H
1932-11-05,1932,Leicester City,Sheffield Wednesday,0-0,0,0,1,1,0,0,D
1932-11-05,1932,Liverpool,Leeds United,0-1,0,1,1,1,1,-1,A
1932-11-05,1932,Middlesbrough,Derby County,0-3,0,3,1,1,3,-3,A
1932-11-05,1932,Newcastle United,Everton,1-2,1,2,1,1,3,-1,A
1932-11-05,1932,Portsmouth,West Bromwich Albion,3-0,3,0,1,1,3,3,H
1932-11-05,1932,Sheffield United,Manchester City,2-5,2,5,1,1,7,-3,A
1932-11-05,1932,Wolverhampton Wanderers,Arsenal,1-7,1,7,1,1,8,-6,A
1932-11-12,1932,Arsenal,Newcastle United,1-0,1,0,1,1,1,1,H
1932-11-12,1932,Birmingham City,Huddersfield Town,0-2,0,2,1,1,2,-2,A
1932-11-12,1932,Blackburn Rovers,Liverpool,2-2,2,2,1,1,4,0,D
1932-11-12,1932,Blackpool,Middlesbrough,3-1,3,1,1,1,4,2,H
1932-11-12,1932,Derby County,Bolton Wanderers,4-1,4,1,1,1,5,3,H
1932-11-12,1932,Everton,Aston Villa,3-3,3,3,1,1,6,0,D
1932-11-12,1932,Leeds United,Leicester City,1-1,1,1,1,1,2,0,D
1932-11-12,1932,Manchester City,Wolverhampton Wanderers,4-1,4,1,1,1,5,3,H
1932-11-12,1932,Sheffield Wednesday,Portsmouth,2-1,2,1,1,1,3,1,H
1932-11-12,1932,Sunderland,Sheffield United,2-2,2,2,1,1,4,0,D
1932-11-12,1932,West Bromwich Albion,Chelsea,3-2,3,2,1,1,5,1,H
1932-11-19,1932,Aston Villa,Arsenal,5-3,5,3,1,1,8,2,H
1932-11-19,1932,Bolton Wanderers,Blackpool,1-0,1,0,1,1,1,1,H
1932-11-19,1932,Chelsea,Sheffield Wednesday,0-2,0,2,1,1,2,-2,A
1932-11-19,1932,Huddersfield Town,West Bromwich Albion,2-1,2,1,1,1,3,1,H
1932-11-19,1932,Leicester City,Blackburn Rovers,1-1,1,1,1,1,2,0,D
1932-11-19,1932,Liverpool,Derby County,6-1,6,1,1,1,7,5,H
1932-11-19,1932,Middlesbrough,Everton,0-2,0,2,1,1,2,-2,A
1932-11-19,1932,Newcastle United,Manchester City,2-0,2,0,1,1,2,2,H
1932-11-19,1932,Portsmouth,Leeds United,3-3,3,3,1,1,6,0,D
1932-11-19,1932,Sheffield United,Birmingham City,2-1,2,1,1,1,3,1,H
1932-11-19,1932,Wolverhampton Wanderers,Sunderland,0-2,0,2,1,1,2,-2,A
1932-11-26,1932,Arsenal,Middlesbrough,4-2,4,2,1,1,6,2,H
1932-11-26,1932,Birmingham City,Wolverhampton Wanderers,0-0,0,0,1,1,0,0,D
1932-11-26,1932,Blackburn Rovers,Portsmouth,3-2,3,2,1,1,5,1,H
1932-11-26,1932,Blackpool,Liverpool,4-1,4,1,1,1,5,3,H
1932-11-26,1932,Derby County,Leicester City,3-2,3,2,1,1,5,1,H
1932-11-26,1932,Everton,Bolton Wanderers,2-2,2,2,1,1,4,0,D
1932-11-26,1932,Leeds United,Chelsea,2-0,2,0,1,1,2,2,H
1932-11-26,1932,Manchester City,Aston Villa,5-2,5,2,1,1,7,3,H
1932-11-26,1932,Sheffield Wednesday,Huddersfield Town,2-1,2,1,1,1,3,1,H
1932-11-26,1932,Sunderland,Newcastle United,0-2,0,2,1,1,2,-2,A
1932-11-26,1932,West Bromwich Albion,Sheffield United,0-1,0,1,1,1,1,-1,A
1932-12-03,1932,Aston Villa,Sheffield Wednesday,3-6,3,6,1,1,9,-3,A
1932-12-03,1932,Bolton Wanderers,Birmingham City,2-2,2,2,1,1,4,0,D
1932-12-03,1932,Chelsea,Everton,1-0,1,0,1,1,1,1,H
1932-12-03,1932,Huddersfield Town,Blackpool,0-1,0,1,1,1,1,-1,A
1932-12-03,1932,Leicester City,Manchester City,1-2,1,2,1,1,3,-1,A
1932-12-03,1932,Liverpool,Sunderland,3-3,3,3,1,1,6,0,D
1932-12-03,1932,Middlesbrough,West Bromwich Albion,3-1,3,1,1,1,4,2,H
1932-12-03,1932,Newcastle United,Leeds United,3-1,3,1,1,1,4,2,H
1932-12-03,1932,Portsmouth,Arsenal,1-3,1,3,1,1,4,-2,A
1932-12-03,1932,Sheffield United,Derby County,4-3,4,3,1,1,7,1,H
1932-12-03,1932,Wolverhampton Wanderers,Blackburn Rovers,5-3,5,3,1,1,8,2,H
1932-12-10,1932,Arsenal,Chelsea,4-1,4,1,1,1,5,3,H
1932-12-10,1932,Birmingham City,Liverpool,3-0,3,0,1,1,3,3,H
1932-12-10,1932,Blackburn Rovers,Newcastle United,2-1,2,1,1,1,3,1,H
1932-12-10,1932,Blackpool,Sheffield United,0-3,0,3,1,1,3,-3,A
1932-12-10,1932,Derby County,Wolverhampton Wanderers,4-4,4,4,1,1,8,0,D
1932-12-10,1932,Everton,Huddersfield Town,2-0,2,0,1,1,2,2,H
1932-12-10,1932,Leeds United,Aston Villa,1-1,1,1,1,1,2,0,D
1932-12-10,1932,Manchester City,Portsmouth,3-1,3,1,1,1,4,2,H
1932-12-10,1932,Sheffield Wednesday,Middlesbrough,2-1,2,1,1,1,3,1,H
1932-12-10,1932,Sunderland,Leicester City,2-1,2,1,1,1,3,1,H
1932-12-10,1932,West Bromwich Albion,Bolton Wanderers,4-0,4,0,1,1,4,4,H
1932-12-17,1932,Aston Villa,Blackburn Rovers,4-0,4,0,1,1,4,4,H
1932-12-17,1932,Bolton Wanderers,Sheffield Wednesday,3-0,3,0,1,1,3,3,H
1932-12-17,1932,Chelsea,Manchester City,3-1,3,1,1,1,4,2,H
1932-12-17,1932,Huddersfield Town,Arsenal,0-1,0,1,1,1,1,-1,A
1932-12-17,1932,Leicester City,Birmingham City,2-2,2,2,1,1,4,0,D
1932-12-17,1932,Liverpool,West Bromwich Albion,2-0,2,0,1,1,2,2,H
1932-12-17,1932,Middlesbrough,Leeds United,0-1,0,1,1,1,1,-1,A
1932-12-17,1932,Newcastle United,Derby County,0-0,0,0,1,1,0,0,D
1932-12-17,1932,Portsmouth,Sunderland,1-3,1,3,1,1,4,-2,A
1932-12-17,1932,Sheffield United,Everton,3-2,3,2,1,1,5,1,H
1932-12-17,1932,Wolverhampton Wanderers,Blackpool,2-3,2,3,1,1,5,-1,A
1932-12-24,1932,Arsenal,Sheffield United,9-2,9,2,1,1,11,7,H
1932-12-24,1932,Birmingham City,Portsmouth,4-0,4,0,1,1,4,4,H
1932-12-24,1932,Blackburn Rovers,Middlesbrough,4-2,4,2,1,1,6,2,H
1932-12-24,1932,Blackpool,Newcastle United,0-4,0,4,1,1,4,-4,A
1932-12-24,1932,Derby County,Aston Villa,0-0,0,0,1,1,0,0,D
1932-12-24,1932,Everton,Wolverhampton Wanderers,5-1,5,1,1,1,6,4,H
1932-12-24,1932,Leeds United,Bolton Wanderers,4-3,4,3,1,1,7,1,H
1932-12-24,1932,Manchester City,Huddersfield Town,3-0,3,0,1,1,3,3,H
1932-12-24,1932,Sheffield Wednesday,Liverpool,3-0,3,0,1,1,3,3,H
1932-12-24,1932,Sunderland,Chelsea,2-1,2,1,1,1,3,1,H
1932-12-24,1932,West Bromwich Albion,Leicester City,4-3,4,3,1,1,7,1,H
1932-12-26,1932,Arsenal,Leeds United,1-2,1,2,1,1,3,-1,A
1932-12-26,1932,Aston Villa,Wolverhampton Wanderers,1-3,1,3,1,1,4,-2,A
1932-12-26,1932,Blackburn Rovers,Everton,3-1,3,1,1,1,4,2,H
1932-12-26,1932,Bolton Wanderers,Huddersfield Town,2-1,2,1,1,1,3,1,H
1932-12-26,1932,Derby County,Blackpool,1-1,1,1,1,1,2,0,D
1932-12-26,1932,Liverpool,Chelsea,3-0,3,0,1,1,3,3,H
1932-12-26,1932,Manchester City,Sheffield Wednesday,2-2,2,2,1,1,4,0,D
1932-12-26,1932,Newcastle United,Birmingham City,2-1,2,1,1,1,3,1,H
1932-12-26,1932,Portsmouth,Leicester City,2-1,2,1,1,1,3,1,H
1932-12-26,1932,West Bromwich Albion,Sunderland,5-1,5,1,1,1,6,4,H
1932-12-27,1932,Birmingham City,Newcastle United,1-2,1,2,1,1,3,-1,A
1932-12-27,1932,Blackpool,Derby County,4-1,4,1,1,1,5,3,H
1932-12-27,1932,Chelsea,Liverpool,0-2,0,2,1,1,2,-2,A
1932-12-27,1932,Everton,Blackburn Rovers,6-1,6,1,1,1,7,5,H
1932-12-27,1932,Huddersfield Town,Bolton Wanderers,2-1,2,1,1,1,3,1,H
1932-12-27,1932,Leeds United,Arsenal,0-0,0,0,1,1,0,0,D
1932-12-27,1932,Leicester City,Portsmouth,2-1,2,1,1,1,3,1,H
1932-12-27,1932,Middlesbrough,Sheffield United,2-2,2,2,1,1,4,0,D
1932-12-27,1932,Sheffield Wednesday,Manchester City,2-1,2,1,1,1,3,1,H
1932-12-27,1932,Wolverhampton Wanderers,Aston Villa,2-4,2,4,1,1,6,-2,A
1932-12-31,1932,Arsenal,Birmingham City,3-0,3,0,1,1,3,3,H
1932-12-31,1932,Aston Villa,Middlesbrough,3-1,3,1,1,1,4,2,H
1932-12-31,1932,Blackburn Rovers,Chelsea,1-3,1,3,1,1,4,-2,A
1932-12-31,1932,Blackpool,Sheffield Wednesday,3-4,3,4,1,1,7,-1,A
1932-12-31,1932,Derby County,Leeds United,5-1,5,1,1,1,6,4,H
1932-12-31,1932,Everton,West Bromwich Albion,1-2,1,2,1,1,3,-1,A
1932-12-31,1932,Huddersfield Town,Portsmouth,2-2,2,2,1,1,4,0,D
1932-12-31,1932,Manchester City,Sunderland,2-4,2,4,1,1,6,-2,A
1932-12-31,1932,Newcastle United,Bolton Wanderers,3-1,3,1,1,1,4,2,H
1932-12-31,1932,Sheffield United,Leicester City,5-2,5,2,1,1,7,3,H
1932-12-31,1932,Wolverhampton Wanderers,Liverpool,3-1,3,1,1,1,4,2,H
1933-01-02,1932,Blackburn Rovers,Blackpool,6-5,6,5,1,1,11,1,H
1933-01-02,1932,Bolton Wanderers,Sheffield United,3-3,3,3,1,1,6,0,D
1933-01-02,1932,Middlesbrough,Newcastle United,2-3,2,3,1,1,5,-1,A
1933-01-02,1932,Sheffield Wednesday,Arsenal,3-2,3,2,1,1,5,1,H
1933-01-02,1932,Sunderland,West Bromwich Albion,2-2,2,2,1,1,4,0,D
1933-01-07,1932,Birmingham City,Everton,4-0,4,0,1,1,4,4,H
1933-01-07,1932,Bolton Wanderers,Aston Villa,0-1,0,1,1,1,1,-1,A
1933-01-07,1932,Chelsea,Huddersfield Town,0-1,0,1,1,1,1,-1,A
1933-01-07,1932,Leeds United,Blackburn Rovers,3-1,3,1,1,1,4,2,H
1933-01-07,1932,Leicester City,Wolverhampton Wanderers,2-2,2,2,1,1,4,0,D
1933-01-07,1932,Liverpool,Newcastle United,3-0,3,0,1,1,3,3,H
1933-01-07,1932,Middlesbrough,Manchester City,2-0,2,0,1,1,2,2,H
1933-01-07,1932,Portsmouth,Sheffield United,1-0,1,0,1,1,1,1,H
1933-01-07,1932,Sheffield Wednesday,Derby County,0-0,0,0,1,1,0,0,D
1933-01-07,1932,Sunderland,Arsenal,3-2,3,2,1,1,5,1,H
1933-01-07,1932,West Bromwich Albion,Blackpool,2-1,2,1,1,1,3,1,H
1933-01-21,1932,Arsenal,Manchester City,2-1,2,1,1,1,3,1,H
1933-01-21,1932,Aston Villa,Liverpool,5-2,5,2,1,1,7,3,H
1933-01-21,1932,Blackburn Rovers,Sheffield Wednesday,1-1,1,1,1,1,2,0,D
1933-01-21,1932,Blackpool,Birmingham City,0-1,0,1,1,1,1,-1,A
1933-01-21,1932,Derby County,West Bromwich Albion,2-2,2,2,1,1,4,0,D
1933-01-21,1932,Everton,Sunderland,6-1,6,1,1,1,7,5,H
1933-01-21,1932,Huddersfield Town,Leeds United,2-2,2,2,1,1,4,0,D
1933-01-21,1932,Middlesbrough,Bolton Wanderers,2-1,2,1,1,1,3,1,H
1933-01-21,1932,Newcastle United,Leicester City,2-1,2,1,1,1,3,1,H
1933-01-21,1932,Sheffield United,Chelsea,4-1,4,1,1,1,5,3,H
1933-01-21,1932,Wolverhampton Wanderers,Portsmouth,5-2,5,2,1,1,7,3,H
1933-01-28,1932,Chelsea,Wolverhampton Wanderers,3-1,3,1,1,1,4,2,H
1933-01-28,1932,Portsmouth,Newcastle United,2-0,2,0,1,1,2,2,H
1933-02-01,1932,Birmingham City,Derby County,3-1,3,1,1,1,4,2,H
1933-02-01,1932,Bolton Wanderers,Arsenal,0-4,0,4,1,1,4,-4,A
1933-02-01,1932,Huddersfield Town,Sheffield United,1-0,1,0,1,1,1,1,H
1933-02-01,1932,Liverpool,Middlesbrough,1-3,1,3,1,1,4,-2,A
1933-02-01,1932,Manchester City,Everton,3-0,3,0,1,1,3,3,H
1933-02-01,1932,Sunderland,Blackpool,1-1,1,1,1,1,2,0,D
1933-02-04,1932,Aston Villa,Portsmouth,4-1,4,1,1,1,5,3,H
1933-02-04,1932,Blackburn Rovers,Birmingham City,2-0,2,0,1,1,2,2,H
1933-02-04,1932,Blackpool,Manchester City,1-0,1,0,1,1,1,1,H
1933-02-04,1932,Bolton Wanderers,Liverpool,3-3,3,3,1,1,6,0,D
1933-02-04,1932,Derby County,Sunderland,3-0,3,0,1,1,3,3,H
1933-02-04,1932,Everton,Arsenal,1-1,1,1,1,1,2,0,D
1933-02-04,1932,Leeds United,West Bromwich Albion,1-1,1,1,1,1,2,0,D
1933-02-04,1932,Middlesbrough,Leicester City,1-1,1,1,1,1,2,0,D
1933-02-04,1932,Newcastle United,Chelsea,2-0,2,0,1,1,2,2,H
1933-02-04,1932,Sheffield United,Sheffield Wednesday,2-3,2,3,1,1,5,-1,A
1933-02-04,1932,Wolverhampton Wanderers,Huddersfield Town,6-4,6,4,1,1,10,2,H
1933-02-08,1932,Sheffield Wednesday,Leeds United,2-0,2,0,1,1,2,2,H
1933-02-08,1932,West Bromwich Albion,Blackburn Rovers,1-3,1,3,1,1,4,-2,A
1933-02-09,1932,Leicester City,Aston Villa,3-0,3,0,1,1,3,3,H
1933-02-11,1932,Arsenal,Blackpool,1-1,1,1,1,1,2,0,D
1933-02-11,1932,Birmingham City,Leeds United,2-1,2,1,1,1,3,1,H
1933-02-11,1932,Chelsea,Aston Villa,0-1,0,1,1,1,1,-1,A
1933-02-11,1932,Huddersfield Town,Newcastle United,4-0,4,0,1,1,4,4,H
1933-02-11,1932,Leicester City,Bolton Wanderers,2-0,2,0,1,1,2,2,H
1933-02-11,1932,Liverpool,Everton,7-4,7,4,1,1,11,3,H
1933-02-11,1932,Manchester City,Derby County,2-1,2,1,1,1,3,1,H
1933-02-11,1932,Portsmouth,Middlesbrough,2-0,2,0,1,1,2,2,H
1933-02-11,1932,Sheffield United,Wolverhampton Wanderers,0-0,0,0,1,1,0,0,D
1933-02-11,1932,Sunderland,Blackburn Rovers,4-2,4,2,1,1,6,2,H
1933-02-11,1932,West Bromwich Albion,Sheffield Wednesday,2-0,2,0,1,1,2,2,H
1933-02-18,1932,Aston Villa,Huddersfield Town,0-3,0,3,1,1,3,-3,A
1933-02-18,1932,Liverpool,Leicester City,1-2,1,2,1,1,3,-1,A
1933-02-18,1932,Newcastle United,Sheffield United,2-0,2,0,1,1,2,2,H
1933-02-18,1932,Wolverhampton Wanderers,West Bromwich Albion,3-3,3,3,1,1,6,0,D
1933-02-22,1932,Blackpool,Everton,2-1,2,1,1,1,3,1,H
1933-02-22,1932,Bolton Wanderers,Portsmouth,4-1,4,1,1,1,5,3,H
1933-02-22,1932,Derby County,Arsenal,2-2,2,2,1,1,4,0,D
1933-02-22,1932,Leeds United,Sunderland,2-3,2,3,1,1,5,-1,A
1933-02-23,1932,Blackburn Rovers,Manchester City,1-0,1,0,1,1,1,1,H
1933-02-25,1932,Arsenal,Blackburn Rovers,8-0,8,0,1,1,8,8,H
1933-02-25,1932,Chelsea,Bolton Wanderers,1-1,1,1,1,1,2,0,D
1933-02-25,1932,Everton,Derby County,4-2,4,2,1,1,6,2,H
1933-02-25,1932,Portsmouth,Liverpool,2-1,2,1,1,1,3,1,H
1933-02-25,1932,Sunderland,Sheffield Wednesday,1-2,1,2,1,1,3,-1,A
1933-03-01,1932,Middlesbrough,Chelsea,2-1,2,1,1,1,3,1,H
1933-03-04,1932,Arsenal,Liverpool,0-1,0,1,1,1,1,-1,A
1933-03-04,1932,Blackburn Rovers,Huddersfield Town,4-2,4,2,1,1,6,2,H
1933-03-04,1932,Blackpool,Portsmouth,0-2,0,2,1,1,2,-2,A
1933-03-04,1932,Leeds United,Sheffield United,1-3,1,3,1,1,4,-2,A
1933-03-04,1932,Sheffield Wednesday,Wolverhampton Wanderers,2-0,2,0,1,1,2,2,H
1933-03-04,1932,West Bromwich Albion,Newcastle United,3-2,3,2,1,1,5,1,H
1933-03-06,1932,Wolverhampton Wanderers,Newcastle United,1-1,1,1,1,1,2,0,D
1933-03-08,1932,Birmingham City,Aston Villa,3-2,3,2,1,1,5,1,H
1933-03-08,1932,Everton,Leicester City,6-3,6,3,1,1,9,3,H
1933-03-08,1932,Manchester City,Bolton Wanderers,2-1,2,1,1,1,3,1,H
1933-03-11,1932,Aston Villa,West Bromwich Albion,3-2,3,2,1,1,5,1,H
1933-03-11,1932,Bolton Wanderers,Sunderland,0-0,0,0,1,1,0,0,D
1933-03-11,1932,Chelsea,Blackpool,1-0,1,0,1,1,1,1,H
1933-03-11,1932,Huddersfield Town,Derby County,0-0,0,0,1,1,0,0,D
1933-03-11,1932,Leicester City,Arsenal,1-1,1,1,1,1,2,0,D
1933-03-11,1932,Liverpool,Manchester City,1-1,1,1,1,1,2,0,D
1933-03-11,1932,Middlesbrough,Birmingham City,2-2,2,2,1,1,4,0,D
1933-03-11,1932,Newcastle United,Sheffield Wednesday,3-1,3,1,1,1,4,2,H
1933-03-11,1932,Portsmouth,Everton,2-2,2,2,1,1,4,0,D
1933-03-11,1932,Sheffield United,Blackburn Rovers,2-1,2,1,1,1,3,1,H
1933-03-11,1932,Wolverhampton Wanderers,Leeds United,3-3,3,3,1,1,6,0,D
1933-03-15,1932,Huddersfield Town,Middlesbrough,0-1,0,1,1,1,1,-1,A
1933-03-18,1932,Arsenal,Wolverhampton Wanderers,1-2,1,2,1,1,3,-1,A
1933-03-18,1932,Birmingham City,Chelsea,0-0,0,0,1,1,0,0,D
1933-03-18,1932,Blackburn Rovers,Bolton Wanderers,3-2,3,2,1,1,5,1,H
1933-03-18,1932,Blackpool,Aston Villa,6-2,6,2,1,1,8,4,H
1933-03-18,1932,Leeds United,Liverpool,5-0,5,0,1,1,5,5,H
1933-03-18,1932,Sheffield Wednesday,Leicester City,4-1,4,1,1,1,5,3,H
1933-03-18,1932,Sunderland,Huddersfield Town,1-2,1,2,1,1,3,-1,A
1933-03-18,1932,West Bromwich Albion,Portsmouth,4-2,4,2,1,1,6,2,H
1933-03-22,1932,Manchester City,Sheffield United,1-0,1,0,1,1,1,1,H
1933-03-22,1932,Sunderland,Middlesbrough,0-0,0,0,1,1,0,0,D
1933-03-25,1932,Aston Villa,Everton,2-1,2,1,1,1,3,1,H
1933-03-25,1932,Bolton Wanderers,Derby County,1-1,1,1,1,1,2,0,D
1933-03-25,1932,Chelsea,West Bromwich Albion,1-2,1,2,1,1,3,-1,A
1933-03-25,1932,Huddersfield Town,Birmingham City,0-0,0,0,1,1,0,0,D
1933-03-25,1932,Leicester City,Leeds United,3-1,3,1,1,1,4,2,H
1933-03-25,1932,Liverpool,Blackburn Rovers,2-2,2,2,1,1,4,0,D
1933-03-25,1932,Middlesbrough,Blackpool,2-0,2,0,1,1,2,2,H
1933-03-25,1932,Newcastle United,Arsenal,2-1,2,1,1,1,3,1,H
1933-03-25,1932,Portsmouth,Sheffield Wednesday,3-0,3,0,1,1,3,3,H
1933-03-25,1932,Sheffield United,Sunderland,3-0,3,0,1,1,3,3,H
1933-03-25,1932,Wolverhampton Wanderers,Manchester City,1-2,1,2,1,1,3,-1,A
1933-03-27,1932,Sheffield United,Middlesbrough,2-0,2,0,1,1,2,2,H
1933-03-29,1932,Derby County,Chelsea,0-1,0,1,1,1,1,-1,A
1933-03-30,1932,Leicester City,Blackpool,3-0,3,0,1,1,3,3,H
1933-04-01,1932,Arsenal,Aston Villa,5-0,5,0,1,1,5,5,H
1933-04-01,1932,Birmingham City,Sheffield United,4-1,4,1,1,1,5,3,H
1933-04-01,1932,Blackburn Rovers,Leicester City,1-1,1,1,1,1,2,0,D
1933-04-01,1932,Blackpool,Bolton Wanderers,1-3,1,3,1,1,4,-2,A
1933-04-01,1932,Derby County,Liverpool,1-1,1,1,1,1,2,0,D
1933-04-01,1932,Everton,Middlesbrough,0-0,0,0,1,1,0,0,D
1933-04-01,1932,Leeds United,Portsmouth,0-1,0,1,1,1,1,-1,A
1933-04-01,1932,Manchester City,Newcastle United,1-2,1,2,1,1,3,-1,A
1933-04-01,1932,Sheffield Wednesday,Chelsea,2-2,2,2,1,1,4,0,D
1933-04-01,1932,Sunderland,Wolverhampton Wanderers,0-1,0,1,1,1,1,-1,A
1933-04-01,1932,West Bromwich Albion,Huddersfield Town,2-1,2,1,1,1,3,1,H
1933-04-05,1932,Derby County,Middlesbrough,2-2,2,2,1,1,4,0,D
1933-04-05,1932,Everton,Newcastle United,0-0,0,0,1,1,0,0,D
1933-04-05,1932,Manchester City,Leeds United,0-0,0,0,1,1,0,0,D
1933-04-05,1932,Sheffield Wednesday,Birmingham City,1-1,1,1,1,1,2,0,D
1933-04-08,1932,Aston Villa,Manchester City,1-1,1,1,1,1,2,0,D
1933-04-08,1932,Bolton Wanderers,Everton,2-4,2,4,1,1,6,-2,A
1933-04-08,1932,Chelsea,Leeds United,6-0,6,0,1,1,6,6,H
1933-04-08,1932,Huddersfield Town,Sheffield Wednesday,4-0,4,0,1,1,4,4,H
1933-04-08,1932,Leicester City,Derby County,4-0,4,0,1,1,4,4,H
1933-04-08,1932,Liverpool,Blackpool,4-3,4,3,1,1,7,1,H
1933-04-08,1932,Middlesbrough,Arsenal,3-4,3,4,1,1,7,-1,A
1933-04-08,1932,Newcastle United,Sunderland,0-1,0,1,1,1,1,-1,A
1933-04-08,1932,Portsmouth,Blackburn Rovers,2-0,2,0,1,1,2,2,H
1933-04-08,1932,Sheffield United,West Bromwich Albion,1-1,1,1,1,1,2,0,D
1933-04-08,1932,Wolverhampton Wanderers,Birmingham City,1-0,1,0,1,1,1,1,H
1933-04-14,1932,Arsenal,Sheffield Wednesday,4-2,4,2,1,1,6,2,H
1933-04-14,1932,Blackpool,Blackburn Rovers,3-0,3,0,1,1,3,3,H
1933-04-14,1932,Chelsea,Leicester City,4-1,4,1,1,1,5,3,H
1933-04-14,1932,Liverpool,Huddersfield Town,2-2,2,2,1,1,4,0,D
1933-04-14,1932,Manchester City,West Bromwich Albion,1-0,1,0,1,1,1,1,H
1933-04-14,1932,Portsmouth,Derby County,2-0,2,0,1,1,2,2,H
1933-04-14,1932,Sunderland,Birmingham City,1-0,1,0,1,1,1,1,H
1933-04-14,1932,Wolverhampton Wanderers,Middlesbrough,2-0,2,0,1,1,2,2,H
1933-04-15,1932,Arsenal,Portsmouth,2-0,2,0,1,1,2,2,H
1933-04-15,1932,Birmingham City,Bolton Wanderers,2-1,2,1,1,1,3,1,H
1933-04-15,1932,Blackburn Rovers,Wolverhampton Wanderers,1-0,1,0,1,1,1,1,H
1933-04-15,1932,Blackpool,Huddersfield Town,1-1,1,1,1,1,2,0,D
1933-04-15,1932,Derby County,Sheffield United,3-0,3,0,1,1,3,3,H
1933-04-15,1932,Everton,Chelsea,3-2,3,2,1,1,5,1,H
1933-04-15,1932,Leeds United,Newcastle United,6-1,6,1,1,1,7,5,H
1933-04-15,1932,Manchester City,Leicester City,4-1,4,1,1,1,5,3,H
1933-04-15,1932,Sheffield Wednesday,Aston Villa,0-2,0,2,1,1,2,-2,A
1933-04-15,1932,Sunderland,Liverpool,0-0,0,0,1,1,0,0,D
1933-04-15,1932,West Bromwich Albion,Middlesbrough,0-1,0,1,1,1,1,-1,A
1933-04-17,1932,Birmingham City,Sunderland,2-0,2,0,1,1,2,2,H
1933-04-17,1932,Derby County,Portsmouth,2-0,2,0,1,1,2,2,H
1933-04-17,1932,Everton,Leeds United,0-1,0,1,1,1,1,-1,A
1933-04-17,1932,Middlesbrough,Wolverhampton Wanderers,2-1,2,1,1,1,3,1,H
1933-04-17,1932,Newcastle United,Aston Villa,3-1,3,1,1,1,4,2,H
1933-04-17,1932,Sheffield United,Bolton Wanderers,3-2,3,2,1,1,5,1,H
1933-04-17,1932,West Bromwich Albion,Manchester City,4-0,4,0,1,1,4,4,H
1933-04-18,1932,Aston Villa,Newcastle United,3-0,3,0,1,1,3,3,H
1933-04-18,1932,Huddersfield Town,Liverpool,3-1,3,1,1,1,4,2,H
1933-04-18,1932,Leeds United,Everton,1-0,1,0,1,1,1,1,H
1933-04-18,1932,Leicester City,Chelsea,1-1,1,1,1,1,2,0,D
1933-04-22,1932,Aston Villa,Leeds United,0-0,0,0,1,1,0,0,D
1933-04-22,1932,Bolton Wanderers,West Bromwich Albion,2-2,2,2,1,1,4,0,D
1933-04-22,1932,Chelsea,Arsenal,1-3,1,3,1,1,4,-2,A
1933-04-22,1932,Huddersfield Town,Everton,0-0,0,0,1,1,0,0,D
1933-04-22,1932,Leicester City,Sunderland,4-2,4,2,1,1,6,2,H
1933-04-22,1932,Liverpool,Birmingham City,1-0,1,0,1,1,1,1,H
1933-04-22,1932,Middlesbrough,Sheffield Wednesday,1-1,1,1,1,1,2,0,D
1933-04-22,1932,Newcastle United,Blackburn Rovers,2-1,2,1,1,1,3,1,H
1933-04-22,1932,Portsmouth,Manchester City,1-2,1,2,1,1,3,-1,A
1933-04-22,1932,Sheffield United,Blackpool,1-0,1,0,1,1,1,1,H
1933-04-22,1932,Wolverhampton Wanderers,Derby County,3-1,3,1,1,1,4,2,H
1933-04-24,1932,Sheffield United,Aston Villa,1-0,1,0,1,1,1,1,H
1933-04-26,1932,Birmingham City,West Bromwich Albion,1-1,1,1,1,1,2,0,D
1933-04-29,1932,Arsenal,Huddersfield Town,2-2,2,2,1,1,4,0,D
1933-04-29,1932,Birmingham City,Leicester City,0-4,0,4,1,1,4,-4,A
1933-04-29,1932,Blackburn Rovers,Aston Villa,0-5,0,5,1,1,5,-5,A
1933-04-29,1932,Blackpool,Wolverhampton Wanderers,2-2,2,2,1,1,4,0,D
1933-04-29,1932,Derby County,Newcastle United,3-2,3,2,1,1,5,1,H
1933-04-29,1932,Leeds United,Middlesbrough,0-1,0,1,1,1,1,-1,A
1933-04-29,1932,Sheffield Wednesday,Bolton Wanderers,2-0,2,0,1,1,2,2,H
1933-04-29,1932,Sunderland,Portsmouth,0-3,0,3,1,1,3,-3,A
1933-04-29,1932,West Bromwich Albion,Liverpool,2-1,2,1,1,1,3,1,H
1933-05-03,1932,Everton,Sheffield United,1-0,1,0,1,1,1,1,H
1933-05-03,1932,Manchester City,Chelsea,1-4,1,4,1,1,5,-3,A
1933-05-06,1932,Aston Villa,Derby County,2-0,2,0,1,1,2,2,H
1933-05-06,1932,Bolton Wanderers,Leeds United,5-0,5,0,1,1,5,5,H
1933-05-06,1932,Chelsea,Sunderland,1-1,1,1,1,1,2,0,D
1933-05-06,1932,Huddersfield Town,Manchester City,1-0,1,0,1,1,1,1,H
1933-05-06,1932,Leicester City,West Bromwich Albion,6-2,6,2,1,1,8,4,H
1933-05-06,1932,Liverpool,Sheffield Wednesday,4-1,4,1,1,1,5,3,H
1933-05-06,1932,Middlesbrough,Blackburn Rovers,4-0,4,0,1,1,4,4,H
1933-05-06,1932,Newcastle United,Blackpool,1-2,1,2,1,1,3,-1,A
1933-05-06,1932,Portsmouth,Birmingham City,1-1,1,1,1,1,2,0,D
1933-05-06,1932,Sheffield United,Arsenal,3-1,3,1,1,1,4,2,H
1933-05-06,1932,Wolverhampton Wanderers,Everton,4-2,4,2,1,1,6,2,H
1933-08-26,1933,Arsenal,Birmingham City,1-1,1,1,1,1,2,0,D
1933-08-26,1933,Aston Villa,Leicester City,2-3,2,3,1,1,5,-1,A
1933-08-26,1933,Blackburn Rovers,Leeds United,4-2,4,2,1,1,6,2,H
1933-08-26,1933,Everton,West Bromwich Albion,1-0,1,0,1,1,1,1,H
1933-08-26,1933,Huddersfield Town,Sunderland,2-1,2,1,1,1,3,1,H
1933-08-26,1933,Manchester City,Sheffield Wednesday,2-3,2,3,1,1,5,-1,A
1933-08-26,1933,Middlesbrough,Derby County,3-1,3,1,1,1,4,2,H
1933-08-26,1933,Newcastle United,Portsmouth,2-2,2,2,1,1,4,0,D
1933-08-26,1933,Sheffield United,Tottenham Hotspur,0-0,0,0,1,1,0,0,D
1933-08-26,1933,Stoke City,Chelsea,1-0,1,0,1,1,1,1,H
1933-08-26,1933,Wolverhampton Wanderers,Liverpool,3-2,3,2,1,1,5,1,H
1933-08-28,1933,Leeds United,Middlesbrough,5-2,5,2,1,1,7,3,H
1933-08-28,1933,Leicester City,Sheffield United,4-0,4,0,1,1,4,4,H
1933-08-28,1933,Sheffield Wednesday,Aston Villa,1-2,1,2,1,1,3,-1,A
1933-08-28,1933,Tottenham Hotspur,Wolverhampton Wanderers,4-0,4,0,1,1,4,4,H
1933-08-30,1933,Birmingham City,Manchester City,0-1,0,1,1,1,1,-1,A
1933-08-30,1933,Derby County,Everton,1-1,1,1,1,1,2,0,D
1933-08-30,1933,Liverpool,Stoke City,1-1,1,1,1,1,2,0,D
1933-08-30,1933,Sunderland,Portsmouth,0-2,0,2,1,1,2,-2,A
1933-09-02,1933,Birmingham City,Everton,2-2,2,2,1,1,4,0,D
1933-09-02,1933,Chelsea,Wolverhampton Wanderers,5-2,5,2,1,1,7,3,H
1933-09-02,1933,Derby County,Blackburn Rovers,1-1,1,1,1,1,2,0,D
1933-09-02,1933,Leeds United,Newcastle United,3-0,3,0,1,1,3,3,H
1933-09-02,1933,Leicester City,Manchester City,0-0,0,0,1,1,0,0,D
1933-09-02,1933,Liverpool,Sheffield United,3-2,3,2,1,1,5,1,H
1933-09-02,1933,Portsmouth,Huddersfield Town,3-0,3,0,1,1,3,3,H
1933-09-02,1933,Sheffield Wednesday,Arsenal,1-2,1,2,1,1,3,-1,A
1933-09-02,1933,Sunderland,Stoke City,4-1,4,1,1,1,5,3,H
1933-09-02,1933,Tottenham Hotspur,Aston Villa,3-2,3,2,1,1,5,1,H
1933-09-02,1933,West Bromwich Albion,Middlesbrough,3-0,3,0,1,1,3,3,H
1933-09-04,1933,Aston Villa,Sheffield Wednesday,1-0,1,0,1,1,1,1,H
1933-09-04,1933,Huddersfield Town,Chelsea,6-1,6,1,1,1,7,5,H
1933-09-04,1933,Sheffield United,Leicester City,2-1,2,1,1,1,3,1,H
1933-09-04,1933,Stoke City,Liverpool,1-1,1,1,1,1,2,0,D
1933-09-04,1933,Wolverhampton Wanderers,Tottenham Hotspur,1-0,1,0,1,1,1,1,H
1933-09-06,1933,Arsenal,West Bromwich Albion,3-1,3,1,1,1,4,2,H
1933-09-06,1933,Manchester City,Birmingham City,1-0,1,0,1,1,1,1,H
1933-09-06,1933,Newcastle United,Blackburn Rovers,3-1,3,1,1,1,4,2,H
1933-09-06,1933,Portsmouth,Sunderland,0-0,0,0,1,1,0,0,D
1933-09-09,1933,Arsenal,Manchester City,1-1,1,1,1,1,2,0,D
1933-09-09,1933,Aston Villa,Liverpool,4-2,4,2,1,1,6,2,H
1933-09-09,1933,Blackburn Rovers,West Bromwich Albion,4-0,4,0,1,1,4,4,H
1933-09-09,1933,Everton,Sheffield Wednesday,2-3,2,3,1,1,5,-1,A
1933-09-09,1933,Huddersfield Town,Leeds United,0-0,0,0,1,1,0,0,D
1933-09-09,1933,Leicester City,Tottenham Hotspur,1-3,1,3,1,1,4,-2,A
1933-09-09,1933,Middlesbrough,Birmingham City,0-3,0,3,1,1,3,-3,A
1933-09-09,1933,Newcastle United,Derby County,1-1,1,1,1,1,2,0,D
1933-09-09,1933,Sheffield United,Chelsea,4-1,4,1,1,1,5,3,H
1933-09-09,1933,Stoke City,Portsmouth,2-1,2,1,1,1,3,1,H
1933-09-09,1933,Wolverhampton Wanderers,Sunderland,1-6,1,6,1,1,7,-5,A
1933-09-13,1933,Chelsea,Huddersfield Town,2-3,2,3,1,1,5,-1,A
1933-09-13,1933,West Bromwich Albion,Arsenal,1-0,1,0,1,1,1,1,H
1933-09-16,1933,Birmingham City,Blackburn Rovers,2-0,2,0,1,1,2,2,H
1933-09-16,1933,Chelsea,Aston Villa,1-0,1,0,1,1,1,1,H
1933-09-16,1933,Derby County,Leeds United,3-1,3,1,1,1,4,2,H
1933-09-16,1933,Huddersfield Town,Stoke City,2-2,2,2,1,1,4,0,D
1933-09-16,1933,Liverpool,Leicester City,1-3,1,3,1,1,4,-2,A
1933-09-16,1933,Manchester City,Everton,2-2,2,2,1,1,4,0,D
1933-09-16,1933,Portsmouth,Wolverhampton Wanderers,1-1,1,1,1,1,2,0,D
1933-09-16,1933,Sheffield Wednesday,Middlesbrough,3-0,3,0,1,1,3,3,H
1933-09-16,1933,Sunderland,Sheffield United,5-0,5,0,1,1,5,5,H
1933-09-16,1933,Tottenham Hotspur,Arsenal,1-1,1,1,1,1,2,0,D
1933-09-16,1933,West Bromwich Albion,Newcastle United,1-1,1,1,1,1,2,0,D
1933-09-18,1933,Blackburn Rovers,Newcastle United,3-2,3,2,1,1,5,1,H
1933-09-23,1933,Aston Villa,Sunderland,2-1,2,1,1,1,3,1,H
1933-09-23,1933,Blackburn Rovers,Sheffield Wednesday,3-1,3,1,1,1,4,2,H
1933-09-23,1933,Everton,Arsenal,3-1,3,1,1,1,4,2,H
1933-09-23,1933,Leeds United,West Bromwich Albion,3-0,3,0,1,1,3,3,H
1933-09-23,1933,Leicester City,Chelsea,1-1,1,1,1,1,2,0,D
1933-09-23,1933,Middlesbrough,Manchester City,2-1,2,1,1,1,3,1,H
1933-09-23,1933,Newcastle United,Birmingham City,0-0,0,0,1,1,0,0,D
1933-09-23,1933,Sheffield United,Portsmouth,0-1,0,1,1,1,1,-1,A
1933-09-23,1933,Stoke City,Derby County,0-4,0,4,1,1,4,-4,A
1933-09-23,1933,Tottenham Hotspur,Liverpool,0-3,0,3,1,1,3,-3,A
1933-09-23,1933,Wolverhampton Wanderers,Huddersfield Town,5-2,5,2,1,1,7,3,H
1933-09-30,1933,Arsenal,Middlesbrough,6-0,6,0,1,1,6,6,H
1933-09-30,1933,Birmingham City,Leeds United,4-0,4,0,1,1,4,4,H
1933-09-30,1933,Chelsea,Tottenham Hotspur,0-4,0,4,1,1,4,-4,A
1933-09-30,1933,Huddersfield Town,Sheffield United,6-1,6,1,1,1,7,5,H
1933-09-30,1933,Liverpool,Everton,3-2,3,2,1,1,5,1,H
1933-09-30,1933,Manchester City,Blackburn Rovers,3-1,3,1,1,1,4,2,H
1933-09-30,1933,Portsmouth,Aston Villa,3-2,3,2,1,1,5,1,H
1933-09-30,1933,Sheffield Wednesday,Newcastle United,3-1,3,1,1,1,4,2,H
1933-09-30,1933,Stoke City,Wolverhampton Wanderers,1-1,1,1,1,1,2,0,D
1933-09-30,1933,Sunderland,Leicester City,2-1,2,1,1,1,3,1,H
1933-09-30,1933,West Bromwich Albion,Derby County,5-1,5,1,1,1,6,4,H
1933-10-07,1933,Aston Villa,Huddersfield Town,4-3,4,3,1,1,7,1,H
1933-10-07,1933,Blackburn Rovers,Arsenal,2-2,2,2,1,1,4,0,D
1933-10-07,1933,Derby County,Birmingham City,4-0,4,0,1,1,4,4,H
1933-10-07,1933,Leeds United,Sheffield Wednesday,2-1,2,1,1,1,3,1,H
1933-10-07,1933,Leicester City,Portsmouth,2-1,2,1,1,1,3,1,H
1933-10-07,1933,Liverpool,Chelsea,3-0,3,0,1,1,3,3,H
1933-10-07,1933,Middlesbrough,Everton,2-0,2,0,1,1,2,2,H
1933-10-07,1933,Newcastle United,Manchester City,2-2,2,2,1,1,4,0,D
1933-10-07,1933,Sheffield United,Stoke City,1-2,1,2,1,1,3,-1,A
1933-10-07,1933,Tottenham Hotspur,Sunderland,3-1,3,1,1,1,4,2,H
1933-10-07,1933,Wolverhampton Wanderers,West Bromwich Albion,0-0,0,0,1,1,0,0,D
1933-10-14,1933,Arsenal,Newcastle United,3-0,3,0,1,1,3,3,H
1933-10-14,1933,Birmingham City,West Bromwich Albion,0-1,0,1,1,1,1,-1,A
1933-10-14,1933,Chelsea,Middlesbrough,2-3,2,3,1,1,5,-1,A
1933-10-14,1933,Everton,Blackburn Rovers,7-1,7,1,1,1,8,6,H
1933-10-14,1933,Huddersfield Town,Leicester City,5-1,5,1,1,1,6,4,H
1933-10-14,1933,Manchester City,Leeds United,0-1,0,1,1,1,1,-1,A
1933-10-14,1933,Portsmouth,Tottenham Hotspur,0-1,0,1,1,1,1,-1,A
1933-10-14,1933,Sheffield Wednesday,Derby County,1-1,1,1,1,1,2,0,D
1933-10-14,1933,Stoke City,Aston Villa,1-1,1,1,1,1,2,0,D
1933-10-14,1933,Sunderland,Liverpool,4-1,4,1,1,1,5,3,H
1933-10-14,1933,Wolverhampton Wanderers,Sheffield United,3-2,3,2,1,1,5,1,H
1933-10-21,1933,Arsenal,Leicester City,2-0,2,0,1,1,2,2,H
1933-10-21,1933,Birmingham City,Wolverhampton Wanderers,0-0,0,0,1,1,0,0,D
1933-10-21,1933,Blackburn Rovers,Chelsea,4-2,4,2,1,1,6,2,H
1933-10-21,1933,Derby County,Huddersfield Town,1-1,1,1,1,1,2,0,D
1933-10-21,1933,Everton,Tottenham Hotspur,1-1,1,1,1,1,2,0,D
1933-10-21,1933,Leeds United,Portsmouth,1-0,1,0,1,1,1,1,H
1933-10-21,1933,Manchester City,Aston Villa,1-0,1,0,1,1,1,1,H
1933-10-21,1933,Middlesbrough,Liverpool,4-1,4,1,1,1,5,3,H
1933-10-21,1933,Newcastle United,Sunderland,2-1,2,1,1,1,3,1,H
1933-10-21,1933,Sheffield Wednesday,Sheffield United,0-1,0,1,1,1,1,-1,A
1933-10-21,1933,West Bromwich Albion,Stoke City,5-1,5,1,1,1,6,4,H
1933-10-28,1933,Aston Villa,Arsenal,2-3,2,3,1,1,5,-1,A
1933-10-28,1933,Chelsea,Newcastle United,2-1,2,1,1,1,3,1,H
1933-10-28,1933,Huddersfield Town,West Bromwich Albion,3-1,3,1,1,1,4,2,H
1933-10-28,1933,Leicester City,Everton,3-1,3,1,1,1,4,2,H
1933-10-28,1933,Liverpool,Blackburn Rovers,4-0,4,0,1,1,4,4,H
1933-10-28,1933,Portsmouth,Derby County,1-0,1,0,1,1,1,1,H
1933-10-28,1933,Sheffield United,Manchester City,1-1,1,1,1,1,2,0,D
1933-10-28,1933,Stoke City,Birmingham City,1-1,1,1,1,1,2,0,D
1933-10-28,1933,Sunderland,Leeds United,4-2,4,2,1,1,6,2,H
1933-10-28,1933,Tottenham Hotspur,Middlesbrough,2-0,2,0,1,1,2,2,H
1933-10-28,1933,Wolverhampton Wanderers,Sheffield Wednesday,6-2,6,2,1,1,8,4,H
1933-11-04,1933,Arsenal,Portsmouth,1-1,1,1,1,1,2,0,D
1933-11-04,1933,Birmingham City,Liverpool,1-2,1,2,1,1,3,-1,A
1933-11-04,1933,Blackburn Rovers,Wolverhampton Wanderers,7-1,7,1,1,1,8,6,H
1933-11-04,1933,Derby County,Leicester City,2-1,2,1,1,1,3,1,H
1933-11-04,1933,Everton,Huddersfield Town,0-1,0,1,1,1,1,-1,A
1933-11-04,1933,Leeds United,Aston Villa,2-4,2,4,1,1,6,-2,A
1933-11-04,1933,Manchester City,Sunderland,4-1,4,1,1,1,5,3,H
1933-11-04,1933,Middlesbrough,Stoke City,6-1,6,1,1,1,7,5,H
1933-11-04,1933,Newcastle United,Sheffield United,3-1,3,1,1,1,4,2,H
1933-11-04,1933,Sheffield Wednesday,Chelsea,2-1,2,1,1,1,3,1,H
1933-11-04,1933,West Bromwich Albion,Tottenham Hotspur,1-2,1,2,1,1,3,-1,A
1933-11-11,1933,Aston Villa,Middlesbrough,3-0,3,0,1,1,3,3,H
1933-11-11,1933,Chelsea,Derby County,0-2,0,2,1,1,2,-2,A
1933-11-11,1933,Huddersfield Town,Sheffield Wednesday,3-2,3,2,1,1,5,1,H
1933-11-11,1933,Leicester City,Blackburn Rovers,1-2,1,2,1,1,3,-1,A
1933-11-11,1933,Liverpool,Leeds United,4-3,4,3,1,1,7,1,H
1933-11-11,1933,Portsmouth,Birmingham City,0-2,0,2,1,1,2,-2,A
1933-11-11,1933,Sheffield United,Everton,1-1,1,1,1,1,2,0,D
1933-11-11,1933,Stoke City,Manchester City,0-1,0,1,1,1,1,-1,A
1933-11-11,1933,Sunderland,West Bromwich Albion,2-2,2,2,1,1,4,0,D
1933-11-11,1933,Tottenham Hotspur,Newcastle United,4-0,4,0,1,1,4,4,H
1933-11-11,1933,Wolverhampton Wanderers,Arsenal,0-1,0,1,1,1,1,-1,A
1933-11-18,1933,Arsenal,Stoke City,3-0,3,0,1,1,3,3,H
1933-11-18,1933,Birmingham City,Sunderland,1-1,1,1,1,1,2,0,D
1933-11-18,1933,Blackburn Rovers,Aston Villa,2-1,2,1,1,1,3,1,H
1933-11-18,1933,Derby County,Liverpool,3-1,3,1,1,1,4,2,H
1933-11-18,1933,Everton,Wolverhampton Wanderers,1-2,1,2,1,1,3,-1,A
1933-11-18,1933,Leeds United,Tottenham Hotspur,0-0,0,0,1,1,0,0,D
1933-11-18,1933,Manchester City,Huddersfield Town,2-2,2,2,1,1,4,0,D
1933-11-18,1933,Middlesbrough,Sheffield United,10-3,10,3,1,1,13,7,H
1933-11-18,1933,Newcastle United,Leicester City,1-1,1,1,1,1,2,0,D
1933-11-18,1933,Sheffield Wednesday,Portsmouth,1-2,1,2,1,1,3,-1,A
1933-11-18,1933,West Bromwich Albion,Chelsea,3-1,3,1,1,1,4,2,H
1933-11-25,1933,Aston Villa,Newcastle United,2-3,2,3,1,1,5,-1,A
1933-11-25,1933,Chelsea,Birmingham City,1-1,1,1,1,1,2,0,D
1933-11-25,1933,Huddersfield Town,Arsenal,0-1,0,1,1,1,1,-1,A
1933-11-25,1933,Leicester City,Leeds United,2-2,2,2,1,1,4,0,D
1933-11-25,1933,Liverpool,West Bromwich Albion,1-1,1,1,1,1,2,0,D
1933-11-25,1933,Portsmouth,Manchester City,2-0,2,0,1,1,2,2,H
1933-11-25,1933,Sheffield United,Blackburn Rovers,1-0,1,0,1,1,1,1,H
1933-11-25,1933,Stoke City,Everton,1-2,1,2,1,1,3,-1,A
1933-11-25,1933,Sunderland,Sheffield Wednesday,4-0,4,0,1,1,4,4,H
1933-11-25,1933,Tottenham Hotspur,Derby County,1-2,1,2,1,1,3,-1,A
1933-11-25,1933,Wolverhampton Wanderers,Middlesbrough,0-1,0,1,1,1,1,-1,A
1933-12-02,1933,Arsenal,Liverpool,2-1,2,1,1,1,3,1,H
1933-12-02,1933,Birmingham City,Aston Villa,0-0,0,0,1,1,0,0,D
1933-12-02,1933,Blackburn Rovers,Portsmouth,3-2,3,2,1,1,5,1,H
1933-12-02,1933,Derby County,Wolverhampton Wanderers,3-1,3,1,1,1,4,2,H
1933-12-02,1933,Everton,Chelsea,2-1,2,1,1,1,3,1,H
1933-12-02,1933,Leeds United,Stoke City,2-0,2,0,1,1,2,2,H
1933-12-02,1933,Manchester City,Tottenham Hotspur,2-0,2,0,1,1,2,2,H
1933-12-02,1933,Middlesbrough,Sunderland,0-4,0,4,1,1,4,-4,A
1933-12-02,1933,Newcastle United,Huddersfield Town,3-3,3,3,1,1,6,0,D
1933-12-02,1933,Sheffield Wednesday,Leicester City,1-1,1,1,1,1,2,0,D
1933-12-02,1933,West Bromwich Albion,Sheffield United,3-0,3,0,1,1,3,3,H
1933-12-09,1933,Aston Villa,Derby County,0-2,0,2,1,1,2,-2,A
1933-12-09,1933,Chelsea,Manchester City,1-2,1,2,1,1,3,-1,A
1933-12-09,1933,Huddersfield Town,Middlesbrough,2-1,2,1,1,1,3,1,H
1933-12-09,1933,Leicester City,West Bromwich Albion,0-1,0,1,1,1,1,-1,A
1933-12-09,1933,Liverpool,Sheffield Wednesday,1-3,1,3,1,1,4,-2,A
1933-12-09,1933,Portsmouth,Everton,0-0,0,0,1,1,0,0,D
1933-12-09,1933,Sheffield United,Leeds United,2-1,2,1,1,1,3,1,H
1933-12-09,1933,Stoke City,Blackburn Rovers,2-0,2,0,1,1,2,2,H
1933-12-09,1933,Sunderland,Arsenal,3-0,3,0,1,1,3,3,H
1933-12-09,1933,Tottenham Hotspur,Birmingham City,3-2,3,2,1,1,5,1,H
1933-12-09,1933,Wolverhampton Wanderers,Newcastle United,2-1,2,1,1,1,3,1,H
1933-12-16,1933,Arsenal,Chelsea,2-1,2,1,1,1,3,1,H
1933-12-16,1933,Blackburn Rovers,Huddersfield Town,2-2,2,2,1,1,4,0,D
1933-12-16,1933,Derby County,Sheffield United,5-1,5,1,1,1,6,4,H
1933-12-16,1933,Everton,Sunderland,1-0,1,0,1,1,1,1,H
1933-12-16,1933,Leeds United,Wolverhampton Wanderers,3-3,3,3,1,1,6,0,D
1933-12-16,1933,Manchester City,Liverpool,2-1,2,1,1,1,3,1,H
1933-12-16,1933,Middlesbrough,Portsmouth,2-0,2,0,1,1,2,2,H
1933-12-16,1933,Newcastle United,Stoke City,2-2,2,2,1,1,4,0,D
1933-12-16,1933,Sheffield Wednesday,Tottenham Hotspur,2-1,2,1,1,1,3,1,H
1933-12-16,1933,West Bromwich Albion,Aston Villa,2-1,2,1,1,1,3,1,H
1933-12-23,1933,Aston Villa,Everton,2-1,2,1,1,1,3,1,H
1933-12-23,1933,Chelsea,Leeds United,1-1,1,1,1,1,2,0,D
1933-12-23,1933,Huddersfield Town,Birmingham City,0-0,0,0,1,1,0,0,D
1933-12-23,1933,Leicester City,Middlesbrough,1-2,1,2,1,1,3,-1,A
1933-12-23,1933,Liverpool,Newcastle United,1-2,1,2,1,1,3,-1,A
1933-12-23,1933,Portsmouth,West Bromwich Albion,2-2,2,2,1,1,4,0,D
1933-12-23,1933,Sheffield United,Arsenal,1-3,1,3,1,1,4,-2,A
1933-12-23,1933,Stoke City,Sheffield Wednesday,0-1,0,1,1,1,1,-1,A
1933-12-23,1933,Sunderland,Derby County,0-0,0,0,1,1,0,0,D
1933-12-23,1933,Tottenham Hotspur,Blackburn Rovers,4-1,4,1,1,1,5,3,H
1933-12-23,1933,Wolverhampton Wanderers,Manchester City,8-0,8,0,1,1,8,8,H
1933-12-25,1933,Aston Villa,Wolverhampton Wanderers,6-2,6,2,1,1,8,4,H
1933-12-25,1933,Blackburn Rovers,Middlesbrough,0-0,0,0,1,1,0,0,D
1933-12-25,1933,Derby County,Manchester City,4-1,4,1,1,1,5,3,H
1933-12-25,1933,Leeds United,Arsenal,0-1,0,1,1,1,1,-1,A
1933-12-25,1933,Liverpool,Portsmouth,2-2,2,2,1,1,4,0,D
1933-12-25,1933,Newcastle United,Everton,1-2,1,2,1,1,3,-1,A
1933-12-25,1933,Sheffield United,Birmingham City,2-1,2,1,1,1,3,1,H
1933-12-25,1933,Stoke City,Leicester City,2-1,2,1,1,1,3,1,H
1933-12-25,1933,Tottenham Hotspur,Huddersfield Town,1-3,1,3,1,1,4,-2,A
1933-12-26,1933,Arsenal,Leeds United,2-0,2,0,1,1,2,2,H
1933-12-26,1933,Birmingham City,Sheffield United,4-2,4,2,1,1,6,2,H
1933-12-26,1933,Chelsea,Sunderland,4-0,4,0,1,1,4,4,H
1933-12-26,1933,Everton,Newcastle United,3-7,3,7,1,1,10,-4,A
1933-12-26,1933,Huddersfield Town,Tottenham Hotspur,2-0,2,0,1,1,2,2,H
1933-12-26,1933,Leicester City,Stoke City,3-1,3,1,1,1,4,2,H
1933-12-26,1933,Manchester City,Derby County,2-0,2,0,1,1,2,2,H
1933-12-26,1933,Middlesbrough,Blackburn Rovers,3-1,3,1,1,1,4,2,H
1933-12-26,1933,Portsmouth,Liverpool,1-0,1,0,1,1,1,1,H
1933-12-26,1933,Sheffield Wednesday,West Bromwich Albion,3-1,3,1,1,1,4,2,H
1933-12-26,1933,Wolverhampton Wanderers,Aston Villa,4-3,4,3,1,1,7,1,H
1933-12-27,1933,West Bromwich Albion,Sheffield Wednesday,1-1,1,1,1,1,2,0,D
1933-12-30,1933,Birmingham City,Arsenal,0-0,0,0,1,1,0,0,D
1933-12-30,1933,Chelsea,Stoke City,2-0,2,0,1,1,2,2,H
1933-12-30,1933,Derby County,Middlesbrough,2-0,2,0,1,1,2,2,H
1933-12-30,1933,Leeds United,Blackburn Rovers,4-0,4,0,1,1,4,4,H
1933-12-30,1933,Leicester City,Aston Villa,1-1,1,1,1,1,2,0,D
1933-12-30,1933,Liverpool,Wolverhampton Wanderers,1-1,1,1,1,1,2,0,D
1933-12-30,1933,Portsmouth,Newcastle United,2-0,2,0,1,1,2,2,H
1933-12-30,1933,Sheffield Wednesday,Manchester City,1-1,1,1,1,1,2,0,D
1933-12-30,1933,Sunderland,Huddersfield Town,1-1,1,1,1,1,2,0,D
1933-12-30,1933,Tottenham Hotspur,Sheffield United,4-1,4,1,1,1,5,3,H
1933-12-30,1933,West Bromwich Albion,Everton,3-3,3,3,1,1,6,0,D
1934-01-01,1933,Blackburn Rovers,Tottenham Hotspur,1-0,1,0,1,1,1,1,H
1934-01-01,1933,Everton,Derby County,0-3,0,3,1,1,3,-3,A
1934-01-01,1933,Manchester City,West Bromwich Albion,2-7,2,7,1,1,9,-5,A
1934-01-01,1933,Middlesbrough,Leeds United,2-1,2,1,1,1,3,1,H
1934-01-01,1933,Newcastle United,Liverpool,9-2,9,2,1,1,11,7,H
1934-01-01,1933,Sheffield United,Aston Villa,3-3,3,3,1,1,6,0,D
1934-01-01,1933,Sunderland,Chelsea,0-0,0,0,1,1,0,0,D
1934-01-02,1933,Sheffield Wednesday,Birmingham City,2-1,2,1,1,1,3,1,H
1934-01-06,1933,Arsenal,Sheffield Wednesday,1-1,1,1,1,1,2,0,D
1934-01-06,1933,Aston Villa,Tottenham Hotspur,1-5,1,5,1,1,6,-4,A
1934-01-06,1933,Blackburn Rovers,Derby County,2-1,2,1,1,1,3,1,H
1934-01-06,1933,Everton,Birmingham City,2-0,2,0,1,1,2,2,H
1934-01-06,1933,Huddersfield Town,Portsmouth,4-0,4,0,1,1,4,4,H
1934-01-06,1933,Manchester City,Leicester City,1-1,1,1,1,1,2,0,D
1934-01-06,1933,Middlesbrough,West Bromwich Albion,3-0,3,0,1,1,3,3,H
1934-01-06,1933,Newcastle United,Leeds United,2-0,2,0,1,1,2,2,H
1934-01-06,1933,Sheffield United,Liverpool,2-2,2,2,1,1,4,0,D
1934-01-06,1933,Stoke City,Sunderland,3-0,3,0,1,1,3,3,H
1934-01-06,1933,Wolverhampton Wanderers,Chelsea,1-1,1,1,1,1,2,0,D
1934-01-20,1933,Birmingham City,Middlesbrough,0-0,0,0,1,1,0,0,D
1934-01-20,1933,Chelsea,Sheffield United,5-0,5,0,1,1,5,5,H
1934-01-20,1933,Derby County,Newcastle United,1-1,1,1,1,1,2,0,D
1934-01-20,1933,Leeds United,Huddersfield Town,1-1,1,1,1,1,2,0,D
1934-01-20,1933,Liverpool,Aston Villa,2-3,2,3,1,1,5,-1,A
1934-01-20,1933,Manchester City,Arsenal,2-1,2,1,1,1,3,1,H
1934-01-20,1933,Portsmouth,Stoke City,3-1,3,1,1,1,4,2,H
1934-01-20,1933,Sheffield Wednesday,Everton,0-0,0,0,1,1,0,0,D
1934-01-20,1933,Sunderland,Wolverhampton Wanderers,3-3,3,3,1,1,6,0,D
1934-01-20,1933,Tottenham Hotspur,Leicester City,0-1,0,1,1,1,1,-1,A
1934-01-20,1933,West Bromwich Albion,Blackburn Rovers,0-1,0,1,1,1,1,-1,A
1934-01-27,1933,Newcastle United,West Bromwich Albion,1-2,1,2,1,1,3,-1,A
1934-01-29,1933,Blackburn Rovers,Birmingham City,3-1,3,1,1,1,4,2,H
1934-01-29,1933,Sheffield United,Sunderland,2-0,2,0,1,1,2,2,H
1934-01-29,1933,Stoke City,Huddersfield Town,3-0,3,0,1,1,3,3,H
1934-01-31,1933,Arsenal,Tottenham Hotspur,1-3,1,3,1,1,4,-2,A
1934-01-31,1933,Leeds United,Derby County,0-2,0,2,1,1,2,-2,A
1934-02-01,1933,Leicester City,Liverpool,1-0,1,0,1,1,1,1,H
1934-02-03,1933,Arsenal,Everton,1-2,1,2,1,1,3,-1,A
1934-02-03,1933,Birmingham City,Newcastle United,1-2,1,2,1,1,3,-1,A
1934-02-03,1933,Derby County,Stoke City,5-1,5,1,1,1,6,4,H
1934-02-03,1933,Huddersfield Town,Wolverhampton Wanderers,3-1,3,1,1,1,4,2,H
1934-02-03,1933,Liverpool,Tottenham Hotspur,3-1,3,1,1,1,4,2,H
1934-02-03,1933,Manchester City,Middlesbrough,5-2,5,2,1,1,7,3,H
1934-02-03,1933,Portsmouth,Sheffield United,1-1,1,1,1,1,2,0,D
1934-02-03,1933,Sheffield Wednesday,Blackburn Rovers,4-0,4,0,1,1,4,4,H
1934-02-03,1933,Sunderland,Aston Villa,5-1,5,1,1,1,6,4,H
1934-02-03,1933,West Bromwich Albion,Leeds United,0-3,0,3,1,1,3,-3,A
1934-02-07,1933,Aston Villa,Chelsea,2-0,2,0,1,1,2,2,H
1934-02-07,1933,Everton,Manchester City,2-0,2,0,1,1,2,2,H
1934-02-07,1933,Middlesbrough,Sheffield Wednesday,2-3,2,3,1,1,5,-1,A
1934-02-07,1933,Wolverhampton Wanderers,Portsmouth,1-1,1,1,1,1,2,0,D
1934-02-10,1933,Aston Villa,Portsmouth,1-1,1,1,1,1,2,0,D
1934-02-10,1933,Blackburn Rovers,Manchester City,3-0,3,0,1,1,3,3,H
1934-02-10,1933,Derby County,West Bromwich Albion,1-1,1,1,1,1,2,0,D
1934-02-10,1933,Everton,Liverpool,0-0,0,0,1,1,0,0,D
1934-02-10,1933,Leeds United,Birmingham City,1-0,1,0,1,1,1,1,H
1934-02-10,1933,Leicester City,Sunderland,0-0,0,0,1,1,0,0,D
1934-02-10,1933,Middlesbrough,Arsenal,0-2,0,2,1,1,2,-2,A
1934-02-10,1933,Newcastle United,Sheffield Wednesday,0-0,0,0,1,1,0,0,D
1934-02-10,1933,Sheffield United,Huddersfield Town,1-4,1,4,1,1,5,-3,A
1934-02-10,1933,Tottenham Hotspur,Chelsea,2-1,2,1,1,1,3,1,H
1934-02-10,1933,Wolverhampton Wanderers,Stoke City,0-2,0,2,1,1,2,-2,A
1934-02-17,1933,Everton,Middlesbrough,1-1,1,1,1,1,2,0,D
1934-02-17,1933,West Bromwich Albion,Wolverhampton Wanderers,2-0,2,0,1,1,2,2,H
1934-02-21,1933,Arsenal,Blackburn Rovers,2-1,2,1,1,1,3,1,H
1934-02-21,1933,Birmingham City,Derby County,2-1,2,1,1,1,3,1,H
1934-02-21,1933,Chelsea,Liverpool,2-0,2,0,1,1,2,2,H
1934-02-21,1933,Huddersfield Town,Aston Villa,2-1,2,1,1,1,3,1,H
1934-02-21,1933,Portsmouth,Leicester City,3-5,3,5,1,1,8,-2,A
1934-02-21,1933,Sunderland,Tottenham Hotspur,6-0,6,0,1,1,6,6,H
1934-02-22,1933,Stoke City,Sheffield United,3-0,3,0,1,1,3,3,H
1934-02-24,1933,Aston Villa,Stoke City,1-2,1,2,1,1,3,-1,A
1934-02-24,1933,Blackburn Rovers,Everton,1-1,1,1,1,1,2,0,D
1934-02-24,1933,Derby County,Sheffield Wednesday,1-1,1,1,1,1,2,0,D
1934-02-24,1933,Leeds United,Manchester City,3-1,3,1,1,1,4,2,H
1934-02-24,1933,Leicester City,Huddersfield Town,1-0,1,0,1,1,1,1,H
1934-02-24,1933,Liverpool,Sunderland,1-1,1,1,1,1,2,0,D
1934-02-24,1933,Middlesbrough,Chelsea,2-2,2,2,1,1,4,0,D
1934-02-24,1933,Newcastle United,Arsenal,0-1,0,1,1,1,1,-1,A
1934-02-24,1933,Sheffield United,Wolverhampton Wanderers,3-1,3,1,1,1,4,2,H
1934-02-24,1933,Tottenham Hotspur,Portsmouth,0-0,0,0,1,1,0,0,D
1934-02-24,1933,West Bromwich Albion,Birmingham City,1-2,1,2,1,1,3,-1,A
1934-02-26,1933,Sheffield Wednesday,Leeds United,0-2,0,2,1,1,2,-2,A
1934-03-03,1933,Chelsea,Blackburn Rovers,3-0,3,0,1,1,3,3,H
1934-03-03,1933,Huddersfield Town,Derby County,2-0,2,0,1,1,2,2,H
1934-03-03,1933,Liverpool,Middlesbrough,6-2,6,2,1,1,8,4,H
1934-03-03,1933,Sheffield United,Sheffield Wednesday,5-1,5,1,1,1,6,4,H
1934-03-03,1933,Sunderland,Newcastle United,2-0,2,0,1,1,2,2,H
1934-03-03,1933,Tottenham Hotspur,Everton,3-0,3,0,1,1,3,3,H
1934-03-03,1933,Wolverhampton Wanderers,Birmingham City,2-0,2,0,1,1,2,2,H
1934-03-07,1933,Aston Villa,Manchester City,0-0,0,0,1,1,0,0,D
1934-03-07,1933,Portsmouth,Leeds United,2-1,2,1,1,1,3,1,H
1934-03-08,1933,Leicester City,Arsenal,4-1,4,1,1,1,5,3,H
1934-03-08,1933,Stoke City,West Bromwich Albion,4-1,4,1,1,1,5,3,H
1934-03-10,1933,Arsenal,Aston Villa,3-2,3,2,1,1,5,1,H
1934-03-10,1933,Birmingham City,Stoke City,0-1,0,1,1,1,1,-1,A
1934-03-10,1933,Blackburn Rovers,Liverpool,3-1,3,1,1,1,4,2,H
1934-03-10,1933,Derby County,Portsmouth,0-1,0,1,1,1,1,-1,A
1934-03-10,1933,Everton,Leicester City,1-1,1,1,1,1,2,0,D
1934-03-10,1933,Leeds United,Sunderland,3-1,3,1,1,1,4,2,H
1934-03-10,1933,Manchester City,Sheffield United,4-1,4,1,1,1,5,3,H
1934-03-10,1933,Middlesbrough,Tottenham Hotspur,1-1,1,1,1,1,2,0,D
1934-03-10,1933,Newcastle United,Chelsea,2-2,2,2,1,1,4,0,D
1934-03-10,1933,Sheffield Wednesday,Wolverhampton Wanderers,2-1,2,1,1,1,3,1,H
1934-03-10,1933,West Bromwich Albion,Huddersfield Town,2-3,2,3,1,1,5,-1,A
1934-03-17,1933,Chelsea,Sheffield Wednesday,0-1,0,1,1,1,1,-1,A
1934-03-17,1933,Derby County,Sunderland,0-0,0,0,1,1,0,0,D
1934-03-17,1933,Liverpool,Birmingham City,4-1,4,1,1,1,5,3,H
1934-03-17,1933,Sheffield United,Newcastle United,4-0,4,0,1,1,4,4,H
1934-03-17,1933,Stoke City,Middlesbrough,2-0,2,0,1,1,2,2,H
1934-03-17,1933,Tottenham Hotspur,West Bromwich Albion,2-1,2,1,1,1,3,1,H
1934-03-17,1933,Wolverhampton Wanderers,Blackburn Rovers,5-3,5,3,1,1,8,2,H
1934-03-21,1933,Manchester City,Newcastle United,1-1,1,1,1,1,2,0,D
1934-03-24,1933,Arsenal,Wolverhampton Wanderers,3-2,3,2,1,1,5,1,H
1934-03-24,1933,Birmingham City,Portsmouth,3-1,3,1,1,1,4,2,H
1934-03-24,1933,Blackburn Rovers,Leicester City,3-0,3,0,1,1,3,3,H
1934-03-24,1933,Derby County,Chelsea,1-0,1,0,1,1,1,1,H
1934-03-24,1933,Everton,Sheffield United,4-0,4,0,1,1,4,4,H
1934-03-24,1933,Leeds United,Liverpool,5-1,5,1,1,1,6,4,H
1934-03-24,1933,Manchester City,Stoke City,4-2,4,2,1,1,6,2,H
1934-03-24,1933,Middlesbrough,Aston Villa,1-2,1,2,1,1,3,-1,A
1934-03-24,1933,Newcastle United,Tottenham Hotspur,1-3,1,3,1,1,4,-2,A
1934-03-24,1933,Sheffield Wednesday,Huddersfield Town,1-2,1,2,1,1,3,-1,A
1934-03-24,1933,West Bromwich Albion,Sunderland,6-5,6,5,1,1,11,1,H
1934-03-28,1933,Birmingham City,Leicester City,3-0,3,0,1,1,3,3,H
1934-03-30,1933,Arsenal,Derby County,1-0,1,0,1,1,1,1,H
1934-03-30,1933,Leeds United,Everton,2-2,2,2,1,1,4,0,D
1934-03-30,1933,Liverpool,Huddersfield Town,2-2,2,2,1,1,4,0,D
1934-03-30,1933,Newcastle United,Middlesbrough,1-1,1,1,1,1,2,0,D
1934-03-30,1933,Portsmouth,Chelsea,0-2,0,2,1,1,2,-2,A
1934-03-30,1933,Sunderland,Blackburn Rovers,3-0,3,0,1,1,3,3,H
1934-03-30,1933,Tottenham Hotspur,Stoke City,0-0,0,0,1,1,0,0,D
1934-03-31,1933,Aston Villa,Blackburn Rovers,1-1,1,1,1,1,2,0,D
1934-03-31,1933,Chelsea,West Bromwich Albion,3-2,3,2,1,1,5,1,H
1934-03-31,1933,Huddersfield Town,Manchester City,1-0,1,0,1,1,1,1,H
1934-03-31,1933,Leicester City,Newcastle United,3-2,3,2,1,1,5,1,H
1934-03-31,1933,Liverpool,Derby County,4-2,4,2,1,1,6,2,H
1934-03-31,1933,Portsmouth,Sheffield Wednesday,0-2,0,2,1,1,2,-2,A
1934-03-31,1933,Sheffield United,Middlesbrough,3-1,3,1,1,1,4,2,H
1934-03-31,1933,Stoke City,Arsenal,1-1,1,1,1,1,2,0,D
1934-03-31,1933,Sunderland,Birmingham City,4-1,4,1,1,1,5,3,H
1934-03-31,1933,Tottenham Hotspur,Leeds United,5-1,5,1,1,1,6,4,H
1934-03-31,1933,Wolverhampton Wanderers,Everton,2-0,2,0,1,1,2,2,H
1934-04-02,1933,Aston Villa,Sheffield United,3-0,3,0,1,1,3,3,H
1934-04-02,1933,Blackburn Rovers,Sunderland,0-0,0,0,1,1,0,0,D
1934-04-02,1933,Chelsea,Portsmouth,4-0,4,0,1,1,4,4,H
1934-04-02,1933,Derby County,Arsenal,2-4,2,4,1,1,6,-2,A
1934-04-02,1933,Everton,Leeds United,2-0,2,0,1,1,2,2,H
1934-04-02,1933,Middlesbrough,Newcastle United,1-0,1,0,1,1,1,1,H
1934-04-02,1933,Stoke City,Tottenham Hotspur,2-0,2,0,1,1,2,2,H
1934-04-02,1933,West Bromwich Albion,Manchester City,4-0,4,0,1,1,4,4,H
1934-04-02,1933,Wolverhampton Wanderers,Leicester City,1-1,1,1,1,1,2,0,D
1934-04-03,1933,Birmingham City,Sheffield Wednesday,3-0,3,0,1,1,3,3,H
1934-04-03,1933,Huddersfield Town,Liverpool,0-2,0,2,1,1,2,-2,A
1934-04-03,1933,Leicester City,Wolverhampton Wanderers,1-1,1,1,1,1,2,0,D
1934-04-07,1933,Arsenal,Huddersfield Town,3-1,3,1,1,1,4,2,H
1934-04-07,1933,Birmingham City,Chelsea,0-3,0,3,1,1,3,-3,A
1934-04-07,1933,Blackburn Rovers,Sheffield United,3-1,3,1,1,1,4,2,H
1934-04-07,1933,Derby County,Tottenham Hotspur,4-3,4,3,1,1,7,1,H
1934-04-07,1933,Everton,Stoke City,2-2,2,2,1,1,4,0,D
1934-04-07,1933,Leeds United,Leicester City,8-0,8,0,1,1,8,8,H
1934-04-07,1933,Manchester City,Portsmouth,2-1,2,1,1,1,3,1,H
1934-04-07,1933,Middlesbrough,Wolverhampton Wanderers,0-0,0,0,1,1,0,0,D
1934-04-07,1933,Newcastle United,Aston Villa,1-1,1,1,1,1,2,0,D
1934-04-07,1933,Sheffield Wednesday,Sunderland,2-0,2,0,1,1,2,2,H
1934-04-07,1933,West Bromwich Albion,Liverpool,2-2,2,2,1,1,4,0,D
1934-04-11,1933,Sunderland,Manchester City,0-0,0,0,1,1,0,0,D
1934-04-14,1933,Aston Villa,Birmingham City,1-1,1,1,1,1,2,0,D
1934-04-14,1933,Chelsea,Everton,2-0,2,0,1,1,2,2,H
1934-04-14,1933,Huddersfield Town,Newcastle United,4-1,4,1,1,1,5,3,H
1934-04-14,1933,Leicester City,Sheffield Wednesday,2-0,2,0,1,1,2,2,H
1934-04-14,1933,Liverpool,Arsenal,2-3,2,3,1,1,5,-1,A
1934-04-14,1933,Portsmouth,Blackburn Rovers,2-0,2,0,1,1,2,2,H
1934-04-14,1933,Sheffield United,West Bromwich Albion,0-1,0,1,1,1,1,-1,A
1934-04-14,1933,Stoke City,Leeds United,1-2,1,2,1,1,3,-1,A
1934-04-14,1933,Sunderland,Middlesbrough,2-0,2,0,1,1,2,2,H
1934-04-14,1933,Tottenham Hotspur,Manchester City,5-1,5,1,1,1,6,4,H
1934-04-14,1933,Wolverhampton Wanderers,Derby County,3-0,3,0,1,1,3,3,H
1934-04-18,1933,Portsmouth,Arsenal,1-0,1,0,1,1,1,1,H
1934-04-19,1933,Leicester City,Derby County,2-0,2,0,1,1,2,2,H
1934-04-21,1933,Arsenal,Sunderland,2-1,2,1,1,1,3,1,H
1934-04-21,1933,Birmingham City,Tottenham Hotspur,2-0,2,0,1,1,2,2,H
1934-04-21,1933,Blackburn Rovers,Stoke City,4-1,4,1,1,1,5,3,H
1934-04-21,1933,Derby County,Aston Villa,1-1,1,1,1,1,2,0,D
1934-04-21,1933,Everton,Portsmouth,1-1,1,1,1,1,2,0,D
1934-04-21,1933,Leeds United,Sheffield United,1-1,1,1,1,1,2,0,D
1934-04-21,1933,Manchester City,Chelsea,4-2,4,2,1,1,6,2,H
1934-04-21,1933,Middlesbrough,Huddersfield Town,3-0,3,0,1,1,3,3,H
1934-04-21,1933,Newcastle United,Wolverhampton Wanderers,5-1,5,1,1,1,6,4,H
1934-04-21,1933,Sheffield Wednesday,Liverpool,1-2,1,2,1,1,3,-1,A
1934-04-21,1933,West Bromwich Albion,Leicester City,2-0,2,0,1,1,2,2,H
1934-04-23,1933,Chelsea,Leicester City,2-0,2,0,1,1,2,2,H
1934-04-25,1933,Huddersfield Town,Everton,1-0,1,0,1,1,1,1,H
1934-04-28,1933,Aston Villa,West Bromwich Albion,4-4,4,4,1,1,8,0,D
1934-04-28,1933,Chelsea,Arsenal,2-2,2,2,1,1,4,0,D
1934-04-28,1933,Huddersfield Town,Blackburn Rovers,5-3,5,3,1,1,8,2,H
1934-04-28,1933,Leicester City,Birmingham City,3-7,3,7,1,1,10,-4,A
1934-04-28,1933,Sheffield United,Derby County,2-0,2,0,1,1,2,2,H
1934-04-28,1933,Stoke City,Newcastle United,2-1,2,1,1,1,3,1,H
1934-04-28,1933,Sunderland,Everton,3-2,3,2,1,1,5,1,H
1934-04-28,1933,Tottenham Hotspur,Sheffield Wednesday,4-3,4,3,1,1,7,1,H
1934-04-28,1933,Wolverhampton Wanderers,Leeds United,2-0,2,0,1,1,2,2,H
1934-04-30,1933,Aston Villa,Leeds United,3-0,3,0,1,1,3,3,H
1934-04-30,1933,Portsmouth,Middlesbrough,4-1,4,1,1,1,5,3,H
1934-05-02,1933,Liverpool,Manchester City,3-2,3,2,1,1,5,1,H
1934-05-05,1933,Arsenal,Sheffield United,2-0,2,0,1,1,2,2,H
1934-05-05,1933,Birmingham City,Huddersfield Town,1-3,1,3,1,1,4,-2,A
1934-05-05,1933,Everton,Aston Villa,2-2,2,2,1,1,4,0,D
1934-05-05,1933,Leeds United,Chelsea,3-1,3,1,1,1,4,2,H
1934-05-05,1933,Manchester City,Wolverhampton Wanderers,4-0,4,0,1,1,4,4,H
1934-05-05,1933,Middlesbrough,Leicester City,4-1,4,1,1,1,5,3,H
1934-05-05,1933,Sheffield Wednesday,Stoke City,2-2,2,2,1,1,4,0,D
1934-05-05,1933,West Bromwich Albion,Portsmouth,2-1,2,1,1,1,3,1,H
1934-08-25,1934,Birmingham City,Aston Villa,2-1,2,1,1,1,3,1,H
1934-08-25,1934,Derby County,Chelsea,3-0,3,0,1,1,3,3,H
1934-08-25,1934,Leeds United,Middlesbrough,2-4,2,4,1,1,6,-2,A
1934-08-25,1934,Leicester City,Wolverhampton Wanderers,1-1,1,1,1,1,2,0,D
1934-08-25,1934,Liverpool,Blackburn Rovers,2-0,2,0,1,1,2,2,H
1934-08-25,1934,Portsmouth,Arsenal,3-3,3,3,1,1,6,0,D
1934-08-25,1934,Preston North End,Grimsby Town,1-0,1,0,1,1,1,1,H
1934-08-25,1934,Sheffield Wednesday,Stoke City,4-1,4,1,1,1,5,3,H
1934-08-25,1934,Sunderland,Huddersfield Town,4-1,4,1,1,1,5,3,H
1934-08-25,1934,Tottenham Hotspur,Everton,1-1,1,1,1,1,2,0,D
1934-08-25,1934,West Bromwich Albion,Manchester City,1-1,1,1,1,1,2,0,D
1934-08-27,1934,Aston Villa,Wolverhampton Wanderers,2-1,2,1,1,1,3,1,H
1934-08-27,1934,Huddersfield Town,Derby County,1-0,1,0,1,1,1,1,H
1934-08-27,1934,Stoke City,Leeds United,8-1,8,1,1,1,9,7,H
1934-08-27,1934,Tottenham Hotspur,Preston North End,1-2,1,2,1,1,3,-1,A
1934-08-28,1934,Grimsby Town,Sunderland,0-0,0,0,1,1,0,0,D
1934-08-29,1934,Chelsea,Sheffield Wednesday,1-2,1,2,1,1,3,-1,A
1934-08-29,1934,Everton,Leicester City,2-1,2,1,1,1,3,1,H
1934-08-29,1934,Manchester City,Liverpool,3-1,3,1,1,1,4,2,H
1934-08-29,1934,Middlesbrough,Portsmouth,1-1,1,1,1,1,2,0,D
1934-08-29,1934,West Bromwich Albion,Birmingham City,1-2,1,2,1,1,3,-1,A
1934-09-01,1934,Arsenal,Liverpool,8-1,8,1,1,1,9,7,H
1934-09-01,1934,Aston Villa,Derby County,3-2,3,2,1,1,5,1,H
1934-09-01,1934,Blackburn Rovers,Leeds United,1-1,1,1,1,1,2,0,D
1934-09-01,1934,Chelsea,Leicester City,3-1,3,1,1,1,4,2,H
1934-09-01,1934,Everton,Preston North End,4-1,4,1,1,1,5,3,H
1934-09-01,1934,Grimsby Town,Portsmouth,3-0,3,0,1,1,3,3,H
1934-09-01,1934,Huddersfield Town,Tottenham Hotspur,0-0,0,0,1,1,0,0,D
1934-09-01,1934,Manchester City,Sheffield Wednesday,4-1,4,1,1,1,5,3,H
1934-09-01,1934,Middlesbrough,West Bromwich Albion,0-0,0,0,1,1,0,0,D
1934-09-01,1934,Stoke City,Birmingham City,2-0,2,0,1,1,2,2,H
1934-09-01,1934,Wolverhampton Wanderers,Sunderland,1-2,1,2,1,1,3,-1,A
1934-09-03,1934,Birmingham City,West Bromwich Albion,1-2,1,2,1,1,3,-1,A
1934-09-03,1934,Leeds United,Stoke City,4-2,4,2,1,1,6,2,H
1934-09-03,1934,Leicester City,Everton,5-2,5,2,1,1,7,3,H
1934-09-03,1934,Preston North End,Tottenham Hotspur,1-0,1,0,1,1,1,1,H
1934-09-03,1934,Sheffield Wednesday,Chelsea,3-1,3,1,1,1,4,2,H
1934-09-03,1934,Wolverhampton Wanderers,Aston Villa,5-2,5,2,1,1,7,3,H
1934-09-05,1934,Arsenal,Blackburn Rovers,4-0,4,0,1,1,4,4,H
1934-09-05,1934,Derby County,Huddersfield Town,4-1,4,1,1,1,5,3,H
1934-09-05,1934,Liverpool,Manchester City,2-1,2,1,1,1,3,1,H
1934-09-05,1934,Portsmouth,Middlesbrough,1-0,1,0,1,1,1,1,H
1934-09-05,1934,Sunderland,Grimsby Town,3-0,3,0,1,1,3,3,H
1934-09-08,1934,Birmingham City,Manchester City,1-3,1,3,1,1,4,-2,A
1934-09-08,1934,Derby County,Stoke City,0-2,0,2,1,1,2,-2,A
1934-09-08,1934,Grimsby Town,Everton,0-0,0,0,1,1,0,0,D
1934-09-08,1934,Leeds United,Arsenal,1-1,1,1,1,1,2,0,D
1934-09-08,1934,Leicester City,Aston Villa,5-0,5,0,1,1,5,5,H
1934-09-08,1934,Liverpool,Portsmouth,0-1,0,1,1,1,1,-1,A
1934-09-08,1934,Preston North End,Huddersfield Town,2-0,2,0,1,1,2,2,H
1934-09-08,1934,Sheffield Wednesday,Middlesbrough,3-3,3,3,1,1,6,0,D
1934-09-08,1934,Sunderland,Chelsea,4-0,4,0,1,1,4,4,H
1934-09-08,1934,Tottenham Hotspur,Wolverhampton Wanderers,3-1,3,1,1,1,4,2,H
1934-09-08,1934,West Bromwich Albion,Blackburn Rovers,2-2,2,2,1,1,4,0,D
1934-09-15,1934,Arsenal,West Bromwich Albion,4-3,4,3,1,1,7,1,H
1934-09-15,1934,Aston Villa,Sunderland,1-1,1,1,1,1,2,0,D
1934-09-15,1934,Blackburn Rovers,Sheffield Wednesday,2-1,2,1,1,1,3,1,H
1934-09-15,1934,Chelsea,Tottenham Hotspur,1-3,1,3,1,1,4,-2,A
1934-09-15,1934,Derby County,Leicester City,1-1,1,1,1,1,2,0,D
1934-09-15,1934,Everton,Liverpool,1-0,1,0,1,1,1,1,H
1934-09-15,1934,Huddersfield Town,Grimsby Town,1-5,1,5,1,1,6,-4,A
1934-09-15,1934,Manchester City,Stoke City,3-1,3,1,1,1,4,2,H
1934-09-15,1934,Middlesbrough,Birmingham City,0-1,0,1,1,1,1,-1,A
1934-09-15,1934,Portsmouth,Leeds United,0-0,0,0,1,1,0,0,D
1934-09-15,1934,Wolverhampton Wanderers,Preston North End,2-2,2,2,1,1,4,0,D
1934-09-17,1934,Blackburn Rovers,Arsenal,2-0,2,0,1,1,2,2,H
1934-09-22,1934,Birmingham City,Blackburn Rovers,1-0,1,0,1,1,1,1,H
1934-09-22,1934,Everton,Huddersfield Town,4-2,4,2,1,1,6,2,H
1934-09-22,1934,Grimsby Town,Wolverhampton Wanderers,2-1,2,1,1,1,3,1,H
1934-09-22,1934,Leeds United,Liverpool,0-3,0,3,1,1,3,-3,A
1934-09-22,1934,Leicester City,Manchester City,1-3,1,3,1,1,4,-2,A
1934-09-22,1934,Preston North End,Chelsea,2-0,2,0,1,1,2,2,H
1934-09-22,1934,Sheffield Wednesday,Arsenal,0-0,0,0,1,1,0,0,D
1934-09-22,1934,Stoke City,Middlesbrough,2-0,2,0,1,1,2,2,H
1934-09-22,1934,Sunderland,Derby County,1-4,1,4,1,1,5,-3,A
1934-09-22,1934,Tottenham Hotspur,Aston Villa,0-2,0,2,1,1,2,-2,A
1934-09-22,1934,West Bromwich Albion,Portsmouth,4-2,4,2,1,1,6,2,H
1934-09-29,1934,Arsenal,Birmingham City,5-1,5,1,1,1,6,4,H
1934-09-29,1934,Aston Villa,Preston North End,4-2,4,2,1,1,6,2,H
1934-09-29,1934,Blackburn Rovers,Stoke City,0-1,0,1,1,1,1,-1,A
1934-09-29,1934,Chelsea,Grimsby Town,2-0,2,0,1,1,2,2,H
1934-09-29,1934,Derby County,Tottenham Hotspur,2-1,2,1,1,1,3,1,H
1934-09-29,1934,Leeds United,Huddersfield Town,2-0,2,0,1,1,2,2,H
1934-09-29,1934,Leicester City,Sunderland,0-2,0,2,1,1,2,-2,A
1934-09-29,1934,Liverpool,West Bromwich Albion,3-2,3,2,1,1,5,1,H
1934-09-29,1934,Middlesbrough,Manchester City,1-2,1,2,1,1,3,-1,A
1934-09-29,1934,Portsmouth,Sheffield Wednesday,2-1,2,1,1,1,3,1,H
1934-09-29,1934,Wolverhampton Wanderers,Everton,4-2,4,2,1,1,6,2,H
1934-10-06,1934,Birmingham City,Portsmouth,2-1,2,1,1,1,3,1,H
1934-10-06,1934,Everton,Chelsea,3-2,3,2,1,1,5,1,H
1934-10-06,1934,Grimsby Town,Aston Villa,5-1,5,1,1,1,6,4,H
1934-10-06,1934,Huddersfield Town,Wolverhampton Wanderers,4-1,4,1,1,1,5,3,H
1934-10-06,1934,Manchester City,Blackburn Rovers,3-3,3,3,1,1,6,0,D
1934-10-06,1934,Preston North End,Derby County,0-1,0,1,1,1,1,-1,A
1934-10-06,1934,Sheffield Wednesday,Liverpool,4-1,4,1,1,1,5,3,H
1934-10-06,1934,Stoke City,Arsenal,2-2,2,2,1,1,4,0,D
1934-10-06,1934,Sunderland,Middlesbrough,1-1,1,1,1,1,2,0,D
1934-10-06,1934,Tottenham Hotspur,Leicester City,2-2,2,2,1,1,4,0,D
1934-10-06,1934,West Bromwich Albion,Leeds United,6-3,6,3,1,1,9,3,H
1934-10-13,1934,Arsenal,Manchester City,3-0,3,0,1,1,3,3,H
1934-10-13,1934,Aston Villa,Everton,2-2,2,2,1,1,4,0,D
1934-10-13,1934,Blackburn Rovers,Middlesbrough,3-2,3,2,1,1,5,1,H
1934-10-13,1934,Chelsea,Huddersfield Town,2-1,2,1,1,1,3,1,H
1934-10-13,1934,Derby County,Grimsby Town,1-4,1,4,1,1,5,-3,A
1934-10-13,1934,Leeds United,Sheffield Wednesday,0-0,0,0,1,1,0,0,D
1934-10-13,1934,Leicester City,Preston North End,0-0,0,0,1,1,0,0,D
1934-10-13,1934,Liverpool,Birmingham City,5-4,5,4,1,1,9,1,H
1934-10-13,1934,Portsmouth,Stoke City,0-1,0,1,1,1,1,-1,A
1934-10-13,1934,Sunderland,Tottenham Hotspur,1-2,1,2,1,1,3,-1,A
1934-10-13,1934,Wolverhampton Wanderers,West Bromwich Albion,3-2,3,2,1,1,5,1,H
1934-10-20,1934,Arsenal,Tottenham Hotspur,5-1,5,1,1,1,6,4,H
1934-10-20,1934,Birmingham City,Chelsea,0-1,0,1,1,1,1,-1,A
1934-10-20,1934,Blackburn Rovers,Sunderland,0-0,0,0,1,1,0,0,D
1934-10-20,1934,Leeds United,Everton,2-0,2,0,1,1,2,2,H
1934-10-20,1934,Liverpool,Grimsby Town,1-1,1,1,1,1,2,0,D
1934-10-20,1934,Manchester City,Derby County,0-1,0,1,1,1,1,-1,A
1934-10-20,1934,Middlesbrough,Leicester City,1-0,1,0,1,1,1,1,H
1934-10-20,1934,Sheffield Wednesday,Wolverhampton Wanderers,3-1,3,1,1,1,4,2,H
1934-10-20,1934,Stoke City,Aston Villa,4-1,4,1,1,1,5,3,H
1934-10-20,1934,West Bromwich Albion,Huddersfield Town,4-1,4,1,1,1,5,3,H
1934-10-24,1934,Portsmouth,Preston North End,4-0,4,0,1,1,4,4,H
1934-10-27,1934,Aston Villa,Manchester City,4-2,4,2,1,1,6,2,H
1934-10-27,1934,Chelsea,Stoke City,0-2,0,2,1,1,2,-2,A
1934-10-27,1934,Derby County,Middlesbrough,2-0,2,0,1,1,2,2,H
1934-10-27,1934,Everton,West Bromwich Albion,4-0,4,0,1,1,4,4,H
1934-10-27,1934,Grimsby Town,Leeds United,3-2,3,2,1,1,5,1,H
1934-10-27,1934,Huddersfield Town,Sheffield Wednesday,4-0,4,0,1,1,4,4,H
1934-10-27,1934,Leicester City,Blackburn Rovers,0-1,0,1,1,1,1,-1,A
1934-10-27,1934,Preston North End,Liverpool,2-2,2,2,1,1,4,0,D
1934-10-27,1934,Sunderland,Arsenal,2-1,2,1,1,1,3,1,H
1934-10-27,1934,Tottenham Hotspur,Portsmouth,4-1,4,1,1,1,5,3,H
1934-10-27,1934,Wolverhampton Wanderers,Birmingham City,3-1,3,1,1,1,4,2,H
1934-11-03,1934,Arsenal,Everton,2-0,2,0,1,1,2,2,H
1934-11-03,1934,Birmingham City,Leicester City,2-3,2,3,1,1,5,-1,A
1934-11-03,1934,Blackburn Rovers,Grimsby Town,2-2,2,2,1,1,4,0,D
1934-11-03,1934,Leeds United,Chelsea,5-2,5,2,1,1,7,3,H
1934-11-03,1934,Liverpool,Wolverhampton Wanderers,2-1,2,1,1,1,3,1,H
1934-11-03,1934,Manchester City,Tottenham Hotspur,3-1,3,1,1,1,4,2,H
1934-11-03,1934,Middlesbrough,Preston North End,3-3,3,3,1,1,6,0,D
1934-11-03,1934,Portsmouth,Huddersfield Town,5-0,5,0,1,1,5,5,H
1934-11-03,1934,Sheffield Wednesday,Derby County,1-0,1,0,1,1,1,1,H
1934-11-03,1934,Stoke City,Sunderland,0-3,0,3,1,1,3,-3,A
1934-11-03,1934,West Bromwich Albion,Aston Villa,2-2,2,2,1,1,4,0,D
1934-11-10,1934,Aston Villa,Sheffield Wednesday,4-0,4,0,1,1,4,4,H
1934-11-10,1934,Chelsea,West Bromwich Albion,2-3,2,3,1,1,5,-1,A
1934-11-10,1934,Derby County,Birmingham City,1-1,1,1,1,1,2,0,D
1934-11-10,1934,Everton,Portsmouth,3-2,3,2,1,1,5,1,H
1934-11-10,1934,Grimsby Town,Arsenal,2-2,2,2,1,1,4,0,D
1934-11-10,1934,Huddersfield Town,Liverpool,8-0,8,0,1,1,8,8,H
1934-11-10,1934,Leicester City,Stoke City,0-3,0,3,1,1,3,-3,A
1934-11-10,1934,Preston North End,Blackburn Rovers,3-1,3,1,1,1,4,2,H
1934-11-10,1934,Sunderland,Manchester City,3-2,3,2,1,1,5,1,H
1934-11-10,1934,Tottenham Hotspur,Middlesbrough,3-1,3,1,1,1,4,2,H
1934-11-10,1934,Wolverhampton Wanderers,Leeds United,1-2,1,2,1,1,3,-1,A
1934-11-12,1934,Blackburn Rovers,Chelsea,1-2,1,2,1,1,3,-1,A
1934-11-17,1934,Arsenal,Aston Villa,1-2,1,2,1,1,3,-1,A
1934-11-17,1934,Birmingham City,Grimsby Town,3-2,3,2,1,1,5,1,H
1934-11-17,1934,Leeds United,Sunderland,2-4,2,4,1,1,6,-2,A
1934-11-17,1934,Liverpool,Leicester City,5-1,5,1,1,1,6,4,H
1934-11-17,1934,Manchester City,Huddersfield Town,0-0,0,0,1,1,0,0,D
1934-11-17,1934,Middlesbrough,Wolverhampton Wanderers,2-2,2,2,1,1,4,0,D
1934-11-17,1934,Portsmouth,Derby County,5-1,5,1,1,1,6,4,H
1934-11-17,1934,Sheffield Wednesday,Preston North End,2-1,2,1,1,1,3,1,H
1934-11-17,1934,Stoke City,Everton,3-2,3,2,1,1,5,1,H
1934-11-17,1934,West Bromwich Albion,Tottenham Hotspur,4-0,4,0,1,1,4,4,H
1934-11-24,1934,Chelsea,Arsenal,2-5,2,5,1,1,7,-3,A
1934-11-24,1934,Derby County,Liverpool,1-2,1,2,1,1,3,-1,A
1934-11-24,1934,Everton,Manchester City,1-2,1,2,1,1,3,-1,A
1934-11-24,1934,Grimsby Town,Stoke City,3-1,3,1,1,1,4,2,H
1934-11-24,1934,Huddersfield Town,Middlesbrough,3-1,3,1,1,1,4,2,H
1934-11-24,1934,Leicester City,Leeds United,1-0,1,0,1,1,1,1,H
1934-11-24,1934,Preston North End,Birmingham City,0-1,0,1,1,1,1,-1,A
1934-11-24,1934,Sunderland,West Bromwich Albion,0-1,0,1,1,1,1,-1,A
1934-11-24,1934,Tottenham Hotspur,Sheffield Wednesday,3-2,3,2,1,1,5,1,H
1934-11-24,1934,Wolverhampton Wanderers,Blackburn Rovers,2-1,2,1,1,1,3,1,H
1934-11-26,1934,Aston Villa,Portsmouth,5-4,5,4,1,1,9,1,H
1934-12-01,1934,Arsenal,Wolverhampton Wanderers,7-0,7,0,1,1,7,7,H
1934-12-01,1934,Birmingham City,Tottenham Hotspur,2-1,2,1,1,1,3,1,H
1934-12-01,1934,Blackburn Rovers,Huddersfield Town,4-2,4,2,1,1,6,2,H
1934-12-01,1934,Leeds United,Derby County,4-2,4,2,1,1,6,2,H
1934-12-01,1934,Liverpool,Aston Villa,3-1,3,1,1,1,4,2,H
1934-12-01,1934,Manchester City,Grimsby Town,1-0,1,0,1,1,1,1,H
1934-12-01,1934,Middlesbrough,Everton,3-2,3,2,1,1,5,1,H
1934-12-01,1934,Portsmouth,Chelsea,1-1,1,1,1,1,2,0,D
1934-12-01,1934,Sheffield Wednesday,Sunderland,2-2,2,2,1,1,4,0,D
1934-12-01,1934,Stoke City,Preston North End,3-1,3,1,1,1,4,2,H
1934-12-01,1934,West Bromwich Albion,Leicester City,4-1,4,1,1,1,5,3,H
1934-12-08,1934,Aston Villa,Leeds United,1-1,1,1,1,1,2,0,D
1934-12-08,1934,Chelsea,Liverpool,4-1,4,1,1,1,5,3,H
1934-12-08,1934,Derby County,West Bromwich Albion,9-3,9,3,1,1,12,6,H
1934-12-08,1934,Everton,Blackburn Rovers,5-2,5,2,1,1,7,3,H
1934-12-08,1934,Grimsby Town,Middlesbrough,2-2,2,2,1,1,4,0,D
1934-12-08,1934,Huddersfield Town,Arsenal,1-1,1,1,1,1,2,0,D
1934-12-08,1934,Leicester City,Sheffield Wednesday,0-1,0,1,1,1,1,-1,A
1934-12-08,1934,Preston North End,Manchester City,2-4,2,4,1,1,6,-2,A
1934-12-08,1934,Sunderland,Birmingham City,5-1,5,1,1,1,6,4,H
1934-12-08,1934,Tottenham Hotspur,Stoke City,3-2,3,2,1,1,5,1,H
1934-12-08,1934,Wolverhampton Wanderers,Portsmouth,2-3,2,3,1,1,5,-1,A
1934-12-15,1934,Arsenal,Leicester City,8-0,8,0,1,1,8,8,H
1934-12-15,1934,Birmingham City,Huddersfield Town,0-4,0,4,1,1,4,-4,A
1934-12-15,1934,Blackburn Rovers,Derby County,2-5,2,5,1,1,7,-3,A
1934-12-15,1934,Leeds United,Preston North End,3-3,3,3,1,1,6,0,D
1934-12-15,1934,Liverpool,Tottenham Hotspur,4-1,4,1,1,1,5,3,H
1934-12-15,1934,Manchester City,Chelsea,2-0,2,0,1,1,2,2,H
1934-12-15,1934,Middlesbrough,Aston Villa,4-1,4,1,1,1,5,3,H
1934-12-15,1934,Portsmouth,Sunderland,2-4,2,4,1,1,6,-2,A
1934-12-15,1934,Sheffield Wednesday,Everton,0-0,0,0,1,1,0,0,D
1934-12-15,1934,Stoke City,Wolverhampton Wanderers,1-2,1,2,1,1,3,-1,A
1934-12-15,1934,West Bromwich Albion,Grimsby Town,4-2,4,2,1,1,6,2,H
1934-12-22,1934,Aston Villa,Blackburn Rovers,1-1,1,1,1,1,2,0,D
1934-12-22,1934,Chelsea,Middlesbrough,2-1,2,1,1,1,3,1,H
1934-12-22,1934,Derby County,Arsenal,3-1,3,1,1,1,4,2,H
1934-12-22,1934,Everton,Birmingham City,2-0,2,0,1,1,2,2,H
1934-12-22,1934,Grimsby Town,Sheffield Wednesday,3-1,3,1,1,1,4,2,H
1934-12-22,1934,Huddersfield Town,Stoke City,1-4,1,4,1,1,5,-3,A
1934-12-22,1934,Leicester City,Portsmouth,6-3,6,3,1,1,9,3,H
1934-12-22,1934,Preston North End,West Bromwich Albion,1-2,1,2,1,1,3,-1,A
1934-12-22,1934,Sunderland,Liverpool,2-3,2,3,1,1,5,-1,A
1934-12-22,1934,Tottenham Hotspur,Leeds United,1-1,1,1,1,1,2,0,D
1934-12-22,1934,Wolverhampton Wanderers,Manchester City,5-0,5,0,1,1,5,5,H
1934-12-25,1934,Arsenal,Preston North End,5-3,5,3,1,1,8,2,H
1934-12-25,1934,Blackburn Rovers,Portsmouth,0-0,0,0,1,1,0,0,D
1934-12-25,1934,Chelsea,Aston Villa,2-0,2,0,1,1,2,2,H
1934-12-25,1934,Everton,Sunderland,6-2,6,2,1,1,8,4,H
1934-12-25,1934,Grimsby Town,Tottenham Hotspur,3-0,3,0,1,1,3,3,H
1934-12-25,1934,Leeds United,Manchester City,1-2,1,2,1,1,3,-1,A
1934-12-25,1934,Leicester City,Huddersfield Town,0-3,0,3,1,1,3,-3,A
1934-12-25,1934,Sheffield Wednesday,Birmingham City,2-1,2,1,1,1,3,1,H
1934-12-25,1934,West Bromwich Albion,Stoke City,3-0,3,0,1,1,3,3,H
1934-12-25,1934,Wolverhampton Wanderers,Derby County,5-1,5,1,1,1,6,4,H
1934-12-26,1934,Aston Villa,Chelsea,0-3,0,3,1,1,3,-3,A
1934-12-26,1934,Birmingham City,Sheffield Wednesday,0-4,0,4,1,1,4,-4,A
1934-12-26,1934,Derby County,Wolverhampton Wanderers,2-0,2,0,1,1,2,2,H
1934-12-26,1934,Huddersfield Town,Leicester City,2-3,2,3,1,1,5,-1,A
1934-12-26,1934,Liverpool,Middlesbrough,2-2,2,2,1,1,4,0,D
1934-12-26,1934,Manchester City,Leeds United,3-0,3,0,1,1,3,3,H
1934-12-26,1934,Portsmouth,Blackburn Rovers,3-1,3,1,1,1,4,2,H
1934-12-26,1934,Preston North End,Arsenal,2-1,2,1,1,1,3,1,H
1934-12-26,1934,Stoke City,West Bromwich Albion,3-0,3,0,1,1,3,3,H
1934-12-26,1934,Sunderland,Everton,7-0,7,0,1,1,7,7,H
1934-12-26,1934,Tottenham Hotspur,Grimsby Town,2-1,2,1,1,1,3,1,H
1934-12-29,1934,Arsenal,Portsmouth,1-1,1,1,1,1,2,0,D
1934-12-29,1934,Aston Villa,Birmingham City,2-2,2,2,1,1,4,0,D
1934-12-29,1934,Blackburn Rovers,Liverpool,0-2,0,2,1,1,2,-2,A
1934-12-29,1934,Chelsea,Derby County,1-1,1,1,1,1,2,0,D
1934-12-29,1934,Everton,Tottenham Hotspur,5-2,5,2,1,1,7,3,H
1934-12-29,1934,Grimsby Town,Preston North End,3-1,3,1,1,1,4,2,H
1934-12-29,1934,Huddersfield Town,Sunderland,0-3,0,3,1,1,3,-3,A
1934-12-29,1934,Manchester City,West Bromwich Albion,3-2,3,2,1,1,5,1,H
1934-12-29,1934,Middlesbrough,Leeds United,3-3,3,3,1,1,6,0,D
1934-12-29,1934,Stoke City,Sheffield Wednesday,1-1,1,1,1,1,2,0,D
1934-12-29,1934,Wolverhampton Wanderers,Leicester City,3-1,3,1,1,1,4,2,H
1935-01-01,1934,Blackburn Rovers,Tottenham Hotspur,2-0,2,0,1,1,2,2,H
1935-01-01,1934,Everton,Derby County,2-2,2,2,1,1,4,0,D
1935-01-01,1934,Middlesbrough,Liverpool,2-0,2,0,1,1,2,2,H
1935-01-01,1934,Sheffield Wednesday,West Bromwich Albion,2-1,2,1,1,1,3,1,H
1935-01-05,1934,Birmingham City,Stoke City,0-0,0,0,1,1,0,0,D
1935-01-05,1934,Derby County,Aston Villa,1-1,1,1,1,1,2,0,D
1935-01-05,1934,Leeds United,Blackburn Rovers,5-1,5,1,1,1,6,4,H
1935-01-05,1934,Leicester City,Chelsea,1-0,1,0,1,1,1,1,H
1935-01-05,1934,Liverpool,Arsenal,0-2,0,2,1,1,2,-2,A
1935-01-05,1934,Portsmouth,Grimsby Town,1-0,1,0,1,1,1,1,H
1935-01-05,1934,Preston North End,Everton,2-2,2,2,1,1,4,0,D
1935-01-05,1934,Sheffield Wednesday,Manchester City,1-0,1,0,1,1,1,1,H
1935-01-05,1934,Sunderland,Wolverhampton Wanderers,0-0,0,0,1,1,0,0,D
1935-01-05,1934,Tottenham Hotspur,Huddersfield Town,0-0,0,0,1,1,0,0,D
1935-01-05,1934,West Bromwich Albion,Middlesbrough,6-3,6,3,1,1,9,3,H
1935-01-19,1934,Arsenal,Leeds United,3-0,3,0,1,1,3,3,H
1935-01-19,1934,Aston Villa,Leicester City,5-0,5,0,1,1,5,5,H
1935-01-19,1934,Blackburn Rovers,West Bromwich Albion,3-0,3,0,1,1,3,3,H
1935-01-19,1934,Chelsea,Sunderland,2-2,2,2,1,1,4,0,D
1935-01-19,1934,Everton,Grimsby Town,3-1,3,1,1,1,4,2,H
1935-01-19,1934,Huddersfield Town,Preston North End,3-4,3,4,1,1,7,-1,A
1935-01-19,1934,Manchester City,Birmingham City,0-0,0,0,1,1,0,0,D
1935-01-19,1934,Middlesbrough,Sheffield Wednesday,5-3,5,3,1,1,8,2,H
1935-01-19,1934,Portsmouth,Liverpool,1-2,1,2,1,1,3,-1,A
1935-01-19,1934,Stoke City,Derby County,1-1,1,1,1,1,2,0,D
1935-01-19,1934,Wolverhampton Wanderers,Tottenham Hotspur,6-2,6,2,1,1,8,4,H
1935-01-26,1934,Stoke City,Manchester City,2-0,2,0,1,1,2,2,H
1935-01-28,1934,Preston North End,Wolverhampton Wanderers,2-1,2,1,1,1,3,1,H
1935-01-28,1934,Sheffield Wednesday,Blackburn Rovers,2-2,2,2,1,1,4,0,D
1935-01-30,1934,Tottenham Hotspur,Chelsea,1-3,1,3,1,1,4,-2,A
1935-01-30,1934,West Bromwich Albion,Arsenal,0-3,0,3,1,1,3,-3,A
1935-01-31,1934,Leicester City,Derby County,0-1,0,1,1,1,1,-1,A
1935-02-02,1934,Arsenal,Sheffield Wednesday,4-1,4,1,1,1,5,3,H
1935-02-02,1934,Aston Villa,Tottenham Hotspur,1-0,1,0,1,1,1,1,H
1935-02-02,1934,Blackburn Rovers,Birmingham City,3-1,3,1,1,1,4,2,H
1935-02-02,1934,Chelsea,Preston North End,0-0,0,0,1,1,0,0,D
1935-02-02,1934,Derby County,Sunderland,3-1,3,1,1,1,4,2,H
1935-02-02,1934,Huddersfield Town,Everton,1-1,1,1,1,1,2,0,D
1935-02-02,1934,Liverpool,Leeds United,4-2,4,2,1,1,6,2,H
1935-02-02,1934,Manchester City,Leicester City,6-3,6,3,1,1,9,3,H
1935-02-02,1934,Middlesbrough,Stoke City,2-0,2,0,1,1,2,2,H
1935-02-02,1934,Portsmouth,West Bromwich Albion,0-2,0,2,1,1,2,-2,A
1935-02-02,1934,Wolverhampton Wanderers,Grimsby Town,0-3,0,3,1,1,3,-3,A
1935-02-06,1934,Birmingham City,Middlesbrough,4-2,4,2,1,1,6,2,H
1935-02-06,1934,Sunderland,Aston Villa,3-3,3,3,1,1,6,0,D
1935-02-09,1934,Birmingham City,Arsenal,3-0,3,0,1,1,3,3,H
1935-02-09,1934,Everton,Wolverhampton Wanderers,5-2,5,2,1,1,7,3,H
1935-02-09,1934,Grimsby Town,Chelsea,3-1,3,1,1,1,4,2,H
1935-02-09,1934,Huddersfield Town,Leeds United,3-1,3,1,1,1,4,2,H
1935-02-09,1934,Manchester City,Middlesbrough,6-2,6,2,1,1,8,4,H
1935-02-09,1934,Preston North End,Aston Villa,0-0,0,0,1,1,0,0,D
1935-02-09,1934,Sheffield Wednesday,Portsmouth,3-0,3,0,1,1,3,3,H
1935-02-09,1934,Stoke City,Blackburn Rovers,3-1,3,1,1,1,4,2,H
1935-02-09,1934,Sunderland,Leicester City,2-0,2,0,1,1,2,2,H
1935-02-09,1934,Tottenham Hotspur,Derby County,2-2,2,2,1,1,4,0,D
1935-02-09,1934,West Bromwich Albion,Liverpool,1-1,1,1,1,1,2,0,D
1935-02-16,1934,Aston Villa,Grimsby Town,3-2,3,2,1,1,5,1,H
1935-02-16,1934,Middlesbrough,Sunderland,0-0,0,0,1,1,0,0,D
1935-02-16,1934,Wolverhampton Wanderers,Huddersfield Town,2-3,2,3,1,1,5,-1,A
1935-02-20,1934,Arsenal,Stoke City,2-0,2,0,1,1,2,2,H
1935-02-20,1934,Chelsea,Everton,3-0,3,0,1,1,3,3,H
1935-02-20,1934,Leeds United,West Bromwich Albion,4-1,4,1,1,1,5,3,H
1935-02-20,1934,Liverpool,Sheffield Wednesday,1-2,1,2,1,1,3,-1,A
1935-02-23,1934,Birmingham City,Liverpool,1-3,1,3,1,1,4,-2,A
1935-02-23,1934,Everton,Aston Villa,2-2,2,2,1,1,4,0,D
1935-02-23,1934,Grimsby Town,Derby County,1-3,1,3,1,1,4,-2,A
1935-02-23,1934,Huddersfield Town,Chelsea,3-0,3,0,1,1,3,3,H
1935-02-23,1934,Manchester City,Arsenal,1-1,1,1,1,1,2,0,D
1935-02-23,1934,Middlesbrough,Blackburn Rovers,3-3,3,3,1,1,6,0,D
1935-02-23,1934,Preston North End,Leicester City,2-0,2,0,1,1,2,2,H
1935-02-23,1934,Sheffield Wednesday,Leeds United,1-0,1,0,1,1,1,1,H
1935-02-23,1934,Stoke City,Portsmouth,1-2,1,2,1,1,3,-1,A
1935-02-23,1934,Tottenham Hotspur,Sunderland,1-1,1,1,1,1,2,0,D
1935-02-23,1934,West Bromwich Albion,Wolverhampton Wanderers,5-2,5,2,1,1,7,3,H
1935-03-02,1934,Aston Villa,Stoke City,4-1,4,1,1,1,5,3,H
1935-03-02,1934,Derby County,Manchester City,1-2,1,2,1,1,3,-1,A
1935-03-02,1934,Grimsby Town,Liverpool,3-2,3,2,1,1,5,1,H
1935-03-02,1934,Leeds United,Portsmouth,3-1,3,1,1,1,4,2,H
1935-03-02,1934,Leicester City,Middlesbrough,3-1,3,1,1,1,4,2,H
1935-03-02,1934,Sunderland,Blackburn Rovers,3-0,3,0,1,1,3,3,H
1935-03-04,1934,Blackburn Rovers,Manchester City,1-0,1,0,1,1,1,1,H
1935-03-04,1934,Wolverhampton Wanderers,Sheffield Wednesday,2-2,2,2,1,1,4,0,D
1935-03-06,1934,Chelsea,Birmingham City,2-2,2,2,1,1,4,0,D
1935-03-06,1934,Everton,Leeds United,4-4,4,4,1,1,8,0,D
1935-03-06,1934,Huddersfield Town,West Bromwich Albion,3-0,3,0,1,1,3,3,H
1935-03-06,1934,Preston North End,Portsmouth,1-1,1,1,1,1,2,0,D
1935-03-06,1934,Tottenham Hotspur,Arsenal,0-6,0,6,1,1,6,-6,A
1935-03-09,1934,Arsenal,Sunderland,0-0,0,0,1,1,0,0,D
1935-03-09,1934,Birmingham City,Wolverhampton Wanderers,1-1,1,1,1,1,2,0,D
1935-03-09,1934,Blackburn Rovers,Leicester City,0-0,0,0,1,1,0,0,D
1935-03-09,1934,Leeds United,Grimsby Town,3-1,3,1,1,1,4,2,H
1935-03-09,1934,Liverpool,Preston North End,0-0,0,0,1,1,0,0,D
1935-03-09,1934,Manchester City,Aston Villa,4-1,4,1,1,1,5,3,H
1935-03-09,1934,Middlesbrough,Derby County,1-1,1,1,1,1,2,0,D
1935-03-09,1934,Portsmouth,Tottenham Hotspur,1-1,1,1,1,1,2,0,D
1935-03-09,1934,Sheffield Wednesday,Huddersfield Town,1-1,1,1,1,1,2,0,D
1935-03-09,1934,Stoke City,Chelsea,0-1,0,1,1,1,1,-1,A
1935-03-09,1934,West Bromwich Albion,Everton,0-1,0,1,1,1,1,-1,A
1935-03-16,1934,Chelsea,Leeds United,7-1,7,1,1,1,8,6,H
1935-03-16,1934,Everton,Arsenal,0-2,0,2,1,1,2,-2,A
1935-03-16,1934,Grimsby Town,Blackburn Rovers,1-2,1,2,1,1,3,-1,A
1935-03-16,1934,Huddersfield Town,Portsmouth,2-0,2,0,1,1,2,2,H
1935-03-16,1934,Leicester City,Birmingham City,2-1,2,1,1,1,3,1,H
1935-03-16,1934,Preston North End,Middlesbrough,2-0,2,0,1,1,2,2,H
1935-03-16,1934,Sunderland,Stoke City,4-1,4,1,1,1,5,3,H
1935-03-16,1934,Tottenham Hotspur,Manchester City,0-0,0,0,1,1,0,0,D
1935-03-16,1934,Wolverhampton Wanderers,Liverpool,5-3,5,3,1,1,8,2,H
1935-03-20,1934,Derby County,Sheffield Wednesday,4-0,4,0,1,1,4,4,H
1935-03-20,1934,Liverpool,Everton,2-1,2,1,1,1,3,1,H
1935-03-23,1934,Arsenal,Grimsby Town,1-1,1,1,1,1,2,0,D
1935-03-23,1934,Birmingham City,Derby County,3-2,3,2,1,1,5,1,H
1935-03-23,1934,Blackburn Rovers,Preston North End,1-0,1,0,1,1,1,1,H
1935-03-23,1934,Leeds United,Wolverhampton Wanderers,1-1,1,1,1,1,2,0,D
1935-03-23,1934,Liverpool,Huddersfield Town,3-2,3,2,1,1,5,1,H
1935-03-23,1934,Middlesbrough,Tottenham Hotspur,3-1,3,1,1,1,4,2,H
1935-03-23,1934,Portsmouth,Everton,5-1,5,1,1,1,6,4,H
1935-03-23,1934,Sheffield Wednesday,Aston Villa,2-1,2,1,1,1,3,1,H
1935-03-23,1934,Stoke City,Leicester City,3-0,3,0,1,1,3,3,H
1935-03-23,1934,West Bromwich Albion,Chelsea,2-2,2,2,1,1,4,0,D
1935-03-28,1934,Leicester City,Tottenham Hotspur,6-0,6,0,1,1,6,6,H
1935-03-30,1934,Aston Villa,Arsenal,1-3,1,3,1,1,4,-2,A
1935-03-30,1934,Chelsea,Blackburn Rovers,4-2,4,2,1,1,6,2,H
1935-03-30,1934,Derby County,Portsmouth,0-1,0,1,1,1,1,-1,A
1935-03-30,1934,Everton,Stoke City,5-0,5,0,1,1,5,5,H
1935-03-30,1934,Grimsby Town,Birmingham City,4-3,4,3,1,1,7,1,H
1935-03-30,1934,Huddersfield Town,Manchester City,3-0,3,0,1,1,3,3,H
1935-03-30,1934,Leicester City,Liverpool,3-1,3,1,1,1,4,2,H
1935-03-30,1934,Preston North End,Sheffield Wednesday,2-1,2,1,1,1,3,1,H
1935-03-30,1934,Sunderland,Leeds United,3-0,3,0,1,1,3,3,H
1935-03-30,1934,Tottenham Hotspur,West Bromwich Albion,0-1,0,1,1,1,1,-1,A
1935-03-30,1934,Wolverhampton Wanderers,Middlesbrough,5-3,5,3,1,1,8,2,H
1935-04-02,1934,Grimsby Town,Huddersfield Town,1-1,1,1,1,1,2,0,D
1935-04-03,1934,Aston Villa,West Bromwich Albion,2-3,2,3,1,1,5,-1,A
1935-04-06,1934,Arsenal,Chelsea,2-2,2,2,1,1,4,0,D
1935-04-06,1934,Birmingham City,Preston North End,3-0,3,0,1,1,3,3,H
1935-04-06,1934,Blackburn Rovers,Wolverhampton Wanderers,4-2,4,2,1,1,6,2,H
1935-04-06,1934,Leeds United,Leicester City,0-2,0,2,1,1,2,-2,A
1935-04-06,1934,Liverpool,Derby County,1-3,1,3,1,1,4,-2,A
1935-04-06,1934,Manchester City,Everton,2-2,2,2,1,1,4,0,D
1935-04-06,1934,Middlesbrough,Huddersfield Town,2-1,2,1,1,1,3,1,H
1935-04-06,1934,Portsmouth,Aston Villa,0-1,0,1,1,1,1,-1,A
1935-04-06,1934,Sheffield Wednesday,Tottenham Hotspur,4-0,4,0,1,1,4,4,H
1935-04-06,1934,Stoke City,Grimsby Town,0-0,0,0,1,1,0,0,D
1935-04-06,1934,West Bromwich Albion,Sunderland,1-1,1,1,1,1,2,0,D
1935-04-10,1934,Derby County,Preston North End,0-3,0,3,1,1,3,-3,A
1935-04-10,1934,Manchester City,Sunderland,1-0,1,0,1,1,1,1,H
1935-04-10,1934,Portsmouth,Birmingham City,2-1,2,1,1,1,3,1,H
1935-04-13,1934,Aston Villa,Liverpool,4-2,4,2,1,1,6,2,H
1935-04-13,1934,Chelsea,Portsmouth,1-1,1,1,1,1,2,0,D
1935-04-13,1934,Derby County,Leeds United,1-2,1,2,1,1,3,-1,A
1935-04-13,1934,Everton,Middlesbrough,1-1,1,1,1,1,2,0,D
1935-04-13,1934,Grimsby Town,Manchester City,1-1,1,1,1,1,2,0,D
1935-04-13,1934,Huddersfield Town,Blackburn Rovers,6-0,6,0,1,1,6,6,H
1935-04-13,1934,Leicester City,West Bromwich Albion,0-0,0,0,1,1,0,0,D
1935-04-13,1934,Preston North End,Stoke City,5-2,5,2,1,1,7,3,H
1935-04-13,1934,Sunderland,Sheffield Wednesday,2-2,2,2,1,1,4,0,D
1935-04-13,1934,Tottenham Hotspur,Birmingham City,1-1,1,1,1,1,2,0,D
1935-04-13,1934,Wolverhampton Wanderers,Arsenal,1-1,1,1,1,1,2,0,D
1935-04-19,1934,Arsenal,Middlesbrough,8-0,8,0,1,1,8,8,H
1935-04-19,1934,Aston Villa,Huddersfield Town,1-1,1,1,1,1,2,0,D
1935-04-19,1934,Chelsea,Wolverhampton Wanderers,4-2,4,2,1,1,6,2,H
1935-04-19,1934,Grimsby Town,Leicester City,3-1,3,1,1,1,4,2,H
1935-04-19,1934,Leeds United,Birmingham City,1-1,1,1,1,1,2,0,D
1935-04-19,1934,Liverpool,Stoke City,5-0,5,0,1,1,5,5,H
1935-04-19,1934,Manchester City,Portsmouth,2-4,2,4,1,1,6,-2,A
1935-04-19,1934,Sunderland,Preston North End,3-1,3,1,1,1,4,2,H
1935-04-19,1934,Tottenham Hotspur,Blackburn Rovers,1-0,1,0,1,1,1,1,H
1935-04-20,1934,Arsenal,Huddersfield Town,1-0,1,0,1,1,1,1,H
1935-04-20,1934,Birmingham City,Sunderland,2-2,2,2,1,1,4,0,D
1935-04-20,1934,Blackburn Rovers,Everton,6-2,6,2,1,1,8,4,H
1935-04-20,1934,Leeds United,Aston Villa,1-1,1,1,1,1,2,0,D
1935-04-20,1934,Liverpool,Chelsea,6-0,6,0,1,1,6,6,H
1935-04-20,1934,Manchester City,Preston North End,1-2,1,2,1,1,3,-1,A
1935-04-20,1934,Middlesbrough,Grimsby Town,0-2,0,2,1,1,2,-2,A
1935-04-20,1934,Portsmouth,Wolverhampton Wanderers,0-1,0,1,1,1,1,-1,A
1935-04-20,1934,Sheffield Wednesday,Leicester City,1-1,1,1,1,1,2,0,D
1935-04-20,1934,Stoke City,Tottenham Hotspur,4-1,4,1,1,1,5,3,H
1935-04-20,1934,West Bromwich Albion,Derby County,4-3,4,3,1,1,7,1,H
1935-04-22,1934,Birmingham City,Leeds United,3-1,3,1,1,1,4,2,H
1935-04-22,1934,Derby County,Everton,4-1,4,1,1,1,5,3,H
1935-04-22,1934,Leicester City,Grimsby Town,2-2,2,2,1,1,4,0,D
1935-04-22,1934,Middlesbrough,Arsenal,0-1,0,1,1,1,1,-1,A
1935-04-22,1934,Portsmouth,Manchester City,4-2,4,2,1,1,6,2,H
1935-04-22,1934,Preston North End,Sunderland,1-1,1,1,1,1,2,0,D
1935-04-22,1934,Stoke City,Liverpool,1-1,1,1,1,1,2,0,D
1935-04-22,1934,West Bromwich Albion,Sheffield Wednesday,1-1,1,1,1,1,2,0,D
1935-04-22,1934,Wolverhampton Wanderers,Chelsea,6-1,6,1,1,1,7,5,H
1935-04-24,1934,Huddersfield Town,Aston Villa,1-1,1,1,1,1,2,0,D
1935-04-27,1934,Aston Villa,Middlesbrough,0-3,0,3,1,1,3,-3,A
1935-04-27,1934,Chelsea,Manchester City,4-2,4,2,1,1,6,2,H
1935-04-27,1934,Derby County,Blackburn Rovers,1-1,1,1,1,1,2,0,D
1935-04-27,1934,Huddersfield Town,Birmingham City,2-2,2,2,1,1,4,0,D
1935-04-27,1934,Leicester City,Arsenal,3-5,3,5,1,1,8,-2,A
1935-04-27,1934,Preston North End,Leeds United,0-2,0,2,1,1,2,-2,A
1935-04-27,1934,Sunderland,Portsmouth,4-1,4,1,1,1,5,3,H
1935-04-27,1934,Tottenham Hotspur,Liverpool,5-1,5,1,1,1,6,4,H
1935-04-27,1934,Wolverhampton Wanderers,Stoke City,2-1,2,1,1,1,3,1,H
1935-05-01,1934,Everton,Sheffield Wednesday,2-2,2,2,1,1,4,0,D
1935-05-01,1934,Grimsby Town,West Bromwich Albion,3-0,3,0,1,1,3,3,H
1935-05-04,1934,Arsenal,Derby County,0-1,0,1,1,1,1,-1,A
1935-05-04,1934,Birmingham City,Everton,2-3,2,3,1,1,5,-1,A
1935-05-04,1934,Blackburn Rovers,Aston Villa,5-0,5,0,1,1,5,5,H
1935-05-04,1934,Leeds United,Tottenham Hotspur,4-3,4,3,1,1,7,1,H
1935-05-04,1934,Liverpool,Sunderland,2-2,2,2,1,1,4,0,D
1935-05-04,1934,Manchester City,Wolverhampton Wanderers,5-0,5,0,1,1,5,5,H
1935-05-04,1934,Middlesbrough,Chelsea,2-2,2,2,1,1,4,0,D
1935-05-04,1934,Portsmouth,Leicester City,1-1,1,1,1,1,2,0,D
1935-05-04,1934,Sheffield Wednesday,Grimsby Town,1-0,1,0,1,1,1,1,H
1935-05-04,1934,Stoke City,Huddersfield Town,2-0,2,0,1,1,2,2,H
1935-05-04,1934,West Bromwich Albion,Preston North End,0-0,0,0,1,1,0,0,D
1935-08-31,1935,Arsenal,Sunderland,3-1,3,1,1,1,4,2,H
1935-08-31,1935,Aston Villa,Sheffield Wednesday,1-2,1,2,1,1,3,-1,A
1935-08-31,1935,Blackburn Rovers,Grimsby Town,1-0,1,0,1,1,1,1,H
1935-08-31,1935,Bolton Wanderers,Brentford,0-2,0,2,1,1,2,-2,A
1935-08-31,1935,Chelsea,Liverpool,2-2,2,2,1,1,4,0,D
1935-08-31,1935,Everton,Derby County,4-0,4,0,1,1,4,4,H
1935-08-31,1935,Huddersfield Town,Preston North End,1-0,1,0,1,1,1,1,H
1935-08-31,1935,Manchester City,West Bromwich Albion,1-0,1,0,1,1,1,1,H
1935-08-31,1935,Middlesbrough,Portsmouth,3-2,3,2,1,1,5,1,H
1935-08-31,1935,Stoke City,Leeds United,3-1,3,1,1,1,4,2,H
1935-08-31,1935,Wolverhampton Wanderers,Birmingham City,3-1,3,1,1,1,4,2,H
1935-09-02,1935,Bolton Wanderers,Sheffield Wednesday,1-1,1,1,1,1,2,0,D
1935-09-02,1935,Preston North End,Derby County,1-0,1,0,1,1,1,1,H
1935-09-02,1935,Wolverhampton Wanderers,Huddersfield Town,2-2,2,2,1,1,4,0,D
1935-09-03,1935,Grimsby Town,Arsenal,1-0,1,0,1,1,1,1,H
1935-09-04,1935,Chelsea,Stoke City,3-5,3,5,1,1,8,-2,A
1935-09-04,1935,Leeds United,Birmingham City,0-0,0,0,1,1,0,0,D
1935-09-04,1935,Liverpool,Manchester City,0-2,0,2,1,1,2,-2,A
1935-09-04,1935,Middlesbrough,Aston Villa,1-2,1,2,1,1,3,-1,A
1935-09-04,1935,Portsmouth,Everton,2-0,2,0,1,1,2,2,H
1935-09-04,1935,West Bromwich Albion,Sunderland,1-3,1,3,1,1,4,-2,A
1935-09-05,1935,Brentford,Blackburn Rovers,3-1,3,1,1,1,4,2,H
1935-09-07,1935,Birmingham City,Arsenal,1-1,1,1,1,1,2,0,D
1935-09-07,1935,Brentford,Huddersfield Town,1-2,1,2,1,1,3,-1,A
1935-09-07,1935,Derby County,Bolton Wanderers,4-0,4,0,1,1,4,4,H
1935-09-07,1935,Grimsby Town,Chelsea,1-3,1,3,1,1,4,-2,A
1935-09-07,1935,Leeds United,Blackburn Rovers,1-4,1,4,1,1,5,-3,A
1935-09-07,1935,Liverpool,Everton,6-0,6,0,1,1,6,6,H
1935-09-07,1935,Portsmouth,Aston Villa,3-0,3,0,1,1,3,3,H
1935-09-07,1935,Preston North End,Middlesbrough,0-5,0,5,1,1,5,-5,A
1935-09-07,1935,Sheffield Wednesday,Wolverhampton Wanderers,0-0,0,0,1,1,0,0,D
1935-09-07,1935,Sunderland,Manchester City,2-0,2,0,1,1,2,2,H
1935-09-07,1935,West Bromwich Albion,Stoke City,2-0,2,0,1,1,2,2,H
1935-09-09,1935,Aston Villa,Middlesbrough,2-7,2,7,1,1,9,-5,A
1935-09-09,1935,Sheffield Wednesday,Bolton Wanderers,2-2,2,2,1,1,4,0,D
1935-09-09,1935,Stoke City,Chelsea,3-0,3,0,1,1,3,3,H
1935-09-11,1935,Arsenal,Grimsby Town,6-0,6,0,1,1,6,6,H
1935-09-11,1935,Birmingham City,Leeds United,2-0,2,0,1,1,2,2,H
1935-09-11,1935,Derby County,Preston North End,2-0,2,0,1,1,2,2,H
1935-09-11,1935,Everton,Portsmouth,3-0,3,0,1,1,3,3,H
1935-09-11,1935,Huddersfield Town,Wolverhampton Wanderers,3-0,3,0,1,1,3,3,H
1935-09-11,1935,Manchester City,Liverpool,6-0,6,0,1,1,6,6,H
1935-09-11,1935,Sunderland,West Bromwich Albion,6-1,6,1,1,1,7,5,H
1935-09-14,1935,Arsenal,Sheffield Wednesday,2-2,2,2,1,1,4,0,D
1935-09-14,1935,Aston Villa,Preston North End,5-1,5,1,1,1,6,4,H
1935-09-14,1935,Blackburn Rovers,West Bromwich Albion,3-1,3,1,1,1,4,2,H
1935-09-14,1935,Bolton Wanderers,Everton,2-0,2,0,1,1,2,2,H
1935-09-14,1935,Chelsea,Leeds United,1-0,1,0,1,1,1,1,H
1935-09-14,1935,Huddersfield Town,Derby County,1-1,1,1,1,1,2,0,D
1935-09-14,1935,Liverpool,Grimsby Town,7-2,7,2,1,1,9,5,H
1935-09-14,1935,Manchester City,Birmingham City,3-1,3,1,1,1,4,2,H
1935-09-14,1935,Middlesbrough,Brentford,0-0,0,0,1,1,0,0,D
1935-09-14,1935,Stoke City,Sunderland,0-2,0,2,1,1,2,-2,A
1935-09-14,1935,Wolverhampton Wanderers,Portsmouth,2-0,2,0,1,1,2,2,H
1935-09-16,1935,Aston Villa,Sunderland,2-2,2,2,1,1,4,0,D
1935-09-16,1935,Blackburn Rovers,Chelsea,1-0,1,0,1,1,1,1,H
1935-09-16,1935,Sheffield Wednesday,Huddersfield Town,1-2,1,2,1,1,3,-1,A
1935-09-18,1935,Derby County,Brentford,2-1,2,1,1,1,3,1,H
1935-09-18,1935,Leeds United,Arsenal,1-1,1,1,1,1,2,0,D
1935-09-18,1935,Liverpool,Stoke City,2-0,2,0,1,1,2,2,H
1935-09-18,1935,Middlesbrough,Wolverhampton Wanderers,4-2,4,2,1,1,6,2,H
1935-09-18,1935,Preston North End,Everton,2-2,2,2,1,1,4,0,D
1935-09-18,1935,West Bromwich Albion,Birmingham City,0-0,0,0,1,1,0,0,D
1935-09-21,1935,Arsenal,Manchester City,2-3,2,3,1,1,5,-1,A
1935-09-21,1935,Birmingham City,Stoke City,0-5,0,5,1,1,5,-5,A
1935-09-21,1935,Brentford,Aston Villa,1-2,1,2,1,1,3,-1,A
1935-09-21,1935,Derby County,Middlesbrough,3-2,3,2,1,1,5,1,H
1935-09-21,1935,Everton,Huddersfield Town,1-3,1,3,1,1,4,-2,A
1935-09-21,1935,Grimsby Town,Bolton Wanderers,3-1,3,1,1,1,4,2,H
1935-09-21,1935,Leeds United,Liverpool,1-0,1,0,1,1,1,1,H
1935-09-21,1935,Portsmouth,Sheffield Wednesday,3-2,3,2,1,1,5,1,H
1935-09-21,1935,Preston North End,Wolverhampton Wanderers,2-0,2,0,1,1,2,2,H
1935-09-21,1935,Sunderland,Blackburn Rovers,7-2,7,2,1,1,9,5,H
1935-09-21,1935,West Bromwich Albion,Chelsea,1-2,1,2,1,1,3,-1,A
1935-09-28,1935,Aston Villa,Derby County,0-2,0,2,1,1,2,-2,A
1935-09-28,1935,Blackburn Rovers,Birmingham City,1-2,1,2,1,1,3,-1,A
1935-09-28,1935,Chelsea,Sunderland,3-1,3,1,1,1,4,2,H
1935-09-28,1935,Grimsby Town,Leeds United,0-1,0,1,1,1,1,-1,A
1935-09-28,1935,Huddersfield Town,Bolton Wanderers,0-0,0,0,1,1,0,0,D
1935-09-28,1935,Liverpool,West Bromwich Albion,5-0,5,0,1,1,5,5,H
1935-09-28,1935,Manchester City,Portsmouth,0-0,0,0,1,1,0,0,D
1935-09-28,1935,Middlesbrough,Everton,6-1,6,1,1,1,7,5,H
1935-09-28,1935,Sheffield Wednesday,Preston North End,1-0,1,0,1,1,1,1,H
1935-09-28,1935,Stoke City,Arsenal,0-3,0,3,1,1,3,-3,A
1935-09-28,1935,Wolverhampton Wanderers,Brentford,3-2,3,2,1,1,5,1,H
1935-10-05,1935,Arsenal,Blackburn Rovers,5-1,5,1,1,1,6,4,H
1935-10-05,1935,Birmingham City,Chelsea,2-1,2,1,1,1,3,1,H
1935-10-05,1935,Bolton Wanderers,Middlesbrough,3-1,3,1,1,1,4,2,H
1935-10-05,1935,Brentford,Sheffield Wednesday,2-2,2,2,1,1,4,0,D
1935-10-05,1935,Derby County,Wolverhampton Wanderers,3-1,3,1,1,1,4,2,H
1935-10-05,1935,Everton,Aston Villa,2-2,2,2,1,1,4,0,D
1935-10-05,1935,Leeds United,Huddersfield Town,2-2,2,2,1,1,4,0,D
1935-10-05,1935,Manchester City,Stoke City,1-2,1,2,1,1,3,-1,A
1935-10-05,1935,Preston North End,Portsmouth,1-1,1,1,1,1,2,0,D
1935-10-05,1935,Sunderland,Liverpool,2-0,2,0,1,1,2,2,H
1935-10-05,1935,West Bromwich Albion,Grimsby Town,4-1,4,1,1,1,5,3,H
1935-10-12,1935,Aston Villa,Bolton Wanderers,1-2,1,2,1,1,3,-1,A
1935-10-12,1935,Blackburn Rovers,Manchester City,4-1,4,1,1,1,5,3,H
1935-10-12,1935,Chelsea,Arsenal,1-1,1,1,1,1,2,0,D
1935-10-12,1935,Grimsby Town,Sunderland,4-0,4,0,1,1,4,4,H
1935-10-12,1935,Leeds United,West Bromwich Albion,1-1,1,1,1,1,2,0,D
1935-10-12,1935,Liverpool,Birmingham City,1-2,1,2,1,1,3,-1,A
1935-10-12,1935,Middlesbrough,Huddersfield Town,4-2,4,2,1,1,6,2,H
1935-10-12,1935,Portsmouth,Brentford,1-3,1,3,1,1,4,-2,A
1935-10-12,1935,Sheffield Wednesday,Derby County,1-0,1,0,1,1,1,1,H
1935-10-12,1935,Stoke City,Preston North End,2-1,2,1,1,1,3,1,H
1935-10-12,1935,Wolverhampton Wanderers,Everton,4-0,4,0,1,1,4,4,H
1935-10-19,1935,Aston Villa,West Bromwich Albion,0-7,0,7,1,1,7,-7,A
1935-10-19,1935,Bolton Wanderers,Liverpool,0-0,0,0,1,1,0,0,D
1935-10-19,1935,Brentford,Stoke City,0-0,0,0,1,1,0,0,D
1935-10-19,1935,Derby County,Blackburn Rovers,1-0,1,0,1,1,1,1,H
1935-10-19,1935,Everton,Chelsea,5-1,5,1,1,1,6,4,H
1935-10-19,1935,Huddersfield Town,Grimsby Town,1-0,1,0,1,1,1,1,H
1935-10-19,1935,Middlesbrough,Leeds United,1-1,1,1,1,1,2,0,D
1935-10-19,1935,Portsmouth,Arsenal,2-1,2,1,1,1,3,1,H
1935-10-19,1935,Preston North End,Manchester City,4-0,4,0,1,1,4,4,H
1935-10-19,1935,Sheffield Wednesday,Birmingham City,3-1,3,1,1,1,4,2,H
1935-10-19,1935,Wolverhampton Wanderers,Sunderland,3-4,3,4,1,1,7,-1,A
1935-10-26,1935,Arsenal,Preston North End,2-1,2,1,1,1,3,1,H
1935-10-26,1935,Birmingham City,Portsmouth,4-0,4,0,1,1,4,4,H
1935-10-26,1935,Blackburn Rovers,Everton,1-1,1,1,1,1,2,0,D
1935-10-26,1935,Chelsea,Bolton Wanderers,2-1,2,1,1,1,3,1,H
1935-10-26,1935,Grimsby Town,Middlesbrough,1-0,1,0,1,1,1,1,H
1935-10-26,1935,Leeds United,Aston Villa,4-2,4,2,1,1,6,2,H
1935-10-26,1935,Liverpool,Huddersfield Town,3-0,3,0,1,1,3,3,H
1935-10-26,1935,Manchester City,Brentford,2-1,2,1,1,1,3,1,H
1935-10-26,1935,Stoke City,Derby County,0-0,0,0,1,1,0,0,D
1935-10-26,1935,Sunderland,Sheffield Wednesday,5-1,5,1,1,1,6,4,H
1935-10-26,1935,West Bromwich Albion,Wolverhampton Wanderers,2-1,2,1,1,1,3,1,H
1935-11-02,1935,Aston Villa,Grimsby Town,2-6,2,6,1,1,8,-4,A
1935-11-02,1935,Bolton Wanderers,Blackburn Rovers,3-1,3,1,1,1,4,2,H
1935-11-02,1935,Brentford,Arsenal,2-1,2,1,1,1,3,1,H
1935-11-02,1935,Derby County,Manchester City,3-0,3,0,1,1,3,3,H
1935-11-02,1935,Everton,Stoke City,5-1,5,1,1,1,6,4,H
1935-11-02,1935,Huddersfield Town,Chelsea,2-0,2,0,1,1,2,2,H
1935-11-02,1935,Middlesbrough,Liverpool,2-2,2,2,1,1,4,0,D
1935-11-02,1935,Portsmouth,Sunderland,2-2,2,2,1,1,4,0,D
1935-11-02,1935,Preston North End,Birmingham City,3-1,3,1,1,1,4,2,H
1935-11-02,1935,Sheffield Wednesday,West Bromwich Albion,2-5,2,5,1,1,7,-3,A
1935-11-02,1935,Wolverhampton Wanderers,Leeds United,3-0,3,0,1,1,3,3,H
1935-11-09,1935,Arsenal,Derby County,1-1,1,1,1,1,2,0,D
1935-11-09,1935,Birmingham City,Brentford,2-1,2,1,1,1,3,1,H
1935-11-09,1935,Blackburn Rovers,Huddersfield Town,2-1,2,1,1,1,3,1,H
1935-11-09,1935,Chelsea,Middlesbrough,2-1,2,1,1,1,3,1,H
1935-11-09,1935,Grimsby Town,Wolverhampton Wanderers,2-1,2,1,1,1,3,1,H
1935-11-09,1935,Leeds United,Sheffield Wednesday,7-2,7,2,1,1,9,5,H
1935-11-09,1935,Liverpool,Aston Villa,3-2,3,2,1,1,5,1,H
1935-11-09,1935,Manchester City,Everton,1-0,1,0,1,1,1,1,H
1935-11-09,1935,Stoke City,Bolton Wanderers,1-2,1,2,1,1,3,-1,A
1935-11-09,1935,Sunderland,Preston North End,4-2,4,2,1,1,6,2,H
1935-11-09,1935,West Bromwich Albion,Portsmouth,2-0,2,0,1,1,2,2,H
1935-11-16,1935,Aston Villa,Chelsea,2-2,2,2,1,1,4,0,D
1935-11-16,1935,Bolton Wanderers,Manchester City,3-3,3,3,1,1,6,0,D
1935-11-16,1935,Brentford,Sunderland,1-5,1,5,1,1,6,-4,A
1935-11-16,1935,Derby County,Birmingham City,2-2,2,2,1,1,4,0,D
1935-11-16,1935,Everton,Arsenal,0-2,0,2,1,1,2,-2,A
1935-11-16,1935,Huddersfield Town,Stoke City,2-1,2,1,1,1,3,1,H
1935-11-16,1935,Middlesbrough,Blackburn Rovers,6-1,6,1,1,1,7,5,H
1935-11-16,1935,Portsmouth,Leeds United,2-2,2,2,1,1,4,0,D
1935-11-16,1935,Preston North End,West Bromwich Albion,3-0,3,0,1,1,3,3,H
1935-11-16,1935,Sheffield Wednesday,Grimsby Town,3-0,3,0,1,1,3,3,H
1935-11-16,1935,Wolverhampton Wanderers,Liverpool,3-1,3,1,1,1,4,2,H
1935-11-23,1935,Arsenal,Wolverhampton Wanderers,4-0,4,0,1,1,4,4,H
1935-11-23,1935,Birmingham City,Aston Villa,2-2,2,2,1,1,4,0,D
1935-11-23,1935,Blackburn Rovers,Preston North End,1-1,1,1,1,1,2,0,D
1935-11-23,1935,Chelsea,Brentford,2-1,2,1,1,1,3,1,H
1935-11-23,1935,Grimsby Town,Everton,0-4,0,4,1,1,4,-4,A
1935-11-23,1935,Leeds United,Bolton Wanderers,5-2,5,2,1,1,7,3,H
1935-11-23,1935,Liverpool,Derby County,0-0,0,0,1,1,0,0,D
1935-11-23,1935,Manchester City,Sheffield Wednesday,3-0,3,0,1,1,3,3,H
1935-11-23,1935,Stoke City,Portsmouth,2-0,2,0,1,1,2,2,H
1935-11-23,1935,Sunderland,Middlesbrough,2-1,2,1,1,1,3,1,H
1935-11-23,1935,West Bromwich Albion,Huddersfield Town,1-2,1,2,1,1,3,-1,A
1935-11-30,1935,Aston Villa,Stoke City,4-0,4,0,1,1,4,4,H
1935-11-30,1935,Bolton Wanderers,Birmingham City,2-0,2,0,1,1,2,2,H
1935-11-30,1935,Brentford,Leeds United,2-2,2,2,1,1,4,0,D
1935-11-30,1935,Derby County,West Bromwich Albion,2-0,2,0,1,1,2,2,H
1935-11-30,1935,Everton,Sunderland,0-3,0,3,1,1,3,-3,A
1935-11-30,1935,Huddersfield Town,Arsenal,0-0,0,0,1,1,0,0,D
1935-11-30,1935,Middlesbrough,Manchester City,2-0,2,0,1,1,2,2,H
1935-11-30,1935,Portsmouth,Liverpool,2-1,2,1,1,1,3,1,H
1935-11-30,1935,Preston North End,Grimsby Town,1-0,1,0,1,1,1,1,H
1935-11-30,1935,Sheffield Wednesday,Chelsea,4-1,4,1,1,1,5,3,H
1935-11-30,1935,Wolverhampton Wanderers,Blackburn Rovers,8-1,8,1,1,1,9,7,H
1935-12-07,1935,Birmingham City,Huddersfield Town,4-1,4,1,1,1,5,3,H
1935-12-07,1935,Blackburn Rovers,Sheffield Wednesday,3-2,3,2,1,1,5,1,H
1935-12-07,1935,Grimsby Town,Brentford,6-1,6,1,1,1,7,5,H
1935-12-07,1935,Leeds United,Derby County,1-0,1,0,1,1,1,1,H
1935-12-07,1935,Liverpool,Preston North End,2-1,2,1,1,1,3,1,H
1935-12-07,1935,Manchester City,Aston Villa,5-0,5,0,1,1,5,5,H
1935-12-07,1935,Stoke City,Wolverhampton Wanderers,4-1,4,1,1,1,5,3,H
1935-12-07,1935,Sunderland,Bolton Wanderers,7-2,7,2,1,1,9,5,H
1935-12-07,1935,West Bromwich Albion,Everton,6-1,6,1,1,1,7,5,H
1935-12-09,1935,Arsenal,Middlesbrough,2-0,2,0,1,1,2,2,H
1935-12-14,1935,Aston Villa,Arsenal,1-7,1,7,1,1,8,-6,A
1935-12-14,1935,Bolton Wanderers,West Bromwich Albion,3-1,3,1,1,1,4,2,H
1935-12-14,1935,Brentford,Liverpool,1-2,1,2,1,1,3,-1,A
1935-12-14,1935,Derby County,Grimsby Town,2-0,2,0,1,1,2,2,H
1935-12-14,1935,Everton,Leeds United,0-0,0,0,1,1,0,0,D
1935-12-14,1935,Huddersfield Town,Sunderland,1-0,1,0,1,1,1,1,H
1935-12-14,1935,Middlesbrough,Birmingham City,0-2,0,2,1,1,2,-2,A
1935-12-14,1935,Portsmouth,Blackburn Rovers,3-1,3,1,1,1,4,2,H
1935-12-14,1935,Preston North End,Chelsea,2-0,2,0,1,1,2,2,H
1935-12-14,1935,Sheffield Wednesday,Stoke City,0-1,0,1,1,1,1,-1,A
1935-12-14,1935,Wolverhampton Wanderers,Manchester City,4-3,4,3,1,1,7,1,H
1935-12-21,1935,Birmingham City,Everton,4-2,4,2,1,1,6,2,H
1935-12-21,1935,Blackburn Rovers,Aston Villa,5-1,5,1,1,1,6,4,H
1935-12-21,1935,Chelsea,Wolverhampton Wanderers,2-2,2,2,1,1,4,0,D
1935-12-21,1935,Grimsby Town,Portsmouth,1-2,1,2,1,1,3,-1,A
1935-12-21,1935,Leeds United,Preston North End,0-1,0,1,1,1,1,-1,A
1935-12-21,1935,Liverpool,Sheffield Wednesday,1-0,1,0,1,1,1,1,H
1935-12-21,1935,Stoke City,Middlesbrough,1-1,1,1,1,1,2,0,D
1935-12-21,1935,Sunderland,Derby County,3-1,3,1,1,1,4,2,H
1935-12-21,1935,West Bromwich Albion,Brentford,1-0,1,0,1,1,1,1,H
1935-12-25,1935,Aston Villa,Huddersfield Town,4-1,4,1,1,1,5,3,H
1935-12-25,1935,Blackburn Rovers,Stoke City,0-1,0,1,1,1,1,-1,A
1935-12-25,1935,Bolton Wanderers,Wolverhampton Wanderers,0-3,0,3,1,1,3,-3,A
1935-12-25,1935,Brentford,Preston North End,5-2,5,2,1,1,7,3,H
1935-12-25,1935,Grimsby Town,Birmingham City,1-0,1,0,1,1,1,1,H
1935-12-25,1935,Liverpool,Arsenal,0-1,0,1,1,1,1,-1,A
1935-12-25,1935,Manchester City,Chelsea,0-0,0,0,1,1,0,0,D
1935-12-25,1935,Portsmouth,Derby County,3-0,3,0,1,1,3,3,H
1935-12-26,1935,Arsenal,Liverpool,1-2,1,2,1,1,3,-1,A
1935-12-26,1935,Birmingham City,Grimsby Town,1-1,1,1,1,1,2,0,D
1935-12-26,1935,Chelsea,Manchester City,2-1,2,1,1,1,3,1,H
1935-12-26,1935,Derby County,Portsmouth,1-1,1,1,1,1,2,0,D
1935-12-26,1935,Everton,Sheffield Wednesday,4-3,4,3,1,1,7,1,H
1935-12-26,1935,Huddersfield Town,Aston Villa,4-1,4,1,1,1,5,3,H
1935-12-26,1935,Preston North End,Brentford,2-4,2,4,1,1,6,-2,A
1935-12-26,1935,Stoke City,Blackburn Rovers,2-0,2,0,1,1,2,2,H
1935-12-26,1935,Sunderland,Leeds United,2-1,2,1,1,1,3,1,H
1935-12-26,1935,West Bromwich Albion,Middlesbrough,5-2,5,2,1,1,7,3,H
1935-12-26,1935,Wolverhampton Wanderers,Bolton Wanderers,3-3,3,3,1,1,6,0,D
1935-12-28,1935,Birmingham City,Wolverhampton Wanderers,0-0,0,0,1,1,0,0,D
1935-12-28,1935,Brentford,Bolton Wanderers,4-0,4,0,1,1,4,4,H
1935-12-28,1935,Derby County,Everton,3-3,3,3,1,1,6,0,D
1935-12-28,1935,Grimsby Town,Blackburn Rovers,1-1,1,1,1,1,2,0,D
1935-12-28,1935,Leeds United,Stoke City,4-1,4,1,1,1,5,3,H
1935-12-28,1935,Liverpool,Chelsea,2-3,2,3,1,1,5,-1,A
1935-12-28,1935,Portsmouth,Middlesbrough,1-0,1,0,1,1,1,1,H
1935-12-28,1935,Preston North End,Huddersfield Town,4-0,4,0,1,1,4,4,H
1935-12-28,1935,Sheffield Wednesday,Aston Villa,5-2,5,2,1,1,7,3,H
1935-12-28,1935,Sunderland,Arsenal,5-4,5,4,1,1,9,1,H
1935-12-28,1935,West Bromwich Albion,Manchester City,5-1,5,1,1,1,6,4,H
1936-01-01,1935,Blackburn Rovers,Brentford,1-0,1,0,1,1,1,1,H
1936-01-01,1935,Bolton Wanderers,Portsmouth,4-0,4,0,1,1,4,4,H
1936-01-01,1935,Manchester City,Grimsby Town,0-3,0,3,1,1,3,-3,A
1936-01-01,1935,Middlesbrough,West Bromwich Albion,3-1,3,1,1,1,4,2,H
1936-01-01,1935,Sunderland,Aston Villa,1-3,1,3,1,1,4,-2,A
1936-01-04,1935,Arsenal,Birmingham City,1-1,1,1,1,1,2,0,D
1936-01-04,1935,Aston Villa,Portsmouth,4-2,4,2,1,1,6,2,H
1936-01-04,1935,Blackburn Rovers,Leeds United,0-3,0,3,1,1,3,-3,A
1936-01-04,1935,Bolton Wanderers,Derby County,0-2,0,2,1,1,2,-2,A
1936-01-04,1935,Chelsea,Grimsby Town,0-2,0,2,1,1,2,-2,A
1936-01-04,1935,Everton,Liverpool,0-0,0,0,1,1,0,0,D
1936-01-04,1935,Huddersfield Town,Brentford,2-2,2,2,1,1,4,0,D
1936-01-04,1935,Manchester City,Sunderland,0-1,0,1,1,1,1,-1,A
1936-01-04,1935,Middlesbrough,Preston North End,2-0,2,0,1,1,2,2,H
1936-01-04,1935,Stoke City,West Bromwich Albion,3-2,3,2,1,1,5,1,H
1936-01-04,1935,Wolverhampton Wanderers,Sheffield Wednesday,2-1,2,1,1,1,3,1,H
1936-01-15,1935,Manchester City,Huddersfield Town,1-2,1,2,1,1,3,-1,A
1936-01-18,1935,Birmingham City,Manchester City,0-1,0,1,1,1,1,-1,A
1936-01-18,1935,Brentford,Middlesbrough,1-0,1,0,1,1,1,1,H
1936-01-18,1935,Derby County,Huddersfield Town,2-0,2,0,1,1,2,2,H
1936-01-18,1935,Grimsby Town,Liverpool,0-0,0,0,1,1,0,0,D
1936-01-18,1935,Leeds United,Chelsea,2-0,2,0,1,1,2,2,H
1936-01-18,1935,Portsmouth,Wolverhampton Wanderers,1-0,1,0,1,1,1,1,H
1936-01-18,1935,Preston North End,Aston Villa,3-0,3,0,1,1,3,3,H
1936-01-18,1935,Sheffield Wednesday,Arsenal,3-2,3,2,1,1,5,1,H
1936-01-18,1935,Sunderland,Stoke City,1-0,1,0,1,1,1,1,H
1936-01-18,1935,West Bromwich Albion,Blackburn Rovers,8-1,8,1,1,1,9,7,H
1936-01-22,1935,Everton,Bolton Wanderers,3-3,3,3,1,1,6,0,D
1936-01-25,1935,Aston Villa,Brentford,2-2,2,2,1,1,4,0,D
1936-01-29,1935,Bolton Wanderers,Grimsby Town,4-0,4,0,1,1,4,4,H
1936-01-29,1935,Huddersfield Town,Everton,2-1,2,1,1,1,3,1,H
1936-01-29,1935,Middlesbrough,Derby County,0-3,0,3,1,1,3,-3,A
1936-02-01,1935,Arsenal,Stoke City,1-0,1,0,1,1,1,1,H
1936-02-01,1935,Birmingham City,Blackburn Rovers,4-2,4,2,1,1,6,2,H
1936-02-01,1935,Bolton Wanderers,Huddersfield Town,1-2,1,2,1,1,3,-1,A
1936-02-01,1935,Brentford,Wolverhampton Wanderers,5-0,5,0,1,1,5,5,H
1936-02-01,1935,Derby County,Aston Villa,1-3,1,3,1,1,4,-2,A
1936-02-01,1935,Everton,Middlesbrough,5-2,5,2,1,1,7,3,H
1936-02-01,1935,Leeds United,Grimsby Town,1-2,1,2,1,1,3,-1,A
1936-02-01,1935,Portsmouth,Manchester City,1-2,1,2,1,1,3,-1,A
1936-02-01,1935,Preston North End,Sheffield Wednesday,0-1,0,1,1,1,1,-1,A
1936-02-01,1935,Sunderland,Chelsea,3-3,3,3,1,1,6,0,D
1936-02-01,1935,West Bromwich Albion,Liverpool,6-1,6,1,1,1,7,5,H
1936-02-03,1935,Sheffield Wednesday,Everton,3-3,3,3,1,1,6,0,D
1936-02-03,1935,Stoke City,Birmingham City,3-1,3,1,1,1,4,2,H
1936-02-08,1935,Aston Villa,Everton,1-1,1,1,1,1,2,0,D
1936-02-08,1935,Blackburn Rovers,Arsenal,0-1,0,1,1,1,1,-1,A
1936-02-08,1935,Chelsea,Birmingham City,0-0,0,0,1,1,0,0,D
1936-02-08,1935,Grimsby Town,West Bromwich Albion,4-2,4,2,1,1,6,2,H
1936-02-08,1935,Huddersfield Town,Leeds United,1-2,1,2,1,1,3,-1,A
1936-02-08,1935,Liverpool,Sunderland,0-3,0,3,1,1,3,-3,A
1936-02-08,1935,Middlesbrough,Bolton Wanderers,0-0,0,0,1,1,0,0,D
1936-02-08,1935,Portsmouth,Preston North End,1-1,1,1,1,1,2,0,D
1936-02-08,1935,Sheffield Wednesday,Brentford,3-3,3,3,1,1,6,0,D
1936-02-08,1935,Stoke City,Manchester City,1-0,1,0,1,1,1,1,H
1936-02-08,1935,Wolverhampton Wanderers,Derby County,0-0,0,0,1,1,0,0,D
1936-02-12,1935,Sheffield Wednesday,Portsmouth,0-1,0,1,1,1,1,-1,A
1936-02-15,1935,Birmingham City,Liverpool,2-0,2,0,1,1,2,2,H
1936-02-15,1935,Blackburn Rovers,Sunderland,1-1,1,1,1,1,2,0,D
1936-02-15,1935,Bolton Wanderers,Aston Villa,4-3,4,3,1,1,7,1,H
1936-02-15,1935,Everton,Wolverhampton Wanderers,4-1,4,1,1,1,5,3,H
1936-02-19,1935,Derby County,Sheffield Wednesday,3-1,3,1,1,1,4,2,H
1936-02-19,1935,Huddersfield Town,Middlesbrough,4-1,4,1,1,1,5,3,H
1936-02-19,1935,Manchester City,Blackburn Rovers,2-0,2,0,1,1,2,2,H
1936-02-19,1935,Preston North End,Stoke City,1-1,1,1,1,1,2,0,D
1936-02-19,1935,Sunderland,Grimsby Town,3-1,3,1,1,1,4,2,H
1936-02-19,1935,West Bromwich Albion,Leeds United,3-2,3,2,1,1,5,1,H
1936-02-22,1935,Arsenal,Portsmouth,2-3,2,3,1,1,5,-1,A
1936-02-22,1935,Blackburn Rovers,Derby County,0-0,0,0,1,1,0,0,D
1936-02-22,1935,Chelsea,Everton,2-2,2,2,1,1,4,0,D
1936-02-22,1935,Grimsby Town,Huddersfield Town,1-1,1,1,1,1,2,0,D
1936-02-22,1935,Leeds United,Middlesbrough,0-1,0,1,1,1,1,-1,A
1936-02-22,1935,Liverpool,Bolton Wanderers,1-1,1,1,1,1,2,0,D
1936-02-22,1935,Manchester City,Preston North End,1-3,1,3,1,1,4,-2,A
1936-02-22,1935,Stoke City,Brentford,2-2,2,2,1,1,4,0,D
1936-02-22,1935,Sunderland,Wolverhampton Wanderers,3-1,3,1,1,1,4,2,H
1936-02-29,1935,Aston Villa,Liverpool,3-0,3,0,1,1,3,3,H
1936-02-29,1935,Bolton Wanderers,Stoke City,1-2,1,2,1,1,3,-1,A
1936-02-29,1935,Brentford,Birmingham City,0-1,0,1,1,1,1,-1,A
1936-02-29,1935,Everton,Manchester City,2-2,2,2,1,1,4,0,D
1936-02-29,1935,Huddersfield Town,Blackburn Rovers,1-1,1,1,1,1,2,0,D
1936-02-29,1935,Portsmouth,West Bromwich Albion,3-1,3,1,1,1,4,2,H
1936-02-29,1935,Preston North End,Sunderland,3-2,3,2,1,1,5,1,H
1936-02-29,1935,Sheffield Wednesday,Leeds United,3-0,3,0,1,1,3,3,H
1936-03-04,1935,Derby County,Arsenal,0-4,0,4,1,1,4,-4,A
1936-03-04,1935,Middlesbrough,Chelsea,4-1,4,1,1,1,5,3,H
1936-03-04,1935,Wolverhampton Wanderers,Grimsby Town,1-0,1,0,1,1,1,1,H
1936-03-07,1935,Arsenal,Huddersfield Town,1-1,1,1,1,1,2,0,D
1936-03-07,1935,Birmingham City,Bolton Wanderers,0-0,0,0,1,1,0,0,D
1936-03-07,1935,Blackburn Rovers,Wolverhampton Wanderers,1-0,1,0,1,1,1,1,H
1936-03-07,1935,Chelsea,Sheffield Wednesday,1-2,1,2,1,1,3,-1,A
1936-03-07,1935,Grimsby Town,Preston North End,0-0,0,0,1,1,0,0,D
1936-03-07,1935,Leeds United,Brentford,1-2,1,2,1,1,3,-1,A
1936-03-07,1935,Liverpool,Portsmouth,2-0,2,0,1,1,2,2,H
1936-03-07,1935,Manchester City,Middlesbrough,6-0,6,0,1,1,6,6,H
1936-03-07,1935,Stoke City,Aston Villa,2-3,2,3,1,1,5,-1,A
1936-03-07,1935,Sunderland,Everton,3-3,3,3,1,1,6,0,D
1936-03-07,1935,West Bromwich Albion,Derby County,0-3,0,3,1,1,3,-3,A
1936-03-11,1935,Chelsea,West Bromwich Albion,2-2,2,2,1,1,4,0,D
1936-03-11,1935,Manchester City,Arsenal,1-0,1,0,1,1,1,1,H
1936-03-14,1935,Aston Villa,Leeds United,3-3,3,3,1,1,6,0,D
1936-03-14,1935,Bolton Wanderers,Chelsea,2-3,2,3,1,1,5,-1,A
1936-03-14,1935,Brentford,Manchester City,0-0,0,0,1,1,0,0,D
1936-03-14,1935,Derby County,Stoke City,0-1,0,1,1,1,1,-1,A
1936-03-14,1935,Everton,Blackburn Rovers,4-0,4,0,1,1,4,4,H
1936-03-14,1935,Huddersfield Town,Liverpool,1-0,1,0,1,1,1,1,H
1936-03-14,1935,Middlesbrough,Grimsby Town,5-1,5,1,1,1,6,4,H
1936-03-14,1935,Portsmouth,Birmingham City,0-3,0,3,1,1,3,-3,A
1936-03-14,1935,Preston North End,Arsenal,1-0,1,0,1,1,1,1,H
1936-03-14,1935,Sheffield Wednesday,Sunderland,0-0,0,0,1,1,0,0,D
1936-03-14,1935,Wolverhampton Wanderers,West Bromwich Albion,2-0,2,0,1,1,2,2,H
1936-03-18,1935,Liverpool,Leeds United,2-1,2,1,1,1,3,1,H
1936-03-21,1935,Birmingham City,Derby County,2-3,2,3,1,1,5,-1,A
1936-03-21,1935,Blackburn Rovers,Middlesbrough,2-2,2,2,1,1,4,0,D
1936-03-21,1935,Chelsea,Aston Villa,1-0,1,0,1,1,1,1,H
1936-03-21,1935,Leeds United,Portsmouth,1-0,1,0,1,1,1,1,H
1936-03-21,1935,Liverpool,Wolverhampton Wanderers,0-2,0,2,1,1,2,-2,A
1936-03-21,1935,Manchester City,Bolton Wanderers,7-0,7,0,1,1,7,7,H
1936-03-21,1935,Stoke City,Huddersfield Town,1-0,1,0,1,1,1,1,H
1936-03-21,1935,Sunderland,Brentford,1-3,1,3,1,1,4,-2,A
1936-03-21,1935,West Bromwich Albion,Preston North End,2-4,2,4,1,1,6,-2,A
1936-03-24,1935,Grimsby Town,Sheffield Wednesday,4-0,4,0,1,1,4,4,H
1936-03-25,1935,Arsenal,Everton,1-1,1,1,1,1,2,0,D
1936-03-25,1935,Brentford,Portsmouth,3-1,3,1,1,1,4,2,H
1936-03-28,1935,Aston Villa,Birmingham City,2-1,2,1,1,1,3,1,H
1936-03-28,1935,Bolton Wanderers,Leeds United,3-0,3,0,1,1,3,3,H
1936-03-28,1935,Brentford,Chelsea,2-1,2,1,1,1,3,1,H
1936-03-28,1935,Derby County,Liverpool,2-2,2,2,1,1,4,0,D
1936-03-28,1935,Everton,Grimsby Town,4-0,4,0,1,1,4,4,H
1936-03-28,1935,Huddersfield Town,West Bromwich Albion,2-3,2,3,1,1,5,-1,A
1936-03-28,1935,Middlesbrough,Sunderland,6-0,6,0,1,1,6,6,H
1936-03-28,1935,Portsmouth,Stoke City,2-0,2,0,1,1,2,2,H
1936-03-28,1935,Preston North End,Blackburn Rovers,2-0,2,0,1,1,2,2,H
1936-03-28,1935,Sheffield Wednesday,Manchester City,1-0,1,0,1,1,1,1,H
1936-03-28,1935,Wolverhampton Wanderers,Arsenal,2-2,2,2,1,1,4,0,D
1936-04-01,1935,Arsenal,Bolton Wanderers,1-1,1,1,1,1,2,0,D
1936-04-01,1935,West Bromwich Albion,Aston Villa,0-3,0,3,1,1,3,-3,A
1936-04-04,1935,Arsenal,Brentford,1-1,1,1,1,1,2,0,D
1936-04-04,1935,Birmingham City,Preston North End,0-0,0,0,1,1,0,0,D
1936-04-04,1935,Blackburn Rovers,Bolton Wanderers,0-3,0,3,1,1,3,-3,A
1936-04-04,1935,Chelsea,Huddersfield Town,1-0,1,0,1,1,1,1,H
1936-04-04,1935,Grimsby Town,Aston Villa,4-1,4,1,1,1,5,3,H
1936-04-04,1935,Leeds United,Wolverhampton Wanderers,2-0,2,0,1,1,2,2,H
1936-04-04,1935,Liverpool,Middlesbrough,2-2,2,2,1,1,4,0,D
1936-04-04,1935,Manchester City,Derby County,1-0,1,0,1,1,1,1,H
1936-04-04,1935,Stoke City,Everton,2-1,2,1,1,1,3,1,H
1936-04-04,1935,Sunderland,Portsmouth,5-0,5,0,1,1,5,5,H
1936-04-04,1935,West Bromwich Albion,Sheffield Wednesday,2-2,2,2,1,1,4,0,D
1936-04-10,1935,Arsenal,West Bromwich Albion,4-0,4,0,1,1,4,4,H
1936-04-10,1935,Aston Villa,Wolverhampton Wanderers,4-2,4,2,1,1,6,2,H
1936-04-10,1935,Blackburn Rovers,Liverpool,2-2,2,2,1,1,4,0,D
1936-04-10,1935,Bolton Wanderers,Preston North End,1-1,1,1,1,1,2,0,D
1936-04-10,1935,Chelsea,Derby County,1-1,1,1,1,1,2,0,D
1936-04-10,1935,Everton,Brentford,1-2,1,2,1,1,3,-1,A
1936-04-10,1935,Grimsby Town,Stoke City,3-0,3,0,1,1,3,3,H
1936-04-10,1935,Manchester City,Leeds United,1-3,1,3,1,1,4,-2,A
1936-04-10,1935,Portsmouth,Huddersfield Town,0-0,0,0,1,1,0,0,D
1936-04-10,1935,Sunderland,Birmingham City,2-1,2,1,1,1,3,1,H
1936-04-11,1935,Aston Villa,Manchester City,2-2,2,2,1,1,4,0,D
1936-04-11,1935,Bolton Wanderers,Sunderland,2-1,2,1,1,1,3,1,H
1936-04-11,1935,Brentford,Grimsby Town,3-0,3,0,1,1,3,3,H
1936-04-11,1935,Derby County,Leeds United,2-1,2,1,1,1,3,1,H
1936-04-11,1935,Everton,West Bromwich Albion,5-3,5,3,1,1,8,2,H
1936-04-11,1935,Huddersfield Town,Birmingham City,1-0,1,0,1,1,1,1,H
1936-04-11,1935,Middlesbrough,Arsenal,2-2,2,2,1,1,4,0,D
1936-04-11,1935,Portsmouth,Chelsea,2-0,2,0,1,1,2,2,H
1936-04-11,1935,Preston North End,Liverpool,3-1,3,1,1,1,4,2,H
1936-04-11,1935,Sheffield Wednesday,Blackburn Rovers,0-0,0,0,1,1,0,0,D
1936-04-11,1935,Wolverhampton Wanderers,Stoke City,1-1,1,1,1,1,2,0,D
1936-04-13,1935,Birmingham City,Sunderland,2-7,2,7,1,1,9,-5,A
1936-04-13,1935,Brentford,Everton,4-1,4,1,1,1,5,3,H
1936-04-13,1935,Derby County,Chelsea,1-1,1,1,1,1,2,0,D
1936-04-13,1935,Leeds United,Manchester City,1-1,1,1,1,1,2,0,D
1936-04-13,1935,Liverpool,Blackburn Rovers,4-1,4,1,1,1,5,3,H
1936-04-13,1935,Middlesbrough,Sheffield Wednesday,5-0,5,0,1,1,5,5,H
1936-04-13,1935,Preston North End,Bolton Wanderers,1-0,1,0,1,1,1,1,H
1936-04-13,1935,Stoke City,Grimsby Town,1-0,1,0,1,1,1,1,H
1936-04-13,1935,West Bromwich Albion,Arsenal,1-0,1,0,1,1,1,1,H
1936-04-13,1935,Wolverhampton Wanderers,Aston Villa,2-2,2,2,1,1,4,0,D
1936-04-14,1935,Huddersfield Town,Portsmouth,1-1,1,1,1,1,2,0,D
1936-04-14,1935,Sheffield Wednesday,Middlesbrough,0-0,0,0,1,1,0,0,D
1936-04-18,1935,Arsenal,Aston Villa,1-0,1,0,1,1,1,1,H
1936-04-18,1935,Birmingham City,Middlesbrough,1-0,1,0,1,1,1,1,H
1936-04-18,1935,Blackburn Rovers,Portsmouth,3-1,3,1,1,1,4,2,H
1936-04-18,1935,Chelsea,Preston North End,5-2,5,2,1,1,7,3,H
1936-04-18,1935,Grimsby Town,Derby County,4-1,4,1,1,1,5,3,H
1936-04-18,1935,Leeds United,Everton,3-1,3,1,1,1,4,2,H
1936-04-18,1935,Liverpool,Brentford,0-0,0,0,1,1,0,0,D
1936-04-18,1935,Manchester City,Wolverhampton Wanderers,2-1,2,1,1,1,3,1,H
1936-04-18,1935,Stoke City,Sheffield Wednesday,0-3,0,3,1,1,3,-3,A
1936-04-18,1935,Sunderland,Huddersfield Town,4-3,4,3,1,1,7,1,H
1936-04-18,1935,West Bromwich Albion,Bolton Wanderers,2-2,2,2,1,1,4,0,D
1936-04-20,1935,Wolverhampton Wanderers,Preston North End,4-2,4,2,1,1,6,2,H
1936-04-22,1935,Birmingham City,Sheffield Wednesday,4-1,4,1,1,1,5,3,H
1936-04-22,1935,Chelsea,Portsmouth,1-0,1,0,1,1,1,1,H
1936-04-22,1935,Leeds United,Sunderland,3-0,3,0,1,1,3,3,H
1936-04-25,1935,Aston Villa,Blackburn Rovers,2-4,2,4,1,1,6,-2,A
1936-04-25,1935,Brentford,West Bromwich Albion,2-2,2,2,1,1,4,0,D
1936-04-25,1935,Derby County,Sunderland,4-0,4,0,1,1,4,4,H
1936-04-25,1935,Everton,Birmingham City,4-3,4,3,1,1,7,1,H
1936-04-25,1935,Huddersfield Town,Manchester City,1-1,1,1,1,1,2,0,D
1936-04-25,1935,Middlesbrough,Stoke City,0-0,0,0,1,1,0,0,D
1936-04-25,1935,Portsmouth,Grimsby Town,3-2,3,2,1,1,5,1,H
1936-04-25,1935,Preston North End,Leeds United,5-0,5,0,1,1,5,5,H
1936-04-25,1935,Sheffield Wednesday,Liverpool,0-0,0,0,1,1,0,0,D
1936-04-25,1935,Wolverhampton Wanderers,Chelsea,3-3,3,3,1,1,6,0,D
1936-04-27,1935,Arsenal,Chelsea,1-1,1,1,1,1,2,0,D
1936-04-29,1935,Bolton Wanderers,Arsenal,2-1,2,1,1,1,3,1,H
1936-05-02,1935,Arsenal,Leeds United,2-2,2,2,1,1,4,0,D
1936-05-02,1935,Birmingham City,West Bromwich Albion,1-3,1,3,1,1,4,-2,A
1936-05-02,1935,Brentford,Derby County,6-0,6,0,1,1,6,6,H
1936-05-02,1935,Chelsea,Blackburn Rovers,5-1,5,1,1,1,6,4,H
1936-05-02,1935,Everton,Preston North End,5-0,5,0,1,1,5,5,H
1936-05-02,1935,Grimsby Town,Manchester City,3-1,3,1,1,1,4,2,H
1936-05-02,1935,Huddersfield Town,Sheffield Wednesday,1-0,1,0,1,1,1,1,H
1936-05-02,1935,Portsmouth,Bolton Wanderers,2-1,2,1,1,1,3,1,H
1936-05-02,1935,Stoke City,Liverpool,2-1,2,1,1,1,3,1,H
1936-05-02,1935,Wolverhampton Wanderers,Middlesbrough,4-0,4,0,1,1,4,4,H
1936-08-29,1936,Arsenal,Everton,3-2,3,2,1,1,5,1,H
1936-08-29,1936,Birmingham City,Portsmouth,2-1,2,1,1,1,3,1,H
1936-08-29,1936,Brentford,Bolton Wanderers,2-2,2,2,1,1,4,0,D
1936-08-29,1936,Grimsby Town,Charlton Athletic,0-1,0,1,1,1,1,-1,A
1936-08-29,1936,Leeds United,Chelsea,2-3,2,3,1,1,5,-1,A
1936-08-29,1936,Liverpool,Stoke City,2-1,2,1,1,1,3,1,H
1936-08-29,1936,Manchester United,Wolverhampton Wanderers,1-1,1,1,1,1,2,0,D
1936-08-29,1936,Middlesbrough,Manchester City,2-0,2,0,1,1,2,2,H
1936-08-29,1936,Preston North End,Huddersfield Town,1-1,1,1,1,1,2,0,D
1936-08-29,1936,Sheffield Wednesday,Sunderland,2-0,2,0,1,1,2,2,H
1936-08-29,1936,West Bromwich Albion,Derby County,1-3,1,3,1,1,4,-2,A
1936-08-31,1936,Preston North End,Bolton Wanderers,1-2,1,2,1,1,3,-1,A
1936-08-31,1936,Stoke City,Charlton Athletic,1-1,1,1,1,1,2,0,D
1936-08-31,1936,Wolverhampton Wanderers,Middlesbrough,0-1,0,1,1,1,1,-1,A
1936-09-02,1936,Chelsea,Grimsby Town,3-2,3,2,1,1,5,1,H
1936-09-02,1936,Everton,Sheffield Wednesday,3-1,3,1,1,1,4,2,H
1936-09-02,1936,Huddersfield Town,Manchester United,3-1,3,1,1,1,4,2,H
1936-09-02,1936,Manchester City,Leeds United,4-0,4,0,1,1,4,4,H
1936-09-02,1936,Portsmouth,Liverpool,6-2,6,2,1,1,8,4,H
1936-09-02,1936,Sunderland,Derby County,3-2,3,2,1,1,5,1,H
1936-09-02,1936,West Bromwich Albion,Birmingham City,3-2,3,2,1,1,5,1,H
1936-09-03,1936,Brentford,Arsenal,2-0,2,0,1,1,2,2,H
1936-09-05,1936,Bolton Wanderers,Grimsby Town,1-2,1,2,1,1,3,-1,A
1936-09-05,1936,Charlton Athletic,Liverpool,1-1,1,1,1,1,2,0,D
1936-09-05,1936,Chelsea,Birmingham City,1-3,1,3,1,1,4,-2,A
1936-09-05,1936,Derby County,Manchester United,5-4,5,4,1,1,9,1,H
1936-09-05,1936,Everton,Brentford,3-0,3,0,1,1,3,3,H
1936-09-05,1936,Huddersfield Town,Arsenal,0-0,0,0,1,1,0,0,D
1936-09-05,1936,Manchester City,West Bromwich Albion,6-2,6,2,1,1,8,4,H
1936-09-05,1936,Portsmouth,Middlesbrough,2-1,2,1,1,1,3,1,H
1936-09-05,1936,Stoke City,Leeds United,2-1,2,1,1,1,3,1,H
1936-09-05,1936,Sunderland,Preston North End,3-0,3,0,1,1,3,3,H
1936-09-05,1936,Wolverhampton Wanderers,Sheffield Wednesday,4-3,4,3,1,1,7,1,H
1936-09-07,1936,Bolton Wanderers,Preston North End,0-0,0,0,1,1,0,0,D
1936-09-07,1936,Charlton Athletic,Stoke City,2-0,2,0,1,1,2,2,H
1936-09-08,1936,Grimsby Town,Chelsea,3-0,3,0,1,1,3,3,H
1936-09-09,1936,Arsenal,Brentford,1-1,1,1,1,1,2,0,D
1936-09-09,1936,Birmingham City,West Bromwich Albion,1-1,1,1,1,1,2,0,D
1936-09-09,1936,Derby County,Sunderland,3-0,3,0,1,1,3,3,H
1936-09-09,1936,Leeds United,Manchester City,1-1,1,1,1,1,2,0,D
1936-09-09,1936,Liverpool,Portsmouth,0-0,0,0,1,1,0,0,D
1936-09-09,1936,Manchester United,Huddersfield Town,3-1,3,1,1,1,4,2,H
1936-09-09,1936,Middlesbrough,Wolverhampton Wanderers,1-0,1,0,1,1,1,1,H
1936-09-10,1936,Sheffield Wednesday,Everton,6-4,6,4,1,1,10,2,H
1936-09-12,1936,Arsenal,Sunderland,4-1,4,1,1,1,5,3,H
1936-09-12,1936,Birmingham City,Stoke City,2-4,2,4,1,1,6,-2,A
1936-09-12,1936,Bolton Wanderers,Everton,1-2,1,2,1,1,3,-1,A
1936-09-12,1936,Brentford,Huddersfield Town,1-1,1,1,1,1,2,0,D
1936-09-12,1936,Leeds United,Charlton Athletic,2-0,2,0,1,1,2,2,H
1936-09-12,1936,Liverpool,Grimsby Town,7-1,7,1,1,1,8,6,H
1936-09-12,1936,Manchester United,Manchester City,3-2,3,2,1,1,5,1,H
1936-09-12,1936,Middlesbrough,Chelsea,2-0,2,0,1,1,2,2,H
1936-09-12,1936,Preston North End,Wolverhampton Wanderers,1-3,1,3,1,1,4,-2,A
1936-09-12,1936,Sheffield Wednesday,Derby County,2-3,2,3,1,1,5,-1,A
1936-09-12,1936,West Bromwich Albion,Portsmouth,3-1,3,1,1,1,4,2,H
1936-09-14,1936,Stoke City,Grimsby Town,2-0,2,0,1,1,2,2,H
1936-09-16,1936,Chelsea,Liverpool,2-0,2,0,1,1,2,2,H
1936-09-16,1936,Manchester City,Birmingham City,1-1,1,1,1,1,2,0,D
1936-09-16,1936,Portsmouth,Leeds United,3-0,3,0,1,1,3,3,H
1936-09-17,1936,Brentford,Charlton Athletic,4-2,4,2,1,1,6,2,H
1936-09-17,1936,Sheffield Wednesday,Huddersfield Town,2-2,2,2,1,1,4,0,D
1936-09-19,1936,Charlton Athletic,Birmingham City,2-2,2,2,1,1,4,0,D
1936-09-19,1936,Chelsea,West Bromwich Albion,3-0,3,0,1,1,3,3,H
1936-09-19,1936,Derby County,Preston North End,1-2,1,2,1,1,3,-1,A
1936-09-19,1936,Everton,Liverpool,2-0,2,0,1,1,2,2,H
1936-09-19,1936,Grimsby Town,Leeds United,4-1,4,1,1,1,5,3,H
1936-09-19,1936,Huddersfield Town,Bolton Wanderers,2-0,2,0,1,1,2,2,H
1936-09-19,1936,Manchester United,Sheffield Wednesday,1-1,1,1,1,1,2,0,D
1936-09-19,1936,Portsmouth,Manchester City,2-1,2,1,1,1,3,1,H
1936-09-19,1936,Stoke City,Middlesbrough,6-2,6,2,1,1,8,4,H
1936-09-19,1936,Sunderland,Brentford,4-1,4,1,1,1,5,3,H
1936-09-19,1936,Wolverhampton Wanderers,Arsenal,2-0,2,0,1,1,2,2,H
1936-09-23,1936,Derby County,Wolverhampton Wanderers,5-1,5,1,1,1,6,4,H
1936-09-26,1936,Arsenal,Derby County,2-2,2,2,1,1,4,0,D
1936-09-26,1936,Birmingham City,Grimsby Town,2-3,2,3,1,1,5,-1,A
1936-09-26,1936,Bolton Wanderers,Sunderland,1-1,1,1,1,1,2,0,D
1936-09-26,1936,Brentford,Wolverhampton Wanderers,3-2,3,2,1,1,5,1,H
1936-09-26,1936,Everton,Huddersfield Town,2-1,2,1,1,1,3,1,H
1936-09-26,1936,Leeds United,Liverpool,2-0,2,0,1,1,2,2,H
1936-09-26,1936,Manchester City,Chelsea,0-0,0,0,1,1,0,0,D
1936-09-26,1936,Middlesbrough,Charlton Athletic,1-1,1,1,1,1,2,0,D
1936-09-26,1936,Preston North End,Manchester United,3-1,3,1,1,1,4,2,H
1936-09-26,1936,Sheffield Wednesday,Portsmouth,0-0,0,0,1,1,0,0,D
1936-09-26,1936,West Bromwich Albion,Stoke City,2-2,2,2,1,1,4,0,D
1936-10-03,1936,Charlton Athletic,West Bromwich Albion,4-2,4,2,1,1,6,2,H
1936-10-03,1936,Chelsea,Portsmouth,1-1,1,1,1,1,2,0,D
1936-10-03,1936,Grimsby Town,Middlesbrough,5-1,5,1,1,1,6,4,H
1936-10-03,1936,Huddersfield Town,Leeds United,3-0,3,0,1,1,3,3,H
1936-10-03,1936,Liverpool,Birmingham City,2-0,2,0,1,1,2,2,H
1936-10-03,1936,Manchester United,Arsenal,2-0,2,0,1,1,2,2,H
1936-10-03,1936,Sheffield Wednesday,Preston North End,0-1,0,1,1,1,1,-1,A
1936-10-03,1936,Stoke City,Manchester City,2-2,2,2,1,1,4,0,D
1936-10-03,1936,Sunderland,Everton,3-1,3,1,1,1,4,2,H
1936-10-03,1936,Wolverhampton Wanderers,Bolton Wanderers,2-3,2,3,1,1,5,-1,A
1936-10-10,1936,Arsenal,Sheffield Wednesday,1-1,1,1,1,1,2,0,D
1936-10-10,1936,Birmingham City,Leeds United,2-1,2,1,1,1,3,1,H
1936-10-10,1936,Bolton Wanderers,Derby County,1-3,1,3,1,1,4,-2,A
1936-10-10,1936,Brentford,Manchester United,4-0,4,0,1,1,4,4,H
1936-10-10,1936,Everton,Wolverhampton Wanderers,1-0,1,0,1,1,1,1,H
1936-10-10,1936,Huddersfield Town,Sunderland,2-1,2,1,1,1,3,1,H
1936-10-10,1936,Manchester City,Charlton Athletic,1-1,1,1,1,1,2,0,D
1936-10-10,1936,Middlesbrough,Liverpool,3-3,3,3,1,1,6,0,D
1936-10-10,1936,Portsmouth,Stoke City,1-0,1,0,1,1,1,1,H
1936-10-10,1936,Preston North End,Chelsea,1-0,1,0,1,1,1,1,H
1936-10-10,1936,West Bromwich Albion,Grimsby Town,4-2,4,2,1,1,6,2,H
1936-10-17,1936,Birmingham City,Huddersfield Town,4-2,4,2,1,1,6,2,H
1936-10-17,1936,Charlton Athletic,Arsenal,0-2,0,2,1,1,2,-2,A
1936-10-17,1936,Chelsea,Sheffield Wednesday,1-1,1,1,1,1,2,0,D
1936-10-17,1936,Grimsby Town,Brentford,2-0,2,0,1,1,2,2,H
1936-10-17,1936,Leeds United,Everton,3-0,3,0,1,1,3,3,H
1936-10-17,1936,Liverpool,Bolton Wanderers,0-0,0,0,1,1,0,0,D
1936-10-17,1936,Manchester City,Derby County,3-2,3,2,1,1,5,1,H
1936-10-17,1936,Middlesbrough,Sunderland,5-5,5,5,1,1,10,0,D
1936-10-17,1936,Portsmouth,Manchester United,2-1,2,1,1,1,3,1,H
1936-10-17,1936,Stoke City,Preston North End,0-2,0,2,1,1,2,-2,A
1936-10-17,1936,West Bromwich Albion,Wolverhampton Wanderers,2-1,2,1,1,1,3,1,H
1936-10-23,1936,Derby County,Brentford,2-3,2,3,1,1,5,-1,A
1936-10-24,1936,Arsenal,Grimsby Town,0-0,0,0,1,1,0,0,D
1936-10-24,1936,Bolton Wanderers,Leeds United,2-1,2,1,1,1,3,1,H
1936-10-24,1936,Brentford,Liverpool,5-2,5,2,1,1,7,3,H
1936-10-24,1936,Derby County,Portsmouth,1-3,1,3,1,1,4,-2,A
1936-10-24,1936,Everton,Birmingham City,3-3,3,3,1,1,6,0,D
1936-10-24,1936,Huddersfield Town,Middlesbrough,2-0,2,0,1,1,2,2,H
1936-10-24,1936,Manchester United,Chelsea,0-0,0,0,1,1,0,0,D
1936-10-24,1936,Preston North End,Charlton Athletic,0-0,0,0,1,1,0,0,D
1936-10-24,1936,Sheffield Wednesday,Stoke City,0-0,0,0,1,1,0,0,D
1936-10-24,1936,Sunderland,West Bromwich Albion,1-0,1,0,1,1,1,1,H
1936-10-24,1936,Wolverhampton Wanderers,Manchester City,2-1,2,1,1,1,3,1,H
1936-10-31,1936,Birmingham City,Bolton Wanderers,1-1,1,1,1,1,2,0,D
1936-10-31,1936,Charlton Athletic,Sheffield Wednesday,1-0,1,0,1,1,1,1,H
1936-10-31,1936,Chelsea,Derby County,1-1,1,1,1,1,2,0,D
1936-10-31,1936,Grimsby Town,Preston North End,6-4,6,4,1,1,10,2,H
1936-10-31,1936,Leeds United,Brentford,3-1,3,1,1,1,4,2,H
1936-10-31,1936,Liverpool,Arsenal,2-1,2,1,1,1,3,1,H
1936-10-31,1936,Manchester City,Sunderland,2-4,2,4,1,1,6,-2,A
1936-10-31,1936,Middlesbrough,Everton,2-0,2,0,1,1,2,2,H
1936-10-31,1936,Portsmouth,Wolverhampton Wanderers,1-1,1,1,1,1,2,0,D
1936-10-31,1936,Stoke City,Manchester United,3-0,3,0,1,1,3,3,H
1936-10-31,1936,West Bromwich Albion,Huddersfield Town,2-1,2,1,1,1,3,1,H
1936-11-03,1936,West Bromwich Albion,Bolton Wanderers,0-2,0,2,1,1,2,-2,A
1936-11-07,1936,Arsenal,Leeds United,4-1,4,1,1,1,5,3,H
1936-11-07,1936,Bolton Wanderers,Middlesbrough,1-3,1,3,1,1,4,-2,A
1936-11-07,1936,Brentford,Birmingham City,2-1,2,1,1,1,3,1,H
1936-11-07,1936,Derby County,Stoke City,2-2,2,2,1,1,4,0,D
1936-11-07,1936,Everton,West Bromwich Albion,4-2,4,2,1,1,6,2,H
1936-11-07,1936,Huddersfield Town,Manchester City,1-1,1,1,1,1,2,0,D
1936-11-07,1936,Manchester United,Charlton Athletic,0-0,0,0,1,1,0,0,D
1936-11-07,1936,Preston North End,Liverpool,3-1,3,1,1,1,4,2,H
1936-11-07,1936,Sheffield Wednesday,Grimsby Town,2-1,2,1,1,1,3,1,H
1936-11-07,1936,Sunderland,Portsmouth,3-2,3,2,1,1,5,1,H
1936-11-07,1936,Wolverhampton Wanderers,Chelsea,1-2,1,2,1,1,3,-1,A
1936-11-14,1936,Birmingham City,Arsenal,1-3,1,3,1,1,4,-2,A
1936-11-14,1936,Charlton Athletic,Derby County,2-0,2,0,1,1,2,2,H
1936-11-14,1936,Chelsea,Sunderland,1-3,1,3,1,1,4,-2,A
1936-11-14,1936,Grimsby Town,Manchester United,6-2,6,2,1,1,8,4,H
1936-11-14,1936,Leeds United,Preston North End,1-0,1,0,1,1,1,1,H
1936-11-14,1936,Liverpool,Sheffield Wednesday,2-2,2,2,1,1,4,0,D
1936-11-14,1936,Manchester City,Everton,4-1,4,1,1,1,5,3,H
1936-11-14,1936,Middlesbrough,Brentford,3-0,3,0,1,1,3,3,H
1936-11-14,1936,Portsmouth,Huddersfield Town,1-0,1,0,1,1,1,1,H
1936-11-14,1936,Stoke City,Wolverhampton Wanderers,2-1,2,1,1,1,3,1,H
1936-11-21,1936,Arsenal,Middlesbrough,5-3,5,3,1,1,8,2,H
1936-11-21,1936,Bolton Wanderers,Manchester City,0-2,0,2,1,1,2,-2,A
1936-11-21,1936,Brentford,West Bromwich Albion,2-1,2,1,1,1,3,1,H
1936-11-21,1936,Derby County,Grimsby Town,3-1,3,1,1,1,4,2,H
1936-11-21,1936,Everton,Portsmouth,4-0,4,0,1,1,4,4,H
1936-11-21,1936,Huddersfield Town,Chelsea,4-2,4,2,1,1,6,2,H
1936-11-21,1936,Manchester United,Liverpool,2-5,2,5,1,1,7,-3,A
1936-11-21,1936,Preston North End,Birmingham City,2-2,2,2,1,1,4,0,D
1936-11-21,1936,Sheffield Wednesday,Leeds United,1-2,1,2,1,1,3,-1,A
1936-11-21,1936,Sunderland,Stoke City,3-0,3,0,1,1,3,3,H
1936-11-21,1936,Wolverhampton Wanderers,Charlton Athletic,6-1,6,1,1,1,7,5,H
1936-11-28,1936,Birmingham City,Sheffield Wednesday,1-1,1,1,1,1,2,0,D
1936-11-28,1936,Charlton Athletic,Sunderland,3-1,3,1,1,1,4,2,H
1936-11-28,1936,Chelsea,Everton,4-0,4,0,1,1,4,4,H
1936-11-28,1936,Grimsby Town,Wolverhampton Wanderers,1-1,1,1,1,1,2,0,D
1936-11-28,1936,Leeds United,Manchester United,2-1,2,1,1,1,3,1,H
1936-11-28,1936,Liverpool,Derby County,3-3,3,3,1,1,6,0,D
1936-11-28,1936,Middlesbrough,Preston North End,2-1,2,1,1,1,3,1,H
1936-11-28,1936,Portsmouth,Bolton Wanderers,1-1,1,1,1,1,2,0,D
1936-11-28,1936,Stoke City,Huddersfield Town,1-1,1,1,1,1,2,0,D
1936-11-28,1936,West Bromwich Albion,Arsenal,2-4,2,4,1,1,6,-2,A
1936-12-05,1936,Arsenal,Manchester City,1-3,1,3,1,1,4,-2,A
1936-12-05,1936,Bolton Wanderers,Chelsea,2-1,2,1,1,1,3,1,H
1936-12-05,1936,Brentford,Portsmouth,4-0,4,0,1,1,4,4,H
1936-12-05,1936,Derby County,Leeds United,5-3,5,3,1,1,8,2,H
1936-12-05,1936,Everton,Stoke City,1-1,1,1,1,1,2,0,D
1936-12-05,1936,Huddersfield Town,Charlton Athletic,1-2,1,2,1,1,3,-1,A
1936-12-05,1936,Manchester United,Birmingham City,1-2,1,2,1,1,3,-1,A
1936-12-05,1936,Preston North End,West Bromwich Albion,3-2,3,2,1,1,5,1,H
1936-12-05,1936,Sheffield Wednesday,Middlesbrough,1-0,1,0,1,1,1,1,H
1936-12-05,1936,Sunderland,Grimsby Town,5-1,5,1,1,1,6,4,H
1936-12-05,1936,Wolverhampton Wanderers,Liverpool,2-0,2,0,1,1,2,2,H
1936-12-12,1936,Birmingham City,Derby County,0-1,0,1,1,1,1,-1,A
1936-12-12,1936,Charlton Athletic,Everton,2-0,2,0,1,1,2,2,H
1936-12-12,1936,Chelsea,Brentford,2-1,2,1,1,1,3,1,H
1936-12-12,1936,Grimsby Town,Huddersfield Town,2-2,2,2,1,1,4,0,D
1936-12-12,1936,Liverpool,Sunderland,4-0,4,0,1,1,4,4,H
1936-12-12,1936,Manchester City,Preston North End,4-1,4,1,1,1,5,3,H
1936-12-12,1936,Middlesbrough,Manchester United,3-2,3,2,1,1,5,1,H
1936-12-12,1936,Portsmouth,Arsenal,1-5,1,5,1,1,6,-4,A
1936-12-12,1936,Stoke City,Bolton Wanderers,2-2,2,2,1,1,4,0,D
1936-12-19,1936,Arsenal,Chelsea,4-1,4,1,1,1,5,3,H
1936-12-19,1936,Bolton Wanderers,Charlton Athletic,2-1,2,1,1,1,3,1,H
1936-12-19,1936,Brentford,Stoke City,2-1,2,1,1,1,3,1,H
1936-12-19,1936,Derby County,Middlesbrough,0-2,0,2,1,1,2,-2,A
1936-12-19,1936,Everton,Grimsby Town,3-0,3,0,1,1,3,3,H
1936-12-19,1936,Huddersfield Town,Liverpool,4-0,4,0,1,1,4,4,H
1936-12-19,1936,Manchester United,West Bromwich Albion,2-2,2,2,1,1,4,0,D
1936-12-19,1936,Preston North End,Portsmouth,1-1,1,1,1,1,2,0,D
1936-12-19,1936,Sheffield Wednesday,Manchester City,5-1,5,1,1,1,6,4,H
1936-12-19,1936,Sunderland,Leeds United,2-1,2,1,1,1,3,1,H
1936-12-19,1936,Wolverhampton Wanderers,Birmingham City,2-1,2,1,1,1,3,1,H
1936-12-25,1936,Arsenal,Preston North End,4-1,4,1,1,1,5,3,H
1936-12-25,1936,Birmingham City,Sunderland,2-0,2,0,1,1,2,2,H
1936-12-25,1936,Brentford,Sheffield Wednesday,2-1,2,1,1,1,3,1,H
1936-12-25,1936,Charlton Athletic,Portsmouth,0-0,0,0,1,1,0,0,D
1936-12-25,1936,Everton,Derby County,7-0,7,0,1,1,7,7,H
1936-12-25,1936,Grimsby Town,Manchester City,5-3,5,3,1,1,8,2,H
1936-12-25,1936,Leeds United,Middlesbrough,5-0,5,0,1,1,5,5,H
1936-12-25,1936,Manchester United,Bolton Wanderers,1-0,1,0,1,1,1,1,H
1936-12-25,1936,Stoke City,Chelsea,2-0,2,0,1,1,2,2,H
1936-12-25,1936,West Bromwich Albion,Liverpool,3-1,3,1,1,1,4,2,H
1936-12-25,1936,Wolverhampton Wanderers,Huddersfield Town,3-1,3,1,1,1,4,2,H
1936-12-26,1936,Bolton Wanderers,Brentford,2-2,2,2,1,1,4,0,D
1936-12-26,1936,Charlton Athletic,Grimsby Town,1-0,1,0,1,1,1,1,H
1936-12-26,1936,Chelsea,Leeds United,2-1,2,1,1,1,3,1,H
1936-12-26,1936,Derby County,West Bromwich Albion,1-0,1,0,1,1,1,1,H
1936-12-26,1936,Everton,Arsenal,1-1,1,1,1,1,2,0,D
1936-12-26,1936,Huddersfield Town,Preston North End,4-2,4,2,1,1,6,2,H
1936-12-26,1936,Manchester City,Middlesbrough,2-1,2,1,1,1,3,1,H
1936-12-26,1936,Portsmouth,Birmingham City,2-1,2,1,1,1,3,1,H
1936-12-26,1936,Stoke City,Liverpool,1-1,1,1,1,1,2,0,D
1936-12-26,1936,Sunderland,Sheffield Wednesday,2-1,2,1,1,1,3,1,H
1936-12-26,1936,Wolverhampton Wanderers,Manchester United,3-1,3,1,1,1,4,2,H
1936-12-28,1936,Bolton Wanderers,Manchester United,0-4,0,4,1,1,4,-4,A
1936-12-28,1936,Chelsea,Stoke City,1-0,1,0,1,1,1,1,H
1936-12-28,1936,Derby County,Everton,3-1,3,1,1,1,4,2,H
1936-12-28,1936,Huddersfield Town,Wolverhampton Wanderers,4-0,4,0,1,1,4,4,H
1936-12-28,1936,Liverpool,West Bromwich Albion,1-2,1,2,1,1,3,-1,A
1936-12-28,1936,Manchester City,Grimsby Town,1-1,1,1,1,1,2,0,D
1936-12-28,1936,Middlesbrough,Leeds United,4-2,4,2,1,1,6,2,H
1936-12-28,1936,Portsmouth,Charlton Athletic,0-1,0,1,1,1,1,-1,A
1936-12-28,1936,Preston North End,Arsenal,1-3,1,3,1,1,4,-2,A
1936-12-28,1936,Sheffield Wednesday,Brentford,0-2,0,2,1,1,2,-2,A
1936-12-28,1936,Sunderland,Birmingham City,4-0,4,0,1,1,4,4,H
1937-01-01,1936,Bolton Wanderers,Arsenal,0-5,0,5,1,1,5,-5,A
1937-01-01,1936,Everton,Preston North End,2-2,2,2,1,1,4,0,D
1937-01-01,1936,Manchester United,Sunderland,2-1,2,1,1,1,3,1,H
1937-01-01,1936,Middlesbrough,West Bromwich Albion,4-1,4,1,1,1,5,3,H
1937-01-02,1936,Arsenal,Huddersfield Town,1-1,1,1,1,1,2,0,D
1937-01-02,1936,Birmingham City,Chelsea,0-0,0,0,1,1,0,0,D
1937-01-02,1936,Brentford,Everton,2-2,2,2,1,1,4,0,D
1937-01-02,1936,Grimsby Town,Bolton Wanderers,3-1,3,1,1,1,4,2,H
1937-01-02,1936,Leeds United,Stoke City,2-1,2,1,1,1,3,1,H
1937-01-02,1936,Liverpool,Charlton Athletic,1-2,1,2,1,1,3,-1,A
1937-01-02,1936,Manchester United,Derby County,2-2,2,2,1,1,4,0,D
1937-01-02,1936,Middlesbrough,Portsmouth,2-2,2,2,1,1,4,0,D
1937-01-02,1936,Preston North End,Sunderland,2-0,2,0,1,1,2,2,H
1937-01-02,1936,Sheffield Wednesday,Wolverhampton Wanderers,1-3,1,3,1,1,4,-2,A
1937-01-02,1936,West Bromwich Albion,Manchester City,2-2,2,2,1,1,4,0,D
1937-01-09,1936,Charlton Athletic,Leeds United,1-0,1,0,1,1,1,1,H
1937-01-09,1936,Chelsea,Middlesbrough,1-0,1,0,1,1,1,1,H
1937-01-09,1936,Derby County,Sheffield Wednesday,3-2,3,2,1,1,5,1,H
1937-01-09,1936,Everton,Bolton Wanderers,3-2,3,2,1,1,5,1,H
1937-01-09,1936,Grimsby Town,Liverpool,2-1,2,1,1,1,3,1,H
1937-01-09,1936,Huddersfield Town,Brentford,1-1,1,1,1,1,2,0,D
1937-01-09,1936,Manchester City,Manchester United,1-0,1,0,1,1,1,1,H
1937-01-09,1936,Portsmouth,West Bromwich Albion,5-3,5,3,1,1,8,2,H
1937-01-09,1936,Stoke City,Birmingham City,2-0,2,0,1,1,2,2,H
1937-01-09,1936,Sunderland,Arsenal,1-1,1,1,1,1,2,0,D
1937-01-09,1936,Wolverhampton Wanderers,Preston North End,5-0,5,0,1,1,5,5,H
1937-01-23,1936,Arsenal,Wolverhampton Wanderers,3-0,3,0,1,1,3,3,H
1937-01-23,1936,Birmingham City,Charlton Athletic,1-2,1,2,1,1,3,-1,A
1937-01-23,1936,Bolton Wanderers,Huddersfield Town,2-2,2,2,1,1,4,0,D
1937-01-23,1936,Brentford,Sunderland,3-3,3,3,1,1,6,0,D
1937-01-23,1936,Leeds United,Grimsby Town,2-0,2,0,1,1,2,2,H
1937-01-23,1936,Liverpool,Everton,3-2,3,2,1,1,5,1,H
1937-01-23,1936,Manchester City,Portsmouth,3-1,3,1,1,1,4,2,H
1937-01-23,1936,Middlesbrough,Stoke City,1-0,1,0,1,1,1,1,H
1937-01-23,1936,Preston North End,Derby County,5-2,5,2,1,1,7,3,H
1937-01-23,1936,Sheffield Wednesday,Manchester United,1-0,1,0,1,1,1,1,H
1937-01-23,1936,West Bromwich Albion,Chelsea,2-0,2,0,1,1,2,2,H
1937-01-30,1936,Charlton Athletic,Middlesbrough,2-2,2,2,1,1,4,0,D
1937-01-30,1936,Liverpool,Leeds United,3-0,3,0,1,1,3,3,H
1937-02-02,1936,Grimsby Town,Birmingham City,1-1,1,1,1,1,2,0,D
1937-02-03,1936,Chelsea,Manchester City,4-4,4,4,1,1,8,0,D
1937-02-03,1936,Derby County,Arsenal,5-4,5,4,1,1,9,1,H
1937-02-03,1936,Huddersfield Town,Everton,0-3,0,3,1,1,3,-3,A
1937-02-03,1936,Manchester United,Preston North End,1-1,1,1,1,1,2,0,D
1937-02-03,1936,Portsmouth,Sheffield Wednesday,1-0,1,0,1,1,1,1,H
1937-02-04,1936,Stoke City,West Bromwich Albion,10-3,10,3,1,1,13,7,H
1937-02-06,1936,Arsenal,Manchester United,1-1,1,1,1,1,2,0,D
1937-02-06,1936,Birmingham City,Liverpool,5-0,5,0,1,1,5,5,H
1937-02-06,1936,Bolton Wanderers,Wolverhampton Wanderers,1-2,1,2,1,1,3,-1,A
1937-02-06,1936,Brentford,Derby County,6-2,6,2,1,1,8,4,H
1937-02-06,1936,Everton,Sunderland,3-0,3,0,1,1,3,3,H
1937-02-06,1936,Leeds United,Huddersfield Town,2-1,2,1,1,1,3,1,H
1937-02-06,1936,Manchester City,Stoke City,2-1,2,1,1,1,3,1,H
1937-02-06,1936,Middlesbrough,Grimsby Town,0-0,0,0,1,1,0,0,D
1937-02-06,1936,Portsmouth,Chelsea,4-1,4,1,1,1,5,3,H
1937-02-06,1936,Preston North End,Sheffield Wednesday,1-1,1,1,1,1,2,0,D
1937-02-06,1936,West Bromwich Albion,Charlton Athletic,1-2,1,2,1,1,3,-1,A
1937-02-10,1936,Sunderland,Bolton Wanderers,3-0,3,0,1,1,3,3,H
1937-02-10,1936,Wolverhampton Wanderers,Brentford,4-0,4,0,1,1,4,4,H
1937-02-13,1936,Charlton Athletic,Manchester City,1-1,1,1,1,1,2,0,D
1937-02-13,1936,Chelsea,Preston North End,0-0,0,0,1,1,0,0,D
1937-02-13,1936,Derby County,Bolton Wanderers,3-0,3,0,1,1,3,3,H
1937-02-13,1936,Grimsby Town,West Bromwich Albion,2-3,2,3,1,1,5,-1,A
1937-02-13,1936,Leeds United,Birmingham City,0-2,0,2,1,1,2,-2,A
1937-02-13,1936,Liverpool,Middlesbrough,0-2,0,2,1,1,2,-2,A
1937-02-13,1936,Manchester United,Brentford,1-3,1,3,1,1,4,-2,A
1937-02-13,1936,Sheffield Wednesday,Arsenal,0-0,0,0,1,1,0,0,D
1937-02-13,1936,Stoke City,Portsmouth,2-4,2,4,1,1,6,-2,A
1937-02-13,1936,Sunderland,Huddersfield Town,3-2,3,2,1,1,5,1,H
1937-02-13,1936,Wolverhampton Wanderers,Everton,7-2,7,2,1,1,9,5,H
1937-02-20,1936,Huddersfield Town,Birmingham City,1-1,1,1,1,1,2,0,D
1937-02-20,1936,Manchester United,Portsmouth,0-1,0,1,1,1,1,-1,A
1937-02-20,1936,Sheffield Wednesday,Chelsea,1-1,1,1,1,1,2,0,D
1937-02-24,1936,Arsenal,Charlton Athletic,1-1,1,1,1,1,2,0,D
1937-02-24,1936,Bolton Wanderers,Liverpool,0-1,0,1,1,1,1,-1,A
1937-02-24,1936,Derby County,Manchester City,0-5,0,5,1,1,5,-5,A
1937-02-24,1936,Preston North End,Stoke City,0-1,0,1,1,1,1,-1,A
1937-02-24,1936,Sunderland,Middlesbrough,4-1,4,1,1,1,5,3,H
1937-02-27,1936,Birmingham City,Everton,2-0,2,0,1,1,2,2,H
1937-02-27,1936,Charlton Athletic,Preston North End,3-1,3,1,1,1,4,2,H
1937-02-27,1936,Chelsea,Manchester United,4-2,4,2,1,1,6,2,H
1937-02-27,1936,Grimsby Town,Arsenal,1-3,1,3,1,1,4,-2,A
1937-02-27,1936,Leeds United,Bolton Wanderers,2-2,2,2,1,1,4,0,D
1937-02-27,1936,Liverpool,Brentford,2-2,2,2,1,1,4,0,D
1937-02-27,1936,Manchester City,Wolverhampton Wanderers,4-1,4,1,1,1,5,3,H
1937-02-27,1936,Middlesbrough,Huddersfield Town,5-0,5,0,1,1,5,5,H
1937-02-27,1936,Portsmouth,Derby County,1-2,1,2,1,1,3,-1,A
1937-02-27,1936,West Bromwich Albion,Sunderland,6-4,6,4,1,1,10,2,H
1937-03-03,1936,Brentford,Grimsby Town,2-3,2,3,1,1,5,-1,A
1937-03-03,1936,Everton,Leeds United,7-1,7,1,1,1,8,6,H
1937-03-06,1936,Bolton Wanderers,Birmingham City,0-0,0,0,1,1,0,0,D
1937-03-06,1936,Brentford,Leeds United,4-1,4,1,1,1,5,3,H
1937-03-06,1936,Derby County,Chelsea,1-1,1,1,1,1,2,0,D
1937-03-06,1936,Everton,Middlesbrough,2-3,2,3,1,1,5,-1,A
1937-03-06,1936,Manchester United,Stoke City,2-1,2,1,1,1,3,1,H
1937-03-06,1936,Sheffield Wednesday,Charlton Athletic,3-1,3,1,1,1,4,2,H
1937-03-10,1936,Arsenal,Liverpool,1-0,1,0,1,1,1,1,H
1937-03-10,1936,Huddersfield Town,West Bromwich Albion,1-1,1,1,1,1,2,0,D
1937-03-10,1936,Preston North End,Grimsby Town,3-2,3,2,1,1,5,1,H
1937-03-13,1936,Birmingham City,Brentford,4-0,4,0,1,1,4,4,H
1937-03-13,1936,Charlton Athletic,Manchester United,3-0,3,0,1,1,3,3,H
1937-03-13,1936,Chelsea,Wolverhampton Wanderers,0-1,0,1,1,1,1,-1,A
1937-03-13,1936,Grimsby Town,Sheffield Wednesday,5-1,5,1,1,1,6,4,H
1937-03-13,1936,Leeds United,Arsenal,3-4,3,4,1,1,7,-1,A
1937-03-13,1936,Liverpool,Preston North End,1-1,1,1,1,1,2,0,D
1937-03-13,1936,Manchester City,Huddersfield Town,3-0,3,0,1,1,3,3,H
1937-03-13,1936,Middlesbrough,Bolton Wanderers,2-0,2,0,1,1,2,2,H
1937-03-13,1936,Portsmouth,Sunderland,3-2,3,2,1,1,5,1,H
1937-03-13,1936,Stoke City,Derby County,1-2,1,2,1,1,3,-1,A
1937-03-13,1936,West Bromwich Albion,Everton,2-1,2,1,1,1,3,1,H
1937-03-17,1936,Wolverhampton Wanderers,Portsmouth,1-1,1,1,1,1,2,0,D
1937-03-20,1936,Arsenal,Birmingham City,1-1,1,1,1,1,2,0,D
1937-03-20,1936,Bolton Wanderers,West Bromwich Albion,4-1,4,1,1,1,5,3,H
1937-03-20,1936,Brentford,Middlesbrough,4-1,4,1,1,1,5,3,H
1937-03-20,1936,Derby County,Charlton Athletic,5-0,5,0,1,1,5,5,H
1937-03-20,1936,Everton,Manchester City,1-1,1,1,1,1,2,0,D
1937-03-20,1936,Huddersfield Town,Portsmouth,1-2,1,2,1,1,3,-1,A
1937-03-20,1936,Manchester United,Grimsby Town,1-1,1,1,1,1,2,0,D
1937-03-20,1936,Preston North End,Leeds United,1-0,1,0,1,1,1,1,H
1937-03-20,1936,Sheffield Wednesday,Liverpool,1-2,1,2,1,1,3,-1,A
1937-03-20,1936,Sunderland,Chelsea,2-3,2,3,1,1,5,-1,A
1937-03-20,1936,Wolverhampton Wanderers,Stoke City,2-1,2,1,1,1,3,1,H
1937-03-22,1936,West Bromwich Albion,Preston North End,0-0,0,0,1,1,0,0,D
1937-03-26,1936,Arsenal,Stoke City,0-0,0,0,1,1,0,0,D
1937-03-26,1936,Bolton Wanderers,Sheffield Wednesday,1-0,1,0,1,1,1,1,H
1937-03-26,1936,Brentford,Preston North End,1-1,1,1,1,1,2,0,D
1937-03-26,1936,Chelsea,Charlton Athletic,3-0,3,0,1,1,3,3,H
1937-03-26,1936,Grimsby Town,Portsmouth,1-0,1,0,1,1,1,1,H
1937-03-26,1936,Liverpool,Manchester City,0-5,0,5,1,1,5,-5,A
1937-03-26,1936,Manchester United,Everton,2-1,2,1,1,1,3,1,H
1937-03-26,1936,Middlesbrough,Birmingham City,3-1,3,1,1,1,4,2,H
1937-03-26,1936,Sunderland,Wolverhampton Wanderers,6-2,6,2,1,1,8,4,H
1937-03-27,1936,Birmingham City,Preston North End,1-0,1,0,1,1,1,1,H
1937-03-27,1936,Charlton Athletic,Wolverhampton Wanderers,4-0,4,0,1,1,4,4,H
1937-03-27,1936,Chelsea,Huddersfield Town,0-0,0,0,1,1,0,0,D
1937-03-27,1936,Grimsby Town,Derby County,3-4,3,4,1,1,7,-1,A
1937-03-27,1936,Leeds United,Sheffield Wednesday,1-1,1,1,1,1,2,0,D
1937-03-27,1936,Liverpool,Manchester United,2-0,2,0,1,1,2,2,H
1937-03-27,1936,Manchester City,Bolton Wanderers,2-2,2,2,1,1,4,0,D
1937-03-27,1936,Middlesbrough,Arsenal,1-1,1,1,1,1,2,0,D
1937-03-27,1936,Portsmouth,Everton,2-2,2,2,1,1,4,0,D
1937-03-27,1936,Stoke City,Sunderland,5-3,5,3,1,1,8,2,H
1937-03-27,1936,West Bromwich Albion,Brentford,1-0,1,0,1,1,1,1,H
1937-03-29,1936,Birmingham City,Middlesbrough,0-0,0,0,1,1,0,0,D
1937-03-29,1936,Charlton Athletic,Chelsea,1-0,1,0,1,1,1,1,H
1937-03-29,1936,Derby County,Huddersfield Town,3-3,3,3,1,1,6,0,D
1937-03-29,1936,Everton,Manchester United,2-3,2,3,1,1,5,-1,A
1937-03-29,1936,Manchester City,Liverpool,5-1,5,1,1,1,6,4,H
1937-03-29,1936,Portsmouth,Grimsby Town,2-1,2,1,1,1,3,1,H
1937-03-29,1936,Preston North End,Brentford,1-1,1,1,1,1,2,0,D
1937-03-29,1936,Sheffield Wednesday,Bolton Wanderers,2-0,2,0,1,1,2,2,H
1937-03-29,1936,Stoke City,Arsenal,0-0,0,0,1,1,0,0,D
1937-03-29,1936,West Bromwich Albion,Leeds United,3-0,3,0,1,1,3,3,H
1937-03-29,1936,Wolverhampton Wanderers,Sunderland,1-1,1,1,1,1,2,0,D
1937-03-30,1936,Huddersfield Town,Derby County,2-0,2,0,1,1,2,2,H
1937-03-30,1936,Leeds United,West Bromwich Albion,3-1,3,1,1,1,4,2,H
1937-04-03,1936,Arsenal,West Bromwich Albion,2-0,2,0,1,1,2,2,H
1937-04-03,1936,Bolton Wanderers,Portsmouth,1-0,1,0,1,1,1,1,H
1937-04-03,1936,Brentford,Manchester City,2-6,2,6,1,1,8,-4,A
1937-04-03,1936,Derby County,Liverpool,4-1,4,1,1,1,5,3,H
1937-04-03,1936,Everton,Chelsea,0-0,0,0,1,1,0,0,D
1937-04-03,1936,Huddersfield Town,Stoke City,2-1,2,1,1,1,3,1,H
1937-04-03,1936,Manchester United,Leeds United,0-0,0,0,1,1,0,0,D
1937-04-03,1936,Preston North End,Middlesbrough,2-0,2,0,1,1,2,2,H
1937-04-03,1936,Sheffield Wednesday,Birmingham City,0-3,0,3,1,1,3,-3,A
1937-04-03,1936,Sunderland,Charlton Athletic,1-0,1,0,1,1,1,1,H
1937-04-03,1936,Wolverhampton Wanderers,Grimsby Town,5-2,5,2,1,1,7,3,H
1937-04-05,1936,Stoke City,Sheffield Wednesday,1-0,1,0,1,1,1,1,H
1937-04-07,1936,Manchester City,Brentford,2-1,2,1,1,1,3,1,H
1937-04-10,1936,Birmingham City,Manchester United,2-2,2,2,1,1,4,0,D
1937-04-10,1936,Charlton Athletic,Huddersfield Town,1-0,1,0,1,1,1,1,H
1937-04-10,1936,Chelsea,Bolton Wanderers,0-1,0,1,1,1,1,-1,A
1937-04-10,1936,Leeds United,Derby County,2-0,2,0,1,1,2,2,H
1937-04-10,1936,Liverpool,Wolverhampton Wanderers,1-0,1,0,1,1,1,1,H
1937-04-10,1936,Manchester City,Arsenal,2-0,2,0,1,1,2,2,H
1937-04-10,1936,Middlesbrough,Sheffield Wednesday,2-0,2,0,1,1,2,2,H
1937-04-10,1936,Portsmouth,Brentford,1-3,1,3,1,1,4,-2,A
1937-04-10,1936,Stoke City,Everton,2-1,2,1,1,1,3,1,H
1937-04-12,1936,Grimsby Town,Sunderland,6-0,6,0,1,1,6,6,H
1937-04-14,1936,Preston North End,Everton,1-0,1,0,1,1,1,1,H
1937-04-14,1936,Sunderland,Manchester City,1-3,1,3,1,1,4,-2,A
1937-04-14,1936,Wolverhampton Wanderers,West Bromwich Albion,5-2,5,2,1,1,7,3,H
1937-04-17,1936,Arsenal,Portsmouth,4-0,4,0,1,1,4,4,H
1937-04-17,1936,Bolton Wanderers,Stoke City,0-0,0,0,1,1,0,0,D
1937-04-17,1936,Brentford,Chelsea,1-0,1,0,1,1,1,1,H
1937-04-17,1936,Derby County,Birmingham City,3-1,3,1,1,1,4,2,H
1937-04-17,1936,Everton,Charlton Athletic,2-2,2,2,1,1,4,0,D
1937-04-17,1936,Huddersfield Town,Grimsby Town,0-3,0,3,1,1,3,-3,A
1937-04-17,1936,Manchester United,Middlesbrough,2-1,2,1,1,1,3,1,H
1937-04-17,1936,Preston North End,Manchester City,2-5,2,5,1,1,7,-3,A
1937-04-17,1936,Sheffield Wednesday,West Bromwich Albion,2-3,2,3,1,1,5,-1,A
1937-04-17,1936,Sunderland,Liverpool,4-2,4,2,1,1,6,2,H
1937-04-17,1936,Wolverhampton Wanderers,Leeds United,3-0,3,0,1,1,3,3,H
1937-04-21,1936,Leeds United,Wolverhampton Wanderers,0-1,0,1,1,1,1,-1,A
1937-04-21,1936,Sunderland,Manchester United,1-1,1,1,1,1,2,0,D
1937-04-21,1936,West Bromwich Albion,Sheffield Wednesday,2-3,2,3,1,1,5,-1,A
1937-04-24,1936,Birmingham City,Wolverhampton Wanderers,1-0,1,0,1,1,1,1,H
1937-04-24,1936,Charlton Athletic,Bolton Wanderers,1-0,1,0,1,1,1,1,H
1937-04-24,1936,Chelsea,Arsenal,2-0,2,0,1,1,2,2,H
1937-04-24,1936,Grimsby Town,Everton,1-0,1,0,1,1,1,1,H
1937-04-24,1936,Leeds United,Sunderland,3-0,3,0,1,1,3,3,H
1937-04-24,1936,Liverpool,Huddersfield Town,1-1,1,1,1,1,2,0,D
1937-04-24,1936,Manchester City,Sheffield Wednesday,4-1,4,1,1,1,5,3,H
1937-04-24,1936,Middlesbrough,Derby County,1-3,1,3,1,1,4,-2,A
1937-04-24,1936,Portsmouth,Preston North End,0-1,0,1,1,1,1,-1,A
1937-04-24,1936,Stoke City,Brentford,5-1,5,1,1,1,6,4,H
1937-04-24,1936,West Bromwich Albion,Manchester United,1-0,1,0,1,1,1,1,H
1937-05-01,1936,Arsenal,Bolton Wanderers,0-0,0,0,1,1,0,0,D
1937-05-01,1936,Birmingham City,Manchester City,2-2,2,2,1,1,4,0,D
1937-05-01,1936,Charlton Athletic,Brentford,2-1,2,1,1,1,3,1,H
1937-05-01,1936,Grimsby Town,Stoke City,1-3,1,3,1,1,4,-2,A
1937-05-01,1936,Huddersfield Town,Sheffield Wednesday,1-0,1,0,1,1,1,1,H
1937-05-01,1936,Leeds United,Portsmouth,3-1,3,1,1,1,4,2,H
1937-05-01,1936,Liverpool,Chelsea,1-1,1,1,1,1,2,0,D
1937-05-01,1936,West Bromwich Albion,Middlesbrough,3-1,3,1,1,1,4,2,H
1937-05-01,1936,Wolverhampton Wanderers,Derby County,3-1,3,1,1,1,4,2,H
1937-08-28,1937,Bolton Wanderers,Brentford,2-0,2,0,1,1,2,2,H
1937-08-28,1937,Charlton Athletic,Leeds United,1-1,1,1,1,1,2,0,D
1937-08-28,1937,Chelsea,Liverpool,6-1,6,1,1,1,7,5,H
1937-08-28,1937,Everton,Arsenal,1-4,1,4,1,1,5,-3,A
1937-08-28,1937,Huddersfield Town,Blackpool,3-1,3,1,1,1,4,2,H
1937-08-28,1937,Leicester City,Derby County,0-0,0,0,1,1,0,0,D
1937-08-28,1937,Portsmouth,West Bromwich Albion,2-3,2,3,1,1,5,-1,A
1937-08-28,1937,Preston North End,Grimsby Town,4-1,4,1,1,1,5,3,H
1937-08-28,1937,Stoke City,Birmingham City,2-2,2,2,1,1,4,0,D
1937-08-28,1937,Sunderland,Middlesbrough,3-1,3,1,1,1,4,2,H
1937-08-28,1937,Wolverhampton Wanderers,Manchester City,3-1,3,1,1,1,4,2,H
1937-08-30,1937,Blackpool,Bolton Wanderers,2-2,2,2,1,1,4,0,D
1937-08-30,1937,Leicester City,Sunderland,4-0,4,0,1,1,4,4,H
1937-08-30,1937,West Bromwich Albion,Stoke City,0-1,0,1,1,1,1,-1,A
1937-08-31,1937,Grimsby Town,Charlton Athletic,1-1,1,1,1,1,2,0,D
1937-09-01,1937,Arsenal,Huddersfield Town,3-1,3,1,1,1,4,2,H
1937-09-01,1937,Birmingham City,Middlesbrough,3-1,3,1,1,1,4,2,H
1937-09-01,1937,Brentford,Preston North End,2-1,2,1,1,1,3,1,H
1937-09-01,1937,Derby County,Wolverhampton Wanderers,1-2,1,2,1,1,3,-1,A
1937-09-01,1937,Leeds United,Chelsea,2-0,2,0,1,1,2,2,H
1937-09-01,1937,Liverpool,Portsmouth,3-2,3,2,1,1,5,1,H
1937-09-01,1937,Manchester City,Everton,2-0,2,0,1,1,2,2,H
1937-09-04,1937,Arsenal,Wolverhampton Wanderers,5-0,5,0,1,1,5,5,H
1937-09-04,1937,Birmingham City,Portsmouth,2-2,2,2,1,1,4,0,D
1937-09-04,1937,Blackpool,Everton,1-0,1,0,1,1,1,1,H
1937-09-04,1937,Brentford,Huddersfield Town,2-0,2,0,1,1,2,2,H
1937-09-04,1937,Derby County,Sunderland,2-2,2,2,1,1,4,0,D
1937-09-04,1937,Grimsby Town,Bolton Wanderers,0-1,0,1,1,1,1,-1,A
1937-09-04,1937,Leeds United,Preston North End,0-0,0,0,1,1,0,0,D
1937-09-04,1937,Liverpool,Charlton Athletic,1-2,1,2,1,1,3,-1,A
1937-09-04,1937,Manchester City,Leicester City,3-0,3,0,1,1,3,3,H
1937-09-04,1937,Middlesbrough,Stoke City,2-1,2,1,1,1,3,1,H
1937-09-04,1937,West Bromwich Albion,Chelsea,4-0,4,0,1,1,4,4,H
1937-09-06,1937,Bolton Wanderers,Blackpool,3-0,3,0,1,1,3,3,H
1937-09-06,1937,Charlton Athletic,Grimsby Town,0-0,0,0,1,1,0,0,D
1937-09-06,1937,Preston North End,Brentford,1-1,1,1,1,1,2,0,D
1937-09-06,1937,Stoke City,West Bromwich Albion,4-0,4,0,1,1,4,4,H
1937-09-06,1937,Wolverhampton Wanderers,Derby County,2-2,2,2,1,1,4,0,D
1937-09-08,1937,Chelsea,Leeds United,4-1,4,1,1,1,5,3,H
1937-09-08,1937,Everton,Manchester City,4-1,4,1,1,1,5,3,H
1937-09-08,1937,Huddersfield Town,Arsenal,2-1,2,1,1,1,3,1,H
1937-09-08,1937,Middlesbrough,Birmingham City,1-1,1,1,1,1,2,0,D
1937-09-08,1937,Portsmouth,Liverpool,1-1,1,1,1,1,2,0,D
1937-09-08,1937,Sunderland,Leicester City,1-0,1,0,1,1,1,1,H
1937-09-11,1937,Charlton Athletic,West Bromwich Albion,3-1,3,1,1,1,4,2,H
1937-09-11,1937,Chelsea,Birmingham City,2-0,2,0,1,1,2,2,H
1937-09-11,1937,Everton,Brentford,3-0,3,0,1,1,3,3,H
1937-09-11,1937,Grimsby Town,Leeds United,1-1,1,1,1,1,2,0,D
1937-09-11,1937,Huddersfield Town,Bolton Wanderers,1-0,1,0,1,1,1,1,H
1937-09-11,1937,Leicester City,Arsenal,1-1,1,1,1,1,2,0,D
1937-09-11,1937,Portsmouth,Middlesbrough,0-2,0,2,1,1,2,-2,A
1937-09-11,1937,Preston North End,Liverpool,4-1,4,1,1,1,5,3,H
1937-09-11,1937,Stoke City,Derby County,8-1,8,1,1,1,9,7,H
1937-09-11,1937,Sunderland,Manchester City,3-1,3,1,1,1,4,2,H
1937-09-11,1937,Wolverhampton Wanderers,Blackpool,1-0,1,0,1,1,1,1,H
1937-09-13,1937,Preston North End,Charlton Athletic,0-1,0,1,1,1,1,-1,A
1937-09-13,1937,West Bromwich Albion,Middlesbrough,3-1,3,1,1,1,4,2,H
1937-09-15,1937,Birmingham City,Leicester City,4-1,4,1,1,1,5,3,H
1937-09-15,1937,Bolton Wanderers,Arsenal,1-0,1,0,1,1,1,1,H
1937-09-15,1937,Chelsea,Grimsby Town,1-0,1,0,1,1,1,1,H
1937-09-15,1937,Derby County,Everton,2-1,2,1,1,1,3,1,H
1937-09-15,1937,Leeds United,Portsmouth,3-1,3,1,1,1,4,2,H
1937-09-15,1937,Liverpool,Stoke City,3-0,3,0,1,1,3,3,H
1937-09-15,1937,Manchester City,Huddersfield Town,3-2,3,2,1,1,5,1,H
1937-09-15,1937,Wolverhampton Wanderers,Sunderland,4-0,4,0,1,1,4,4,H
1937-09-16,1937,Brentford,Blackpool,2-4,2,4,1,1,6,-2,A
1937-09-18,1937,Arsenal,Sunderland,4-1,4,1,1,1,5,3,H
1937-09-18,1937,Birmingham City,Charlton Athletic,1-1,1,1,1,1,2,0,D
1937-09-18,1937,Blackpool,Leicester City,2-4,2,4,1,1,6,-2,A
1937-09-18,1937,Bolton Wanderers,Everton,1-2,1,2,1,1,3,-1,A
1937-09-18,1937,Brentford,Wolverhampton Wanderers,2-1,2,1,1,1,3,1,H
1937-09-18,1937,Leeds United,Huddersfield Town,2-1,2,1,1,1,3,1,H
1937-09-18,1937,Liverpool,Grimsby Town,2-1,2,1,1,1,3,1,H
1937-09-18,1937,Manchester City,Derby County,6-1,6,1,1,1,7,5,H
1937-09-18,1937,Middlesbrough,Chelsea,4-3,4,3,1,1,7,1,H
1937-09-18,1937,Stoke City,Portsmouth,3-1,3,1,1,1,4,2,H
1937-09-18,1937,West Bromwich Albion,Preston North End,1-1,1,1,1,1,2,0,D
1937-09-20,1937,Blackpool,Brentford,1-1,1,1,1,1,2,0,D
1937-09-25,1937,Charlton Athletic,Middlesbrough,1-0,1,0,1,1,1,1,H
1937-09-25,1937,Chelsea,Stoke City,2-1,2,1,1,1,3,1,H
1937-09-25,1937,Derby County,Arsenal,2-0,2,0,1,1,2,2,H
1937-09-25,1937,Everton,Huddersfield Town,1-2,1,2,1,1,3,-1,A
1937-09-25,1937,Grimsby Town,West Bromwich Albion,1-4,1,4,1,1,5,-3,A
1937-09-25,1937,Leeds United,Liverpool,2-0,2,0,1,1,2,2,H
1937-09-25,1937,Leicester City,Brentford,0-1,0,1,1,1,1,-1,A
1937-09-25,1937,Portsmouth,Manchester City,2-2,2,2,1,1,4,0,D
1937-09-25,1937,Preston North End,Birmingham City,2-1,2,1,1,1,3,1,H
1937-09-25,1937,Sunderland,Blackpool,2-1,2,1,1,1,3,1,H
1937-09-25,1937,Wolverhampton Wanderers,Bolton Wanderers,1-1,1,1,1,1,2,0,D
1937-10-02,1937,Arsenal,Manchester City,2-1,2,1,1,1,3,1,H
1937-10-02,1937,Birmingham City,Grimsby Town,2-2,2,2,1,1,4,0,D
1937-10-02,1937,Blackpool,Derby County,1-1,1,1,1,1,2,0,D
1937-10-02,1937,Bolton Wanderers,Leicester City,6-1,6,1,1,1,7,5,H
1937-10-02,1937,Brentford,Sunderland,4-0,4,0,1,1,4,4,H
1937-10-02,1937,Huddersfield Town,Wolverhampton Wanderers,1-0,1,0,1,1,1,1,H
1937-10-02,1937,Liverpool,Everton,1-2,1,2,1,1,3,-1,A
1937-10-02,1937,Middlesbrough,Preston North End,2-1,2,1,1,1,3,1,H
1937-10-02,1937,Portsmouth,Chelsea,2-4,2,4,1,1,6,-2,A
1937-10-02,1937,Stoke City,Charlton Athletic,2-0,2,0,1,1,2,2,H
1937-10-02,1937,West Bromwich Albion,Leeds United,2-1,2,1,1,1,3,1,H
1937-10-09,1937,Charlton Athletic,Portsmouth,5-1,5,1,1,1,6,4,H
1937-10-09,1937,Chelsea,Arsenal,2-2,2,2,1,1,4,0,D
1937-10-09,1937,Derby County,Brentford,1-3,1,3,1,1,4,-2,A
1937-10-09,1937,Grimsby Town,Middlesbrough,2-1,2,1,1,1,3,1,H
1937-10-09,1937,Leeds United,Birmingham City,1-0,1,0,1,1,1,1,H
1937-10-09,1937,Leicester City,Huddersfield Town,2-1,2,1,1,1,3,1,H
1937-10-09,1937,Liverpool,West Bromwich Albion,0-1,0,1,1,1,1,-1,A
1937-10-09,1937,Manchester City,Blackpool,2-1,2,1,1,1,3,1,H
1937-10-09,1937,Preston North End,Stoke City,2-1,2,1,1,1,3,1,H
1937-10-09,1937,Sunderland,Bolton Wanderers,3-1,3,1,1,1,4,2,H
1937-10-09,1937,Wolverhampton Wanderers,Everton,2-0,2,0,1,1,2,2,H
1937-10-16,1937,Arsenal,Portsmouth,1-1,1,1,1,1,2,0,D
1937-10-16,1937,Blackpool,Chelsea,0-2,0,2,1,1,2,-2,A
1937-10-16,1937,Bolton Wanderers,Preston North End,1-4,1,4,1,1,5,-3,A
1937-10-16,1937,Brentford,Charlton Athletic,5-2,5,2,1,1,7,3,H
1937-10-16,1937,Derby County,Middlesbrough,1-1,1,1,1,1,2,0,D
1937-10-16,1937,Everton,Leeds United,1-1,1,1,1,1,2,0,D
1937-10-16,1937,Huddersfield Town,Grimsby Town,1-2,1,2,1,1,3,-1,A
1937-10-16,1937,Leicester City,West Bromwich Albion,4-1,4,1,1,1,5,3,H
1937-10-16,1937,Manchester City,Stoke City,0-0,0,0,1,1,0,0,D
1937-10-16,1937,Sunderland,Birmingham City,1-0,1,0,1,1,1,1,H
1937-10-16,1937,Wolverhampton Wanderers,Liverpool,2-0,2,0,1,1,2,2,H
1937-10-23,1937,Birmingham City,Derby County,1-0,1,0,1,1,1,1,H
1937-10-23,1937,Charlton Athletic,Bolton Wanderers,1-1,1,1,1,1,2,0,D
1937-10-23,1937,Chelsea,Brentford,2-1,2,1,1,1,3,1,H
1937-10-23,1937,Grimsby Town,Everton,2-1,2,1,1,1,3,1,H
1937-10-23,1937,Leeds United,Wolverhampton Wanderers,1-2,1,2,1,1,3,-1,A
1937-10-23,1937,Liverpool,Leicester City,1-1,1,1,1,1,2,0,D
1937-10-23,1937,Middlesbrough,Manchester City,4-0,4,0,1,1,4,4,H
1937-10-23,1937,Portsmouth,Blackpool,1-2,1,2,1,1,3,-1,A
1937-10-23,1937,Preston North End,Huddersfield Town,1-1,1,1,1,1,2,0,D
1937-10-23,1937,Stoke City,Arsenal,1-1,1,1,1,1,2,0,D
1937-10-23,1937,West Bromwich Albion,Sunderland,1-6,1,6,1,1,7,-5,A
1937-10-30,1937,Arsenal,Middlesbrough,1-2,1,2,1,1,3,-1,A
1937-10-30,1937,Blackpool,Stoke City,0-1,0,1,1,1,1,-1,A
1937-10-30,1937,Bolton Wanderers,Chelsea,5-5,5,5,1,1,10,0,D
1937-10-30,1937,Brentford,Portsmouth,2-0,2,0,1,1,2,2,H
1937-10-30,1937,Derby County,West Bromwich Albion,5-3,5,3,1,1,8,2,H
1937-10-30,1937,Everton,Preston North End,3-5,3,5,1,1,8,-2,A
1937-10-30,1937,Huddersfield Town,Charlton Athletic,1-1,1,1,1,1,2,0,D
1937-10-30,1937,Leicester City,Leeds United,2-4,2,4,1,1,6,-2,A
1937-10-30,1937,Manchester City,Birmingham City,2-0,2,0,1,1,2,2,H
1937-10-30,1937,Sunderland,Liverpool,2-3,2,3,1,1,5,-1,A
1937-10-30,1937,Wolverhampton Wanderers,Grimsby Town,1-1,1,1,1,1,2,0,D
1937-11-06,1937,Birmingham City,Huddersfield Town,2-2,2,2,1,1,4,0,D
1937-11-06,1937,Charlton Athletic,Derby County,1-2,1,2,1,1,3,-1,A
1937-11-06,1937,Chelsea,Sunderland,0-0,0,0,1,1,0,0,D
1937-11-06,1937,Grimsby Town,Arsenal,2-1,2,1,1,1,3,1,H
1937-11-06,1937,Leeds United,Blackpool,1-1,1,1,1,1,2,0,D
1937-11-06,1937,Liverpool,Brentford,3-4,3,4,1,1,7,-1,A
1937-11-06,1937,Middlesbrough,Everton,1-2,1,2,1,1,3,-1,A
1937-11-06,1937,Portsmouth,Leicester City,1-1,1,1,1,1,2,0,D
1937-11-06,1937,Preston North End,Manchester City,2-2,2,2,1,1,4,0,D
1937-11-06,1937,Stoke City,Wolverhampton Wanderers,1-1,1,1,1,1,2,0,D
1937-11-06,1937,West Bromwich Albion,Bolton Wanderers,2-4,2,4,1,1,6,-2,A
1937-11-13,1937,Arsenal,West Bromwich Albion,1-1,1,1,1,1,2,0,D
1937-11-13,1937,Blackpool,Birmingham City,0-3,0,3,1,1,3,-3,A
1937-11-13,1937,Bolton Wanderers,Stoke City,1-0,1,0,1,1,1,1,H
1937-11-13,1937,Brentford,Middlesbrough,3-3,3,3,1,1,6,0,D
1937-11-13,1937,Derby County,Leeds United,2-2,2,2,1,1,4,0,D
1937-11-13,1937,Everton,Chelsea,4-1,4,1,1,1,5,3,H
1937-11-13,1937,Huddersfield Town,Portsmouth,2-0,2,0,1,1,2,2,H
1937-11-13,1937,Leicester City,Preston North End,1-0,1,0,1,1,1,1,H
1937-11-13,1937,Manchester City,Liverpool,1-3,1,3,1,1,4,-2,A
1937-11-13,1937,Sunderland,Grimsby Town,2-2,2,2,1,1,4,0,D
1937-11-13,1937,Wolverhampton Wanderers,Charlton Athletic,1-1,1,1,1,1,2,0,D
1937-11-20,1937,Birmingham City,Wolverhampton Wanderers,2-0,2,0,1,1,2,2,H
1937-11-20,1937,Charlton Athletic,Arsenal,0-3,0,3,1,1,3,-3,A
1937-11-20,1937,Chelsea,Manchester City,2-2,2,2,1,1,4,0,D
1937-11-20,1937,Grimsby Town,Brentford,0-1,0,1,1,1,1,-1,A
1937-11-20,1937,Leeds United,Bolton Wanderers,1-1,1,1,1,1,2,0,D
1937-11-20,1937,Liverpool,Huddersfield Town,0-1,0,1,1,1,1,-1,A
1937-11-20,1937,Middlesbrough,Leicester City,4-2,4,2,1,1,6,2,H
1937-11-20,1937,Portsmouth,Derby County,4-0,4,0,1,1,4,4,H
1937-11-20,1937,Preston North End,Blackpool,2-0,2,0,1,1,2,2,H
1937-11-20,1937,Stoke City,Sunderland,0-0,0,0,1,1,0,0,D
1937-11-20,1937,West Bromwich Albion,Everton,3-1,3,1,1,1,4,2,H
1937-11-27,1937,Arsenal,Leeds United,4-1,4,1,1,1,5,3,H
1937-11-27,1937,Blackpool,Liverpool,0-1,0,1,1,1,1,-1,A
1937-11-27,1937,Bolton Wanderers,Birmingham City,1-1,1,1,1,1,2,0,D
1937-11-27,1937,Brentford,West Bromwich Albion,0-2,0,2,1,1,2,-2,A
1937-11-27,1937,Derby County,Preston North End,1-1,1,1,1,1,2,0,D
1937-11-27,1937,Everton,Stoke City,3-0,3,0,1,1,3,3,H
1937-11-27,1937,Huddersfield Town,Middlesbrough,3-0,3,0,1,1,3,3,H
1937-11-27,1937,Leicester City,Chelsea,1-0,1,0,1,1,1,1,H
1937-11-27,1937,Manchester City,Grimsby Town,3-1,3,1,1,1,4,2,H
1937-11-27,1937,Sunderland,Charlton Athletic,1-1,1,1,1,1,2,0,D
1937-11-27,1937,Wolverhampton Wanderers,Portsmouth,5-0,5,0,1,1,5,5,H
1937-12-04,1937,Birmingham City,Arsenal,1-2,1,2,1,1,3,-1,A
1937-12-04,1937,Charlton Athletic,Everton,3-1,3,1,1,1,4,2,H
1937-12-04,1937,Chelsea,Huddersfield Town,3-1,3,1,1,1,4,2,H
1937-12-04,1937,Grimsby Town,Leicester City,2-1,2,1,1,1,3,1,H
1937-12-04,1937,Leeds United,Sunderland,4-3,4,3,1,1,7,1,H
1937-12-04,1937,Liverpool,Derby County,3-4,3,4,1,1,7,-1,A
1937-12-04,1937,Middlesbrough,Blackpool,2-2,2,2,1,1,4,0,D
1937-12-04,1937,Portsmouth,Bolton Wanderers,1-1,1,1,1,1,2,0,D
1937-12-04,1937,Preston North End,Wolverhampton Wanderers,2-0,2,0,1,1,2,2,H
1937-12-04,1937,Stoke City,Brentford,3-0,3,0,1,1,3,3,H
1937-12-11,1937,Arsenal,Preston North End,2-0,2,0,1,1,2,2,H
1937-12-11,1937,Blackpool,Grimsby Town,2-2,2,2,1,1,4,0,D
1937-12-11,1937,Bolton Wanderers,Liverpool,0-0,0,0,1,1,0,0,D
1937-12-11,1937,Brentford,Leeds United,1-1,1,1,1,1,2,0,D
1937-12-11,1937,Derby County,Chelsea,4-0,4,0,1,1,4,4,H
1937-12-11,1937,Everton,Birmingham City,1-1,1,1,1,1,2,0,D
1937-12-11,1937,Huddersfield Town,West Bromwich Albion,2-1,2,1,1,1,3,1,H
1937-12-11,1937,Leicester City,Stoke City,2-0,2,0,1,1,2,2,H
1937-12-11,1937,Sunderland,Portsmouth,0-2,0,2,1,1,2,-2,A
1937-12-18,1937,Birmingham City,Brentford,0-0,0,0,1,1,0,0,D
1937-12-18,1937,Charlton Athletic,Leicester City,2-0,2,0,1,1,2,2,H
1937-12-18,1937,Chelsea,Wolverhampton Wanderers,0-2,0,2,1,1,2,-2,A
1937-12-18,1937,Grimsby Town,Derby County,0-0,0,0,1,1,0,0,D
1937-12-18,1937,Leeds United,Manchester City,2-1,2,1,1,1,3,1,H
1937-12-18,1937,Liverpool,Arsenal,2-0,2,0,1,1,2,2,H
1937-12-18,1937,Middlesbrough,Bolton Wanderers,1-2,1,2,1,1,3,-1,A
1937-12-18,1937,Portsmouth,Everton,3-1,3,1,1,1,4,2,H
1937-12-18,1937,Preston North End,Sunderland,0-0,0,0,1,1,0,0,D
1937-12-18,1937,Stoke City,Huddersfield Town,0-1,0,1,1,1,1,-1,A
1937-12-18,1937,West Bromwich Albion,Blackpool,1-2,1,2,1,1,3,-1,A
1937-12-25,1937,Blackpool,Arsenal,2-1,2,1,1,1,3,1,H
1937-12-25,1937,Grimsby Town,Stoke City,1-5,1,5,1,1,6,-4,A
1937-12-25,1937,Leeds United,Middlesbrough,5-3,5,3,1,1,8,2,H
1937-12-25,1937,Leicester City,Everton,3-1,3,1,1,1,4,2,H
1937-12-25,1937,Manchester City,Brentford,0-2,0,2,1,1,2,-2,A
1937-12-25,1937,Portsmouth,Preston North End,3-2,3,2,1,1,5,1,H
1937-12-25,1937,Sunderland,Huddersfield Town,2-1,2,1,1,1,3,1,H
1937-12-27,1937,Arsenal,Blackpool,2-1,2,1,1,1,3,1,H
1937-12-27,1937,Birmingham City,Liverpool,2-2,2,2,1,1,4,0,D
1937-12-27,1937,Brentford,Manchester City,2-1,2,1,1,1,3,1,H
1937-12-27,1937,Charlton Athletic,Chelsea,3-1,3,1,1,1,4,2,H
1937-12-27,1937,Derby County,Bolton Wanderers,4-2,4,2,1,1,6,2,H
1937-12-27,1937,Everton,Leicester City,3-0,3,0,1,1,3,3,H
1937-12-27,1937,Huddersfield Town,Sunderland,1-1,1,1,1,1,2,0,D
1937-12-27,1937,Middlesbrough,Leeds United,2-0,2,0,1,1,2,2,H
1937-12-27,1937,Preston North End,Portsmouth,1-1,1,1,1,1,2,0,D
1937-12-27,1937,Stoke City,Grimsby Town,1-1,1,1,1,1,2,0,D
1937-12-27,1937,West Bromwich Albion,Wolverhampton Wanderers,2-2,2,2,1,1,4,0,D
1938-01-01,1937,Arsenal,Everton,2-1,2,1,1,1,3,1,H
1938-01-01,1937,Birmingham City,Stoke City,1-1,1,1,1,1,2,0,D
1938-01-01,1937,Blackpool,Huddersfield Town,4-0,4,0,1,1,4,4,H
1938-01-01,1937,Brentford,Bolton Wanderers,1-1,1,1,1,1,2,0,D
1938-01-01,1937,Derby County,Leicester City,0-1,0,1,1,1,1,-1,A
1938-01-01,1937,Grimsby Town,Preston North End,1-1,1,1,1,1,2,0,D
1938-01-01,1937,Leeds United,Charlton Athletic,2-2,2,2,1,1,4,0,D
1938-01-01,1937,Liverpool,Chelsea,2-2,2,2,1,1,4,0,D
1938-01-01,1937,Manchester City,Wolverhampton Wanderers,2-4,2,4,1,1,6,-2,A
1938-01-01,1937,Middlesbrough,Sunderland,2-1,2,1,1,1,3,1,H
1938-01-01,1937,West Bromwich Albion,Portsmouth,1-2,1,2,1,1,3,-1,A
1938-01-15,1937,Bolton Wanderers,Grimsby Town,3-1,3,1,1,1,4,2,H
1938-01-15,1937,Charlton Athletic,Liverpool,3-0,3,0,1,1,3,3,H
1938-01-15,1937,Chelsea,West Bromwich Albion,2-2,2,2,1,1,4,0,D
1938-01-15,1937,Everton,Blackpool,3-1,3,1,1,1,4,2,H
1938-01-15,1937,Huddersfield Town,Brentford,0-3,0,3,1,1,3,-3,A
1938-01-15,1937,Leicester City,Manchester City,1-4,1,4,1,1,5,-3,A
1938-01-15,1937,Portsmouth,Birmingham City,1-1,1,1,1,1,2,0,D
1938-01-15,1937,Preston North End,Leeds United,3-1,3,1,1,1,4,2,H
1938-01-15,1937,Stoke City,Middlesbrough,3-0,3,0,1,1,3,3,H
1938-01-15,1937,Sunderland,Derby County,2-0,2,0,1,1,2,2,H
1938-01-15,1937,Wolverhampton Wanderers,Arsenal,3-1,3,1,1,1,4,2,H
1938-01-22,1937,Birmingham City,Chelsea,1-1,1,1,1,1,2,0,D
1938-01-22,1937,Bolton Wanderers,Derby County,0-2,0,2,1,1,2,-2,A
1938-01-26,1937,Blackpool,Wolverhampton Wanderers,0-2,0,2,1,1,2,-2,A
1938-01-26,1937,Bolton Wanderers,Huddersfield Town,2-0,2,0,1,1,2,2,H
1938-01-26,1937,Brentford,Everton,3-0,3,0,1,1,3,3,H
1938-01-26,1937,Leeds United,Grimsby Town,1-1,1,1,1,1,2,0,D
1938-01-26,1937,Middlesbrough,Portsmouth,0-0,0,0,1,1,0,0,D
1938-01-26,1937,West Bromwich Albion,Charlton Athletic,0-0,0,0,1,1,0,0,D
1938-01-29,1937,Charlton Athletic,Birmingham City,2-0,2,0,1,1,2,2,H
1938-01-29,1937,Chelsea,Middlesbrough,0-1,0,1,1,1,1,-1,A
1938-01-29,1937,Derby County,Manchester City,1-7,1,7,1,1,8,-6,A
1938-01-29,1937,Everton,Bolton Wanderers,4-1,4,1,1,1,5,3,H
1938-01-29,1937,Grimsby Town,Liverpool,0-0,0,0,1,1,0,0,D
1938-01-29,1937,Huddersfield Town,Leeds United,0-3,0,3,1,1,3,-3,A
1938-01-29,1937,Leicester City,Blackpool,0-1,0,1,1,1,1,-1,A
1938-01-29,1937,Portsmouth,Stoke City,2-0,2,0,1,1,2,2,H
1938-01-29,1937,Preston North End,West Bromwich Albion,1-1,1,1,1,1,2,0,D
1938-01-29,1937,Sunderland,Arsenal,1-1,1,1,1,1,2,0,D
1938-01-29,1937,Wolverhampton Wanderers,Brentford,2-1,2,1,1,1,3,1,H
1938-02-02,1937,Arsenal,Leicester City,3-1,3,1,1,1,4,2,H
1938-02-02,1937,Derby County,Stoke City,4-1,4,1,1,1,5,3,H
1938-02-02,1937,Liverpool,Preston North End,2-2,2,2,1,1,4,0,D
1938-02-02,1937,Manchester City,Sunderland,0-0,0,0,1,1,0,0,D
1938-02-05,1937,Arsenal,Derby County,3-0,3,0,1,1,3,3,H
1938-02-05,1937,Birmingham City,Preston North End,0-2,0,2,1,1,2,-2,A
1938-02-05,1937,Blackpool,Sunderland,0-0,0,0,1,1,0,0,D
1938-02-05,1937,Bolton Wanderers,Wolverhampton Wanderers,1-2,1,2,1,1,3,-1,A
1938-02-05,1937,Brentford,Leicester City,1-1,1,1,1,1,2,0,D
1938-02-05,1937,Huddersfield Town,Everton,1-3,1,3,1,1,4,-2,A
1938-02-05,1937,Liverpool,Leeds United,1-1,1,1,1,1,2,0,D
1938-02-05,1937,Manchester City,Portsmouth,2-1,2,1,1,1,3,1,H
1938-02-05,1937,Middlesbrough,Charlton Athletic,3-1,3,1,1,1,4,2,H
1938-02-05,1937,Stoke City,Chelsea,2-1,2,1,1,1,3,1,H
1938-02-05,1937,West Bromwich Albion,Grimsby Town,2-1,2,1,1,1,3,1,H
1938-02-12,1937,Chelsea,Portsmouth,3-1,3,1,1,1,4,2,H
1938-02-12,1937,Derby County,Blackpool,3-1,3,1,1,1,4,2,H
1938-02-12,1937,Grimsby Town,Birmingham City,4-0,4,0,1,1,4,4,H
1938-02-12,1937,Leeds United,West Bromwich Albion,1-0,1,0,1,1,1,1,H
1938-02-12,1937,Leicester City,Bolton Wanderers,1-1,1,1,1,1,2,0,D
1938-02-16,1937,Everton,Liverpool,1-3,1,3,1,1,4,-2,A
1938-02-16,1937,Manchester City,Arsenal,1-2,1,2,1,1,3,-1,A
1938-02-16,1937,Preston North End,Middlesbrough,0-2,0,2,1,1,2,-2,A
1938-02-16,1937,Sunderland,Brentford,1-0,1,0,1,1,1,1,H
1938-02-16,1937,Wolverhampton Wanderers,Huddersfield Town,1-4,1,4,1,1,5,-3,A
1938-02-19,1937,Arsenal,Chelsea,2-0,2,0,1,1,2,2,H
1938-02-19,1937,Birmingham City,Leeds United,3-2,3,2,1,1,5,1,H
1938-02-19,1937,Blackpool,Manchester City,2-1,2,1,1,1,3,1,H
1938-02-19,1937,Bolton Wanderers,Sunderland,1-1,1,1,1,1,2,0,D
1938-02-19,1937,Brentford,Derby County,2-3,2,3,1,1,5,-1,A
1938-02-19,1937,Everton,Wolverhampton Wanderers,0-1,0,1,1,1,1,-1,A
1938-02-19,1937,Huddersfield Town,Leicester City,0-0,0,0,1,1,0,0,D
1938-02-19,1937,Middlesbrough,Grimsby Town,1-0,1,0,1,1,1,1,H
1938-02-19,1937,Portsmouth,Charlton Athletic,2-1,2,1,1,1,3,1,H
1938-02-19,1937,Stoke City,Preston North End,1-1,1,1,1,1,2,0,D
1938-02-19,1937,West Bromwich Albion,Liverpool,5-1,5,1,1,1,6,4,H
1938-02-26,1937,Birmingham City,Sunderland,2-2,2,2,1,1,4,0,D
1938-02-26,1937,Charlton Athletic,Brentford,1-0,1,0,1,1,1,1,H
1938-02-26,1937,Chelsea,Blackpool,1-3,1,3,1,1,4,-2,A
1938-02-26,1937,Grimsby Town,Huddersfield Town,4-2,4,2,1,1,6,2,H
1938-02-26,1937,Leeds United,Everton,4-4,4,4,1,1,8,0,D
1938-02-26,1937,Liverpool,Wolverhampton Wanderers,0-1,0,1,1,1,1,-1,A
1938-02-26,1937,Middlesbrough,Derby County,4-2,4,2,1,1,6,2,H
1938-02-26,1937,Portsmouth,Arsenal,0-0,0,0,1,1,0,0,D
1938-02-26,1937,Preston North End,Bolton Wanderers,2-2,2,2,1,1,4,0,D
1938-02-26,1937,Stoke City,Manchester City,3-2,3,2,1,1,5,1,H
1938-02-26,1937,West Bromwich Albion,Leicester City,1-3,1,3,1,1,4,-2,A
1938-03-02,1937,Charlton Athletic,Stoke City,3-0,3,0,1,1,3,3,H
1938-03-05,1937,Arsenal,Stoke City,4-0,4,0,1,1,4,4,H
1938-03-05,1937,Blackpool,Portsmouth,2-0,2,0,1,1,2,2,H
1938-03-05,1937,Bolton Wanderers,Charlton Athletic,1-0,1,0,1,1,1,1,H
1938-03-05,1937,Derby County,Birmingham City,0-0,0,0,1,1,0,0,D
1938-03-05,1937,Everton,Grimsby Town,3-2,3,2,1,1,5,1,H
1938-03-05,1937,Leicester City,Liverpool,2-2,2,2,1,1,4,0,D
1938-03-05,1937,Wolverhampton Wanderers,Leeds United,1-1,1,1,1,1,2,0,D
1938-03-09,1937,Brentford,Chelsea,1-1,1,1,1,1,2,0,D
1938-03-09,1937,Manchester City,Middlesbrough,1-6,1,6,1,1,7,-5,A
1938-03-09,1937,Preston North End,Leicester City,0-0,0,0,1,1,0,0,D
1938-03-09,1937,Sunderland,West Bromwich Albion,3-0,3,0,1,1,3,3,H
1938-03-12,1937,Birmingham City,Manchester City,2-2,2,2,1,1,4,0,D
1938-03-12,1937,Charlton Athletic,Huddersfield Town,4-0,4,0,1,1,4,4,H
1938-03-12,1937,Chelsea,Bolton Wanderers,0-0,0,0,1,1,0,0,D
1938-03-12,1937,Grimsby Town,Wolverhampton Wanderers,1-0,1,0,1,1,1,1,H
1938-03-12,1937,Leeds United,Leicester City,0-2,0,2,1,1,2,-2,A
1938-03-12,1937,Liverpool,Sunderland,4-0,4,0,1,1,4,4,H
1938-03-12,1937,Middlesbrough,Arsenal,2-1,2,1,1,1,3,1,H
1938-03-12,1937,Portsmouth,Brentford,4-1,4,1,1,1,5,3,H
1938-03-12,1937,Preston North End,Everton,2-1,2,1,1,1,3,1,H
1938-03-12,1937,Stoke City,Blackpool,1-3,1,3,1,1,4,-2,A
1938-03-12,1937,West Bromwich Albion,Derby County,4-2,4,2,1,1,6,2,H
1938-03-16,1937,Huddersfield Town,Preston North End,1-3,1,3,1,1,4,-2,A
1938-03-16,1937,West Bromwich Albion,Manchester City,1-1,1,1,1,1,2,0,D
1938-03-19,1937,Arsenal,Grimsby Town,5-1,5,1,1,1,6,4,H
1938-03-19,1937,Blackpool,Leeds United,5-2,5,2,1,1,7,3,H
1938-03-19,1937,Bolton Wanderers,West Bromwich Albion,3-0,3,0,1,1,3,3,H
1938-03-19,1937,Brentford,Liverpool,1-3,1,3,1,1,4,-2,A
1938-03-19,1937,Derby County,Charlton Athletic,3-2,3,2,1,1,5,1,H
1938-03-19,1937,Everton,Middlesbrough,2-2,2,2,1,1,4,0,D
1938-03-19,1937,Huddersfield Town,Birmingham City,2-1,2,1,1,1,3,1,H
1938-03-19,1937,Leicester City,Portsmouth,3-3,3,3,1,1,6,0,D
1938-03-19,1937,Manchester City,Preston North End,1-2,1,2,1,1,3,-1,A
1938-03-19,1937,Sunderland,Chelsea,1-1,1,1,1,1,2,0,D
1938-03-19,1937,Wolverhampton Wanderers,Stoke City,2-2,2,2,1,1,4,0,D
1938-03-23,1937,Wolverhampton Wanderers,Middlesbrough,0-1,0,1,1,1,1,-1,A
1938-03-26,1937,Birmingham City,Blackpool,1-1,1,1,1,1,2,0,D
1938-03-26,1937,Charlton Athletic,Wolverhampton Wanderers,4-1,4,1,1,1,5,3,H
1938-03-26,1937,Chelsea,Everton,2-0,2,0,1,1,2,2,H
1938-03-26,1937,Leeds United,Derby County,0-2,0,2,1,1,2,-2,A
1938-03-26,1937,Liverpool,Manchester City,2-0,2,0,1,1,2,2,H
1938-03-26,1937,Middlesbrough,Brentford,0-1,0,1,1,1,1,-1,A
1938-03-26,1937,Stoke City,Bolton Wanderers,3-2,3,2,1,1,5,1,H
1938-03-26,1937,West Bromwich Albion,Arsenal,0-0,0,0,1,1,0,0,D
1938-03-29,1937,Grimsby Town,Sunderland,0-2,0,2,1,1,2,-2,A
1938-03-30,1937,Portsmouth,Huddersfield Town,3-0,3,0,1,1,3,3,H
1938-04-02,1937,Arsenal,Charlton Athletic,2-2,2,2,1,1,4,0,D
1938-04-02,1937,Blackpool,Preston North End,1-0,1,0,1,1,1,1,H
1938-04-02,1937,Bolton Wanderers,Leeds United,0-0,0,0,1,1,0,0,D
1938-04-02,1937,Brentford,Grimsby Town,6-1,6,1,1,1,7,5,H
1938-04-02,1937,Derby County,Portsmouth,1-0,1,0,1,1,1,1,H
1938-04-02,1937,Everton,West Bromwich Albion,5-3,5,3,1,1,8,2,H
1938-04-02,1937,Huddersfield Town,Liverpool,1-2,1,2,1,1,3,-1,A
1938-04-02,1937,Leicester City,Middlesbrough,0-1,0,1,1,1,1,-1,A
1938-04-02,1937,Manchester City,Chelsea,1-0,1,0,1,1,1,1,H
1938-04-02,1937,Sunderland,Stoke City,1-1,1,1,1,1,2,0,D
1938-04-02,1937,Wolverhampton Wanderers,Birmingham City,3-2,3,2,1,1,5,1,H
1938-04-06,1937,Liverpool,Birmingham City,3-2,3,2,1,1,5,1,H
1938-04-06,1937,Manchester City,Charlton Athletic,5-3,5,3,1,1,8,2,H
1938-04-09,1937,Birmingham City,Bolton Wanderers,2-0,2,0,1,1,2,2,H
1938-04-09,1937,Charlton Athletic,Sunderland,2-1,2,1,1,1,3,1,H
1938-04-09,1937,Chelsea,Leicester City,4-1,4,1,1,1,5,3,H
1938-04-09,1937,Grimsby Town,Manchester City,3-1,3,1,1,1,4,2,H
1938-04-09,1937,Leeds United,Arsenal,0-1,0,1,1,1,1,-1,A
1938-04-09,1937,Liverpool,Blackpool,4-2,4,2,1,1,6,2,H
1938-04-09,1937,Middlesbrough,Huddersfield Town,0-1,0,1,1,1,1,-1,A
1938-04-09,1937,Portsmouth,Wolverhampton Wanderers,1-0,1,0,1,1,1,1,H
1938-04-09,1937,Preston North End,Derby County,4-1,4,1,1,1,5,3,H
1938-04-09,1937,Stoke City,Everton,1-1,1,1,1,1,2,0,D
1938-04-09,1937,West Bromwich Albion,Brentford,4-3,4,3,1,1,7,1,H
1938-04-15,1937,Arsenal,Brentford,0-2,0,2,1,1,2,-2,A
1938-04-15,1937,Birmingham City,West Bromwich Albion,2-1,2,1,1,1,3,1,H
1938-04-15,1937,Blackpool,Charlton Athletic,1-0,1,0,1,1,1,1,H
1938-04-15,1937,Chelsea,Preston North End,0-2,0,2,1,1,2,-2,A
1938-04-15,1937,Everton,Sunderland,3-3,3,3,1,1,6,0,D
1938-04-15,1937,Grimsby Town,Portsmouth,1-0,1,0,1,1,1,1,H
1938-04-15,1937,Manchester City,Bolton Wanderers,1-2,1,2,1,1,3,-1,A
1938-04-15,1937,Middlesbrough,Liverpool,1-1,1,1,1,1,2,0,D
1938-04-15,1937,Wolverhampton Wanderers,Leicester City,10-1,10,1,1,1,11,9,H
1938-04-16,1937,Arsenal,Birmingham City,0-0,0,0,1,1,0,0,D
1938-04-16,1937,Blackpool,Middlesbrough,4-2,4,2,1,1,6,2,H
1938-04-16,1937,Bolton Wanderers,Portsmouth,1-1,1,1,1,1,2,0,D
1938-04-16,1937,Brentford,Stoke City,0-0,0,0,1,1,0,0,D
1938-04-16,1937,Derby County,Liverpool,4-1,4,1,1,1,5,3,H
1938-04-16,1937,Everton,Charlton Athletic,3-0,3,0,1,1,3,3,H
1938-04-16,1937,Huddersfield Town,Chelsea,1-2,1,2,1,1,3,-1,A
1938-04-16,1937,Leicester City,Grimsby Town,1-0,1,0,1,1,1,1,H
1938-04-16,1937,Manchester City,West Bromwich Albion,7-1,7,1,1,1,8,6,H
1938-04-16,1937,Sunderland,Leeds United,0-0,0,0,1,1,0,0,D
1938-04-16,1937,Wolverhampton Wanderers,Preston North End,0-0,0,0,1,1,0,0,D
1938-04-18,1937,Bolton Wanderers,Manchester City,2-1,2,1,1,1,3,1,H
1938-04-18,1937,Brentford,Arsenal,3-0,3,0,1,1,3,3,H
1938-04-18,1937,Charlton Athletic,Blackpool,4-1,4,1,1,1,5,3,H
1938-04-18,1937,Derby County,Huddersfield Town,0-4,0,4,1,1,4,-4,A
1938-04-18,1937,Leicester City,Wolverhampton Wanderers,1-1,1,1,1,1,2,0,D
1938-04-18,1937,Liverpool,Middlesbrough,1-1,1,1,1,1,2,0,D
1938-04-18,1937,Portsmouth,Grimsby Town,3-0,3,0,1,1,3,3,H
1938-04-18,1937,Preston North End,Chelsea,0-0,0,0,1,1,0,0,D
1938-04-18,1937,Stoke City,Leeds United,0-1,0,1,1,1,1,-1,A
1938-04-18,1937,Sunderland,Everton,2-0,2,0,1,1,2,2,H
1938-04-18,1937,West Bromwich Albion,Birmingham City,4-3,4,3,1,1,7,1,H
1938-04-19,1937,Huddersfield Town,Derby County,2-0,2,0,1,1,2,2,H
1938-04-19,1937,Leeds United,Stoke City,2-1,2,1,1,1,3,1,H
1938-04-23,1937,Birmingham City,Everton,0-3,0,3,1,1,3,-3,A
1938-04-23,1937,Charlton Athletic,Manchester City,0-0,0,0,1,1,0,0,D
1938-04-23,1937,Chelsea,Derby County,3-0,3,0,1,1,3,3,H
1938-04-23,1937,Grimsby Town,Blackpool,1-0,1,0,1,1,1,1,H
1938-04-23,1937,Leeds United,Brentford,4-0,4,0,1,1,4,4,H
1938-04-23,1937,Liverpool,Bolton Wanderers,2-1,2,1,1,1,3,1,H
1938-04-23,1937,Middlesbrough,Wolverhampton Wanderers,0-3,0,3,1,1,3,-3,A
1938-04-23,1937,Portsmouth,Sunderland,1-0,1,0,1,1,1,1,H
1938-04-23,1937,Preston North End,Arsenal,1-3,1,3,1,1,4,-2,A
1938-04-23,1937,Stoke City,Leicester City,1-2,1,2,1,1,3,-1,A
1938-04-23,1937,West Bromwich Albion,Huddersfield Town,5-1,5,1,1,1,6,4,H
1938-04-27,1937,Chelsea,Charlton Athletic,1-1,1,1,1,1,2,0,D
1938-04-30,1937,Arsenal,Liverpool,1-0,1,0,1,1,1,1,H
1938-04-30,1937,Blackpool,West Bromwich Albion,3-1,3,1,1,1,4,2,H
1938-04-30,1937,Bolton Wanderers,Middlesbrough,3-1,3,1,1,1,4,2,H
1938-04-30,1937,Brentford,Birmingham City,1-2,1,2,1,1,3,-1,A
1938-04-30,1937,Derby County,Grimsby Town,1-2,1,2,1,1,3,-1,A
1938-04-30,1937,Everton,Portsmouth,5-2,5,2,1,1,7,3,H
1938-04-30,1937,Leicester City,Charlton Athletic,1-0,1,0,1,1,1,1,H
1938-04-30,1937,Manchester City,Leeds United,6-2,6,2,1,1,8,4,H
1938-04-30,1937,Wolverhampton Wanderers,Chelsea,1-1,1,1,1,1,2,0,D
1938-05-02,1937,Huddersfield Town,Stoke City,3-0,3,0,1,1,3,3,H
1938-05-02,1937,Wolverhampton Wanderers,West Bromwich Albion,2-1,2,1,1,1,3,1,H
1938-05-04,1937,Sunderland,Preston North End,0-2,0,2,1,1,2,-2,A
1938-05-07,1937,Arsenal,Bolton Wanderers,5-0,5,0,1,1,5,5,H
1938-05-07,1937,Charlton Athletic,Preston North End,0-0,0,0,1,1,0,0,D
1938-05-07,1937,Everton,Derby County,1-1,1,1,1,1,2,0,D
1938-05-07,1937,Grimsby Town,Chelsea,2-0,2,0,1,1,2,2,H
1938-05-07,1937,Huddersfield Town,Manchester City,1-0,1,0,1,1,1,1,H
1938-05-07,1937,Leicester City,Birmingham City,1-4,1,4,1,1,5,-3,A
1938-05-07,1937,Middlesbrough,West Bromwich Albion,4-1,4,1,1,1,5,3,H
1938-05-07,1937,Portsmouth,Leeds United,4-0,4,0,1,1,4,4,H
1938-05-07,1937,Stoke City,Liverpool,2-0,2,0,1,1,2,2,H
1938-05-07,1937,Sunderland,Wolverhampton Wanderers,1-0,1,0,1,1,1,1,H
1938-08-27,1938,Arsenal,Portsmouth,2-0,2,0,1,1,2,2,H
1938-08-27,1938,Birmingham City,Sunderland,1-2,1,2,1,1,3,-1,A
1938-08-27,1938,Blackpool,Everton,0-2,0,2,1,1,2,-2,A
1938-08-27,1938,Bolton Wanderers,Charlton Athletic,2-1,2,1,1,1,3,1,H
1938-08-27,1938,Brentford,Huddersfield Town,2-1,2,1,1,1,3,1,H
1938-08-27,1938,Derby County,Wolverhampton Wanderers,2-2,2,2,1,1,4,0,D
1938-08-27,1938,Grimsby Town,Aston Villa,1-2,1,2,1,1,3,-1,A
1938-08-27,1938,Leeds United,Preston North End,2-1,2,1,1,1,3,1,H
1938-08-27,1938,Leicester City,Stoke City,2-2,2,2,1,1,4,0,D
1938-08-27,1938,Liverpool,Chelsea,2-1,2,1,1,1,3,1,H
1938-08-27,1938,Middlesbrough,Manchester United,3-1,3,1,1,1,4,2,H
1938-08-29,1938,Charlton Athletic,Stoke City,4-2,4,2,1,1,6,2,H
1938-08-29,1938,Wolverhampton Wanderers,Leicester City,0-0,0,0,1,1,0,0,D
1938-08-31,1938,Chelsea,Preston North End,3-1,3,1,1,1,4,2,H
1938-08-31,1938,Derby County,Huddersfield Town,1-0,1,0,1,1,1,1,H
1938-08-31,1938,Everton,Grimsby Town,3-0,3,0,1,1,3,3,H
1938-08-31,1938,Leeds United,Birmingham City,2-0,2,0,1,1,2,2,H
1938-08-31,1938,Manchester United,Bolton Wanderers,2-2,2,2,1,1,4,0,D
1938-08-31,1938,Middlesbrough,Aston Villa,1-1,1,1,1,1,2,0,D
1938-08-31,1938,Portsmouth,Blackpool,1-0,1,0,1,1,1,1,H
1938-09-03,1938,Aston Villa,Derby County,0-1,0,1,1,1,1,-1,A
1938-09-03,1938,Charlton Athletic,Leeds United,2-0,2,0,1,1,2,2,H
1938-09-03,1938,Chelsea,Leicester City,3-0,3,0,1,1,3,3,H
1938-09-03,1938,Everton,Brentford,2-1,2,1,1,1,3,1,H
1938-09-03,1938,Huddersfield Town,Arsenal,1-1,1,1,1,1,2,0,D
1938-09-03,1938,Manchester United,Birmingham City,4-1,4,1,1,1,5,3,H
1938-09-03,1938,Portsmouth,Bolton Wanderers,2-1,2,1,1,1,3,1,H
1938-09-03,1938,Preston North End,Liverpool,1-0,1,0,1,1,1,1,H
1938-09-03,1938,Stoke City,Middlesbrough,1-3,1,3,1,1,4,-2,A
1938-09-03,1938,Sunderland,Grimsby Town,1-1,1,1,1,1,2,0,D
1938-09-03,1938,Wolverhampton Wanderers,Blackpool,1-1,1,1,1,1,2,0,D
1938-09-05,1938,Aston Villa,Everton,0-3,0,3,1,1,3,-3,A
1938-09-05,1938,Bolton Wanderers,Chelsea,0-2,0,2,1,1,2,-2,A
1938-09-05,1938,Preston North End,Charlton Athletic,2-0,2,0,1,1,2,2,H
1938-09-05,1938,Stoke City,Leeds United,1-1,1,1,1,1,2,0,D
1938-09-06,1938,Grimsby Town,Portsmouth,2-1,2,1,1,1,3,1,H
1938-09-07,1938,Birmingham City,Leicester City,2-1,2,1,1,1,3,1,H
1938-09-07,1938,Huddersfield Town,Derby County,3-0,3,0,1,1,3,3,H
1938-09-07,1938,Liverpool,Manchester United,1-0,1,0,1,1,1,1,H
1938-09-07,1938,Sunderland,Wolverhampton Wanderers,1-1,1,1,1,1,2,0,D
1938-09-08,1938,Brentford,Arsenal,1-0,1,0,1,1,1,1,H
1938-09-10,1938,Arsenal,Everton,1-2,1,2,1,1,3,-1,A
1938-09-10,1938,Birmingham City,Stoke City,1-2,1,2,1,1,3,-1,A
1938-09-10,1938,Blackpool,Aston Villa,2-4,2,4,1,1,6,-2,A
1938-09-10,1938,Brentford,Wolverhampton Wanderers,0-1,0,1,1,1,1,-1,A
1938-09-10,1938,Derby County,Sunderland,1-0,1,0,1,1,1,1,H
1938-09-10,1938,Grimsby Town,Manchester United,1-0,1,0,1,1,1,1,H
1938-09-10,1938,Leeds United,Bolton Wanderers,1-2,1,2,1,1,3,-1,A
1938-09-10,1938,Leicester City,Preston North End,2-1,2,1,1,1,3,1,H
1938-09-10,1938,Liverpool,Charlton Athletic,1-0,1,0,1,1,1,1,H
1938-09-10,1938,Middlesbrough,Chelsea,1-1,1,1,1,1,2,0,D
1938-09-10,1938,Portsmouth,Huddersfield Town,4-0,4,0,1,1,4,4,H
1938-09-12,1938,Leicester City,Birmingham City,2-1,2,1,1,1,3,1,H
1938-09-14,1938,Arsenal,Derby County,1-2,1,2,1,1,3,-1,A
1938-09-14,1938,Huddersfield Town,Sunderland,0-1,0,1,1,1,1,-1,A
1938-09-14,1938,Liverpool,Middlesbrough,3-1,3,1,1,1,4,2,H
1938-09-17,1938,Aston Villa,Brentford,5-0,5,0,1,1,5,5,H
1938-09-17,1938,Bolton Wanderers,Liverpool,3-1,3,1,1,1,4,2,H
1938-09-17,1938,Charlton Athletic,Leicester City,1-0,1,0,1,1,1,1,H
1938-09-17,1938,Chelsea,Birmingham City,2-2,2,2,1,1,4,0,D
1938-09-17,1938,Everton,Portsmouth,5-1,5,1,1,1,6,4,H
1938-09-17,1938,Grimsby Town,Derby County,1-1,1,1,1,1,2,0,D
1938-09-17,1938,Huddersfield Town,Leeds United,0-1,0,1,1,1,1,-1,A
1938-09-17,1938,Preston North End,Middlesbrough,3-1,3,1,1,1,4,2,H
1938-09-17,1938,Stoke City,Manchester United,1-1,1,1,1,1,2,0,D
1938-09-17,1938,Sunderland,Blackpool,1-2,1,2,1,1,3,-1,A
1938-09-17,1938,Wolverhampton Wanderers,Arsenal,0-1,0,1,1,1,1,-1,A
1938-09-19,1938,Blackpool,Brentford,4-1,4,1,1,1,5,3,H
1938-09-24,1938,Arsenal,Aston Villa,0-0,0,0,1,1,0,0,D
1938-09-24,1938,Birmingham City,Preston North End,1-3,1,3,1,1,4,-2,A
1938-09-24,1938,Blackpool,Grimsby Town,3-1,3,1,1,1,4,2,H
1938-09-24,1938,Brentford,Sunderland,2-3,2,3,1,1,5,-1,A
1938-09-24,1938,Derby County,Stoke City,5-0,5,0,1,1,5,5,H
1938-09-24,1938,Huddersfield Town,Everton,3-0,3,0,1,1,3,3,H
1938-09-24,1938,Leicester City,Bolton Wanderers,0-0,0,0,1,1,0,0,D
1938-09-24,1938,Liverpool,Leeds United,3-0,3,0,1,1,3,3,H
1938-09-24,1938,Manchester United,Chelsea,5-1,5,1,1,1,6,4,H
1938-09-24,1938,Middlesbrough,Charlton Athletic,4-0,4,0,1,1,4,4,H
1938-09-24,1938,Portsmouth,Wolverhampton Wanderers,1-0,1,0,1,1,1,1,H
1938-10-01,1938,Aston Villa,Portsmouth,2-0,2,0,1,1,2,2,H
1938-10-01,1938,Bolton Wanderers,Middlesbrough,4-1,4,1,1,1,5,3,H
1938-10-01,1938,Charlton Athletic,Birmingham City,4-4,4,4,1,1,8,0,D
1938-10-01,1938,Chelsea,Stoke City,1-1,1,1,1,1,2,0,D
1938-10-01,1938,Derby County,Blackpool,2-1,2,1,1,1,3,1,H
1938-10-01,1938,Everton,Liverpool,2-1,2,1,1,1,3,1,H
1938-10-01,1938,Grimsby Town,Brentford,0-0,0,0,1,1,0,0,D
1938-10-01,1938,Leeds United,Leicester City,8-2,8,2,1,1,10,6,H
1938-10-01,1938,Preston North End,Manchester United,1-1,1,1,1,1,2,0,D
1938-10-01,1938,Sunderland,Arsenal,0-0,0,0,1,1,0,0,D
1938-10-01,1938,Wolverhampton Wanderers,Huddersfield Town,3-0,3,0,1,1,3,3,H
1938-10-08,1938,Arsenal,Grimsby Town,2-0,2,0,1,1,2,2,H
1938-10-08,1938,Birmingham City,Bolton Wanderers,0-2,0,2,1,1,2,-2,A
1938-10-08,1938,Blackpool,Chelsea,5-1,5,1,1,1,6,4,H
1938-10-08,1938,Brentford,Derby County,1-3,1,3,1,1,4,-2,A
1938-10-08,1938,Everton,Wolverhampton Wanderers,1-0,1,0,1,1,1,1,H
1938-10-08,1938,Huddersfield Town,Aston Villa,1-1,1,1,1,1,2,0,D
1938-10-08,1938,Leicester City,Liverpool,2-2,2,2,1,1,4,0,D
1938-10-08,1938,Manchester United,Charlton Athletic,0-2,0,2,1,1,2,-2,A
1938-10-08,1938,Middlesbrough,Leeds United,1-2,1,2,1,1,3,-1,A
1938-10-08,1938,Portsmouth,Sunderland,2-1,2,1,1,1,3,1,H
1938-10-08,1938,Stoke City,Preston North End,3-1,3,1,1,1,4,2,H
1938-10-15,1938,Birmingham City,Derby County,3-0,3,0,1,1,3,3,H
1938-10-15,1938,Bolton Wanderers,Everton,4-2,4,2,1,1,6,2,H
1938-10-15,1938,Charlton Athletic,Huddersfield Town,2-1,2,1,1,1,3,1,H
1938-10-15,1938,Chelsea,Arsenal,4-2,4,2,1,1,6,2,H
1938-10-15,1938,Leeds United,Wolverhampton Wanderers,1-0,1,0,1,1,1,1,H
1938-10-15,1938,Leicester City,Sunderland,0-2,0,2,1,1,2,-2,A
1938-10-15,1938,Liverpool,Aston Villa,3-0,3,0,1,1,3,3,H
1938-10-15,1938,Manchester United,Blackpool,0-0,0,0,1,1,0,0,D
1938-10-15,1938,Middlesbrough,Grimsby Town,3-2,3,2,1,1,5,1,H
1938-10-15,1938,Preston North End,Portsmouth,2-2,2,2,1,1,4,0,D
1938-10-15,1938,Stoke City,Brentford,3-2,3,2,1,1,5,1,H
1938-10-22,1938,Arsenal,Preston North End,1-0,1,0,1,1,1,1,H
1938-10-22,1938,Aston Villa,Leicester City,1-2,1,2,1,1,3,-1,A
1938-10-22,1938,Blackpool,Stoke City,1-1,1,1,1,1,2,0,D
1938-10-22,1938,Brentford,Chelsea,1-0,1,0,1,1,1,1,H
1938-10-22,1938,Derby County,Manchester United,5-1,5,1,1,1,6,4,H
1938-10-22,1938,Everton,Leeds United,4-0,4,0,1,1,4,4,H
1938-10-22,1938,Grimsby Town,Birmingham City,1-0,1,0,1,1,1,1,H
1938-10-22,1938,Huddersfield Town,Bolton Wanderers,2-1,2,1,1,1,3,1,H
1938-10-22,1938,Portsmouth,Charlton Athletic,0-2,0,2,1,1,2,-2,A
1938-10-22,1938,Sunderland,Middlesbrough,1-2,1,2,1,1,3,-1,A
1938-10-22,1938,Wolverhampton Wanderers,Liverpool,2-2,2,2,1,1,4,0,D
1938-10-29,1938,Birmingham City,Aston Villa,3-0,3,0,1,1,3,3,H
1938-10-29,1938,Bolton Wanderers,Arsenal,1-1,1,1,1,1,2,0,D
1938-10-29,1938,Charlton Athletic,Brentford,1-1,1,1,1,1,2,0,D
1938-10-29,1938,Chelsea,Derby County,0-2,0,2,1,1,2,-2,A
1938-10-29,1938,Leeds United,Portsmouth,2-2,2,2,1,1,4,0,D
1938-10-29,1938,Leicester City,Everton,3-0,3,0,1,1,3,3,H
1938-10-29,1938,Liverpool,Huddersfield Town,3-3,3,3,1,1,6,0,D
1938-10-29,1938,Manchester United,Sunderland,0-1,0,1,1,1,1,-1,A
1938-10-29,1938,Middlesbrough,Wolverhampton Wanderers,1-0,1,0,1,1,1,1,H
1938-10-29,1938,Preston North End,Blackpool,1-1,1,1,1,1,2,0,D
1938-10-29,1938,Stoke City,Grimsby Town,1-2,1,2,1,1,3,-1,A
1938-11-05,1938,Arsenal,Leeds United,2-3,2,3,1,1,5,-1,A
1938-11-05,1938,Aston Villa,Manchester United,0-2,0,2,1,1,2,-2,A
1938-11-05,1938,Blackpool,Charlton Athletic,0-0,0,0,1,1,0,0,D
1938-11-05,1938,Brentford,Bolton Wanderers,2-2,2,2,1,1,4,0,D
1938-11-05,1938,Derby County,Preston North End,2-0,2,0,1,1,2,2,H
1938-11-05,1938,Everton,Middlesbrough,4-0,4,0,1,1,4,4,H
1938-11-05,1938,Grimsby Town,Chelsea,2-1,2,1,1,1,3,1,H
1938-11-05,1938,Huddersfield Town,Leicester City,2-0,2,0,1,1,2,2,H
1938-11-05,1938,Portsmouth,Liverpool,1-1,1,1,1,1,2,0,D
1938-11-05,1938,Sunderland,Stoke City,3-0,3,0,1,1,3,3,H
1938-11-05,1938,Wolverhampton Wanderers,Birmingham City,2-1,2,1,1,1,3,1,H
1938-11-12,1938,Birmingham City,Everton,1-0,1,0,1,1,1,1,H
1938-11-12,1938,Bolton Wanderers,Blackpool,0-1,0,1,1,1,1,-1,A
1938-11-12,1938,Charlton Athletic,Derby County,1-0,1,0,1,1,1,1,H
1938-11-12,1938,Chelsea,Sunderland,4-0,4,0,1,1,4,4,H
1938-11-12,1938,Leeds United,Brentford,3-2,3,2,1,1,5,1,H
1938-11-12,1938,Liverpool,Arsenal,2-2,2,2,1,1,4,0,D
1938-11-12,1938,Manchester United,Wolverhampton Wanderers,1-3,1,3,1,1,4,-2,A
1938-11-12,1938,Middlesbrough,Huddersfield Town,4-1,4,1,1,1,5,3,H
1938-11-12,1938,Preston North End,Grimsby Town,1-1,1,1,1,1,2,0,D
1938-11-12,1938,Stoke City,Aston Villa,3-1,3,1,1,1,4,2,H
1938-11-19,1938,Arsenal,Leicester City,0-0,0,0,1,1,0,0,D
1938-11-19,1938,Aston Villa,Chelsea,6-2,6,2,1,1,8,4,H
1938-11-19,1938,Blackpool,Leeds United,1-2,1,2,1,1,3,-1,A
1938-11-19,1938,Brentford,Liverpool,2-1,2,1,1,1,3,1,H
1938-11-19,1938,Derby County,Bolton Wanderers,3-0,3,0,1,1,3,3,H
1938-11-19,1938,Everton,Manchester United,3-0,3,0,1,1,3,3,H
1938-11-19,1938,Grimsby Town,Charlton Athletic,1-1,1,1,1,1,2,0,D
1938-11-19,1938,Huddersfield Town,Birmingham City,3-1,3,1,1,1,4,2,H
1938-11-19,1938,Portsmouth,Middlesbrough,1-1,1,1,1,1,2,0,D
1938-11-19,1938,Sunderland,Preston North End,1-2,1,2,1,1,3,-1,A
1938-11-19,1938,Wolverhampton Wanderers,Stoke City,3-0,3,0,1,1,3,3,H
1938-11-21,1938,Leicester City,Portsmouth,5-0,5,0,1,1,5,5,H
1938-11-26,1938,Birmingham City,Portsmouth,2-0,2,0,1,1,2,2,H
1938-11-26,1938,Bolton Wanderers,Grimsby Town,1-1,1,1,1,1,2,0,D
1938-11-26,1938,Charlton Athletic,Sunderland,3-0,3,0,1,1,3,3,H
1938-11-26,1938,Chelsea,Wolverhampton Wanderers,1-3,1,3,1,1,4,-2,A
1938-11-26,1938,Leeds United,Derby County,1-4,1,4,1,1,5,-3,A
1938-11-26,1938,Leicester City,Brentford,1-1,1,1,1,1,2,0,D
1938-11-26,1938,Liverpool,Blackpool,1-0,1,0,1,1,1,1,H
1938-11-26,1938,Manchester United,Huddersfield Town,1-1,1,1,1,1,2,0,D
1938-11-26,1938,Middlesbrough,Arsenal,1-1,1,1,1,1,2,0,D
1938-11-26,1938,Preston North End,Aston Villa,3-2,3,2,1,1,5,1,H
1938-11-26,1938,Stoke City,Everton,0-0,0,0,1,1,0,0,D
1938-12-03,1938,Arsenal,Birmingham City,3-1,3,1,1,1,4,2,H
1938-12-03,1938,Aston Villa,Charlton Athletic,2-0,2,0,1,1,2,2,H
1938-12-03,1938,Blackpool,Leicester City,1-1,1,1,1,1,2,0,D
1938-12-03,1938,Brentford,Middlesbrough,2-1,2,1,1,1,3,1,H
1938-12-03,1938,Derby County,Liverpool,2-2,2,2,1,1,4,0,D
1938-12-03,1938,Everton,Chelsea,4-1,4,1,1,1,5,3,H
1938-12-03,1938,Grimsby Town,Leeds United,3-2,3,2,1,1,5,1,H
1938-12-03,1938,Huddersfield Town,Stoke City,1-4,1,4,1,1,5,-3,A
1938-12-03,1938,Portsmouth,Manchester United,0-0,0,0,1,1,0,0,D
1938-12-03,1938,Sunderland,Bolton Wanderers,2-2,2,2,1,1,4,0,D
1938-12-03,1938,Wolverhampton Wanderers,Preston North End,3-0,3,0,1,1,3,3,H
1938-12-10,1938,Birmingham City,Brentford,5-1,5,1,1,1,6,4,H
1938-12-10,1938,Bolton Wanderers,Aston Villa,1-2,1,2,1,1,3,-1,A
1938-12-10,1938,Charlton Athletic,Wolverhampton Wanderers,0-4,0,4,1,1,4,-4,A
1938-12-10,1938,Chelsea,Huddersfield Town,3-0,3,0,1,1,3,3,H
1938-12-10,1938,Leeds United,Sunderland,3-3,3,3,1,1,6,0,D
1938-12-10,1938,Leicester City,Derby County,2-3,2,3,1,1,5,-1,A
1938-12-10,1938,Liverpool,Grimsby Town,2-2,2,2,1,1,4,0,D
1938-12-10,1938,Manchester United,Arsenal,1-0,1,0,1,1,1,1,H
1938-12-10,1938,Middlesbrough,Blackpool,9-2,9,2,1,1,11,7,H
1938-12-10,1938,Preston North End,Everton,0-1,0,1,1,1,1,-1,A
1938-12-10,1938,Stoke City,Portsmouth,1-1,1,1,1,1,2,0,D
1938-12-17,1938,Arsenal,Stoke City,4-1,4,1,1,1,5,3,H
1938-12-17,1938,Aston Villa,Leeds United,2-1,2,1,1,1,3,1,H
1938-12-17,1938,Blackpool,Birmingham City,2-1,2,1,1,1,3,1,H
1938-12-17,1938,Brentford,Manchester United,2-5,2,5,1,1,7,-3,A
1938-12-17,1938,Derby County,Middlesbrough,1-4,1,4,1,1,5,-3,A
1938-12-17,1938,Everton,Charlton Athletic,1-4,1,4,1,1,5,-3,A
1938-12-17,1938,Grimsby Town,Leicester City,6-1,6,1,1,1,7,5,H
1938-12-17,1938,Huddersfield Town,Preston North End,3-0,3,0,1,1,3,3,H
1938-12-17,1938,Portsmouth,Chelsea,2-1,2,1,1,1,3,1,H
1938-12-17,1938,Sunderland,Liverpool,2-3,2,3,1,1,5,-1,A
1938-12-17,1938,Wolverhampton Wanderers,Bolton Wanderers,1-1,1,1,1,1,2,0,D
1938-12-24,1938,Aston Villa,Grimsby Town,0-2,0,2,1,1,2,-2,A
1938-12-24,1938,Charlton Athletic,Bolton Wanderers,2-1,2,1,1,1,3,1,H
1938-12-24,1938,Chelsea,Liverpool,4-1,4,1,1,1,5,3,H
1938-12-24,1938,Everton,Blackpool,4-0,4,0,1,1,4,4,H
1938-12-24,1938,Huddersfield Town,Brentford,1-2,1,2,1,1,3,-1,A
1938-12-24,1938,Manchester United,Middlesbrough,1-1,1,1,1,1,2,0,D
1938-12-24,1938,Portsmouth,Arsenal,0-0,0,0,1,1,0,0,D
1938-12-24,1938,Preston North End,Leeds United,2-0,2,0,1,1,2,2,H
1938-12-24,1938,Stoke City,Leicester City,1-0,1,0,1,1,1,1,H
1938-12-24,1938,Sunderland,Birmingham City,1-0,1,0,1,1,1,1,H
1938-12-24,1938,Wolverhampton Wanderers,Derby County,0-0,0,0,1,1,0,0,D
1938-12-26,1938,Birmingham City,Middlesbrough,2-1,2,1,1,1,3,1,H
1938-12-26,1938,Blackpool,Huddersfield Town,1-1,1,1,1,1,2,0,D
1938-12-26,1938,Charlton Athletic,Arsenal,1-0,1,0,1,1,1,1,H
1938-12-26,1938,Everton,Derby County,2-2,2,2,1,1,4,0,D
1938-12-26,1938,Grimsby Town,Wolverhampton Wanderers,2-4,2,4,1,1,6,-2,A
1938-12-26,1938,Leeds United,Chelsea,1-1,1,1,1,1,2,0,D
1938-12-26,1938,Manchester United,Leicester City,3-0,3,0,1,1,3,3,H
1938-12-26,1938,Stoke City,Liverpool,3-1,3,1,1,1,4,2,H
1938-12-26,1938,Sunderland,Aston Villa,1-5,1,5,1,1,6,-4,A
1938-12-27,1938,Aston Villa,Sunderland,1-1,1,1,1,1,2,0,D
1938-12-27,1938,Chelsea,Leeds United,2-2,2,2,1,1,4,0,D
1938-12-27,1938,Derby County,Everton,2-1,2,1,1,1,3,1,H
1938-12-27,1938,Huddersfield Town,Blackpool,3-0,3,0,1,1,3,3,H
1938-12-27,1938,Leicester City,Manchester United,1-1,1,1,1,1,2,0,D
1938-12-27,1938,Liverpool,Stoke City,1-0,1,0,1,1,1,1,H
1938-12-27,1938,Middlesbrough,Birmingham City,2-2,2,2,1,1,4,0,D
1938-12-27,1938,Portsmouth,Brentford,2-2,2,2,1,1,4,0,D
1938-12-27,1938,Preston North End,Bolton Wanderers,2-2,2,2,1,1,4,0,D
1938-12-27,1938,Wolverhampton Wanderers,Grimsby Town,5-0,5,0,1,1,5,5,H
1938-12-31,1938,Arsenal,Huddersfield Town,1-0,1,0,1,1,1,1,H
1938-12-31,1938,Birmingham City,Manchester United,3-3,3,3,1,1,6,0,D
1938-12-31,1938,Blackpool,Wolverhampton Wanderers,1-0,1,0,1,1,1,1,H
1938-12-31,1938,Bolton Wanderers,Portsmouth,5-1,5,1,1,1,6,4,H
1938-12-31,1938,Brentford,Everton,2-0,2,0,1,1,2,2,H
1938-12-31,1938,Derby County,Aston Villa,2-1,2,1,1,1,3,1,H
1938-12-31,1938,Grimsby Town,Sunderland,1-3,1,3,1,1,4,-2,A
1938-12-31,1938,Leeds United,Charlton Athletic,2-1,2,1,1,1,3,1,H
1938-12-31,1938,Leicester City,Chelsea,3-2,3,2,1,1,5,1,H
1938-12-31,1938,Liverpool,Preston North End,4-1,4,1,1,1,5,3,H
1938-12-31,1938,Middlesbrough,Stoke City,5-1,5,1,1,1,6,4,H
1939-01-02,1938,Bolton Wanderers,Stoke City,1-3,1,3,1,1,4,-2,A
1939-01-02,1938,Middlesbrough,Liverpool,3-0,3,0,1,1,3,3,H
1939-01-14,1938,Aston Villa,Blackpool,3-1,3,1,1,1,4,2,H
1939-01-14,1938,Bolton Wanderers,Leeds United,2-2,2,2,1,1,4,0,D
1939-01-14,1938,Charlton Athletic,Liverpool,1-3,1,3,1,1,4,-2,A
1939-01-14,1938,Chelsea,Middlesbrough,4-2,4,2,1,1,6,2,H
1939-01-14,1938,Everton,Arsenal,2-0,2,0,1,1,2,2,H
1939-01-14,1938,Huddersfield Town,Portsmouth,3-0,3,0,1,1,3,3,H
1939-01-14,1938,Manchester United,Grimsby Town,3-1,3,1,1,1,4,2,H
1939-01-14,1938,Preston North End,Leicester City,2-1,2,1,1,1,3,1,H
1939-01-14,1938,Stoke City,Birmingham City,6-3,6,3,1,1,9,3,H
1939-01-14,1938,Sunderland,Derby County,1-0,1,0,1,1,1,1,H
1939-01-14,1938,Wolverhampton Wanderers,Brentford,5-2,5,2,1,1,7,3,H
1939-01-21,1938,Arsenal,Charlton Athletic,2-0,2,0,1,1,2,2,H
1939-01-21,1938,Manchester United,Stoke City,0-1,0,1,1,1,1,-1,A
1939-01-25,1938,Blackpool,Sunderland,1-1,1,1,1,1,2,0,D
1939-01-25,1938,Liverpool,Bolton Wanderers,1-2,1,2,1,1,3,-1,A
1939-01-25,1938,Middlesbrough,Preston North End,2-2,2,2,1,1,4,0,D
1939-01-28,1938,Aston Villa,Arsenal,1-3,1,3,1,1,4,-2,A
1939-01-28,1938,Bolton Wanderers,Leicester City,4-0,4,0,1,1,4,4,H
1939-01-28,1938,Charlton Athletic,Middlesbrough,3-0,3,0,1,1,3,3,H
1939-01-28,1938,Chelsea,Manchester United,0-1,0,1,1,1,1,-1,A
1939-01-28,1938,Everton,Huddersfield Town,3-2,3,2,1,1,5,1,H
1939-01-28,1938,Grimsby Town,Blackpool,2-0,2,0,1,1,2,2,H
1939-01-28,1938,Leeds United,Liverpool,1-1,1,1,1,1,2,0,D
1939-01-28,1938,Preston North End,Birmingham City,5-0,5,0,1,1,5,5,H
1939-01-28,1938,Stoke City,Derby County,3-0,3,0,1,1,3,3,H
1939-01-28,1938,Sunderland,Brentford,1-1,1,1,1,1,2,0,D
1939-01-28,1938,Wolverhampton Wanderers,Portsmouth,3-0,3,0,1,1,3,3,H
1939-02-01,1938,Arsenal,Wolverhampton Wanderers,0-0,0,0,1,1,0,0,D
1939-02-01,1938,Derby County,Grimsby Town,4-1,4,1,1,1,5,3,H
1939-02-01,1938,Portsmouth,Everton,0-1,0,1,1,1,1,-1,A
1939-02-04,1938,Arsenal,Sunderland,2-0,2,0,1,1,2,2,H
1939-02-04,1938,Birmingham City,Charlton Athletic,3-4,3,4,1,1,7,-1,A
1939-02-04,1938,Blackpool,Derby County,2-2,2,2,1,1,4,0,D
1939-02-04,1938,Brentford,Grimsby Town,1-2,1,2,1,1,3,-1,A
1939-02-04,1938,Huddersfield Town,Wolverhampton Wanderers,1-2,1,2,1,1,3,-1,A
1939-02-04,1938,Leicester City,Leeds United,2-0,2,0,1,1,2,2,H
1939-02-04,1938,Liverpool,Everton,0-3,0,3,1,1,3,-3,A
1939-02-04,1938,Manchester United,Preston North End,1-1,1,1,1,1,2,0,D
1939-02-04,1938,Middlesbrough,Bolton Wanderers,1-2,1,2,1,1,3,-1,A
1939-02-04,1938,Portsmouth,Aston Villa,0-0,0,0,1,1,0,0,D
1939-02-04,1938,Stoke City,Chelsea,6-1,6,1,1,1,7,5,H
1939-02-08,1938,Brentford,Aston Villa,2-4,2,4,1,1,6,-2,A
1939-02-09,1938,Leicester City,Charlton Athletic,1-5,1,5,1,1,6,-4,A
1939-02-11,1938,Charlton Athletic,Manchester United,7-1,7,1,1,1,8,6,H
1939-02-11,1938,Derby County,Brentford,1-2,1,2,1,1,3,-1,A
1939-02-11,1938,Leeds United,Middlesbrough,0-1,0,1,1,1,1,-1,A
1939-02-15,1938,Aston Villa,Huddersfield Town,4-0,4,0,1,1,4,4,H
1939-02-15,1938,Preston North End,Stoke City,1-1,1,1,1,1,2,0,D
1939-02-18,1938,Arsenal,Chelsea,1-0,1,0,1,1,1,1,H
1939-02-18,1938,Aston Villa,Liverpool,2-0,2,0,1,1,2,2,H
1939-02-18,1938,Blackpool,Manchester United,3-5,3,5,1,1,8,-2,A
1939-02-18,1938,Brentford,Stoke City,1-0,1,0,1,1,1,1,H
1939-02-18,1938,Derby County,Birmingham City,0-1,0,1,1,1,1,-1,A
1939-02-18,1938,Everton,Bolton Wanderers,2-1,2,1,1,1,3,1,H
1939-02-18,1938,Grimsby Town,Middlesbrough,0-2,0,2,1,1,2,-2,A
1939-02-18,1938,Huddersfield Town,Charlton Athletic,4-0,4,0,1,1,4,4,H
1939-02-18,1938,Portsmouth,Preston North End,0-0,0,0,1,1,0,0,D
1939-02-18,1938,Sunderland,Leicester City,2-0,2,0,1,1,2,2,H
1939-02-18,1938,Wolverhampton Wanderers,Leeds United,4-1,4,1,1,1,5,3,H
1939-02-21,1938,Grimsby Town,Arsenal,2-1,2,1,1,1,3,1,H
1939-02-22,1938,Bolton Wanderers,Birmingham City,3-0,3,0,1,1,3,3,H
1939-02-22,1938,Brentford,Portsmouth,2-0,2,0,1,1,2,2,H
1939-02-22,1938,Wolverhampton Wanderers,Everton,7-0,7,0,1,1,7,7,H
1939-02-25,1938,Birmingham City,Grimsby Town,1-1,1,1,1,1,2,0,D
1939-02-25,1938,Bolton Wanderers,Huddersfield Town,3-2,3,2,1,1,5,1,H
1939-02-25,1938,Charlton Athletic,Portsmouth,3-3,3,3,1,1,6,0,D
1939-02-25,1938,Chelsea,Brentford,1-3,1,3,1,1,4,-2,A
1939-02-25,1938,Leeds United,Everton,1-2,1,2,1,1,3,-1,A
1939-02-25,1938,Leicester City,Aston Villa,1-1,1,1,1,1,2,0,D
1939-02-25,1938,Liverpool,Wolverhampton Wanderers,0-2,0,2,1,1,2,-2,A
1939-02-25,1938,Manchester United,Derby County,1-1,1,1,1,1,2,0,D
1939-02-25,1938,Middlesbrough,Sunderland,3-0,3,0,1,1,3,3,H
1939-02-25,1938,Preston North End,Arsenal,2-1,2,1,1,1,3,1,H
1939-02-25,1938,Stoke City,Blackpool,1-1,1,1,1,1,2,0,D
1939-03-04,1938,Arsenal,Bolton Wanderers,3-1,3,1,1,1,4,2,H
1939-03-04,1938,Aston Villa,Birmingham City,5-1,5,1,1,1,6,4,H
1939-03-04,1938,Brentford,Charlton Athletic,1-0,1,0,1,1,1,1,H
1939-03-04,1938,Liverpool,Leicester City,1-1,1,1,1,1,2,0,D
1939-03-04,1938,Sunderland,Manchester United,5-2,5,2,1,1,7,3,H
1939-03-07,1938,Grimsby Town,Stoke City,3-1,3,1,1,1,4,2,H
1939-03-08,1938,Blackpool,Preston North End,2-1,2,1,1,1,3,1,H
1939-03-08,1938,Derby County,Chelsea,0-1,0,1,1,1,1,-1,A
1939-03-08,1938,Everton,Leicester City,4-0,4,0,1,1,4,4,H
1939-03-08,1938,Portsmouth,Leeds United,2-0,2,0,1,1,2,2,H
1939-03-08,1938,Wolverhampton Wanderers,Middlesbrough,6-1,6,1,1,1,7,5,H
1939-03-11,1938,Birmingham City,Wolverhampton Wanderers,3-2,3,2,1,1,5,1,H
1939-03-11,1938,Bolton Wanderers,Brentford,1-1,1,1,1,1,2,0,D
1939-03-11,1938,Charlton Athletic,Blackpool,3-1,3,1,1,1,4,2,H
1939-03-11,1938,Chelsea,Grimsby Town,5-1,5,1,1,1,6,4,H
1939-03-11,1938,Leeds United,Arsenal,4-2,4,2,1,1,6,2,H
1939-03-11,1938,Leicester City,Huddersfield Town,0-1,0,1,1,1,1,-1,A
1939-03-11,1938,Liverpool,Portsmouth,4-4,4,4,1,1,8,0,D
1939-03-11,1938,Manchester United,Aston Villa,1-1,1,1,1,1,2,0,D
1939-03-11,1938,Middlesbrough,Everton,4-4,4,4,1,1,8,0,D
1939-03-11,1938,Preston North End,Derby County,4-1,4,1,1,1,5,3,H
1939-03-11,1938,Stoke City,Sunderland,3-1,3,1,1,1,4,2,H
1939-03-15,1938,Chelsea,Blackpool,1-1,1,1,1,1,2,0,D
1939-03-15,1938,Huddersfield Town,Liverpool,1-1,1,1,1,1,2,0,D
1939-03-15,1938,Sunderland,Portsmouth,0-2,0,2,1,1,2,-2,A
1939-03-18,1938,Arsenal,Liverpool,2-0,2,0,1,1,2,2,H
1939-03-18,1938,Aston Villa,Stoke City,3-0,3,0,1,1,3,3,H
1939-03-18,1938,Blackpool,Bolton Wanderers,0-0,0,0,1,1,0,0,D
1939-03-18,1938,Brentford,Leeds United,0-1,0,1,1,1,1,-1,A
1939-03-18,1938,Derby County,Charlton Athletic,3-1,3,1,1,1,4,2,H
1939-03-18,1938,Everton,Birmingham City,4-2,4,2,1,1,6,2,H
1939-03-18,1938,Grimsby Town,Preston North End,1-1,1,1,1,1,2,0,D
1939-03-18,1938,Huddersfield Town,Middlesbrough,0-1,0,1,1,1,1,-1,A
1939-03-18,1938,Portsmouth,Leicester City,0-1,0,1,1,1,1,-1,A
1939-03-18,1938,Sunderland,Chelsea,3-2,3,2,1,1,5,1,H
1939-03-18,1938,Wolverhampton Wanderers,Manchester United,3-0,3,0,1,1,3,3,H
1939-03-25,1938,Bolton Wanderers,Derby County,2-1,2,1,1,1,3,1,H
1939-03-25,1938,Chelsea,Aston Villa,2-1,2,1,1,1,3,1,H
1939-03-25,1938,Leeds United,Blackpool,1-0,1,0,1,1,1,1,H
1939-03-25,1938,Leicester City,Arsenal,0-2,0,2,1,1,2,-2,A
1939-03-25,1938,Liverpool,Brentford,1-0,1,0,1,1,1,1,H
1939-03-25,1938,Preston North End,Sunderland,2-1,2,1,1,1,3,1,H
1939-03-29,1938,Birmingham City,Huddersfield Town,1-1,1,1,1,1,2,0,D
1939-03-29,1938,Charlton Athletic,Grimsby Town,3-1,3,1,1,1,4,2,H
1939-03-29,1938,Manchester United,Everton,0-2,0,2,1,1,2,-2,A
1939-03-29,1938,Middlesbrough,Portsmouth,8-2,8,2,1,1,10,6,H
1939-03-29,1938,Stoke City,Wolverhampton Wanderers,5-3,5,3,1,1,8,2,H
1939-04-01,1938,Arsenal,Middlesbrough,1-2,1,2,1,1,3,-1,A
1939-04-01,1938,Aston Villa,Preston North End,3-0,3,0,1,1,3,3,H
1939-04-01,1938,Blackpool,Liverpool,1-1,1,1,1,1,2,0,D
1939-04-01,1938,Brentford,Leicester City,2-0,2,0,1,1,2,2,H
1939-04-01,1938,Derby County,Leeds United,1-0,1,0,1,1,1,1,H
1939-04-01,1938,Everton,Stoke City,1-1,1,1,1,1,2,0,D
1939-04-01,1938,Grimsby Town,Bolton Wanderers,1-1,1,1,1,1,2,0,D
1939-04-01,1938,Huddersfield Town,Manchester United,1-1,1,1,1,1,2,0,D
1939-04-01,1938,Portsmouth,Birmingham City,2-0,2,0,1,1,2,2,H
1939-04-01,1938,Sunderland,Charlton Athletic,1-1,1,1,1,1,2,0,D
1939-04-01,1938,Wolverhampton Wanderers,Chelsea,2-0,2,0,1,1,2,2,H
1939-04-07,1938,Blackpool,Arsenal,1-0,1,0,1,1,1,1,H
1939-04-07,1938,Brentford,Preston North End,3-1,3,1,1,1,4,2,H
1939-04-07,1938,Charlton Athletic,Chelsea,2-0,2,0,1,1,2,2,H
1939-04-07,1938,Grimsby Town,Huddersfield Town,3-3,3,3,1,1,6,0,D
1939-04-07,1938,Liverpool,Birmingham City,4-0,4,0,1,1,4,4,H
1939-04-07,1938,Manchester United,Leeds United,0-0,0,0,1,1,0,0,D
1939-04-07,1938,Portsmouth,Derby County,1-3,1,3,1,1,4,-2,A
1939-04-07,1938,Sunderland,Everton,1-2,1,2,1,1,3,-1,A
1939-04-08,1938,Birmingham City,Arsenal,1-2,1,2,1,1,3,-1,A
1939-04-08,1938,Bolton Wanderers,Sunderland,2-1,2,1,1,1,3,1,H
1939-04-08,1938,Charlton Athletic,Aston Villa,1-0,1,0,1,1,1,1,H
1939-04-08,1938,Chelsea,Everton,0-2,0,2,1,1,2,-2,A
1939-04-08,1938,Leeds United,Grimsby Town,0-1,0,1,1,1,1,-1,A
1939-04-08,1938,Leicester City,Blackpool,3-4,3,4,1,1,7,-1,A
1939-04-08,1938,Liverpool,Derby County,2-1,2,1,1,1,3,1,H
1939-04-08,1938,Manchester United,Portsmouth,1-1,1,1,1,1,2,0,D
1939-04-08,1938,Middlesbrough,Brentford,3-1,3,1,1,1,4,2,H
1939-04-08,1938,Preston North End,Wolverhampton Wanderers,4-2,4,2,1,1,6,2,H
1939-04-08,1938,Stoke City,Huddersfield Town,2-2,2,2,1,1,4,0,D
1939-04-10,1938,Arsenal,Blackpool,2-1,2,1,1,1,3,1,H
1939-04-10,1938,Birmingham City,Liverpool,0-0,0,0,1,1,0,0,D
1939-04-10,1938,Chelsea,Charlton Athletic,1-3,1,3,1,1,4,-2,A
1939-04-10,1938,Derby County,Portsmouth,0-1,0,1,1,1,1,-1,A
1939-04-10,1938,Everton,Sunderland,6-2,6,2,1,1,8,4,H
1939-04-10,1938,Leeds United,Manchester United,3-1,3,1,1,1,4,2,H
1939-04-10,1938,Middlesbrough,Leicester City,3-2,3,2,1,1,5,1,H
1939-04-10,1938,Preston North End,Brentford,2-0,2,0,1,1,2,2,H
1939-04-10,1938,Stoke City,Bolton Wanderers,4-1,4,1,1,1,5,3,H
1939-04-10,1938,Wolverhampton Wanderers,Aston Villa,2-1,2,1,1,1,3,1,H
1939-04-11,1938,Aston Villa,Wolverhampton Wanderers,2-2,2,2,1,1,4,0,D
1939-04-11,1938,Huddersfield Town,Grimsby Town,2-0,2,0,1,1,2,2,H
1939-04-11,1938,Leicester City,Middlesbrough,5-3,5,3,1,1,8,2,H
1939-04-15,1938,Arsenal,Manchester United,2-1,2,1,1,1,3,1,H
1939-04-15,1938,Aston Villa,Bolton Wanderers,1-3,1,3,1,1,4,-2,A
1939-04-15,1938,Blackpool,Middlesbrough,4-0,4,0,1,1,4,4,H
1939-04-15,1938,Brentford,Birmingham City,0-1,0,1,1,1,1,-1,A
1939-04-15,1938,Derby County,Leicester City,1-1,1,1,1,1,2,0,D
1939-04-15,1938,Everton,Preston North End,0-0,0,0,1,1,0,0,D
1939-04-15,1938,Grimsby Town,Liverpool,2-1,2,1,1,1,3,1,H
1939-04-15,1938,Huddersfield Town,Chelsea,3-1,3,1,1,1,4,2,H
1939-04-15,1938,Portsmouth,Stoke City,2-0,2,0,1,1,2,2,H
1939-04-15,1938,Sunderland,Leeds United,2-1,2,1,1,1,3,1,H
1939-04-15,1938,Wolverhampton Wanderers,Charlton Athletic,3-1,3,1,1,1,4,2,H
1939-04-19,1938,Leeds United,Huddersfield Town,2-1,2,1,1,1,3,1,H
1939-04-19,1938,Portsmouth,Grimsby Town,2-1,2,1,1,1,3,1,H
1939-04-22,1938,Birmingham City,Blackpool,2-1,2,1,1,1,3,1,H
1939-04-22,1938,Bolton Wanderers,Wolverhampton Wanderers,0-0,0,0,1,1,0,0,D
1939-04-22,1938,Charlton Athletic,Everton,2-1,2,1,1,1,3,1,H
1939-04-22,1938,Chelsea,Portsmouth,1-0,1,0,1,1,1,1,H
1939-04-22,1938,Leeds United,Aston Villa,2-0,2,0,1,1,2,2,H
1939-04-22,1938,Leicester City,Grimsby Town,0-2,0,2,1,1,2,-2,A
1939-04-22,1938,Liverpool,Sunderland,1-1,1,1,1,1,2,0,D
1939-04-22,1938,Manchester United,Brentford,3-0,3,0,1,1,3,3,H
1939-04-22,1938,Middlesbrough,Derby County,2-0,2,0,1,1,2,2,H
1939-04-22,1938,Preston North End,Huddersfield Town,3-0,3,0,1,1,3,3,H
1939-04-22,1938,Stoke City,Arsenal,1-0,1,0,1,1,1,1,H
1939-04-26,1938,Birmingham City,Chelsea,1-1,1,1,1,1,2,0,D
1939-04-26,1938,Bolton Wanderers,Preston North End,0-2,0,2,1,1,2,-2,A
1939-04-29,1938,Birmingham City,Leeds United,4-0,4,0,1,1,4,4,H
1939-04-29,1938,Bolton Wanderers,Manchester United,0-0,0,0,1,1,0,0,D
1939-04-29,1938,Brentford,Blackpool,1-1,1,1,1,1,2,0,D
1939-04-29,1938,Derby County,Arsenal,1-2,1,2,1,1,3,-1,A
1939-04-29,1938,Everton,Aston Villa,3-0,3,0,1,1,3,3,H
1939-04-29,1938,Preston North End,Chelsea,1-1,1,1,1,1,2,0,D
1939-04-29,1938,Stoke City,Charlton Athletic,1-0,1,0,1,1,1,1,H
1939-04-29,1938,Sunderland,Huddersfield Town,0-0,0,0,1,1,0,0,D
1939-05-04,1938,Leicester City,Wolverhampton Wanderers,0-2,0,2,1,1,2,-2,A
1939-05-06,1938,Arsenal,Brentford,2-0,2,0,1,1,2,2,H
1939-05-06,1938,Aston Villa,Middlesbrough,1-1,1,1,1,1,2,0,D
1939-05-06,1938,Blackpool,Portsmouth,2-1,2,1,1,1,3,1,H
1939-05-06,1938,Charlton Athletic,Preston North End,3-1,3,1,1,1,4,2,H
1939-05-06,1938,Chelsea,Bolton Wanderers,1-1,1,1,1,1,2,0,D
1939-05-06,1938,Grimsby Town,Everton,3-0,3,0,1,1,3,3,H
1939-05-06,1938,Leeds United,Stoke City,0-0,0,0,1,1,0,0,D
1939-05-06,1938,Manchester United,Liverpool,2-0,2,0,1,1,2,2,H
1939-05-06,1938,Wolverhampton Wanderers,Sunderland,0-0,0,0,1,1,0,0,D
1946-08-31,1946,Aston Villa,Middlesbrough,0-1,0,1,1,1,1,-1,A
1946-08-31,1946,Chelsea,Bolton Wanderers,4-3,4,3,1,1,7,1,H
1946-08-31,1946,Everton,Brentford,0-2,0,2,1,1,2,-2,A
1946-08-31,1946,Huddersfield Town,Blackpool,1-3,1,3,1,1,4,-2,A
1946-08-31,1946,Manchester United,Grimsby Town,2-1,2,1,1,1,3,1,H
1946-08-31,1946,Portsmouth,Blackburn Rovers,3-1,3,1,1,1,4,2,H
1946-08-31,1946,Preston North End,Leeds United,3-2,3,2,1,1,5,1,H
1946-08-31,1946,Sheffield United,Liverpool,0-1,0,1,1,1,1,-1,A
1946-08-31,1946,Stoke City,Charlton Athletic,2-2,2,2,1,1,4,0,D
1946-08-31,1946,Sunderland,Derby County,3-2,3,2,1,1,5,1,H
1946-08-31,1946,Wolverhampton Wanderers,Arsenal,6-1,6,1,1,1,7,5,H
1946-09-02,1946,Aston Villa,Everton,0-1,0,1,1,1,1,-1,A
1946-09-02,1946,Blackpool,Brentford,4-2,4,2,1,1,6,2,H
1946-09-02,1946,Stoke City,Bolton Wanderers,1-2,1,2,1,1,3,-1,A
1946-09-03,1946,Grimsby Town,Wolverhampton Wanderers,0-0,0,0,1,1,0,0,D
1946-09-04,1946,Arsenal,Blackburn Rovers,1-3,1,3,1,1,4,-2,A
1946-09-04,1946,Chelsea,Manchester United,0-3,0,3,1,1,3,-3,A
1946-09-04,1946,Derby County,Portsmouth,2-0,2,0,1,1,2,2,H
1946-09-04,1946,Leeds United,Charlton Athletic,0-2,0,2,1,1,2,-2,A
1946-09-04,1946,Liverpool,Middlesbrough,0-1,0,1,1,1,1,-1,A
1946-09-04,1946,Preston North End,Sheffield United,1-2,1,2,1,1,3,-1,A
1946-09-04,1946,Sunderland,Huddersfield Town,3-0,3,0,1,1,3,3,H
1946-09-07,1946,Arsenal,Sunderland,2-2,2,2,1,1,4,0,D
1946-09-07,1946,Blackburn Rovers,Everton,4-1,4,1,1,1,5,3,H
1946-09-07,1946,Blackpool,Wolverhampton Wanderers,2-0,2,0,1,1,2,2,H
1946-09-07,1946,Bolton Wanderers,Portsmouth,1-0,1,0,1,1,1,1,H
1946-09-07,1946,Brentford,Huddersfield Town,2-0,2,0,1,1,2,2,H
1946-09-07,1946,Charlton Athletic,Manchester United,1-3,1,3,1,1,4,-2,A
1946-09-07,1946,Derby County,Aston Villa,1-2,1,2,1,1,3,-1,A
1946-09-07,1946,Grimsby Town,Preston North End,2-3,2,3,1,1,5,-1,A
1946-09-07,1946,Leeds United,Sheffield United,2-2,2,2,1,1,4,0,D
1946-09-07,1946,Liverpool,Chelsea,7-4,7,4,1,1,11,3,H
1946-09-07,1946,Middlesbrough,Stoke City,5-4,5,4,1,1,9,1,H
1946-09-09,1946,Sheffield United,Chelsea,2-2,2,2,1,1,4,0,D
1946-09-11,1946,Bolton Wanderers,Stoke City,3-2,3,2,1,1,5,1,H
1946-09-11,1946,Charlton Athletic,Sunderland,5-0,5,0,1,1,5,5,H
1946-09-11,1946,Everton,Arsenal,3-2,3,2,1,1,5,1,H
1946-09-11,1946,Huddersfield Town,Derby County,5-2,5,2,1,1,7,3,H
1946-09-11,1946,Manchester United,Liverpool,5-0,5,0,1,1,5,5,H
1946-09-11,1946,Portsmouth,Blackpool,0-1,0,1,1,1,1,-1,A
1946-09-11,1946,Wolverhampton Wanderers,Aston Villa,1-2,1,2,1,1,3,-1,A
1946-09-14,1946,Aston Villa,Arsenal,0-2,0,2,1,1,2,-2,A
1946-09-14,1946,Bolton Wanderers,Liverpool,1-3,1,3,1,1,4,-2,A
1946-09-14,1946,Chelsea,Leeds United,3-0,3,0,1,1,3,3,H
1946-09-14,1946,Everton,Portsmouth,1-0,1,0,1,1,1,1,H
1946-09-14,1946,Huddersfield Town,Blackburn Rovers,0-1,0,1,1,1,1,-1,A
1946-09-14,1946,Manchester United,Middlesbrough,1-0,1,0,1,1,1,1,H
1946-09-14,1946,Preston North End,Charlton Athletic,5-1,5,1,1,1,6,4,H
1946-09-14,1946,Sheffield United,Grimsby Town,1-1,1,1,1,1,2,0,D
1946-09-14,1946,Stoke City,Derby County,3-2,3,2,1,1,5,1,H
1946-09-14,1946,Sunderland,Blackpool,3-2,3,2,1,1,5,1,H
1946-09-14,1946,Wolverhampton Wanderers,Brentford,1-2,1,2,1,1,3,-1,A
1946-09-16,1946,Aston Villa,Wolverhampton Wanderers,3-0,3,0,1,1,3,3,H
1946-09-16,1946,Preston North End,Bolton Wanderers,0-4,0,4,1,1,4,-4,A
1946-09-16,1946,Stoke City,Leeds United,5-2,5,2,1,1,7,3,H
1946-09-17,1946,Blackburn Rovers,Arsenal,1-2,1,2,1,1,3,-1,A
1946-09-18,1946,Brentford,Blackpool,2-1,2,1,1,1,3,1,H
1946-09-18,1946,Manchester United,Chelsea,1-1,1,1,1,1,2,0,D
1946-09-21,1946,Arsenal,Derby County,0-1,0,1,1,1,1,-1,A
1946-09-21,1946,Blackburn Rovers,Wolverhampton Wanderers,1-2,1,2,1,1,3,-1,A
1946-09-21,1946,Blackpool,Aston Villa,1-0,1,0,1,1,1,1,H
1946-09-21,1946,Brentford,Sunderland,0-3,0,3,1,1,3,-3,A
1946-09-21,1946,Charlton Athletic,Sheffield United,1-2,1,2,1,1,3,-1,A
1946-09-21,1946,Grimsby Town,Chelsea,2-1,2,1,1,1,3,1,H
1946-09-21,1946,Leeds United,Bolton Wanderers,4-0,4,0,1,1,4,4,H
1946-09-21,1946,Liverpool,Everton,0-0,0,0,1,1,0,0,D
1946-09-21,1946,Middlesbrough,Preston North End,2-0,2,0,1,1,2,2,H
1946-09-21,1946,Portsmouth,Huddersfield Town,3-1,3,1,1,1,4,2,H
1946-09-21,1946,Stoke City,Manchester United,3-2,3,2,1,1,5,1,H
1946-09-23,1946,Blackpool,Portsmouth,4-3,4,3,1,1,7,1,H
1946-09-23,1946,Wolverhampton Wanderers,Grimsby Town,2-0,2,0,1,1,2,2,H
1946-09-25,1946,Charlton Athletic,Leeds United,5-0,5,0,1,1,5,5,H
1946-09-25,1946,Huddersfield Town,Sunderland,0-0,0,0,1,1,0,0,D
1946-09-28,1946,Aston Villa,Brentford,5-2,5,2,1,1,7,3,H
1946-09-28,1946,Bolton Wanderers,Grimsby Town,1-2,1,2,1,1,3,-1,A
1946-09-28,1946,Chelsea,Charlton Athletic,2-2,2,2,1,1,4,0,D
1946-09-28,1946,Derby County,Blackpool,1-2,1,2,1,1,3,-1,A
1946-09-28,1946,Huddersfield Town,Everton,1-0,1,0,1,1,1,1,H
1946-09-28,1946,Liverpool,Leeds United,2-0,2,0,1,1,2,2,H
1946-09-28,1946,Manchester United,Arsenal,5-2,5,2,1,1,7,3,H
1946-09-28,1946,Preston North End,Stoke City,1-3,1,3,1,1,4,-2,A
1946-09-28,1946,Sheffield United,Middlesbrough,2-1,2,1,1,1,3,1,H
1946-09-28,1946,Sunderland,Blackburn Rovers,1-0,1,0,1,1,1,1,H
1946-09-28,1946,Wolverhampton Wanderers,Portsmouth,3-1,3,1,1,1,4,2,H
1946-10-05,1946,Blackburn Rovers,Aston Villa,0-1,0,1,1,1,1,-1,A
1946-10-05,1946,Blackpool,Arsenal,2-1,2,1,1,1,3,1,H
1946-10-05,1946,Brentford,Derby County,0-3,0,3,1,1,3,-3,A
1946-10-05,1946,Charlton Athletic,Bolton Wanderers,2-0,2,0,1,1,2,2,H
1946-10-05,1946,Everton,Wolverhampton Wanderers,0-2,0,2,1,1,2,-2,A
1946-10-05,1946,Grimsby Town,Liverpool,1-6,1,6,1,1,7,-5,A
1946-10-05,1946,Leeds United,Huddersfield Town,5-0,5,0,1,1,5,5,H
1946-10-05,1946,Manchester United,Preston North End,1-1,1,1,1,1,2,0,D
1946-10-05,1946,Middlesbrough,Chelsea,3-2,3,2,1,1,5,1,H
1946-10-05,1946,Portsmouth,Sunderland,4-1,4,1,1,1,5,3,H
1946-10-05,1946,Stoke City,Sheffield United,3-0,3,0,1,1,3,3,H
1946-10-09,1946,Middlesbrough,Liverpool,2-2,2,2,1,1,4,0,D
1946-10-12,1946,Arsenal,Brentford,2-2,2,2,1,1,4,0,D
1946-10-12,1946,Aston Villa,Portsmouth,1-1,1,1,1,1,2,0,D
1946-10-12,1946,Bolton Wanderers,Middlesbrough,1-1,1,1,1,1,2,0,D
1946-10-12,1946,Chelsea,Stoke City,2-5,2,5,1,1,7,-3,A
1946-10-12,1946,Derby County,Blackburn Rovers,2-1,2,1,1,1,3,1,H
1946-10-12,1946,Leeds United,Grimsby Town,1-0,1,0,1,1,1,1,H
1946-10-12,1946,Liverpool,Charlton Athletic,1-1,1,1,1,1,2,0,D
1946-10-12,1946,Preston North End,Blackpool,2-0,2,0,1,1,2,2,H
1946-10-12,1946,Sheffield United,Manchester United,2-2,2,2,1,1,4,0,D
1946-10-12,1946,Sunderland,Everton,4-1,4,1,1,1,5,3,H
1946-10-12,1946,Wolverhampton Wanderers,Huddersfield Town,6-1,6,1,1,1,7,5,H
1946-10-19,1946,Arsenal,Stoke City,1-0,1,0,1,1,1,1,H
1946-10-19,1946,Aston Villa,Charlton Athletic,4-0,4,0,1,1,4,4,H
1946-10-19,1946,Blackburn Rovers,Sheffield United,2-0,2,0,1,1,2,2,H
1946-10-19,1946,Blackpool,Manchester United,3-1,3,1,1,1,4,2,H
1946-10-19,1946,Brentford,Preston North End,2-3,2,3,1,1,5,-1,A
1946-10-19,1946,Derby County,Middlesbrough,1-1,1,1,1,1,2,0,D
1946-10-19,1946,Everton,Bolton Wanderers,2-1,2,1,1,1,3,1,H
1946-10-19,1946,Huddersfield Town,Liverpool,1-4,1,4,1,1,5,-3,A
1946-10-19,1946,Portsmouth,Chelsea,0-2,0,2,1,1,2,-2,A
1946-10-19,1946,Sunderland,Grimsby Town,1-2,1,2,1,1,3,-1,A
1946-10-19,1946,Wolverhampton Wanderers,Leeds United,1-0,1,0,1,1,1,1,H
1946-10-26,1946,Bolton Wanderers,Blackpool,1-1,1,1,1,1,2,0,D
1946-10-26,1946,Charlton Athletic,Everton,4-1,4,1,1,1,5,3,H
1946-10-26,1946,Chelsea,Arsenal,2-1,2,1,1,1,3,1,H
1946-10-26,1946,Grimsby Town,Portsmouth,3-2,3,2,1,1,5,1,H
1946-10-26,1946,Leeds United,Blackburn Rovers,0-1,0,1,1,1,1,-1,A
1946-10-26,1946,Liverpool,Brentford,1-0,1,0,1,1,1,1,H
1946-10-26,1946,Manchester United,Sunderland,0-3,0,3,1,1,3,-3,A
1946-10-26,1946,Middlesbrough,Huddersfield Town,4-1,4,1,1,1,5,3,H
1946-10-26,1946,Preston North End,Aston Villa,3-1,3,1,1,1,4,2,H
1946-10-26,1946,Sheffield United,Derby County,3-2,3,2,1,1,5,1,H
1946-10-26,1946,Stoke City,Wolverhampton Wanderers,0-3,0,3,1,1,3,-3,A
1946-11-02,1946,Arsenal,Sheffield United,2-3,2,3,1,1,5,-1,A
1946-11-02,1946,Aston Villa,Manchester United,0-0,0,0,1,1,0,0,D
1946-11-02,1946,Blackburn Rovers,Liverpool,0-0,0,0,1,1,0,0,D
1946-11-02,1946,Blackpool,Chelsea,1-0,1,0,1,1,1,1,H
1946-11-02,1946,Brentford,Bolton Wanderers,1-0,1,0,1,1,1,1,H
1946-11-02,1946,Derby County,Preston North End,2-2,2,2,1,1,4,0,D
1946-11-02,1946,Everton,Grimsby Town,3-3,3,3,1,1,6,0,D
1946-11-02,1946,Huddersfield Town,Charlton Athletic,5-1,5,1,1,1,6,4,H
1946-11-02,1946,Portsmouth,Leeds United,4-1,4,1,1,1,5,3,H
1946-11-02,1946,Sunderland,Stoke City,0-1,0,1,1,1,1,-1,A
1946-11-02,1946,Wolverhampton Wanderers,Middlesbrough,2-4,2,4,1,1,6,-2,A
1946-11-09,1946,Bolton Wanderers,Blackburn Rovers,0-0,0,0,1,1,0,0,D
1946-11-09,1946,Charlton Athletic,Wolverhampton Wanderers,1-4,1,4,1,1,5,-3,A
1946-11-09,1946,Chelsea,Brentford,3-2,3,2,1,1,5,1,H
1946-11-09,1946,Grimsby Town,Huddersfield Town,1-0,1,0,1,1,1,1,H
1946-11-09,1946,Leeds United,Everton,2-1,2,1,1,1,3,1,H
1946-11-09,1946,Liverpool,Portsmouth,3-0,3,0,1,1,3,3,H
1946-11-09,1946,Manchester United,Derby County,4-1,4,1,1,1,5,3,H
1946-11-09,1946,Middlesbrough,Sunderland,1-3,1,3,1,1,4,-2,A
1946-11-09,1946,Preston North End,Arsenal,2-0,2,0,1,1,2,2,H
1946-11-09,1946,Sheffield United,Blackpool,4-2,4,2,1,1,6,2,H
1946-11-09,1946,Stoke City,Aston Villa,0-0,0,0,1,1,0,0,D
1946-11-16,1946,Arsenal,Leeds United,4-2,4,2,1,1,6,2,H
1946-11-16,1946,Aston Villa,Bolton Wanderers,1-1,1,1,1,1,2,0,D
1946-11-16,1946,Blackburn Rovers,Middlesbrough,1-2,1,2,1,1,3,-1,A
1946-11-16,1946,Blackpool,Grimsby Town,2-3,2,3,1,1,5,-1,A
1946-11-16,1946,Brentford,Charlton Athletic,1-4,1,4,1,1,5,-3,A
1946-11-16,1946,Derby County,Liverpool,1-4,1,4,1,1,5,-3,A
1946-11-16,1946,Everton,Manchester United,2-2,2,2,1,1,4,0,D
1946-11-16,1946,Huddersfield Town,Preston North End,3-0,3,0,1,1,3,3,H
1946-11-16,1946,Portsmouth,Stoke City,1-3,1,3,1,1,4,-2,A
1946-11-16,1946,Sunderland,Chelsea,1-2,1,2,1,1,3,-1,A
1946-11-16,1946,Wolverhampton Wanderers,Sheffield United,3-1,3,1,1,1,4,2,H
1946-11-23,1946,Bolton Wanderers,Derby County,5-1,5,1,1,1,6,4,H
1946-11-23,1946,Charlton Athletic,Blackburn Rovers,0-2,0,2,1,1,2,-2,A
1946-11-23,1946,Chelsea,Aston Villa,1-3,1,3,1,1,4,-2,A
1946-11-23,1946,Grimsby Town,Brentford,2-2,2,2,1,1,4,0,D
1946-11-23,1946,Leeds United,Blackpool,4-2,4,2,1,1,6,2,H
1946-11-23,1946,Liverpool,Arsenal,4-2,4,2,1,1,6,2,H
1946-11-23,1946,Manchester United,Huddersfield Town,5-2,5,2,1,1,7,3,H
1946-11-23,1946,Middlesbrough,Portsmouth,3-3,3,3,1,1,6,0,D
1946-11-23,1946,Preston North End,Wolverhampton Wanderers,2-2,2,2,1,1,4,0,D
1946-11-23,1946,Sheffield United,Sunderland,4-2,4,2,1,1,6,2,H
1946-11-23,1946,Stoke City,Everton,2-1,2,1,1,1,3,1,H
1946-11-30,1946,Arsenal,Bolton Wanderers,2-2,2,2,1,1,4,0,D
1946-11-30,1946,Aston Villa,Sheffield United,2-3,2,3,1,1,5,-1,A
1946-11-30,1946,Blackburn Rovers,Grimsby Town,1-1,1,1,1,1,2,0,D
1946-11-30,1946,Blackpool,Liverpool,3-2,3,2,1,1,5,1,H
1946-11-30,1946,Brentford,Leeds United,1-1,1,1,1,1,2,0,D
1946-11-30,1946,Derby County,Chelsea,3-1,3,1,1,1,4,2,H
1946-11-30,1946,Everton,Middlesbrough,2-1,2,1,1,1,3,1,H
1946-11-30,1946,Huddersfield Town,Stoke City,1-0,1,0,1,1,1,1,H
1946-11-30,1946,Portsmouth,Charlton Athletic,3-0,3,0,1,1,3,3,H
1946-11-30,1946,Sunderland,Preston North End,0-2,0,2,1,1,2,-2,A
1946-11-30,1946,Wolverhampton Wanderers,Manchester United,3-2,3,2,1,1,5,1,H
1946-12-07,1946,Bolton Wanderers,Huddersfield Town,4-0,4,0,1,1,4,4,H
1946-12-07,1946,Charlton Athletic,Derby County,2-4,2,4,1,1,6,-2,A
1946-12-07,1946,Chelsea,Everton,1-1,1,1,1,1,2,0,D
1946-12-07,1946,Grimsby Town,Aston Villa,0-3,0,3,1,1,3,-3,A
1946-12-07,1946,Leeds United,Sunderland,1-1,1,1,1,1,2,0,D
1946-12-07,1946,Liverpool,Wolverhampton Wanderers,1-5,1,5,1,1,6,-4,A
1946-12-07,1946,Manchester United,Brentford,4-1,4,1,1,1,5,3,H
1946-12-07,1946,Middlesbrough,Arsenal,2-0,2,0,1,1,2,2,H
1946-12-07,1946,Preston North End,Blackburn Rovers,4-0,4,0,1,1,4,4,H
1946-12-07,1946,Stoke City,Blackpool,4-1,4,1,1,1,5,3,H
1946-12-14,1946,Arsenal,Charlton Athletic,1-0,1,0,1,1,1,1,H
1946-12-14,1946,Aston Villa,Leeds United,2-1,2,1,1,1,3,1,H
1946-12-14,1946,Blackburn Rovers,Manchester United,2-1,2,1,1,1,3,1,H
1946-12-14,1946,Blackpool,Middlesbrough,0-5,0,5,1,1,5,-5,A
1946-12-14,1946,Brentford,Stoke City,1-4,1,4,1,1,5,-3,A
1946-12-14,1946,Derby County,Grimsby Town,4-1,4,1,1,1,5,3,H
1946-12-14,1946,Everton,Sheffield United,2-3,2,3,1,1,5,-1,A
1946-12-14,1946,Huddersfield Town,Chelsea,1-4,1,4,1,1,5,-3,A
1946-12-14,1946,Portsmouth,Preston North End,4-4,4,4,1,1,8,0,D
1946-12-14,1946,Sunderland,Liverpool,1-4,1,4,1,1,5,-3,A
1946-12-14,1946,Wolverhampton Wanderers,Bolton Wanderers,5-0,5,0,1,1,5,5,H
1946-12-21,1946,Bolton Wanderers,Sunderland,0-1,0,1,1,1,1,-1,A
1946-12-21,1946,Charlton Athletic,Blackpool,0-1,0,1,1,1,1,-1,A
1946-12-21,1946,Chelsea,Wolverhampton Wanderers,1-2,1,2,1,1,3,-1,A
1946-12-21,1946,Grimsby Town,Arsenal,0-0,0,0,1,1,0,0,D
1946-12-21,1946,Leeds United,Derby County,1-2,1,2,1,1,3,-1,A
1946-12-21,1946,Liverpool,Aston Villa,4-1,4,1,1,1,5,3,H
1946-12-21,1946,Middlesbrough,Brentford,2-0,2,0,1,1,2,2,H
1946-12-21,1946,Preston North End,Everton,2-1,2,1,1,1,3,1,H
1946-12-21,1946,Sheffield United,Huddersfield Town,2-2,2,2,1,1,4,0,D
1946-12-21,1946,Stoke City,Blackburn Rovers,0-0,0,0,1,1,0,0,D
1946-12-25,1946,Arsenal,Portsmouth,2-1,2,1,1,1,3,1,H
1946-12-25,1946,Aston Villa,Huddersfield Town,2-2,2,2,1,1,4,0,D
1946-12-25,1946,Blackburn Rovers,Blackpool,1-1,1,1,1,1,2,0,D
1946-12-25,1946,Bolton Wanderers,Manchester United,2-2,2,2,1,1,4,0,D
1946-12-25,1946,Chelsea,Preston North End,1-2,1,2,1,1,3,-1,A
1946-12-25,1946,Everton,Derby County,4-1,4,1,1,1,5,3,H
1946-12-25,1946,Grimsby Town,Charlton Athletic,3-1,3,1,1,1,4,2,H
1946-12-25,1946,Leeds United,Middlesbrough,3-3,3,3,1,1,6,0,D
1946-12-25,1946,Sheffield United,Brentford,6-1,6,1,1,1,7,5,H
1946-12-25,1946,Stoke City,Liverpool,2-1,2,1,1,1,3,1,H
1946-12-25,1946,Sunderland,Wolverhampton Wanderers,0-1,0,1,1,1,1,-1,A
1946-12-26,1946,Blackpool,Blackburn Rovers,1-0,1,0,1,1,1,1,H
1946-12-26,1946,Brentford,Sheffield United,2-1,2,1,1,1,3,1,H
1946-12-26,1946,Charlton Athletic,Grimsby Town,0-0,0,0,1,1,0,0,D
1946-12-26,1946,Derby County,Everton,5-1,5,1,1,1,6,4,H
1946-12-26,1946,Huddersfield Town,Aston Villa,1-0,1,0,1,1,1,1,H
1946-12-26,1946,Liverpool,Stoke City,2-0,2,0,1,1,2,2,H
1946-12-26,1946,Manchester United,Bolton Wanderers,1-0,1,0,1,1,1,1,H
1946-12-26,1946,Middlesbrough,Leeds United,3-0,3,0,1,1,3,3,H
1946-12-26,1946,Portsmouth,Arsenal,0-2,0,2,1,1,2,-2,A
1946-12-26,1946,Preston North End,Chelsea,1-1,1,1,1,1,2,0,D
1946-12-26,1946,Wolverhampton Wanderers,Sunderland,2-1,2,1,1,1,3,1,H
1946-12-28,1946,Arsenal,Wolverhampton Wanderers,1-1,1,1,1,1,2,0,D
1946-12-28,1946,Blackburn Rovers,Portsmouth,0-1,0,1,1,1,1,-1,A
1946-12-28,1946,Blackpool,Huddersfield Town,2-1,2,1,1,1,3,1,H
1946-12-28,1946,Bolton Wanderers,Chelsea,1-1,1,1,1,1,2,0,D
1946-12-28,1946,Brentford,Everton,1-1,1,1,1,1,2,0,D
1946-12-28,1946,Charlton Athletic,Stoke City,1-0,1,0,1,1,1,1,H
1946-12-28,1946,Derby County,Sunderland,5-1,5,1,1,1,6,4,H
1946-12-28,1946,Grimsby Town,Manchester United,0-0,0,0,1,1,0,0,D
1946-12-28,1946,Leeds United,Preston North End,0-3,0,3,1,1,3,-3,A
1946-12-28,1946,Liverpool,Sheffield United,1-2,1,2,1,1,3,-1,A
1946-12-28,1946,Middlesbrough,Aston Villa,1-2,1,2,1,1,3,-1,A
1947-01-01,1946,Blackburn Rovers,Brentford,0-3,0,3,1,1,3,-3,A
1947-01-01,1946,Bolton Wanderers,Preston North End,1-2,1,2,1,1,3,-1,A
1947-01-01,1946,Everton,Aston Villa,2-0,2,0,1,1,2,2,H
1947-01-01,1946,Middlesbrough,Grimsby Town,3-0,3,0,1,1,3,3,H
1947-01-04,1946,Aston Villa,Derby County,2-0,2,0,1,1,2,2,H
1947-01-04,1946,Chelsea,Liverpool,3-1,3,1,1,1,4,2,H
1947-01-04,1946,Everton,Blackburn Rovers,1-0,1,0,1,1,1,1,H
1947-01-04,1946,Huddersfield Town,Brentford,3-0,3,0,1,1,3,3,H
1947-01-04,1946,Manchester United,Charlton Athletic,4-1,4,1,1,1,5,3,H
1947-01-04,1946,Portsmouth,Bolton Wanderers,2-0,2,0,1,1,2,2,H
1947-01-04,1946,Preston North End,Grimsby Town,3-0,3,0,1,1,3,3,H
1947-01-04,1946,Sheffield United,Leeds United,6-2,6,2,1,1,8,4,H
1947-01-04,1946,Stoke City,Middlesbrough,3-1,3,1,1,1,4,2,H
1947-01-04,1946,Sunderland,Arsenal,1-4,1,4,1,1,5,-3,A
1947-01-04,1946,Wolverhampton Wanderers,Blackpool,3-1,3,1,1,1,4,2,H
1947-01-18,1946,Arsenal,Aston Villa,0-2,0,2,1,1,2,-2,A
1947-01-18,1946,Blackburn Rovers,Huddersfield Town,2-2,2,2,1,1,4,0,D
1947-01-18,1946,Blackpool,Sunderland,0-5,0,5,1,1,5,-5,A
1947-01-18,1946,Brentford,Wolverhampton Wanderers,4-1,4,1,1,1,5,3,H
1947-01-18,1946,Charlton Athletic,Preston North End,0-0,0,0,1,1,0,0,D
1947-01-18,1946,Derby County,Stoke City,3-0,3,0,1,1,3,3,H
1947-01-18,1946,Grimsby Town,Sheffield United,2-1,2,1,1,1,3,1,H
1947-01-18,1946,Leeds United,Chelsea,2-1,2,1,1,1,3,1,H
1947-01-18,1946,Liverpool,Bolton Wanderers,0-3,0,3,1,1,3,-3,A
1947-01-18,1946,Middlesbrough,Manchester United,2-4,2,4,1,1,6,-2,A
1947-01-18,1946,Portsmouth,Everton,2-1,2,1,1,1,3,1,H
1947-01-25,1946,Aston Villa,Blackpool,1-1,1,1,1,1,2,0,D
1947-01-29,1946,Everton,Liverpool,1-0,1,0,1,1,1,1,H
1947-01-29,1946,Huddersfield Town,Portsmouth,1-2,1,2,1,1,3,-1,A
1947-01-29,1946,Preston North End,Middlesbrough,0-1,0,1,1,1,1,-1,A
1947-02-01,1946,Arsenal,Manchester United,6-2,6,2,1,1,8,4,H
1947-02-01,1946,Blackburn Rovers,Sunderland,1-2,1,2,1,1,3,-1,A
1947-02-01,1946,Blackpool,Derby County,2-1,2,1,1,1,3,1,H
1947-02-01,1946,Brentford,Aston Villa,0-2,0,2,1,1,2,-2,A
1947-02-01,1946,Charlton Athletic,Chelsea,2-3,2,3,1,1,5,-1,A
1947-02-01,1946,Everton,Huddersfield Town,1-0,1,0,1,1,1,1,H
1947-02-01,1946,Grimsby Town,Bolton Wanderers,2-2,2,2,1,1,4,0,D
1947-02-01,1946,Leeds United,Liverpool,1-2,1,2,1,1,3,-1,A
1947-02-01,1946,Middlesbrough,Sheffield United,2-4,2,4,1,1,6,-2,A
1947-02-01,1946,Stoke City,Preston North End,5-0,5,0,1,1,5,5,H
1947-02-03,1946,Bolton Wanderers,Leeds United,2-0,2,0,1,1,2,2,H
1947-02-05,1946,Manchester United,Stoke City,1-1,1,1,1,1,2,0,D
1947-02-08,1946,Arsenal,Blackpool,1-1,1,1,1,1,2,0,D
1947-02-08,1946,Chelsea,Grimsby Town,0-0,0,0,1,1,0,0,D
1947-02-08,1946,Sunderland,Portsmouth,0-0,0,0,1,1,0,0,D
1947-02-12,1946,Liverpool,Grimsby Town,5-0,5,0,1,1,5,5,H
1947-02-15,1946,Blackburn Rovers,Derby County,1-1,1,1,1,1,2,0,D
1947-02-15,1946,Blackpool,Preston North End,4-0,4,0,1,1,4,4,H
1947-02-15,1946,Everton,Sunderland,4-2,4,2,1,1,6,2,H
1947-02-15,1946,Middlesbrough,Bolton Wanderers,3-1,3,1,1,1,4,2,H
1947-02-15,1946,Portsmouth,Aston Villa,3-2,3,2,1,1,5,1,H
1947-02-15,1946,Stoke City,Chelsea,6-1,6,1,1,1,7,5,H
1947-02-19,1946,Bolton Wanderers,Charlton Athletic,0-1,0,1,1,1,1,-1,A
1947-02-22,1946,Bolton Wanderers,Everton,0-2,0,2,1,1,2,-2,A
1947-02-22,1946,Charlton Athletic,Aston Villa,1-1,1,1,1,1,2,0,D
1947-02-22,1946,Leeds United,Wolverhampton Wanderers,0-1,0,1,1,1,1,-1,A
1947-02-22,1946,Liverpool,Huddersfield Town,1-0,1,0,1,1,1,1,H
1947-02-22,1946,Manchester United,Blackpool,3-0,3,0,1,1,3,3,H
1947-02-22,1946,Middlesbrough,Derby County,1-0,1,0,1,1,1,1,H
1947-02-22,1946,Preston North End,Brentford,5-2,5,2,1,1,7,3,H
1947-02-22,1946,Sheffield United,Blackburn Rovers,0-1,0,1,1,1,1,-1,A
1947-02-22,1946,Stoke City,Arsenal,3-1,3,1,1,1,4,2,H
1947-03-01,1946,Arsenal,Chelsea,1-2,1,2,1,1,3,-1,A
1947-03-01,1946,Blackburn Rovers,Leeds United,1-0,1,0,1,1,1,1,H
1947-03-01,1946,Blackpool,Bolton Wanderers,0-1,0,1,1,1,1,-1,A
1947-03-01,1946,Derby County,Brentford,2-1,2,1,1,1,3,1,H
1947-03-01,1946,Portsmouth,Grimsby Town,4-1,4,1,1,1,5,3,H
1947-03-01,1946,Sunderland,Manchester United,1-1,1,1,1,1,2,0,D
1947-03-01,1946,Wolverhampton Wanderers,Stoke City,3-0,3,0,1,1,3,3,H
1947-03-08,1946,Charlton Athletic,Huddersfield Town,0-3,0,3,1,1,3,-3,A
1947-03-08,1946,Chelsea,Blackpool,1-4,1,4,1,1,5,-3,A
1947-03-08,1946,Grimsby Town,Everton,2-2,2,2,1,1,4,0,D
1947-03-08,1946,Liverpool,Blackburn Rovers,2-1,2,1,1,1,3,1,H
1947-03-08,1946,Manchester United,Aston Villa,2-1,2,1,1,1,3,1,H
1947-03-08,1946,Middlesbrough,Wolverhampton Wanderers,1-1,1,1,1,1,2,0,D
1947-03-15,1946,Arsenal,Preston North End,4-1,4,1,1,1,5,3,H
1947-03-15,1946,Blackburn Rovers,Bolton Wanderers,2-1,2,1,1,1,3,1,H
1947-03-15,1946,Blackpool,Sheffield United,4-2,4,2,1,1,6,2,H
1947-03-15,1946,Brentford,Chelsea,0-2,0,2,1,1,2,-2,A
1947-03-15,1946,Derby County,Manchester United,4-3,4,3,1,1,7,1,H
1947-03-15,1946,Huddersfield Town,Grimsby Town,3-2,3,2,1,1,5,1,H
1947-03-15,1946,Portsmouth,Liverpool,1-2,1,2,1,1,3,-1,A
1947-03-15,1946,Sunderland,Middlesbrough,1-0,1,0,1,1,1,1,H
1947-03-15,1946,Wolverhampton Wanderers,Charlton Athletic,2-0,2,0,1,1,2,2,H
1947-03-22,1946,Bolton Wanderers,Aston Villa,2-1,2,1,1,1,3,1,H
1947-03-22,1946,Charlton Athletic,Brentford,3-0,3,0,1,1,3,3,H
1947-03-22,1946,Chelsea,Sunderland,2-1,2,1,1,1,3,1,H
1947-03-22,1946,Grimsby Town,Blackpool,2-3,2,3,1,1,5,-1,A
1947-03-22,1946,Leeds United,Arsenal,1-1,1,1,1,1,2,0,D
1947-03-22,1946,Liverpool,Derby County,1-1,1,1,1,1,2,0,D
1947-03-22,1946,Manchester United,Everton,3-0,3,0,1,1,3,3,H
1947-03-22,1946,Middlesbrough,Blackburn Rovers,0-1,0,1,1,1,1,-1,A
1947-03-22,1946,Preston North End,Huddersfield Town,6-2,6,2,1,1,8,4,H
1947-03-22,1946,Sheffield United,Wolverhampton Wanderers,2-0,2,0,1,1,2,2,H
1947-03-22,1946,Stoke City,Portsmouth,1-1,1,1,1,1,2,0,D
1947-03-29,1946,Aston Villa,Chelsea,2-0,2,0,1,1,2,2,H
1947-03-29,1946,Blackpool,Leeds United,3-0,3,0,1,1,3,3,H
1947-03-29,1946,Brentford,Grimsby Town,0-1,0,1,1,1,1,-1,A
1947-03-29,1946,Derby County,Bolton Wanderers,1-3,1,3,1,1,4,-2,A
1947-03-29,1946,Everton,Stoke City,2-2,2,2,1,1,4,0,D
1947-03-29,1946,Huddersfield Town,Manchester United,2-2,2,2,1,1,4,0,D
1947-03-29,1946,Portsmouth,Middlesbrough,3-1,3,1,1,1,4,2,H
1947-03-29,1946,Sunderland,Sheffield United,2-1,2,1,1,1,3,1,H
1947-03-29,1946,Wolverhampton Wanderers,Preston North End,4-1,4,1,1,1,5,3,H
1947-04-04,1946,Arsenal,Huddersfield Town,1-2,1,2,1,1,3,-1,A
1947-04-04,1946,Bolton Wanderers,Sheffield United,3-2,3,2,1,1,5,1,H
1947-04-04,1946,Brentford,Portsmouth,1-3,1,3,1,1,4,-2,A
1947-04-04,1946,Charlton Athletic,Middlesbrough,3-3,3,3,1,1,6,0,D
1947-04-04,1946,Chelsea,Blackburn Rovers,0-2,0,2,1,1,2,-2,A
1947-04-04,1946,Everton,Blackpool,1-1,1,1,1,1,2,0,D
1947-04-04,1946,Grimsby Town,Stoke City,2-5,2,5,1,1,7,-3,A
1947-04-04,1946,Preston North End,Liverpool,0-0,0,0,1,1,0,0,D
1947-04-04,1946,Sunderland,Aston Villa,4-1,4,1,1,1,5,3,H
1947-04-05,1946,Bolton Wanderers,Arsenal,1-3,1,3,1,1,4,-2,A
1947-04-05,1946,Charlton Athletic,Portsmouth,0-0,0,0,1,1,0,0,D
1947-04-05,1946,Chelsea,Derby County,3-0,3,0,1,1,3,3,H
1947-04-05,1946,Grimsby Town,Blackburn Rovers,2-1,2,1,1,1,3,1,H
1947-04-05,1946,Leeds United,Brentford,1-2,1,2,1,1,3,-1,A
1947-04-05,1946,Liverpool,Blackpool,2-3,2,3,1,1,5,-1,A
1947-04-05,1946,Manchester United,Wolverhampton Wanderers,3-1,3,1,1,1,4,2,H
1947-04-05,1946,Middlesbrough,Everton,4-0,4,0,1,1,4,4,H
1947-04-05,1946,Preston North End,Sunderland,2-2,2,2,1,1,4,0,D
1947-04-05,1946,Sheffield United,Aston Villa,1-2,1,2,1,1,3,-1,A
1947-04-05,1946,Stoke City,Huddersfield Town,3-0,3,0,1,1,3,3,H
1947-04-07,1946,Blackburn Rovers,Chelsea,1-2,1,2,1,1,3,-1,A
1947-04-07,1946,Blackpool,Everton,0-3,0,3,1,1,3,-3,A
1947-04-07,1946,Derby County,Wolverhampton Wanderers,2-1,2,1,1,1,3,1,H
1947-04-07,1946,Huddersfield Town,Arsenal,0-0,0,0,1,1,0,0,D
1947-04-07,1946,Liverpool,Preston North End,3-0,3,0,1,1,3,3,H
1947-04-07,1946,Manchester United,Leeds United,3-1,3,1,1,1,4,2,H
1947-04-07,1946,Middlesbrough,Charlton Athletic,1-2,1,2,1,1,3,-1,A
1947-04-07,1946,Portsmouth,Brentford,3-0,3,0,1,1,3,3,H
1947-04-07,1946,Sheffield United,Bolton Wanderers,4-2,4,2,1,1,6,2,H
1947-04-07,1946,Stoke City,Grimsby Town,3-0,3,0,1,1,3,3,H
1947-04-08,1946,Aston Villa,Sunderland,4-0,4,0,1,1,4,4,H
1947-04-08,1946,Leeds United,Manchester United,0-2,0,2,1,1,2,-2,A
1947-04-08,1946,Wolverhampton Wanderers,Derby County,7-2,7,2,1,1,9,5,H
1947-04-12,1946,Arsenal,Middlesbrough,4-0,4,0,1,1,4,4,H
1947-04-12,1946,Aston Villa,Grimsby Town,3-3,3,3,1,1,6,0,D
1947-04-12,1946,Blackburn Rovers,Preston North End,1-2,1,2,1,1,3,-1,A
1947-04-12,1946,Blackpool,Stoke City,0-2,0,2,1,1,2,-2,A
1947-04-12,1946,Brentford,Manchester United,0-0,0,0,1,1,0,0,D
1947-04-12,1946,Derby County,Charlton Athletic,1-0,1,0,1,1,1,1,H
1947-04-12,1946,Everton,Chelsea,2-0,2,0,1,1,2,2,H
1947-04-12,1946,Huddersfield Town,Bolton Wanderers,1-0,1,0,1,1,1,1,H
1947-04-12,1946,Portsmouth,Sheffield United,0-0,0,0,1,1,0,0,D
1947-04-12,1946,Sunderland,Leeds United,1-0,1,0,1,1,1,1,H
1947-04-19,1946,Bolton Wanderers,Wolverhampton Wanderers,0-3,0,3,1,1,3,-3,A
1947-04-19,1946,Charlton Athletic,Arsenal,2-2,2,2,1,1,4,0,D
1947-04-19,1946,Chelsea,Huddersfield Town,1-0,1,0,1,1,1,1,H
1947-04-19,1946,Grimsby Town,Derby County,2-0,2,0,1,1,2,2,H
1947-04-19,1946,Leeds United,Aston Villa,1-1,1,1,1,1,2,0,D
1947-04-19,1946,Liverpool,Sunderland,1-0,1,0,1,1,1,1,H
1947-04-19,1946,Manchester United,Blackburn Rovers,4-0,4,0,1,1,4,4,H
1947-04-19,1946,Middlesbrough,Blackpool,1-2,1,2,1,1,3,-1,A
1947-04-19,1946,Preston North End,Portsmouth,1-1,1,1,1,1,2,0,D
1947-04-19,1946,Sheffield United,Everton,2-0,2,0,1,1,2,2,H
1947-04-19,1946,Stoke City,Brentford,3-1,3,1,1,1,4,2,H
1947-04-26,1946,Arsenal,Grimsby Town,5-3,5,3,1,1,8,2,H
1947-04-26,1946,Aston Villa,Liverpool,1-2,1,2,1,1,3,-1,A
1947-04-26,1946,Blackburn Rovers,Stoke City,0-2,0,2,1,1,2,-2,A
1947-04-26,1946,Brentford,Middlesbrough,0-0,0,0,1,1,0,0,D
1947-04-26,1946,Derby County,Leeds United,2-1,2,1,1,1,3,1,H
1947-04-26,1946,Everton,Preston North End,2-0,2,0,1,1,2,2,H
1947-04-26,1946,Huddersfield Town,Sheffield United,1-1,1,1,1,1,2,0,D
1947-04-26,1946,Portsmouth,Manchester United,0-1,0,1,1,1,1,-1,A
1947-04-26,1946,Sunderland,Bolton Wanderers,3-1,3,1,1,1,4,2,H
1947-04-26,1946,Wolverhampton Wanderers,Chelsea,6-4,6,4,1,1,10,2,H
1947-05-03,1946,Brentford,Blackburn Rovers,0-3,0,3,1,1,3,-3,A
1947-05-03,1946,Chelsea,Sheffield United,1-4,1,4,1,1,5,-3,A
1947-05-03,1946,Derby County,Huddersfield Town,1-0,1,0,1,1,1,1,H
1947-05-03,1946,Grimsby Town,Middlesbrough,4-0,4,0,1,1,4,4,H
1947-05-03,1946,Leeds United,Stoke City,1-2,1,2,1,1,3,-1,A
1947-05-03,1946,Liverpool,Manchester United,1-0,1,0,1,1,1,1,H
1947-05-03,1946,Portsmouth,Wolverhampton Wanderers,1-1,1,1,1,1,2,0,D
1947-05-03,1946,Sunderland,Charlton Athletic,1-1,1,1,1,1,2,0,D
1947-05-10,1946,Aston Villa,Blackburn Rovers,2-1,2,1,1,1,3,1,H
1947-05-10,1946,Bolton Wanderers,Brentford,1-0,1,0,1,1,1,1,H
1947-05-10,1946,Charlton Athletic,Liverpool,1-3,1,3,1,1,4,-2,A
1947-05-10,1946,Chelsea,Middlesbrough,2-0,2,0,1,1,2,2,H
1947-05-10,1946,Derby County,Arsenal,0-1,0,1,1,1,1,-1,A
1947-05-10,1946,Grimsby Town,Sunderland,1-2,1,2,1,1,3,-1,A
1947-05-10,1946,Huddersfield Town,Leeds United,1-0,1,0,1,1,1,1,H
1947-05-10,1946,Preston North End,Manchester United,1-1,1,1,1,1,2,0,D
1947-05-10,1946,Sheffield United,Portsmouth,3-1,3,1,1,1,4,2,H
1947-05-10,1946,Wolverhampton Wanderers,Everton,2-3,2,3,1,1,5,-1,A
1947-05-17,1946,Aston Villa,Preston North End,4-2,4,2,1,1,6,2,H
1947-05-17,1946,Blackpool,Charlton Athletic,0-0,0,0,1,1,0,0,D
1947-05-17,1946,Brentford,Liverpool,1-1,1,1,1,1,2,0,D
1947-05-17,1946,Derby County,Sheffield United,1-2,1,2,1,1,3,-1,A
1947-05-17,1946,Grimsby Town,Leeds United,4-1,4,1,1,1,5,3,H
1947-05-17,1946,Huddersfield Town,Middlesbrough,3-1,3,1,1,1,4,2,H
1947-05-17,1946,Manchester United,Portsmouth,3-0,3,0,1,1,3,3,H
1947-05-17,1946,Stoke City,Sunderland,0-0,0,0,1,1,0,0,D
1947-05-17,1946,Wolverhampton Wanderers,Blackburn Rovers,3-3,3,3,1,1,6,0,D
1947-05-24,1946,Arsenal,Liverpool,1-2,1,2,1,1,3,-1,A
1947-05-24,1946,Everton,Charlton Athletic,1-1,1,1,1,1,2,0,D
1947-05-24,1946,Leeds United,Portsmouth,0-1,0,1,1,1,1,-1,A
1947-05-24,1946,Sheffield United,Preston North End,2-3,2,3,1,1,5,-1,A
1947-05-24,1946,Sunderland,Brentford,2-1,2,1,1,1,3,1,H
1947-05-26,1946,Aston Villa,Stoke City,0-1,0,1,1,1,1,-1,A
1947-05-26,1946,Blackburn Rovers,Charlton Athletic,1-0,1,0,1,1,1,1,H
1947-05-26,1946,Brentford,Arsenal,0-1,0,1,1,1,1,-1,A
1947-05-26,1946,Chelsea,Portsmouth,0-3,0,3,1,1,3,-3,A
1947-05-26,1946,Everton,Leeds United,4-1,4,1,1,1,5,3,H
1947-05-26,1946,Huddersfield Town,Wolverhampton Wanderers,0-1,0,1,1,1,1,-1,A
1947-05-26,1946,Manchester United,Sheffield United,6-2,6,2,1,1,8,4,H
1947-05-26,1946,Preston North End,Derby County,1-1,1,1,1,1,2,0,D
1947-05-31,1946,Arsenal,Everton,2-1,2,1,1,1,3,1,H
1947-05-31,1946,Portsmouth,Derby County,1-2,1,2,1,1,3,-1,A
1947-05-31,1946,Sheffield United,Charlton Athletic,1-3,1,3,1,1,4,-2,A
1947-05-31,1946,Wolverhampton Wanderers,Liverpool,1-2,1,2,1,1,3,-1,A
1947-06-07,1946,Sheffield United,Arsenal,2-1,2,1,1,1,3,1,H
1947-06-14,1946,Sheffield United,Stoke City,2-1,2,1,1,1,3,1,H
1947-08-23,1947,Arsenal,Sunderland,3-1,3,1,1,1,4,2,H
1947-08-23,1947,Blackburn Rovers,Everton,2-3,2,3,1,1,5,-1,A
1947-08-23,1947,Blackpool,Chelsea,3-0,3,0,1,1,3,3,H
1947-08-23,1947,Bolton Wanderers,Stoke City,0-1,0,1,1,1,1,-1,A
1947-08-23,1947,Charlton Athletic,Sheffield United,4-0,4,0,1,1,4,4,H
1947-08-23,1947,Derby County,Huddersfield Town,0-0,0,0,1,1,0,0,D
1947-08-23,1947,Grimsby Town,Aston Villa,3-0,3,0,1,1,3,3,H
1947-08-23,1947,Liverpool,Preston North End,3-1,3,1,1,1,4,2,H
1947-08-23,1947,Manchester City,Wolverhampton Wanderers,4-3,4,3,1,1,7,1,H
1947-08-23,1947,Middlesbrough,Manchester United,2-2,2,2,1,1,4,0,D
1947-08-23,1947,Portsmouth,Burnley,0-1,0,1,1,1,1,-1,A
1947-08-25,1947,Preston North End,Bolton Wanderers,1-0,1,0,1,1,1,1,H
1947-08-25,1947,Sheffield United,Middlesbrough,1-1,1,1,1,1,2,0,D
1947-08-25,1947,Stoke City,Portsmouth,2-1,2,1,1,1,3,1,H
1947-08-26,1947,Burnley,Derby County,0-2,0,2,1,1,2,-2,A
1947-08-27,1947,Charlton Athletic,Arsenal,2-4,2,4,1,1,6,-2,A
1947-08-27,1947,Chelsea,Blackburn Rovers,1-0,1,0,1,1,1,1,H
1947-08-27,1947,Everton,Manchester City,1-0,1,0,1,1,1,1,H
1947-08-27,1947,Huddersfield Town,Blackpool,2-0,2,0,1,1,2,2,H
1947-08-27,1947,Manchester United,Liverpool,2-0,2,0,1,1,2,2,H
1947-08-27,1947,Sunderland,Aston Villa,0-0,0,0,1,1,0,0,D
1947-08-27,1947,Wolverhampton Wanderers,Grimsby Town,8-1,8,1,1,1,9,7,H
1947-08-30,1947,Aston Villa,Manchester City,1-1,1,1,1,1,2,0,D
1947-08-30,1947,Burnley,Bolton Wanderers,2-0,2,0,1,1,2,2,H
1947-08-30,1947,Chelsea,Derby County,1-0,1,0,1,1,1,1,H
1947-08-30,1947,Everton,Blackpool,1-2,1,2,1,1,3,-1,A
1947-08-30,1947,Huddersfield Town,Portsmouth,0-2,0,2,1,1,2,-2,A
1947-08-30,1947,Manchester United,Charlton Athletic,6-2,6,2,1,1,8,4,H
1947-08-30,1947,Preston North End,Middlesbrough,2-1,2,1,1,1,3,1,H
1947-08-30,1947,Sheffield United,Arsenal,1-2,1,2,1,1,3,-1,A
1947-08-30,1947,Stoke City,Liverpool,0-2,0,2,1,1,2,-2,A
1947-08-30,1947,Sunderland,Grimsby Town,4-2,4,2,1,1,6,2,H
1947-08-30,1947,Wolverhampton Wanderers,Blackburn Rovers,5-1,5,1,1,1,6,4,H
1947-09-01,1947,Aston Villa,Sunderland,2-0,2,0,1,1,2,2,H
1947-09-01,1947,Blackpool,Huddersfield Town,4-0,4,0,1,1,4,4,H
1947-09-01,1947,Bolton Wanderers,Preston North End,1-2,1,2,1,1,3,-1,A
1947-09-03,1947,Arsenal,Charlton Athletic,6-0,6,0,1,1,6,6,H
1947-09-03,1947,Derby County,Burnley,1-1,1,1,1,1,2,0,D
1947-09-03,1947,Grimsby Town,Wolverhampton Wanderers,0-4,0,4,1,1,4,-4,A
1947-09-03,1947,Liverpool,Manchester United,2-2,2,2,1,1,4,0,D
1947-09-03,1947,Manchester City,Everton,0-1,0,1,1,1,1,-1,A
1947-09-03,1947,Middlesbrough,Sheffield United,3-0,3,0,1,1,3,3,H
1947-09-03,1947,Portsmouth,Stoke City,3-0,3,0,1,1,3,3,H
1947-09-06,1947,Arsenal,Manchester United,2-1,2,1,1,1,3,1,H
1947-09-06,1947,Blackburn Rovers,Aston Villa,0-0,0,0,1,1,0,0,D
1947-09-06,1947,Blackpool,Wolverhampton Wanderers,2-2,2,2,1,1,4,0,D
1947-09-06,1947,Bolton Wanderers,Portsmouth,4-0,4,0,1,1,4,4,H
1947-09-06,1947,Charlton Athletic,Preston North End,1-2,1,2,1,1,3,-1,A
1947-09-06,1947,Derby County,Everton,1-0,1,0,1,1,1,1,H
1947-09-06,1947,Grimsby Town,Sheffield United,0-3,0,3,1,1,3,-3,A
1947-09-06,1947,Huddersfield Town,Chelsea,3-1,3,1,1,1,4,2,H
1947-09-06,1947,Liverpool,Burnley,1-1,1,1,1,1,2,0,D
1947-09-06,1947,Manchester City,Sunderland,3-0,3,0,1,1,3,3,H
1947-09-06,1947,Middlesbrough,Stoke City,2-1,2,1,1,1,3,1,H
1947-09-08,1947,Aston Villa,Everton,3-0,3,0,1,1,3,3,H
1947-09-08,1947,Blackpool,Blackburn Rovers,1-0,1,0,1,1,1,1,H
1947-09-08,1947,Burnley,Manchester United,0-0,0,0,1,1,0,0,D
1947-09-08,1947,Sheffield United,Liverpool,3-1,3,1,1,1,4,2,H
1947-09-08,1947,Stoke City,Preston North End,0-1,0,1,1,1,1,-1,A
1947-09-10,1947,Arsenal,Bolton Wanderers,2-0,2,0,1,1,2,2,H
1947-09-10,1947,Chelsea,Sunderland,1-1,1,1,1,1,2,0,D
1947-09-10,1947,Derby County,Manchester City,0-0,0,0,1,1,0,0,D
1947-09-10,1947,Huddersfield Town,Grimsby Town,5-1,5,1,1,1,6,4,H
1947-09-10,1947,Wolverhampton Wanderers,Middlesbrough,1-3,1,3,1,1,4,-2,A
1947-09-13,1947,Aston Villa,Blackpool,0-1,0,1,1,1,1,-1,A
1947-09-13,1947,Burnley,Middlesbrough,3-0,3,0,1,1,3,3,H
1947-09-13,1947,Chelsea,Bolton Wanderers,1-1,1,1,1,1,2,0,D
1947-09-13,1947,Everton,Huddersfield Town,1-1,1,1,1,1,2,0,D
1947-09-13,1947,Grimsby Town,Manchester City,1-0,1,0,1,1,1,1,H
1947-09-13,1947,Manchester United,Sheffield United,0-1,0,1,1,1,1,-1,A
1947-09-13,1947,Portsmouth,Liverpool,1-0,1,0,1,1,1,1,H
1947-09-13,1947,Preston North End,Arsenal,0-0,0,0,1,1,0,0,D
1947-09-13,1947,Stoke City,Charlton Athletic,0-1,0,1,1,1,1,-1,A
1947-09-13,1947,Sunderland,Blackburn Rovers,0-1,0,1,1,1,1,-1,A
1947-09-13,1947,Wolverhampton Wanderers,Derby County,1-0,1,0,1,1,1,1,H
1947-09-15,1947,Blackburn Rovers,Blackpool,1-1,1,1,1,1,2,0,D
1947-09-17,1947,Charlton Athletic,Liverpool,2-0,2,0,1,1,2,2,H
1947-09-17,1947,Everton,Aston Villa,3-0,3,0,1,1,3,3,H
1947-09-17,1947,Grimsby Town,Huddersfield Town,3-0,3,0,1,1,3,3,H
1947-09-17,1947,Manchester City,Derby County,3-2,3,2,1,1,5,1,H
1947-09-17,1947,Portsmouth,Sheffield United,6-0,6,0,1,1,6,6,H
1947-09-17,1947,Preston North End,Stoke City,2-1,2,1,1,1,3,1,H
1947-09-17,1947,Sunderland,Chelsea,2-3,2,3,1,1,5,-1,A
1947-09-20,1947,Arsenal,Stoke City,3-0,3,0,1,1,3,3,H
1947-09-20,1947,Blackburn Rovers,Grimsby Town,4-0,4,0,1,1,4,4,H
1947-09-20,1947,Blackpool,Sunderland,0-1,0,1,1,1,1,-1,A
1947-09-20,1947,Charlton Athletic,Burnley,1-1,1,1,1,1,2,0,D
1947-09-20,1947,Chelsea,Everton,3-1,3,1,1,1,4,2,H
1947-09-20,1947,Derby County,Aston Villa,1-3,1,3,1,1,4,-2,A
1947-09-20,1947,Huddersfield Town,Wolverhampton Wanderers,0-1,0,1,1,1,1,-1,A
1947-09-20,1947,Liverpool,Bolton Wanderers,0-0,0,0,1,1,0,0,D
1947-09-20,1947,Manchester City,Manchester United,0-0,0,0,1,1,0,0,D
1947-09-20,1947,Middlesbrough,Portsmouth,1-2,1,2,1,1,3,-1,A
1947-09-20,1947,Sheffield United,Preston North End,3-1,3,1,1,1,4,2,H
1947-09-27,1947,Aston Villa,Huddersfield Town,2-1,2,1,1,1,3,1,H
1947-09-27,1947,Bolton Wanderers,Middlesbrough,1-3,1,3,1,1,4,-2,A
1947-09-27,1947,Burnley,Arsenal,0-1,0,1,1,1,1,-1,A
1947-09-27,1947,Everton,Liverpool,0-3,0,3,1,1,3,-3,A
1947-09-27,1947,Grimsby Town,Blackpool,0-1,0,1,1,1,1,-1,A
1947-09-27,1947,Manchester City,Blackburn Rovers,1-3,1,3,1,1,4,-2,A
1947-09-27,1947,Portsmouth,Charlton Athletic,3-1,3,1,1,1,4,2,H
1947-09-27,1947,Preston North End,Manchester United,2-1,2,1,1,1,3,1,H
1947-09-27,1947,Stoke City,Sheffield United,1-1,1,1,1,1,2,0,D
1947-09-27,1947,Sunderland,Derby County,1-1,1,1,1,1,2,0,D
1947-09-27,1947,Wolverhampton Wanderers,Chelsea,1-0,1,0,1,1,1,1,H
1947-10-04,1947,Arsenal,Portsmouth,0-0,0,0,1,1,0,0,D
1947-10-04,1947,Blackburn Rovers,Preston North End,2-3,2,3,1,1,5,-1,A
1947-10-04,1947,Blackpool,Manchester City,1-1,1,1,1,1,2,0,D
1947-10-04,1947,Charlton Athletic,Bolton Wanderers,2-1,2,1,1,1,3,1,H
1947-10-04,1947,Chelsea,Aston Villa,4-2,4,2,1,1,6,2,H
1947-10-04,1947,Derby County,Grimsby Town,4-1,4,1,1,1,5,3,H
1947-10-04,1947,Everton,Wolverhampton Wanderers,1-1,1,1,1,1,2,0,D
1947-10-04,1947,Huddersfield Town,Sunderland,2-2,2,2,1,1,4,0,D
1947-10-04,1947,Manchester United,Stoke City,1-1,1,1,1,1,2,0,D
1947-10-04,1947,Middlesbrough,Liverpool,3-1,3,1,1,1,4,2,H
1947-10-04,1947,Sheffield United,Burnley,1-1,1,1,1,1,2,0,D
1947-10-11,1947,Arsenal,Aston Villa,1-0,1,0,1,1,1,1,H
1947-10-11,1947,Bolton Wanderers,Huddersfield Town,1-5,1,5,1,1,6,-4,A
1947-10-11,1947,Burnley,Blackpool,1-0,1,0,1,1,1,1,H
1947-10-11,1947,Charlton Athletic,Wolverhampton Wanderers,5-1,5,1,1,1,6,4,H
1947-10-11,1947,Liverpool,Chelsea,3-0,3,0,1,1,3,3,H
1947-10-11,1947,Manchester United,Grimsby Town,3-4,3,4,1,1,7,-1,A
1947-10-11,1947,Middlesbrough,Everton,0-1,0,1,1,1,1,-1,A
1947-10-11,1947,Portsmouth,Derby County,0-0,0,0,1,1,0,0,D
1947-10-11,1947,Preston North End,Manchester City,2-1,2,1,1,1,3,1,H
1947-10-11,1947,Sheffield United,Sunderland,3-2,3,2,1,1,5,1,H
1947-10-11,1947,Stoke City,Blackburn Rovers,2-1,2,1,1,1,3,1,H
1947-10-18,1947,Aston Villa,Sheffield United,2-0,2,0,1,1,2,2,H
1947-10-18,1947,Blackburn Rovers,Burnley,1-2,1,2,1,1,3,-1,A
1947-10-18,1947,Blackpool,Portsmouth,1-0,1,0,1,1,1,1,H
1947-10-18,1947,Chelsea,Middlesbrough,4-2,4,2,1,1,6,2,H
1947-10-18,1947,Derby County,Bolton Wanderers,2-1,2,1,1,1,3,1,H
1947-10-18,1947,Everton,Charlton Athletic,0-1,0,1,1,1,1,-1,A
1947-10-18,1947,Grimsby Town,Preston North End,1-1,1,1,1,1,2,0,D
1947-10-18,1947,Huddersfield Town,Liverpool,1-1,1,1,1,1,2,0,D
1947-10-18,1947,Manchester City,Stoke City,3-0,3,0,1,1,3,3,H
1947-10-18,1947,Sunderland,Manchester United,1-0,1,0,1,1,1,1,H
1947-10-18,1947,Wolverhampton Wanderers,Arsenal,1-1,1,1,1,1,2,0,D
1947-10-25,1947,Arsenal,Everton,1-1,1,1,1,1,2,0,D
1947-10-25,1947,Bolton Wanderers,Blackpool,1-0,1,0,1,1,1,1,H
1947-10-25,1947,Burnley,Manchester City,1-1,1,1,1,1,2,0,D
1947-10-25,1947,Charlton Athletic,Chelsea,3-1,3,1,1,1,4,2,H
1947-10-25,1947,Liverpool,Derby County,2-2,2,2,1,1,4,0,D
1947-10-25,1947,Manchester United,Aston Villa,2-0,2,0,1,1,2,2,H
1947-10-25,1947,Middlesbrough,Huddersfield Town,1-0,1,0,1,1,1,1,H
1947-10-25,1947,Portsmouth,Blackburn Rovers,1-1,1,1,1,1,2,0,D
1947-10-25,1947,Preston North End,Sunderland,2-2,2,2,1,1,4,0,D
1947-10-25,1947,Sheffield United,Wolverhampton Wanderers,2-2,2,2,1,1,4,0,D
1947-10-25,1947,Stoke City,Grimsby Town,2-1,2,1,1,1,3,1,H
1947-11-01,1947,Aston Villa,Preston North End,4-1,4,1,1,1,5,3,H
1947-11-01,1947,Blackburn Rovers,Bolton Wanderers,4-0,4,0,1,1,4,4,H
1947-11-01,1947,Blackpool,Liverpool,2-0,2,0,1,1,2,2,H
1947-11-01,1947,Chelsea,Arsenal,0-0,0,0,1,1,0,0,D
1947-11-01,1947,Derby County,Middlesbrough,4-2,4,2,1,1,6,2,H
1947-11-01,1947,Everton,Sheffield United,2-0,2,0,1,1,2,2,H
1947-11-01,1947,Grimsby Town,Burnley,1-2,1,2,1,1,3,-1,A
1947-11-01,1947,Huddersfield Town,Charlton Athletic,0-1,0,1,1,1,1,-1,A
1947-11-01,1947,Manchester City,Portsmouth,1-0,1,0,1,1,1,1,H
1947-11-01,1947,Sunderland,Stoke City,1-0,1,0,1,1,1,1,H
1947-11-01,1947,Wolverhampton Wanderers,Manchester United,2-6,2,6,1,1,8,-4,A
1947-11-08,1947,Arsenal,Blackpool,2-1,2,1,1,1,3,1,H
1947-11-08,1947,Bolton Wanderers,Sunderland,3-1,3,1,1,1,4,2,H
1947-11-08,1947,Burnley,Wolverhampton Wanderers,1-1,1,1,1,1,2,0,D
1947-11-08,1947,Charlton Athletic,Blackburn Rovers,0-1,0,1,1,1,1,-1,A
1947-11-08,1947,Liverpool,Grimsby Town,3-1,3,1,1,1,4,2,H
1947-11-08,1947,Manchester United,Huddersfield Town,4-4,4,4,1,1,8,0,D
1947-11-08,1947,Middlesbrough,Manchester City,2-1,2,1,1,1,3,1,H
1947-11-08,1947,Portsmouth,Aston Villa,2-4,2,4,1,1,6,-2,A
1947-11-08,1947,Preston North End,Chelsea,2-0,2,0,1,1,2,2,H
1947-11-08,1947,Sheffield United,Derby County,1-2,1,2,1,1,3,-1,A
1947-11-08,1947,Stoke City,Everton,1-1,1,1,1,1,2,0,D
1947-11-15,1947,Aston Villa,Bolton Wanderers,3-1,3,1,1,1,4,2,H
1947-11-15,1947,Blackburn Rovers,Arsenal,0-1,0,1,1,1,1,-1,A
1947-11-15,1947,Blackpool,Sheffield United,2-1,2,1,1,1,3,1,H
1947-11-15,1947,Chelsea,Stoke City,4-1,4,1,1,1,5,3,H
1947-11-15,1947,Derby County,Manchester United,1-1,1,1,1,1,2,0,D
1947-11-15,1947,Everton,Burnley,0-3,0,3,1,1,3,-3,A
1947-11-15,1947,Grimsby Town,Middlesbrough,0-5,0,5,1,1,5,-5,A
1947-11-15,1947,Huddersfield Town,Preston North End,1-0,1,0,1,1,1,1,H
1947-11-15,1947,Manchester City,Charlton Athletic,4-0,4,0,1,1,4,4,H
1947-11-15,1947,Sunderland,Liverpool,5-1,5,1,1,1,6,4,H
1947-11-15,1947,Wolverhampton Wanderers,Portsmouth,3-1,3,1,1,1,4,2,H
1947-11-22,1947,Arsenal,Huddersfield Town,2-0,2,0,1,1,2,2,H
1947-11-22,1947,Bolton Wanderers,Manchester City,2-1,2,1,1,1,3,1,H
1947-11-22,1947,Burnley,Sunderland,4-0,4,0,1,1,4,4,H
1947-11-22,1947,Charlton Athletic,Derby County,1-5,1,5,1,1,6,-4,A
1947-11-22,1947,Liverpool,Blackburn Rovers,2-1,2,1,1,1,3,1,H
1947-11-22,1947,Manchester United,Everton,2-2,2,2,1,1,4,0,D
1947-11-22,1947,Middlesbrough,Blackpool,4-0,4,0,1,1,4,4,H
1947-11-22,1947,Portsmouth,Grimsby Town,4-0,4,0,1,1,4,4,H
1947-11-22,1947,Preston North End,Wolverhampton Wanderers,1-3,1,3,1,1,4,-2,A
1947-11-22,1947,Sheffield United,Chelsea,3-1,3,1,1,1,4,2,H
1947-11-22,1947,Stoke City,Aston Villa,1-2,1,2,1,1,3,-1,A
1947-11-29,1947,Aston Villa,Burnley,2-2,2,2,1,1,4,0,D
1947-11-29,1947,Blackburn Rovers,Middlesbrough,1-7,1,7,1,1,8,-6,A
1947-11-29,1947,Blackpool,Charlton Athletic,3-1,3,1,1,1,4,2,H
1947-11-29,1947,Chelsea,Manchester United,0-4,0,4,1,1,4,-4,A
1947-11-29,1947,Derby County,Arsenal,1-0,1,0,1,1,1,1,H
1947-11-29,1947,Everton,Preston North End,2-1,2,1,1,1,3,1,H
1947-11-29,1947,Grimsby Town,Bolton Wanderers,0-2,0,2,1,1,2,-2,A
1947-11-29,1947,Huddersfield Town,Sheffield United,2-1,2,1,1,1,3,1,H
1947-11-29,1947,Manchester City,Liverpool,2-0,2,0,1,1,2,2,H
1947-11-29,1947,Sunderland,Portsmouth,4-1,4,1,1,1,5,3,H
1947-11-29,1947,Wolverhampton Wanderers,Stoke City,1-2,1,2,1,1,3,-1,A
1947-12-06,1947,Arsenal,Manchester City,1-1,1,1,1,1,2,0,D
1947-12-06,1947,Bolton Wanderers,Wolverhampton Wanderers,3-2,3,2,1,1,5,1,H
1947-12-06,1947,Burnley,Chelsea,1-0,1,0,1,1,1,1,H
1947-12-06,1947,Charlton Athletic,Grimsby Town,2-3,2,3,1,1,5,-1,A
1947-12-06,1947,Liverpool,Aston Villa,3-3,3,3,1,1,6,0,D
1947-12-06,1947,Manchester United,Blackpool,1-1,1,1,1,1,2,0,D
1947-12-06,1947,Middlesbrough,Sunderland,2-2,2,2,1,1,4,0,D
1947-12-06,1947,Portsmouth,Everton,3-0,3,0,1,1,3,3,H
1947-12-06,1947,Preston North End,Derby County,7-4,7,4,1,1,11,3,H
1947-12-06,1947,Sheffield United,Blackburn Rovers,4-1,4,1,1,1,5,3,H
1947-12-06,1947,Stoke City,Huddersfield Town,1-1,1,1,1,1,2,0,D
1947-12-13,1947,Aston Villa,Middlesbrough,1-1,1,1,1,1,2,0,D
1947-12-13,1947,Blackburn Rovers,Manchester United,1-1,1,1,1,1,2,0,D
1947-12-13,1947,Blackpool,Preston North End,0-1,0,1,1,1,1,-1,A
1947-12-13,1947,Chelsea,Portsmouth,1-0,1,0,1,1,1,1,H
1947-12-13,1947,Derby County,Stoke City,1-1,1,1,1,1,2,0,D
1947-12-13,1947,Everton,Bolton Wanderers,2-0,2,0,1,1,2,2,H
1947-12-13,1947,Grimsby Town,Arsenal,0-4,0,4,1,1,4,-4,A
1947-12-13,1947,Huddersfield Town,Burnley,0-1,0,1,1,1,1,-1,A
1947-12-13,1947,Manchester City,Sheffield United,4-3,4,3,1,1,7,1,H
1947-12-13,1947,Sunderland,Charlton Athletic,0-1,0,1,1,1,1,-1,A
1947-12-13,1947,Wolverhampton Wanderers,Liverpool,1-2,1,2,1,1,3,-1,A
1947-12-20,1947,Aston Villa,Grimsby Town,2-2,2,2,1,1,4,0,D
1947-12-20,1947,Burnley,Portsmouth,3-2,3,2,1,1,5,1,H
1947-12-20,1947,Chelsea,Blackpool,2-2,2,2,1,1,4,0,D
1947-12-20,1947,Everton,Blackburn Rovers,4-1,4,1,1,1,5,3,H
1947-12-20,1947,Huddersfield Town,Derby County,2-1,2,1,1,1,3,1,H
1947-12-20,1947,Manchester United,Middlesbrough,2-1,2,1,1,1,3,1,H
1947-12-20,1947,Preston North End,Liverpool,3-3,3,3,1,1,6,0,D
1947-12-20,1947,Sheffield United,Charlton Athletic,1-1,1,1,1,1,2,0,D
1947-12-20,1947,Stoke City,Bolton Wanderers,2-0,2,0,1,1,2,2,H
1947-12-20,1947,Sunderland,Arsenal,1-1,1,1,1,1,2,0,D
1947-12-20,1947,Wolverhampton Wanderers,Manchester City,1-0,1,0,1,1,1,1,H
1947-12-25,1947,Blackburn Rovers,Derby County,3-4,3,4,1,1,7,-1,A
1947-12-25,1947,Blackpool,Stoke City,1-2,1,2,1,1,3,-1,A
1947-12-25,1947,Burnley,Preston North End,1-0,1,0,1,1,1,1,H
1947-12-25,1947,Charlton Athletic,Middlesbrough,1-0,1,0,1,1,1,1,H
1947-12-25,1947,Grimsby Town,Chelsea,0-0,0,0,1,1,0,0,D
1947-12-25,1947,Liverpool,Arsenal,1-3,1,3,1,1,4,-2,A
1947-12-25,1947,Manchester United,Portsmouth,3-2,3,2,1,1,5,1,H
1947-12-25,1947,Sheffield United,Bolton Wanderers,2-1,2,1,1,1,3,1,H
1947-12-25,1947,Sunderland,Everton,2-0,2,0,1,1,2,2,H
1947-12-26,1947,Aston Villa,Wolverhampton Wanderers,1-2,1,2,1,1,3,-1,A
1947-12-26,1947,Everton,Sunderland,3-0,3,0,1,1,3,3,H
1947-12-26,1947,Manchester City,Huddersfield Town,1-1,1,1,1,1,2,0,D
1947-12-26,1947,Preston North End,Burnley,3-2,3,2,1,1,5,1,H
1947-12-27,1947,Arsenal,Liverpool,1-2,1,2,1,1,3,-1,A
1947-12-27,1947,Bolton Wanderers,Sheffield United,2-3,2,3,1,1,5,-1,A
1947-12-27,1947,Chelsea,Grimsby Town,2-3,2,3,1,1,5,-1,A
1947-12-27,1947,Derby County,Blackburn Rovers,5-0,5,0,1,1,5,5,H
1947-12-27,1947,Huddersfield Town,Manchester City,1-1,1,1,1,1,2,0,D
1947-12-27,1947,Middlesbrough,Charlton Athletic,1-2,1,2,1,1,3,-1,A
1947-12-27,1947,Portsmouth,Manchester United,1-3,1,3,1,1,4,-2,A
1947-12-27,1947,Stoke City,Blackpool,1-1,1,1,1,1,2,0,D
1947-12-27,1947,Wolverhampton Wanderers,Aston Villa,4-1,4,1,1,1,5,3,H
1948-01-01,1947,Blackburn Rovers,Chelsea,1-1,1,1,1,1,2,0,D
1948-01-01,1947,Bolton Wanderers,Arsenal,0-1,0,1,1,1,1,-1,A
1948-01-01,1947,Liverpool,Charlton Athletic,2-3,2,3,1,1,5,-1,A
1948-01-01,1947,Manchester United,Burnley,5-0,5,0,1,1,5,5,H
1948-01-01,1947,Middlesbrough,Wolverhampton Wanderers,2-4,2,4,1,1,6,-2,A
1948-01-01,1947,Sheffield United,Portsmouth,1-2,1,2,1,1,3,-1,A
1948-01-03,1947,Arsenal,Sheffield United,3-2,3,2,1,1,5,1,H
1948-01-03,1947,Blackburn Rovers,Wolverhampton Wanderers,1-0,1,0,1,1,1,1,H
1948-01-03,1947,Blackpool,Everton,5-0,5,0,1,1,5,5,H
1948-01-03,1947,Bolton Wanderers,Burnley,1-1,1,1,1,1,2,0,D
1948-01-03,1947,Charlton Athletic,Manchester United,1-2,1,2,1,1,3,-1,A
1948-01-03,1947,Derby County,Chelsea,5-1,5,1,1,1,6,4,H
1948-01-03,1947,Grimsby Town,Sunderland,1-2,1,2,1,1,3,-1,A
1948-01-03,1947,Liverpool,Stoke City,0-0,0,0,1,1,0,0,D
1948-01-03,1947,Manchester City,Aston Villa,0-2,0,2,1,1,2,-2,A
1948-01-03,1947,Middlesbrough,Preston North End,1-1,1,1,1,1,2,0,D
1948-01-03,1947,Portsmouth,Huddersfield Town,3-2,3,2,1,1,5,1,H
1948-01-17,1947,Burnley,Liverpool,3-0,3,0,1,1,3,3,H
1948-01-17,1947,Chelsea,Huddersfield Town,2-4,2,4,1,1,6,-2,A
1948-01-17,1947,Everton,Derby County,1-3,1,3,1,1,4,-2,A
1948-01-17,1947,Manchester United,Arsenal,1-1,1,1,1,1,2,0,D
1948-01-17,1947,Portsmouth,Bolton Wanderers,2-0,2,0,1,1,2,2,H
1948-01-17,1947,Preston North End,Charlton Athletic,2-1,2,1,1,1,3,1,H
1948-01-17,1947,Sheffield United,Grimsby Town,4-0,4,0,1,1,4,4,H
1948-01-17,1947,Stoke City,Middlesbrough,2-4,2,4,1,1,6,-2,A
1948-01-17,1947,Sunderland,Manchester City,0-1,0,1,1,1,1,-1,A
1948-01-17,1947,Wolverhampton Wanderers,Blackpool,1-1,1,1,1,1,2,0,D
1948-01-24,1947,Sunderland,Bolton Wanderers,1-2,1,2,1,1,3,-1,A
1948-01-31,1947,Arsenal,Preston North End,3-0,3,0,1,1,3,3,H
1948-01-31,1947,Blackburn Rovers,Sunderland,4-3,4,3,1,1,7,1,H
1948-01-31,1947,Blackpool,Aston Villa,1-0,1,0,1,1,1,1,H
1948-01-31,1947,Bolton Wanderers,Chelsea,2-1,2,1,1,1,3,1,H
1948-01-31,1947,Charlton Athletic,Stoke City,0-1,0,1,1,1,1,-1,A
1948-01-31,1947,Liverpool,Portsmouth,0-3,0,3,1,1,3,-3,A
1948-01-31,1947,Manchester City,Grimsby Town,3-1,3,1,1,1,4,2,H
1948-01-31,1947,Middlesbrough,Burnley,1-2,1,2,1,1,3,-1,A
1948-01-31,1947,Sheffield United,Manchester United,2-1,2,1,1,1,3,1,H
1948-02-07,1947,Bolton Wanderers,Liverpool,3-0,3,0,1,1,3,3,H
1948-02-07,1947,Grimsby Town,Blackburn Rovers,2-2,2,2,1,1,4,0,D
1948-02-07,1947,Stoke City,Arsenal,0-0,0,0,1,1,0,0,D
1948-02-07,1947,Wolverhampton Wanderers,Huddersfield Town,2-1,2,1,1,1,3,1,H
1948-02-14,1947,Arsenal,Burnley,3-0,3,0,1,1,3,3,H
1948-02-14,1947,Blackburn Rovers,Manchester City,1-0,1,0,1,1,1,1,H
1948-02-14,1947,Blackpool,Grimsby Town,3-1,3,1,1,1,4,2,H
1948-02-14,1947,Charlton Athletic,Portsmouth,2-2,2,2,1,1,4,0,D
1948-02-14,1947,Chelsea,Wolverhampton Wanderers,1-1,1,1,1,1,2,0,D
1948-02-14,1947,Derby County,Sunderland,5-1,5,1,1,1,6,4,H
1948-02-14,1947,Huddersfield Town,Aston Villa,0-1,0,1,1,1,1,-1,A
1948-02-14,1947,Manchester United,Preston North End,1-1,1,1,1,1,2,0,D
1948-02-14,1947,Middlesbrough,Bolton Wanderers,4-1,4,1,1,1,5,3,H
1948-02-14,1947,Sheffield United,Stoke City,3-0,3,0,1,1,3,3,H
1948-02-21,1947,Aston Villa,Chelsea,3-0,3,0,1,1,3,3,H
1948-02-21,1947,Bolton Wanderers,Charlton Athletic,1-0,1,0,1,1,1,1,H
1948-02-21,1947,Burnley,Sheffield United,0-0,0,0,1,1,0,0,D
1948-02-21,1947,Grimsby Town,Derby County,2-3,2,3,1,1,5,-1,A
1948-02-21,1947,Liverpool,Middlesbrough,0-1,0,1,1,1,1,-1,A
1948-02-21,1947,Manchester City,Blackpool,1-0,1,0,1,1,1,1,H
1948-02-21,1947,Preston North End,Blackburn Rovers,2-1,2,1,1,1,3,1,H
1948-02-21,1947,Stoke City,Manchester United,0-2,0,2,1,1,2,-2,A
1948-02-21,1947,Sunderland,Huddersfield Town,2-0,2,0,1,1,2,2,H
1948-02-21,1947,Wolverhampton Wanderers,Everton,2-4,2,4,1,1,6,-2,A
1948-02-28,1947,Aston Villa,Arsenal,4-2,4,2,1,1,6,2,H
1948-02-28,1947,Blackburn Rovers,Stoke City,2-0,2,0,1,1,2,2,H
1948-02-28,1947,Chelsea,Liverpool,3-1,3,1,1,1,4,2,H
1948-02-28,1947,Everton,Middlesbrough,2-1,2,1,1,1,3,1,H
1948-02-28,1947,Huddersfield Town,Bolton Wanderers,1-2,1,2,1,1,3,-1,A
1948-02-28,1947,Sunderland,Sheffield United,1-1,1,1,1,1,2,0,D
1948-02-28,1947,Wolverhampton Wanderers,Charlton Athletic,2-0,2,0,1,1,2,2,H
1948-03-06,1947,Arsenal,Wolverhampton Wanderers,5-2,5,2,1,1,7,3,H
1948-03-06,1947,Burnley,Blackburn Rovers,0-0,0,0,1,1,0,0,D
1948-03-06,1947,Charlton Athletic,Everton,2-3,2,3,1,1,5,-1,A
1948-03-06,1947,Liverpool,Huddersfield Town,4-0,4,0,1,1,4,4,H
1948-03-06,1947,Manchester United,Sunderland,3-1,3,1,1,1,4,2,H
1948-03-06,1947,Middlesbrough,Chelsea,0-0,0,0,1,1,0,0,D
1948-03-06,1947,Portsmouth,Blackpool,1-1,1,1,1,1,2,0,D
1948-03-06,1947,Preston North End,Grimsby Town,2-1,2,1,1,1,3,1,H
1948-03-06,1947,Sheffield United,Aston Villa,3-1,3,1,1,1,4,2,H
1948-03-06,1947,Stoke City,Manchester City,3-0,3,0,1,1,3,3,H
1948-03-13,1947,Blackburn Rovers,Portsmouth,1-0,1,0,1,1,1,1,H
1948-03-13,1947,Chelsea,Charlton Athletic,3-0,3,0,1,1,3,3,H
1948-03-13,1947,Everton,Arsenal,0-2,0,2,1,1,2,-2,A
1948-03-13,1947,Grimsby Town,Stoke City,0-0,0,0,1,1,0,0,D
1948-03-13,1947,Huddersfield Town,Middlesbrough,2-1,2,1,1,1,3,1,H
1948-03-13,1947,Manchester City,Burnley,4-1,4,1,1,1,5,3,H
1948-03-13,1947,Sunderland,Preston North End,0-2,0,2,1,1,2,-2,A
1948-03-13,1947,Wolverhampton Wanderers,Sheffield United,1-1,1,1,1,1,2,0,D
1948-03-17,1947,Grimsby Town,Manchester United,1-1,1,1,1,1,2,0,D
1948-03-20,1947,Arsenal,Chelsea,0-2,0,2,1,1,2,-2,A
1948-03-20,1947,Bolton Wanderers,Blackburn Rovers,1-0,1,0,1,1,1,1,H
1948-03-20,1947,Burnley,Grimsby Town,4-1,4,1,1,1,5,3,H
1948-03-20,1947,Charlton Athletic,Huddersfield Town,0-0,0,0,1,1,0,0,D
1948-03-20,1947,Liverpool,Blackpool,2-0,2,0,1,1,2,2,H
1948-03-20,1947,Manchester United,Wolverhampton Wanderers,3-2,3,2,1,1,5,1,H
1948-03-20,1947,Middlesbrough,Derby County,1-1,1,1,1,1,2,0,D
1948-03-20,1947,Portsmouth,Manchester City,1-0,1,0,1,1,1,1,H
1948-03-20,1947,Preston North End,Aston Villa,3-0,3,0,1,1,3,3,H
1948-03-20,1947,Sheffield United,Everton,2-1,2,1,1,1,3,1,H
1948-03-20,1947,Stoke City,Sunderland,3-1,3,1,1,1,4,2,H
1948-03-22,1947,Aston Villa,Manchester United,0-1,0,1,1,1,1,-1,A
1948-03-26,1947,Arsenal,Middlesbrough,7-0,7,0,1,1,7,7,H
1948-03-26,1947,Blackburn Rovers,Huddersfield Town,1-2,1,2,1,1,3,-1,A
1948-03-26,1947,Blackpool,Derby County,2-2,2,2,1,1,4,0,D
1948-03-26,1947,Burnley,Stoke City,4-0,4,0,1,1,4,4,H
1948-03-26,1947,Charlton Athletic,Aston Villa,1-1,1,1,1,1,2,0,D
1948-03-26,1947,Chelsea,Manchester City,2-2,2,2,1,1,4,0,D
1948-03-26,1947,Grimsby Town,Everton,3-0,3,0,1,1,3,3,H
1948-03-26,1947,Liverpool,Sheffield United,4-0,4,0,1,1,4,4,H
1948-03-26,1947,Manchester United,Bolton Wanderers,0-2,0,2,1,1,2,-2,A
1948-03-26,1947,Portsmouth,Preston North End,1-0,1,0,1,1,1,1,H
1948-03-26,1947,Sunderland,Wolverhampton Wanderers,2-1,2,1,1,1,3,1,H
1948-03-27,1947,Aston Villa,Portsmouth,2-1,2,1,1,1,3,1,H
1948-03-27,1947,Blackburn Rovers,Charlton Athletic,0-0,0,0,1,1,0,0,D
1948-03-27,1947,Blackpool,Arsenal,3-0,3,0,1,1,3,3,H
1948-03-27,1947,Chelsea,Preston North End,2-0,2,0,1,1,2,2,H
1948-03-27,1947,Derby County,Sheffield United,1-1,1,1,1,1,2,0,D
1948-03-27,1947,Everton,Stoke City,0-1,0,1,1,1,1,-1,A
1948-03-27,1947,Grimsby Town,Liverpool,0-2,0,2,1,1,2,-2,A
1948-03-27,1947,Huddersfield Town,Manchester United,0-2,0,2,1,1,2,-2,A
1948-03-27,1947,Manchester City,Middlesbrough,2-0,2,0,1,1,2,2,H
1948-03-27,1947,Wolverhampton Wanderers,Burnley,1-1,1,1,1,1,2,0,D
1948-03-29,1947,Bolton Wanderers,Manchester United,0-1,0,1,1,1,1,-1,A
1948-03-29,1947,Derby County,Blackpool,1-0,1,0,1,1,1,1,H
1948-03-29,1947,Everton,Grimsby Town,3-1,3,1,1,1,4,2,H
1948-03-29,1947,Huddersfield Town,Blackburn Rovers,1-1,1,1,1,1,2,0,D
1948-03-29,1947,Manchester City,Chelsea,1-0,1,0,1,1,1,1,H
1948-03-29,1947,Middlesbrough,Arsenal,1-1,1,1,1,1,2,0,D
1948-03-29,1947,Preston North End,Portsmouth,1-2,1,2,1,1,3,-1,A
1948-03-29,1947,Stoke City,Burnley,3-0,3,0,1,1,3,3,H
1948-03-29,1947,Wolverhampton Wanderers,Sunderland,2-1,2,1,1,1,3,1,H
1948-03-30,1947,Aston Villa,Charlton Athletic,2-1,2,1,1,1,3,1,H
1948-03-31,1947,Derby County,Liverpool,0-4,0,4,1,1,4,-4,A
1948-04-03,1947,Arsenal,Blackburn Rovers,2-0,2,0,1,1,2,2,H
1948-04-03,1947,Bolton Wanderers,Aston Villa,1-0,1,0,1,1,1,1,H
1948-04-03,1947,Burnley,Everton,0-1,0,1,1,1,1,-1,A
1948-04-03,1947,Charlton Athletic,Manchester City,0-1,0,1,1,1,1,-1,A
1948-04-03,1947,Liverpool,Sunderland,0-0,0,0,1,1,0,0,D
1948-04-03,1947,Manchester United,Derby County,1-0,1,0,1,1,1,1,H
1948-04-03,1947,Middlesbrough,Grimsby Town,4-1,4,1,1,1,5,3,H
1948-04-03,1947,Portsmouth,Wolverhampton Wanderers,2-0,2,0,1,1,2,2,H
1948-04-03,1947,Preston North End,Huddersfield Town,0-2,0,2,1,1,2,-2,A
1948-04-03,1947,Sheffield United,Blackpool,2-1,2,1,1,1,3,1,H
1948-04-03,1947,Stoke City,Chelsea,2-0,2,0,1,1,2,2,H
1948-04-05,1947,Blackpool,Bolton Wanderers,1-1,1,1,1,1,2,0,D
1948-04-07,1947,Aston Villa,Derby County,2-2,2,2,1,1,4,0,D
1948-04-07,1947,Blackpool,Burnley,0-1,0,1,1,1,1,-1,A
1948-04-07,1947,Manchester United,Manchester City,1-1,1,1,1,1,2,0,D
1948-04-07,1947,Preston North End,Sheffield United,3-3,3,3,1,1,6,0,D
1948-04-10,1947,Aston Villa,Stoke City,1-0,1,0,1,1,1,1,H
1948-04-10,1947,Blackburn Rovers,Liverpool,1-2,1,2,1,1,3,-1,A
1948-04-10,1947,Blackpool,Middlesbrough,1-0,1,0,1,1,1,1,H
1948-04-10,1947,Chelsea,Sheffield United,1-0,1,0,1,1,1,1,H
1948-04-10,1947,Derby County,Charlton Athletic,0-3,0,3,1,1,3,-3,A
1948-04-10,1947,Everton,Manchester United,2-0,2,0,1,1,2,2,H
1948-04-10,1947,Grimsby Town,Portsmouth,1-0,1,0,1,1,1,1,H
1948-04-10,1947,Huddersfield Town,Arsenal,1-1,1,1,1,1,2,0,D
1948-04-10,1947,Manchester City,Bolton Wanderers,0-2,0,2,1,1,2,-2,A
1948-04-10,1947,Sunderland,Burnley,2-0,2,0,1,1,2,2,H
1948-04-10,1947,Wolverhampton Wanderers,Preston North End,4-2,4,2,1,1,6,2,H
1948-04-12,1947,Sunderland,Blackpool,1-0,1,0,1,1,1,1,H
1948-04-14,1947,Aston Villa,Blackburn Rovers,3-2,3,2,1,1,5,1,H
1948-04-14,1947,Derby County,Wolverhampton Wanderers,1-2,1,2,1,1,3,-1,A
1948-04-14,1947,Everton,Chelsea,2-3,2,3,1,1,5,-1,A
1948-04-14,1947,Portsmouth,Middlesbrough,6-1,6,1,1,1,7,5,H
1948-04-17,1947,Arsenal,Derby County,1-2,1,2,1,1,3,-1,A
1948-04-17,1947,Bolton Wanderers,Grimsby Town,2-0,2,0,1,1,2,2,H
1948-04-17,1947,Burnley,Aston Villa,1-0,1,0,1,1,1,1,H
1948-04-17,1947,Charlton Athletic,Blackpool,2-0,2,0,1,1,2,2,H
1948-04-17,1947,Liverpool,Manchester City,1-1,1,1,1,1,2,0,D
1948-04-17,1947,Manchester United,Chelsea,5-0,5,0,1,1,5,5,H
1948-04-17,1947,Middlesbrough,Blackburn Rovers,1-1,1,1,1,1,2,0,D
1948-04-17,1947,Portsmouth,Sunderland,2-2,2,2,1,1,4,0,D
1948-04-17,1947,Preston North End,Everton,3-0,3,0,1,1,3,3,H
1948-04-17,1947,Sheffield United,Huddersfield Town,0-1,0,1,1,1,1,-1,A
1948-04-17,1947,Stoke City,Wolverhampton Wanderers,2-3,2,3,1,1,5,-1,A
1948-04-20,1947,Burnley,Charlton Athletic,0-2,0,2,1,1,2,-2,A
1948-04-21,1947,Bolton Wanderers,Derby County,0-3,0,3,1,1,3,-3,A
1948-04-21,1947,Liverpool,Everton,4-0,4,0,1,1,4,4,H
1948-04-21,1947,Manchester City,Preston North End,0-3,0,3,1,1,3,-3,A
1948-04-21,1947,Portsmouth,Arsenal,0-0,0,0,1,1,0,0,D
1948-04-24,1947,Aston Villa,Liverpool,2-1,2,1,1,1,3,1,H
1948-04-24,1947,Blackburn Rovers,Sheffield United,4-0,4,0,1,1,4,4,H
1948-04-24,1947,Chelsea,Burnley,0-2,0,2,1,1,2,-2,A
1948-04-24,1947,Derby County,Preston North End,2-1,2,1,1,1,3,1,H
1948-04-24,1947,Everton,Portsmouth,0-2,0,2,1,1,2,-2,A
1948-04-24,1947,Grimsby Town,Charlton Athletic,1-3,1,3,1,1,4,-2,A
1948-04-24,1947,Huddersfield Town,Stoke City,0-0,0,0,1,1,0,0,D
1948-04-24,1947,Manchester City,Arsenal,0-0,0,0,1,1,0,0,D
1948-04-24,1947,Sunderland,Middlesbrough,3-0,3,0,1,1,3,3,H
1948-04-24,1947,Wolverhampton Wanderers,Bolton Wanderers,1-0,1,0,1,1,1,1,H
1948-04-28,1947,Blackpool,Manchester United,1-0,1,0,1,1,1,1,H
1948-04-28,1947,Derby County,Portsmouth,2-1,2,1,1,1,3,1,H
1948-04-28,1947,Huddersfield Town,Everton,1-3,1,3,1,1,4,-2,A
1948-05-01,1947,Arsenal,Grimsby Town,8-0,8,0,1,1,8,8,H
1948-05-01,1947,Bolton Wanderers,Everton,0-0,0,0,1,1,0,0,D
1948-05-01,1947,Burnley,Huddersfield Town,2-1,2,1,1,1,3,1,H
1948-05-01,1947,Charlton Athletic,Sunderland,1-0,1,0,1,1,1,1,H
1948-05-01,1947,Liverpool,Wolverhampton Wanderers,2-1,2,1,1,1,3,1,H
1948-05-01,1947,Manchester United,Blackburn Rovers,4-1,4,1,1,1,5,3,H
1948-05-01,1947,Middlesbrough,Aston Villa,1-3,1,3,1,1,4,-2,A
1948-05-01,1947,Portsmouth,Chelsea,2-1,2,1,1,1,3,1,H
1948-05-01,1947,Preston North End,Blackpool,0-7,0,7,1,1,7,-7,A
1948-05-01,1947,Sheffield United,Manchester City,2-1,2,1,1,1,3,1,H
1948-05-01,1947,Stoke City,Derby County,1-0,1,0,1,1,1,1,H
1948-08-21,1948,Aston Villa,Liverpool,2-1,2,1,1,1,3,1,H
1948-08-21,1948,Burnley,Manchester City,1-0,1,0,1,1,1,1,H
1948-08-21,1948,Chelsea,Middlesbrough,1-0,1,0,1,1,1,1,H
1948-08-21,1948,Everton,Newcastle United,3-3,3,3,1,1,6,0,D
1948-08-21,1948,Huddersfield Town,Arsenal,1-1,1,1,1,1,2,0,D
1948-08-21,1948,Manchester United,Derby County,1-2,1,2,1,1,3,-1,A
1948-08-21,1948,Preston North End,Portsmouth,2-2,2,2,1,1,4,0,D
1948-08-21,1948,Sheffield United,Blackpool,3-2,3,2,1,1,5,1,H
1948-08-21,1948,Stoke City,Charlton Athletic,2-2,2,2,1,1,4,0,D
1948-08-21,1948,Sunderland,Bolton Wanderers,2-0,2,0,1,1,2,2,H
1948-08-21,1948,Wolverhampton Wanderers,Birmingham City,2-2,2,2,1,1,4,0,D
1948-08-23,1948,Blackpool,Manchester United,0-3,0,3,1,1,3,-3,A
1948-08-25,1948,Arsenal,Stoke City,3-0,3,0,1,1,3,3,H
1948-08-25,1948,Birmingham City,Middlesbrough,0-0,0,0,1,1,0,0,D
1948-08-25,1948,Bolton Wanderers,Aston Villa,3-0,3,0,1,1,3,3,H
1948-08-25,1948,Charlton Athletic,Burnley,3-1,3,1,1,1,4,2,H
1948-08-25,1948,Derby County,Huddersfield Town,4-1,4,1,1,1,5,3,H
1948-08-25,1948,Liverpool,Sheffield United,3-3,3,3,1,1,6,0,D
1948-08-25,1948,Manchester City,Preston North End,3-2,3,2,1,1,5,1,H
1948-08-25,1948,Newcastle United,Chelsea,2-2,2,2,1,1,4,0,D
1948-08-25,1948,Portsmouth,Everton,4-0,4,0,1,1,4,4,H
1948-08-25,1948,Wolverhampton Wanderers,Sunderland,0-1,0,1,1,1,1,-1,A
1948-08-28,1948,Arsenal,Manchester United,0-1,0,1,1,1,1,-1,A
1948-08-28,1948,Birmingham City,Chelsea,1-0,1,0,1,1,1,1,H
1948-08-28,1948,Blackpool,Aston Villa,1-0,1,0,1,1,1,1,H
1948-08-28,1948,Bolton Wanderers,Wolverhampton Wanderers,0-5,0,5,1,1,5,-5,A
1948-08-28,1948,Charlton Athletic,Huddersfield Town,3-1,3,1,1,1,4,2,H
1948-08-28,1948,Derby County,Sheffield United,2-1,2,1,1,1,3,1,H
1948-08-28,1948,Liverpool,Sunderland,4-0,4,0,1,1,4,4,H
1948-08-28,1948,Manchester City,Stoke City,0-0,0,0,1,1,0,0,D
1948-08-28,1948,Middlesbrough,Everton,1-0,1,0,1,1,1,1,H
1948-08-28,1948,Newcastle United,Preston North End,2-5,2,5,1,1,7,-3,A
1948-08-28,1948,Portsmouth,Burnley,1-0,1,0,1,1,1,1,H
1948-08-30,1948,Aston Villa,Bolton Wanderers,2-4,2,4,1,1,6,-2,A
1948-08-30,1948,Sheffield United,Liverpool,1-2,1,2,1,1,3,-1,A
1948-08-30,1948,Stoke City,Arsenal,1-0,1,0,1,1,1,1,H
1948-08-31,1948,Burnley,Charlton Athletic,0-0,0,0,1,1,0,0,D
1948-09-01,1948,Chelsea,Newcastle United,2-3,2,3,1,1,5,-1,A
1948-09-01,1948,Everton,Portsmouth,0-5,0,5,1,1,5,-5,A
1948-09-01,1948,Huddersfield Town,Derby County,1-1,1,1,1,1,2,0,D
1948-09-01,1948,Manchester United,Blackpool,3-4,3,4,1,1,7,-1,A
1948-09-01,1948,Middlesbrough,Birmingham City,1-1,1,1,1,1,2,0,D
1948-09-01,1948,Preston North End,Manchester City,1-3,1,3,1,1,4,-2,A
1948-09-01,1948,Sunderland,Wolverhampton Wanderers,3-3,3,3,1,1,6,0,D
1948-09-04,1948,Aston Villa,Derby County,1-1,1,1,1,1,2,0,D
1948-09-04,1948,Burnley,Newcastle United,0-3,0,3,1,1,3,-3,A
1948-09-04,1948,Charlton Athletic,Manchester City,3-2,3,2,1,1,5,1,H
1948-09-04,1948,Chelsea,Bolton Wanderers,2-2,2,2,1,1,4,0,D
1948-09-04,1948,Everton,Birmingham City,0-5,0,5,1,1,5,-5,A
1948-09-04,1948,Manchester United,Huddersfield Town,4-1,4,1,1,1,5,3,H
1948-09-04,1948,Preston North End,Middlesbrough,6-1,6,1,1,1,7,5,H
1948-09-04,1948,Sheffield United,Arsenal,1-1,1,1,1,1,2,0,D
1948-09-04,1948,Stoke City,Portsmouth,0-1,0,1,1,1,1,-1,A
1948-09-04,1948,Sunderland,Blackpool,2-2,2,2,1,1,4,0,D
1948-09-04,1948,Wolverhampton Wanderers,Liverpool,0-0,0,0,1,1,0,0,D
1948-09-06,1948,Blackpool,Derby County,1-1,1,1,1,1,2,0,D
1948-09-06,1948,Bolton Wanderers,Huddersfield Town,1-2,1,2,1,1,3,-1,A
1948-09-06,1948,Burnley,Preston North End,1-0,1,0,1,1,1,1,H
1948-09-06,1948,Sheffield United,Sunderland,2-5,2,5,1,1,7,-3,A
1948-09-08,1948,Arsenal,Liverpool,1-1,1,1,1,1,2,0,D
1948-09-08,1948,Charlton Athletic,Chelsea,1-1,1,1,1,1,2,0,D
1948-09-08,1948,Everton,Stoke City,2-1,2,1,1,1,3,1,H
1948-09-08,1948,Manchester City,Birmingham City,1-0,1,0,1,1,1,1,H
1948-09-08,1948,Newcastle United,Aston Villa,2-1,2,1,1,1,3,1,H
1948-09-08,1948,Portsmouth,Middlesbrough,1-0,1,0,1,1,1,1,H
1948-09-08,1948,Wolverhampton Wanderers,Manchester United,3-2,3,2,1,1,5,1,H
1948-09-11,1948,Arsenal,Aston Villa,3-1,3,1,1,1,4,2,H
1948-09-11,1948,Birmingham City,Preston North End,1-0,1,0,1,1,1,1,H
1948-09-11,1948,Blackpool,Wolverhampton Wanderers,1-3,1,3,1,1,4,-2,A
1948-09-11,1948,Chelsea,Everton,6-0,6,0,1,1,6,6,H
1948-09-11,1948,Derby County,Sunderland,2-2,2,2,1,1,4,0,D
1948-09-11,1948,Huddersfield Town,Sheffield United,0-0,0,0,1,1,0,0,D
1948-09-11,1948,Liverpool,Bolton Wanderers,0-1,0,1,1,1,1,-1,A
1948-09-11,1948,Manchester City,Manchester United,0-0,0,0,1,1,0,0,D
1948-09-11,1948,Middlesbrough,Burnley,4-1,4,1,1,1,5,3,H
1948-09-11,1948,Newcastle United,Stoke City,2-2,2,2,1,1,4,0,D
1948-09-11,1948,Portsmouth,Charlton Athletic,3-1,3,1,1,1,4,2,H
1948-09-13,1948,Aston Villa,Newcastle United,2-4,2,4,1,1,6,-2,A
1948-09-13,1948,Stoke City,Everton,1-0,1,0,1,1,1,1,H
1948-09-15,1948,Birmingham City,Manchester City,4-1,4,1,1,1,5,3,H
1948-09-15,1948,Derby County,Blackpool,3-1,3,1,1,1,4,2,H
1948-09-15,1948,Huddersfield Town,Bolton Wanderers,0-2,0,2,1,1,2,-2,A
1948-09-15,1948,Liverpool,Arsenal,0-1,0,1,1,1,1,-1,A
1948-09-15,1948,Manchester United,Wolverhampton Wanderers,2-0,2,0,1,1,2,2,H
1948-09-15,1948,Middlesbrough,Portsmouth,1-1,1,1,1,1,2,0,D
1948-09-15,1948,Preston North End,Burnley,0-3,0,3,1,1,3,-3,A
1948-09-15,1948,Sunderland,Sheffield United,2-0,2,0,1,1,2,2,H
1948-09-16,1948,Chelsea,Charlton Athletic,2-2,2,2,1,1,4,0,D
1948-09-18,1948,Aston Villa,Huddersfield Town,3-3,3,3,1,1,6,0,D
1948-09-18,1948,Bolton Wanderers,Blackpool,2-2,2,2,1,1,4,0,D
1948-09-18,1948,Burnley,Birmingham City,2-2,2,2,1,1,4,0,D
1948-09-18,1948,Charlton Athletic,Newcastle United,0-0,0,0,1,1,0,0,D
1948-09-18,1948,Everton,Liverpool,1-1,1,1,1,1,2,0,D
1948-09-18,1948,Manchester City,Portsmouth,1-1,1,1,1,1,2,0,D
1948-09-18,1948,Preston North End,Chelsea,3-2,3,2,1,1,5,1,H
1948-09-18,1948,Sheffield United,Manchester United,2-2,2,2,1,1,4,0,D
1948-09-18,1948,Stoke City,Middlesbrough,3-0,3,0,1,1,3,3,H
1948-09-18,1948,Sunderland,Arsenal,1-1,1,1,1,1,2,0,D
1948-09-18,1948,Wolverhampton Wanderers,Derby County,2-2,2,2,1,1,4,0,D
1948-09-25,1948,Arsenal,Wolverhampton Wanderers,3-1,3,1,1,1,4,2,H
1948-09-25,1948,Birmingham City,Stoke City,2-1,2,1,1,1,3,1,H
1948-09-25,1948,Blackpool,Liverpool,1-0,1,0,1,1,1,1,H
1948-09-25,1948,Chelsea,Burnley,1-0,1,0,1,1,1,1,H
1948-09-25,1948,Derby County,Bolton Wanderers,1-0,1,0,1,1,1,1,H
1948-09-25,1948,Everton,Preston North End,4-1,4,1,1,1,5,3,H
1948-09-25,1948,Huddersfield Town,Sunderland,2-0,2,0,1,1,2,2,H
1948-09-25,1948,Manchester United,Aston Villa,3-1,3,1,1,1,4,2,H
1948-09-25,1948,Middlesbrough,Charlton Athletic,2-4,2,4,1,1,6,-2,A
1948-09-25,1948,Newcastle United,Manchester City,0-0,0,0,1,1,0,0,D
1948-09-25,1948,Portsmouth,Sheffield United,3-0,3,0,1,1,3,3,H
1948-10-02,1948,Aston Villa,Sheffield United,4-3,4,3,1,1,7,1,H
1948-10-02,1948,Bolton Wanderers,Arsenal,1-0,1,0,1,1,1,1,H
1948-10-02,1948,Burnley,Everton,1-0,1,0,1,1,1,1,H
1948-10-02,1948,Charlton Athletic,Birmingham City,1-1,1,1,1,1,2,0,D
1948-10-02,1948,Liverpool,Derby County,0-0,0,0,1,1,0,0,D
1948-10-02,1948,Manchester City,Middlesbrough,1-0,1,0,1,1,1,1,H
1948-10-02,1948,Portsmouth,Newcastle United,1-0,1,0,1,1,1,1,H
1948-10-02,1948,Preston North End,Blackpool,1-3,1,3,1,1,4,-2,A
1948-10-02,1948,Stoke City,Chelsea,4-3,4,3,1,1,7,1,H
1948-10-02,1948,Sunderland,Manchester United,2-1,2,1,1,1,3,1,H
1948-10-02,1948,Wolverhampton Wanderers,Huddersfield Town,7-1,7,1,1,1,8,6,H
1948-10-09,1948,Arsenal,Burnley,3-1,3,1,1,1,4,2,H
1948-10-09,1948,Aston Villa,Portsmouth,1-1,1,1,1,1,2,0,D
1948-10-09,1948,Blackpool,Everton,3-0,3,0,1,1,3,3,H
1948-10-09,1948,Bolton Wanderers,Birmingham City,0-0,0,0,1,1,0,0,D
1948-10-09,1948,Derby County,Preston North End,1-0,1,0,1,1,1,1,H
1948-10-09,1948,Huddersfield Town,Stoke City,1-3,1,3,1,1,4,-2,A
1948-10-09,1948,Liverpool,Chelsea,1-1,1,1,1,1,2,0,D
1948-10-09,1948,Manchester United,Charlton Athletic,1-1,1,1,1,1,2,0,D
1948-10-09,1948,Sheffield United,Manchester City,0-2,0,2,1,1,2,-2,A
1948-10-09,1948,Sunderland,Newcastle United,1-1,1,1,1,1,2,0,D
1948-10-09,1948,Wolverhampton Wanderers,Middlesbrough,0-3,0,3,1,1,3,-3,A
1948-10-16,1948,Birmingham City,Liverpool,0-1,0,1,1,1,1,-1,A
1948-10-16,1948,Burnley,Huddersfield Town,1-2,1,2,1,1,3,-1,A
1948-10-16,1948,Charlton Athletic,Sheffield United,2-1,2,1,1,1,3,1,H
1948-10-16,1948,Chelsea,Blackpool,3-3,3,3,1,1,6,0,D
1948-10-16,1948,Everton,Derby County,0-1,0,1,1,1,1,-1,A
1948-10-16,1948,Manchester City,Aston Villa,4-1,4,1,1,1,5,3,H
1948-10-16,1948,Middlesbrough,Bolton Wanderers,5-0,5,0,1,1,5,5,H
1948-10-16,1948,Newcastle United,Wolverhampton Wanderers,3-1,3,1,1,1,4,2,H
1948-10-16,1948,Portsmouth,Sunderland,3-0,3,0,1,1,3,3,H
1948-10-16,1948,Preston North End,Arsenal,1-1,1,1,1,1,2,0,D
1948-10-16,1948,Stoke City,Manchester United,2-1,2,1,1,1,3,1,H
1948-10-23,1948,Arsenal,Everton,5-0,5,0,1,1,5,5,H
1948-10-23,1948,Aston Villa,Charlton Athletic,4-3,4,3,1,1,7,1,H
1948-10-23,1948,Blackpool,Birmingham City,1-0,1,0,1,1,1,1,H
1948-10-23,1948,Bolton Wanderers,Newcastle United,1-5,1,5,1,1,6,-4,A
1948-10-23,1948,Derby County,Chelsea,2-1,2,1,1,1,3,1,H
1948-10-23,1948,Huddersfield Town,Preston North End,0-2,0,2,1,1,2,-2,A
1948-10-23,1948,Liverpool,Middlesbrough,4-0,4,0,1,1,4,4,H
1948-10-23,1948,Manchester United,Burnley,1-1,1,1,1,1,2,0,D
1948-10-23,1948,Sheffield United,Stoke City,2-2,2,2,1,1,4,0,D
1948-10-23,1948,Sunderland,Manchester City,3-0,3,0,1,1,3,3,H
1948-10-23,1948,Wolverhampton Wanderers,Portsmouth,3-0,3,0,1,1,3,3,H
1948-10-30,1948,Birmingham City,Derby County,0-1,0,1,1,1,1,-1,A
1948-10-30,1948,Burnley,Sheffield United,2-0,2,0,1,1,2,2,H
1948-10-30,1948,Charlton Athletic,Sunderland,4-0,4,0,1,1,4,4,H
1948-10-30,1948,Chelsea,Arsenal,0-1,0,1,1,1,1,-1,A
1948-10-30,1948,Everton,Huddersfield Town,2-0,2,0,1,1,2,2,H
1948-10-30,1948,Manchester City,Wolverhampton Wanderers,3-3,3,3,1,1,6,0,D
1948-10-30,1948,Middlesbrough,Blackpool,1-0,1,0,1,1,1,1,H
1948-10-30,1948,Newcastle United,Liverpool,1-0,1,0,1,1,1,1,H
1948-10-30,1948,Portsmouth,Bolton Wanderers,0-0,0,0,1,1,0,0,D
1948-10-30,1948,Preston North End,Manchester United,1-6,1,6,1,1,7,-5,A
1948-10-30,1948,Stoke City,Aston Villa,4-2,4,2,1,1,6,2,H
1948-11-06,1948,Arsenal,Birmingham City,2-0,2,0,1,1,2,2,H
1948-11-06,1948,Aston Villa,Burnley,3-1,3,1,1,1,4,2,H
1948-11-06,1948,Blackpool,Newcastle United,1-3,1,3,1,1,4,-2,A
1948-11-06,1948,Bolton Wanderers,Manchester City,5-1,5,1,1,1,6,4,H
1948-11-06,1948,Derby County,Middlesbrough,2-0,2,0,1,1,2,2,H
1948-11-06,1948,Huddersfield Town,Chelsea,3-4,3,4,1,1,7,-1,A
1948-11-06,1948,Liverpool,Portsmouth,3-1,3,1,1,1,4,2,H
1948-11-06,1948,Manchester United,Everton,2-0,2,0,1,1,2,2,H
1948-11-06,1948,Sheffield United,Preston North End,3-2,3,2,1,1,5,1,H
1948-11-06,1948,Sunderland,Stoke City,1-1,1,1,1,1,2,0,D
1948-11-06,1948,Wolverhampton Wanderers,Charlton Athletic,2-0,2,0,1,1,2,2,H
1948-11-13,1948,Birmingham City,Huddersfield Town,1-0,1,0,1,1,1,1,H
1948-11-13,1948,Burnley,Sunderland,3-1,3,1,1,1,4,2,H
1948-11-13,1948,Charlton Athletic,Bolton Wanderers,1-4,1,4,1,1,5,-3,A
1948-11-13,1948,Chelsea,Manchester United,1-1,1,1,1,1,2,0,D
1948-11-13,1948,Everton,Sheffield United,2-1,2,1,1,1,3,1,H
1948-11-13,1948,Manchester City,Liverpool,2-4,2,4,1,1,6,-2,A
1948-11-13,1948,Middlesbrough,Arsenal,0-1,0,1,1,1,1,-1,A
1948-11-13,1948,Newcastle United,Derby County,3-0,3,0,1,1,3,3,H
1948-11-13,1948,Portsmouth,Blackpool,1-1,1,1,1,1,2,0,D
1948-11-13,1948,Preston North End,Aston Villa,0-1,0,1,1,1,1,-1,A
1948-11-13,1948,Stoke City,Wolverhampton Wanderers,2-1,2,1,1,1,3,1,H
1948-11-20,1948,Arsenal,Newcastle United,0-1,0,1,1,1,1,-1,A
1948-11-20,1948,Aston Villa,Everton,0-1,0,1,1,1,1,-1,A
1948-11-20,1948,Blackpool,Manchester City,1-1,1,1,1,1,2,0,D
1948-11-20,1948,Bolton Wanderers,Stoke City,2-1,2,1,1,1,3,1,H
1948-11-20,1948,Derby County,Portsmouth,1-0,1,0,1,1,1,1,H
1948-11-20,1948,Huddersfield Town,Middlesbrough,0-0,0,0,1,1,0,0,D
1948-11-20,1948,Liverpool,Charlton Athletic,1-1,1,1,1,1,2,0,D
1948-11-20,1948,Manchester United,Birmingham City,3-0,3,0,1,1,3,3,H
1948-11-20,1948,Sheffield United,Chelsea,2-1,2,1,1,1,3,1,H
1948-11-20,1948,Sunderland,Preston North End,0-0,0,0,1,1,0,0,D
1948-11-20,1948,Wolverhampton Wanderers,Burnley,3-0,3,0,1,1,3,3,H
1948-11-27,1948,Birmingham City,Sheffield United,1-2,1,2,1,1,3,-1,A
1948-11-27,1948,Burnley,Bolton Wanderers,3-0,3,0,1,1,3,3,H
1948-11-27,1948,Charlton Athletic,Blackpool,0-0,0,0,1,1,0,0,D
1948-11-27,1948,Chelsea,Aston Villa,2-1,2,1,1,1,3,1,H
1948-11-27,1948,Everton,Sunderland,1-0,1,0,1,1,1,1,H
1948-11-27,1948,Manchester City,Derby County,2-1,2,1,1,1,3,1,H
1948-11-27,1948,Middlesbrough,Manchester United,1-4,1,4,1,1,5,-3,A
1948-11-27,1948,Newcastle United,Huddersfield Town,2-4,2,4,1,1,6,-2,A
1948-11-27,1948,Portsmouth,Arsenal,4-1,4,1,1,1,5,3,H
1948-11-27,1948,Preston North End,Wolverhampton Wanderers,1-1,1,1,1,1,2,0,D
1948-11-27,1948,Stoke City,Liverpool,3-0,3,0,1,1,3,3,H
1948-12-04,1948,Arsenal,Manchester City,1-1,1,1,1,1,2,0,D
1948-12-04,1948,Aston Villa,Birmingham City,0-3,0,3,1,1,3,-3,A
1948-12-04,1948,Blackpool,Stoke City,2-1,2,1,1,1,3,1,H
1948-12-04,1948,Bolton Wanderers,Preston North End,5-3,5,3,1,1,8,2,H
1948-12-04,1948,Derby County,Charlton Athletic,5-1,5,1,1,1,6,4,H
1948-12-04,1948,Huddersfield Town,Portsmouth,0-0,0,0,1,1,0,0,D
1948-12-04,1948,Liverpool,Burnley,1-1,1,1,1,1,2,0,D
1948-12-04,1948,Manchester United,Newcastle United,1-1,1,1,1,1,2,0,D
1948-12-04,1948,Sheffield United,Middlesbrough,1-0,1,0,1,1,1,1,H
1948-12-04,1948,Sunderland,Chelsea,3-0,3,0,1,1,3,3,H
1948-12-04,1948,Wolverhampton Wanderers,Everton,1-0,1,0,1,1,1,1,H
1948-12-11,1948,Birmingham City,Sunderland,0-0,0,0,1,1,0,0,D
1948-12-11,1948,Burnley,Blackpool,2-0,2,0,1,1,2,2,H
1948-12-11,1948,Charlton Athletic,Arsenal,4-3,4,3,1,1,7,1,H
1948-12-11,1948,Chelsea,Wolverhampton Wanderers,4-1,4,1,1,1,5,3,H
1948-12-11,1948,Everton,Bolton Wanderers,1-0,1,0,1,1,1,1,H
1948-12-11,1948,Manchester City,Huddersfield Town,3-1,3,1,1,1,4,2,H
1948-12-11,1948,Middlesbrough,Aston Villa,6-0,6,0,1,1,6,6,H
1948-12-11,1948,Newcastle United,Sheffield United,3-2,3,2,1,1,5,1,H
1948-12-11,1948,Portsmouth,Manchester United,2-2,2,2,1,1,4,0,D
1948-12-11,1948,Preston North End,Liverpool,3-2,3,2,1,1,5,1,H
1948-12-11,1948,Stoke City,Derby County,4-2,4,2,1,1,6,2,H
1948-12-18,1948,Arsenal,Huddersfield Town,3-0,3,0,1,1,3,3,H
1948-12-18,1948,Birmingham City,Wolverhampton Wanderers,0-1,0,1,1,1,1,-1,A
1948-12-18,1948,Blackpool,Sheffield United,0-3,0,3,1,1,3,-3,A
1948-12-18,1948,Bolton Wanderers,Sunderland,4-1,4,1,1,1,5,3,H
1948-12-18,1948,Charlton Athletic,Stoke City,4-1,4,1,1,1,5,3,H
1948-12-18,1948,Derby County,Manchester United,1-3,1,3,1,1,4,-2,A
1948-12-18,1948,Liverpool,Aston Villa,1-1,1,1,1,1,2,0,D
1948-12-18,1948,Manchester City,Burnley,2-2,2,2,1,1,4,0,D
1948-12-18,1948,Middlesbrough,Chelsea,1-1,1,1,1,1,2,0,D
1948-12-18,1948,Newcastle United,Everton,1-0,1,0,1,1,1,1,H
1948-12-18,1948,Portsmouth,Preston North End,3-1,3,1,1,1,4,2,H
1948-12-25,1948,Arsenal,Derby County,3-3,3,3,1,1,6,0,D
1948-12-25,1948,Birmingham City,Newcastle United,2-0,2,0,1,1,2,2,H
1948-12-25,1948,Blackpool,Huddersfield Town,0-0,0,0,1,1,0,0,D
1948-12-25,1948,Burnley,Stoke City,1-3,1,3,1,1,4,-2,A
1948-12-25,1948,Charlton Athletic,Preston North End,0-0,0,0,1,1,0,0,D
1948-12-25,1948,Chelsea,Portsmouth,1-2,1,2,1,1,3,-1,A
1948-12-25,1948,Everton,Manchester City,0-0,0,0,1,1,0,0,D
1948-12-25,1948,Manchester United,Liverpool,0-0,0,0,1,1,0,0,D
1948-12-25,1948,Sheffield United,Bolton Wanderers,1-1,1,1,1,1,2,0,D
1948-12-25,1948,Sunderland,Middlesbrough,1-0,1,0,1,1,1,1,H
1948-12-25,1948,Wolverhampton Wanderers,Aston Villa,4-0,4,0,1,1,4,4,H
1948-12-27,1948,Aston Villa,Wolverhampton Wanderers,5-1,5,1,1,1,6,4,H
1948-12-27,1948,Bolton Wanderers,Sheffield United,6-1,6,1,1,1,7,5,H
1948-12-27,1948,Derby County,Arsenal,2-1,2,1,1,1,3,1,H
1948-12-27,1948,Huddersfield Town,Blackpool,1-0,1,0,1,1,1,1,H
1948-12-27,1948,Liverpool,Manchester United,0-2,0,2,1,1,2,-2,A
1948-12-27,1948,Manchester City,Everton,0-0,0,0,1,1,0,0,D
1948-12-27,1948,Middlesbrough,Sunderland,0-0,0,0,1,1,0,0,D
1948-12-27,1948,Newcastle United,Birmingham City,1-0,1,0,1,1,1,1,H
1948-12-27,1948,Portsmouth,Chelsea,5-2,5,2,1,1,7,3,H
1948-12-27,1948,Preston North End,Charlton Athletic,2-3,2,3,1,1,5,-1,A
1948-12-27,1948,Stoke City,Burnley,2-1,2,1,1,1,3,1,H
1949-01-01,1948,Aston Villa,Blackpool,2-5,2,5,1,1,7,-3,A
1949-01-01,1948,Burnley,Portsmouth,2-1,2,1,1,1,3,1,H
1949-01-01,1948,Chelsea,Birmingham City,2-0,2,0,1,1,2,2,H
1949-01-01,1948,Everton,Middlesbrough,3-1,3,1,1,1,4,2,H
1949-01-01,1948,Huddersfield Town,Charlton Athletic,1-2,1,2,1,1,3,-1,A
1949-01-01,1948,Manchester United,Arsenal,2-0,2,0,1,1,2,2,H
1949-01-01,1948,Preston North End,Newcastle United,2-1,2,1,1,1,3,1,H
1949-01-01,1948,Sheffield United,Derby County,3-1,3,1,1,1,4,2,H
1949-01-01,1948,Stoke City,Manchester City,2-3,2,3,1,1,5,-1,A
1949-01-01,1948,Sunderland,Liverpool,0-2,0,2,1,1,2,-2,A
1949-01-01,1948,Wolverhampton Wanderers,Bolton Wanderers,2-0,2,0,1,1,2,2,H
1949-01-15,1948,Arsenal,Sheffield United,5-3,5,3,1,1,8,2,H
1949-01-15,1948,Blackpool,Sunderland,3-3,3,3,1,1,6,0,D
1949-01-15,1948,Manchester City,Charlton Athletic,0-1,0,1,1,1,1,-1,A
1949-01-15,1948,Middlesbrough,Preston North End,1-0,1,0,1,1,1,1,H
1949-01-15,1948,Newcastle United,Burnley,1-1,1,1,1,1,2,0,D
1949-01-15,1948,Portsmouth,Stoke City,1-0,1,0,1,1,1,1,H
1949-01-22,1948,Aston Villa,Arsenal,1-0,1,0,1,1,1,1,H
1949-01-22,1948,Bolton Wanderers,Liverpool,0-3,0,3,1,1,3,-3,A
1949-01-22,1948,Burnley,Middlesbrough,0-0,0,0,1,1,0,0,D
1949-01-22,1948,Charlton Athletic,Portsmouth,0-1,0,1,1,1,1,-1,A
1949-01-22,1948,Everton,Chelsea,2-1,2,1,1,1,3,1,H
1949-01-22,1948,Manchester United,Manchester City,0-0,0,0,1,1,0,0,D
1949-01-22,1948,Preston North End,Birmingham City,0-0,0,0,1,1,0,0,D
1949-01-22,1948,Sheffield United,Huddersfield Town,0-0,0,0,1,1,0,0,D
1949-01-22,1948,Stoke City,Newcastle United,1-1,1,1,1,1,2,0,D
1949-01-22,1948,Sunderland,Derby County,2-1,2,1,1,1,3,1,H
1949-01-22,1948,Wolverhampton Wanderers,Blackpool,2-1,2,1,1,1,3,1,H
1949-02-05,1948,Arsenal,Sunderland,5-0,5,0,1,1,5,5,H
1949-02-05,1948,Birmingham City,Burnley,0-0,0,0,1,1,0,0,D
1949-02-05,1948,Chelsea,Preston North End,5-3,5,3,1,1,8,2,H
1949-02-05,1948,Derby County,Wolverhampton Wanderers,3-2,3,2,1,1,5,1,H
1949-02-05,1948,Liverpool,Everton,0-0,0,0,1,1,0,0,D
1949-02-05,1948,Newcastle United,Charlton Athletic,2-0,2,0,1,1,2,2,H
1949-02-05,1948,Portsmouth,Manchester City,3-1,3,1,1,1,4,2,H
1949-02-12,1948,Birmingham City,Everton,0-0,0,0,1,1,0,0,D
1949-02-12,1948,Blackpool,Bolton Wanderers,1-0,1,0,1,1,1,1,H
1949-02-12,1948,Huddersfield Town,Aston Villa,0-1,0,1,1,1,1,-1,A
1949-02-19,1948,Aston Villa,Manchester United,2-1,2,1,1,1,3,1,H
1949-02-19,1948,Bolton Wanderers,Derby County,4-0,4,0,1,1,4,4,H
1949-02-19,1948,Burnley,Chelsea,3-0,3,0,1,1,3,3,H
1949-02-19,1948,Charlton Athletic,Middlesbrough,2-0,2,0,1,1,2,2,H
1949-02-19,1948,Liverpool,Blackpool,1-1,1,1,1,1,2,0,D
1949-02-19,1948,Manchester City,Newcastle United,1-0,1,0,1,1,1,1,H
1949-02-19,1948,Preston North End,Everton,3-1,3,1,1,1,4,2,H
1949-02-19,1948,Sheffield United,Portsmouth,3-1,3,1,1,1,4,2,H
1949-02-19,1948,Stoke City,Birmingham City,2-1,2,1,1,1,3,1,H
1949-02-19,1948,Sunderland,Huddersfield Town,0-1,0,1,1,1,1,-1,A
1949-02-19,1948,Wolverhampton Wanderers,Arsenal,1-3,1,3,1,1,4,-2,A
1949-02-26,1948,Arsenal,Bolton Wanderers,5-0,5,0,1,1,5,5,H
1949-02-26,1948,Birmingham City,Charlton Athletic,1-0,1,0,1,1,1,1,H
1949-02-26,1948,Blackpool,Preston North End,2-2,2,2,1,1,4,0,D
1949-02-26,1948,Chelsea,Stoke City,2-2,2,2,1,1,4,0,D
1949-02-26,1948,Everton,Burnley,2-1,2,1,1,1,3,1,H
1949-02-26,1948,Middlesbrough,Manchester City,0-1,0,1,1,1,1,-1,A
1949-02-26,1948,Sheffield United,Aston Villa,0-1,0,1,1,1,1,-1,A
1949-03-05,1948,Birmingham City,Bolton Wanderers,0-0,0,0,1,1,0,0,D
1949-03-05,1948,Burnley,Arsenal,1-1,1,1,1,1,2,0,D
1949-03-05,1948,Charlton Athletic,Manchester United,2-3,2,3,1,1,5,-1,A
1949-03-05,1948,Chelsea,Liverpool,2-1,2,1,1,1,3,1,H
1949-03-05,1948,Everton,Blackpool,5-0,5,0,1,1,5,5,H
1949-03-05,1948,Manchester City,Sheffield United,1-0,1,0,1,1,1,1,H
1949-03-05,1948,Middlesbrough,Wolverhampton Wanderers,4-4,4,4,1,1,8,0,D
1949-03-05,1948,Newcastle United,Sunderland,2-1,2,1,1,1,3,1,H
1949-03-05,1948,Portsmouth,Aston Villa,3-0,3,0,1,1,3,3,H
1949-03-05,1948,Preston North End,Derby County,0-0,0,0,1,1,0,0,D
1949-03-05,1948,Stoke City,Huddersfield Town,1-3,1,3,1,1,4,-2,A
1949-03-12,1948,Arsenal,Preston North End,0-0,0,0,1,1,0,0,D
1949-03-12,1948,Aston Villa,Manchester City,1-0,1,0,1,1,1,1,H
1949-03-12,1948,Blackpool,Chelsea,2-1,2,1,1,1,3,1,H
1949-03-12,1948,Bolton Wanderers,Middlesbrough,4-1,4,1,1,1,5,3,H
1949-03-12,1948,Derby County,Everton,3-2,3,2,1,1,5,1,H
1949-03-12,1948,Huddersfield Town,Burnley,1-0,1,0,1,1,1,1,H
1949-03-12,1948,Liverpool,Birmingham City,1-0,1,0,1,1,1,1,H
1949-03-12,1948,Manchester United,Stoke City,3-0,3,0,1,1,3,3,H
1949-03-12,1948,Sheffield United,Charlton Athletic,2-0,2,0,1,1,2,2,H
1949-03-12,1948,Sunderland,Portsmouth,1-4,1,4,1,1,5,-3,A
1949-03-12,1948,Wolverhampton Wanderers,Newcastle United,3-0,3,0,1,1,3,3,H
1949-03-19,1948,Birmingham City,Manchester United,1-0,1,0,1,1,1,1,H
1949-03-19,1948,Burnley,Wolverhampton Wanderers,0-0,0,0,1,1,0,0,D
1949-03-19,1948,Charlton Athletic,Liverpool,2-1,2,1,1,1,3,1,H
1949-03-19,1948,Chelsea,Sheffield United,1-0,1,0,1,1,1,1,H
1949-03-19,1948,Everton,Aston Villa,1-3,1,3,1,1,4,-2,A
1949-03-19,1948,Manchester City,Blackpool,1-1,1,1,1,1,2,0,D
1949-03-19,1948,Middlesbrough,Huddersfield Town,1-0,1,0,1,1,1,1,H
1949-03-19,1948,Newcastle United,Arsenal,3-2,3,2,1,1,5,1,H
1949-03-19,1948,Portsmouth,Derby County,1-0,1,0,1,1,1,1,H
1949-03-19,1948,Preston North End,Sunderland,1-3,1,3,1,1,4,-2,A
1949-03-19,1948,Stoke City,Bolton Wanderers,4-0,4,0,1,1,4,4,H
1949-03-26,1948,Aston Villa,Chelsea,1-1,1,1,1,1,2,0,D
1949-03-26,1948,Blackpool,Charlton Athletic,0-1,0,1,1,1,1,-1,A
1949-03-26,1948,Bolton Wanderers,Burnley,0-1,0,1,1,1,1,-1,A
1949-03-26,1948,Derby County,Manchester City,2-0,2,0,1,1,2,2,H
1949-03-26,1948,Huddersfield Town,Newcastle United,0-2,0,2,1,1,2,-2,A
1949-03-26,1948,Liverpool,Stoke City,4-0,4,0,1,1,4,4,H
1949-03-26,1948,Sheffield United,Birmingham City,4-0,4,0,1,1,4,4,H
1949-03-26,1948,Sunderland,Everton,1-1,1,1,1,1,2,0,D
1949-04-02,1948,Birmingham City,Arsenal,1-1,1,1,1,1,2,0,D
1949-04-02,1948,Burnley,Aston Villa,1-1,1,1,1,1,2,0,D
1949-04-02,1948,Charlton Athletic,Everton,3-1,3,1,1,1,4,2,H
1949-04-02,1948,Chelsea,Huddersfield Town,5-0,5,0,1,1,5,5,H
1949-04-02,1948,Manchester City,Bolton Wanderers,1-0,1,0,1,1,1,1,H
1949-04-02,1948,Middlesbrough,Derby County,1-0,1,0,1,1,1,1,H
1949-04-02,1948,Newcastle United,Blackpool,3-1,3,1,1,1,4,2,H
1949-04-02,1948,Portsmouth,Liverpool,3-2,3,2,1,1,5,1,H
1949-04-02,1948,Preston North End,Sheffield United,4-1,4,1,1,1,5,3,H
1949-04-02,1948,Stoke City,Sunderland,0-0,0,0,1,1,0,0,D
1949-04-06,1948,Huddersfield Town,Manchester United,2-1,2,1,1,1,3,1,H
1949-04-06,1948,Liverpool,Wolverhampton Wanderers,0-0,0,0,1,1,0,0,D
1949-04-06,1948,Newcastle United,Portsmouth,0-5,0,5,1,1,5,-5,A
1949-04-09,1948,Arsenal,Middlesbrough,1-1,1,1,1,1,2,0,D
1949-04-09,1948,Aston Villa,Preston North End,2-0,2,0,1,1,2,2,H
1949-04-09,1948,Blackpool,Portsmouth,1-0,1,0,1,1,1,1,H
1949-04-09,1948,Bolton Wanderers,Charlton Athletic,2-2,2,2,1,1,4,0,D
1949-04-09,1948,Derby County,Newcastle United,2-4,2,4,1,1,6,-2,A
1949-04-09,1948,Huddersfield Town,Birmingham City,0-0,0,0,1,1,0,0,D
1949-04-09,1948,Liverpool,Manchester City,0-1,0,1,1,1,1,-1,A
1949-04-09,1948,Manchester United,Chelsea,1-1,1,1,1,1,2,0,D
1949-04-09,1948,Sheffield United,Everton,1-1,1,1,1,1,2,0,D
1949-04-09,1948,Sunderland,Burnley,0-0,0,0,1,1,0,0,D
1949-04-09,1948,Wolverhampton Wanderers,Stoke City,3-1,3,1,1,1,4,2,H
1949-04-13,1948,Charlton Athletic,Wolverhampton Wanderers,2-3,2,3,1,1,5,-1,A
1949-04-15,1948,Blackpool,Arsenal,1-1,1,1,1,1,2,0,D
1949-04-15,1948,Bolton Wanderers,Manchester United,0-1,0,1,1,1,1,-1,A
1949-04-15,1948,Burnley,Derby County,3-1,3,1,1,1,4,2,H
1949-04-15,1948,Liverpool,Huddersfield Town,0-1,0,1,1,1,1,-1,A
1949-04-15,1948,Manchester City,Chelsea,1-0,1,0,1,1,1,1,H
1949-04-15,1948,Newcastle United,Middlesbrough,1-0,1,0,1,1,1,1,H
1949-04-15,1948,Portsmouth,Birmingham City,3-1,3,1,1,1,4,2,H
1949-04-15,1948,Preston North End,Stoke City,2-1,2,1,1,1,3,1,H
1949-04-15,1948,Sunderland,Aston Villa,0-0,0,0,1,1,0,0,D
1949-04-16,1948,Birmingham City,Blackpool,1-1,1,1,1,1,2,0,D
1949-04-16,1948,Burnley,Manchester United,0-2,0,2,1,1,2,-2,A
1949-04-16,1948,Charlton Athletic,Aston Villa,0-2,0,2,1,1,2,-2,A
1949-04-16,1948,Chelsea,Derby County,0-3,0,3,1,1,3,-3,A
1949-04-16,1948,Everton,Arsenal,0-0,0,0,1,1,0,0,D
1949-04-16,1948,Manchester City,Sunderland,1-1,1,1,1,1,2,0,D
1949-04-16,1948,Middlesbrough,Liverpool,0-1,0,1,1,1,1,-1,A
1949-04-16,1948,Newcastle United,Bolton Wanderers,1-1,1,1,1,1,2,0,D
1949-04-16,1948,Portsmouth,Wolverhampton Wanderers,5-0,5,0,1,1,5,5,H
1949-04-16,1948,Preston North End,Huddersfield Town,2-0,2,0,1,1,2,2,H
1949-04-16,1948,Stoke City,Sheffield United,0-1,0,1,1,1,1,-1,A
1949-04-18,1948,Arsenal,Blackpool,2-0,2,0,1,1,2,2,H
1949-04-18,1948,Birmingham City,Portsmouth,3-0,3,0,1,1,3,3,H
1949-04-18,1948,Chelsea,Manchester City,1-1,1,1,1,1,2,0,D
1949-04-18,1948,Derby County,Burnley,2-0,2,0,1,1,2,2,H
1949-04-18,1948,Everton,Charlton Athletic,1-1,1,1,1,1,2,0,D
1949-04-18,1948,Huddersfield Town,Liverpool,0-4,0,4,1,1,4,-4,A
1949-04-18,1948,Manchester United,Bolton Wanderers,3-0,3,0,1,1,3,3,H
1949-04-18,1948,Middlesbrough,Newcastle United,3-2,3,2,1,1,5,1,H
1949-04-18,1948,Sheffield United,Wolverhampton Wanderers,1-1,1,1,1,1,2,0,D
1949-04-18,1948,Stoke City,Preston North End,2-0,2,0,1,1,2,2,H
1949-04-19,1948,Aston Villa,Sunderland,1-1,1,1,1,1,2,0,D
1949-04-19,1948,Wolverhampton Wanderers,Sheffield United,6-0,6,0,1,1,6,6,H
1949-04-21,1948,Manchester United,Sunderland,1-2,1,2,1,1,3,-1,A
1949-04-23,1948,Arsenal,Chelsea,1-2,1,2,1,1,3,-1,A
1949-04-23,1948,Aston Villa,Stoke City,2-1,2,1,1,1,3,1,H
1949-04-23,1948,Blackpool,Middlesbrough,1-1,1,1,1,1,2,0,D
1949-04-23,1948,Bolton Wanderers,Portsmouth,1-2,1,2,1,1,3,-1,A
1949-04-23,1948,Derby County,Birmingham City,1-0,1,0,1,1,1,1,H
1949-04-23,1948,Huddersfield Town,Everton,1-1,1,1,1,1,2,0,D
1949-04-23,1948,Liverpool,Newcastle United,1-1,1,1,1,1,2,0,D
1949-04-23,1948,Manchester United,Preston North End,2-2,2,2,1,1,4,0,D
1949-04-23,1948,Sheffield United,Burnley,0-0,0,0,1,1,0,0,D
1949-04-23,1948,Sunderland,Charlton Athletic,1-0,1,0,1,1,1,1,H
1949-04-23,1948,Wolverhampton Wanderers,Manchester City,1-1,1,1,1,1,2,0,D
1949-04-27,1948,Derby County,Aston Villa,2-2,2,2,1,1,4,0,D
1949-04-27,1948,Everton,Manchester United,2-0,2,0,1,1,2,2,H
1949-04-27,1948,Manchester City,Arsenal,0-3,0,3,1,1,3,-3,A
1949-04-27,1948,Middlesbrough,Stoke City,1-1,1,1,1,1,2,0,D
1949-04-30,1948,Birmingham City,Aston Villa,0-1,0,1,1,1,1,-1,A
1949-04-30,1948,Burnley,Liverpool,0-2,0,2,1,1,2,-2,A
1949-04-30,1948,Charlton Athletic,Derby County,1-5,1,5,1,1,6,-4,A
1949-04-30,1948,Chelsea,Sunderland,0-1,0,1,1,1,1,-1,A
1949-04-30,1948,Middlesbrough,Sheffield United,3-1,3,1,1,1,4,2,H
1949-04-30,1948,Newcastle United,Manchester United,0-1,0,1,1,1,1,-1,A
1949-04-30,1948,Portsmouth,Huddersfield Town,2-0,2,0,1,1,2,2,H
1949-04-30,1948,Preston North End,Bolton Wanderers,1-1,1,1,1,1,2,0,D
1949-04-30,1948,Stoke City,Blackpool,3-2,3,2,1,1,5,1,H
1949-05-02,1948,Manchester United,Middlesbrough,1-0,1,0,1,1,1,1,H
1949-05-02,1948,Wolverhampton Wanderers,Preston North End,2-1,2,1,1,1,3,1,H
1949-05-04,1948,Arsenal,Portsmouth,3-2,3,2,1,1,5,1,H
1949-05-04,1948,Bolton Wanderers,Chelsea,1-1,1,1,1,1,2,0,D
1949-05-04,1948,Derby County,Liverpool,3-0,3,0,1,1,3,3,H
1949-05-04,1948,Everton,Wolverhampton Wanderers,1-0,1,0,1,1,1,1,H
1949-05-04,1948,Manchester United,Sheffield United,3-2,3,2,1,1,5,1,H
1949-05-05,1948,Huddersfield Town,Wolverhampton Wanderers,4-0,4,0,1,1,4,4,H
1949-05-07,1948,Arsenal,Charlton Athletic,2-0,2,0,1,1,2,2,H
1949-05-07,1948,Aston Villa,Middlesbrough,1-1,1,1,1,1,2,0,D
1949-05-07,1948,Blackpool,Burnley,1-1,1,1,1,1,2,0,D
1949-05-07,1948,Bolton Wanderers,Everton,1-0,1,0,1,1,1,1,H
1949-05-07,1948,Derby County,Stoke City,4-1,4,1,1,1,5,3,H
1949-05-07,1948,Huddersfield Town,Manchester City,1-0,1,0,1,1,1,1,H
1949-05-07,1948,Liverpool,Preston North End,0-2,0,2,1,1,2,-2,A
1949-05-07,1948,Manchester United,Portsmouth,3-2,3,2,1,1,5,1,H
1949-05-07,1948,Sheffield United,Newcastle United,0-0,0,0,1,1,0,0,D
1949-05-07,1948,Sunderland,Birmingham City,1-1,1,1,1,1,2,0,D
1949-05-07,1948,Wolverhampton Wanderers,Chelsea,1-1,1,1,1,1,2,0,D
1949-08-20,1949,Arsenal,Burnley,0-1,0,1,1,1,1,-1,A
1949-08-20,1949,Birmingham City,Chelsea,0-3,0,3,1,1,3,-3,A
1949-08-20,1949,Blackpool,Huddersfield Town,4-1,4,1,1,1,5,3,H
1949-08-20,1949,Bolton Wanderers,Stoke City,4-0,4,0,1,1,4,4,H
1949-08-20,1949,Derby County,Manchester United,0-1,0,1,1,1,1,-1,A
1949-08-20,1949,Fulham,Wolverhampton Wanderers,1-2,1,2,1,1,3,-1,A
1949-08-20,1949,Liverpool,Sunderland,4-2,4,2,1,1,6,2,H
1949-08-20,1949,Manchester City,Aston Villa,3-3,3,3,1,1,6,0,D
1949-08-20,1949,Middlesbrough,Everton,0-1,0,1,1,1,1,-1,A
1949-08-20,1949,Newcastle United,Portsmouth,1-3,1,3,1,1,4,-2,A
1949-08-20,1949,West Bromwich Albion,Charlton Athletic,1-0,1,0,1,1,1,1,H
1949-08-22,1949,Blackpool,Middlesbrough,1-1,1,1,1,1,2,0,D
1949-08-22,1949,Stoke City,Liverpool,0-0,0,0,1,1,0,0,D
1949-08-23,1949,Aston Villa,Derby County,1-1,1,1,1,1,2,0,D
1949-08-23,1949,Burnley,Sunderland,2-2,2,2,1,1,4,0,D
1949-08-24,1949,Birmingham City,West Bromwich Albion,2-0,2,0,1,1,2,2,H
1949-08-24,1949,Charlton Athletic,Wolverhampton Wanderers,2-3,2,3,1,1,5,-1,A
1949-08-24,1949,Chelsea,Arsenal,1-2,1,2,1,1,3,-1,A
1949-08-24,1949,Everton,Newcastle United,2-1,2,1,1,1,3,1,H
1949-08-24,1949,Huddersfield Town,Fulham,2-2,2,2,1,1,4,0,D
1949-08-24,1949,Manchester United,Bolton Wanderers,3-0,3,0,1,1,3,3,H
1949-08-24,1949,Portsmouth,Manchester City,1-1,1,1,1,1,2,0,D
1949-08-27,1949,Aston Villa,Fulham,3-1,3,1,1,1,4,2,H
1949-08-27,1949,Burnley,Bolton Wanderers,2-1,2,1,1,1,3,1,H
1949-08-27,1949,Charlton Athletic,Manchester City,3-1,3,1,1,1,4,2,H
1949-08-27,1949,Chelsea,Derby County,1-2,1,2,1,1,3,-1,A
1949-08-27,1949,Everton,Liverpool,0-0,0,0,1,1,0,0,D
1949-08-27,1949,Huddersfield Town,Middlesbrough,2-2,2,2,1,1,4,0,D
1949-08-27,1949,Manchester United,West Bromwich Albion,1-1,1,1,1,1,2,0,D
1949-08-27,1949,Portsmouth,Blackpool,2-3,2,3,1,1,5,-1,A
1949-08-27,1949,Stoke City,Birmingham City,3-1,3,1,1,1,4,2,H
1949-08-27,1949,Sunderland,Arsenal,4-2,4,2,1,1,6,2,H
1949-08-27,1949,Wolverhampton Wanderers,Newcastle United,2-1,2,1,1,1,3,1,H
1949-08-29,1949,Wolverhampton Wanderers,Charlton Athletic,2-1,2,1,1,1,3,1,H
1949-08-31,1949,Arsenal,Chelsea,2-3,2,3,1,1,5,-1,A
1949-08-31,1949,Bolton Wanderers,Manchester United,1-2,1,2,1,1,3,-1,A
1949-08-31,1949,Derby County,Aston Villa,3-2,3,2,1,1,5,1,H
1949-08-31,1949,Fulham,Huddersfield Town,4-1,4,1,1,1,5,3,H
1949-08-31,1949,Liverpool,Stoke City,1-1,1,1,1,1,2,0,D
1949-08-31,1949,Manchester City,Portsmouth,1-0,1,0,1,1,1,1,H
1949-08-31,1949,Middlesbrough,Blackpool,2-0,2,0,1,1,2,2,H
1949-08-31,1949,Newcastle United,Everton,4-0,4,0,1,1,4,4,H
1949-08-31,1949,Sunderland,Burnley,2-1,2,1,1,1,3,1,H
1949-08-31,1949,West Bromwich Albion,Birmingham City,3-0,3,0,1,1,3,3,H
1949-09-03,1949,Arsenal,Liverpool,1-2,1,2,1,1,3,-1,A
1949-09-03,1949,Birmingham City,Burnley,0-1,0,1,1,1,1,-1,A
1949-09-03,1949,Blackpool,Wolverhampton Wanderers,1-2,1,2,1,1,3,-1,A
1949-09-03,1949,Bolton Wanderers,Sunderland,2-1,2,1,1,1,3,1,H
1949-09-03,1949,Derby County,Stoke City,2-3,2,3,1,1,5,-1,A
1949-09-03,1949,Everton,Huddersfield Town,3-0,3,0,1,1,3,3,H
1949-09-03,1949,Fulham,Charlton Athletic,1-2,1,2,1,1,3,-1,A
1949-09-03,1949,Manchester United,Manchester City,2-1,2,1,1,1,3,1,H
1949-09-03,1949,Middlesbrough,Portsmouth,1-5,1,5,1,1,6,-4,A
1949-09-03,1949,Newcastle United,Aston Villa,3-2,3,2,1,1,5,1,H
1949-09-03,1949,West Bromwich Albion,Chelsea,1-1,1,1,1,1,2,0,D
1949-09-05,1949,Aston Villa,Portsmouth,1-0,1,0,1,1,1,1,H
1949-09-05,1949,Blackpool,Newcastle United,0-0,0,0,1,1,0,0,D
1949-09-05,1949,Bolton Wanderers,Derby County,0-0,0,0,1,1,0,0,D
1949-09-05,1949,Burnley,Stoke City,2-1,2,1,1,1,3,1,H
1949-09-07,1949,Chelsea,Sunderland,3-1,3,1,1,1,4,2,H
1949-09-07,1949,Huddersfield Town,Charlton Athletic,2-1,2,1,1,1,3,1,H
1949-09-07,1949,Liverpool,Manchester United,1-1,1,1,1,1,2,0,D
1949-09-07,1949,Manchester City,Everton,0-0,0,0,1,1,0,0,D
1949-09-07,1949,Middlesbrough,Fulham,1-2,1,2,1,1,3,-1,A
1949-09-07,1949,West Bromwich Albion,Arsenal,1-2,1,2,1,1,3,-1,A
1949-09-10,1949,Aston Villa,Blackpool,0-0,0,0,1,1,0,0,D
1949-09-10,1949,Burnley,Derby County,0-1,0,1,1,1,1,-1,A
1949-09-10,1949,Charlton Athletic,Newcastle United,6-3,6,3,1,1,9,3,H
1949-09-10,1949,Chelsea,Manchester United,1-1,1,1,1,1,2,0,D
1949-09-10,1949,Huddersfield Town,Arsenal,2-2,2,2,1,1,4,0,D
1949-09-10,1949,Liverpool,Bolton Wanderers,1-1,1,1,1,1,2,0,D
1949-09-10,1949,Manchester City,Fulham,2-0,2,0,1,1,2,2,H
1949-09-10,1949,Portsmouth,Everton,7-0,7,0,1,1,7,7,H
1949-09-10,1949,Stoke City,West Bromwich Albion,1-3,1,3,1,1,4,-2,A
1949-09-10,1949,Sunderland,Birmingham City,1-1,1,1,1,1,2,0,D
1949-09-10,1949,Wolverhampton Wanderers,Middlesbrough,3-1,3,1,1,1,4,2,H
1949-09-12,1949,Stoke City,Burnley,1-1,1,1,1,1,2,0,D
1949-09-14,1949,Arsenal,West Bromwich Albion,4-1,4,1,1,1,5,3,H
1949-09-14,1949,Birmingham City,Wolverhampton Wanderers,1-1,1,1,1,1,2,0,D
1949-09-14,1949,Charlton Athletic,Huddersfield Town,2-2,2,2,1,1,4,0,D
1949-09-17,1949,Birmingham City,Liverpool,2-3,2,3,1,1,5,-1,A
1949-09-17,1949,Blackpool,Charlton Athletic,2-0,2,0,1,1,2,2,H
1949-09-17,1949,Bolton Wanderers,Arsenal,2-2,2,2,1,1,4,0,D
1949-09-17,1949,Derby County,Sunderland,3-2,3,2,1,1,5,1,H
1949-09-17,1949,Everton,Wolverhampton Wanderers,1-2,1,2,1,1,3,-1,A
1949-09-17,1949,Fulham,Chelsea,1-1,1,1,1,1,2,0,D
1949-09-17,1949,Huddersfield Town,Portsmouth,0-1,0,1,1,1,1,-1,A
1949-09-17,1949,Manchester United,Stoke City,2-2,2,2,1,1,4,0,D
1949-09-17,1949,Middlesbrough,Aston Villa,0-2,0,2,1,1,2,-2,A
1949-09-17,1949,Newcastle United,Manchester City,4-2,4,2,1,1,6,2,H
1949-09-17,1949,West Bromwich Albion,Burnley,3-0,3,0,1,1,3,3,H
1949-09-24,1949,Arsenal,Birmingham City,4-2,4,2,1,1,6,2,H
1949-09-24,1949,Aston Villa,Everton,2-2,2,2,1,1,4,0,D
1949-09-24,1949,Burnley,Manchester United,1-0,1,0,1,1,1,1,H
1949-09-24,1949,Charlton Athletic,Middlesbrough,0-3,0,3,1,1,3,-3,A
1949-09-24,1949,Fulham,Newcastle United,2-1,2,1,1,1,3,1,H
1949-09-24,1949,Liverpool,Derby County,3-1,3,1,1,1,4,2,H
1949-09-24,1949,Manchester City,Blackpool,0-3,0,3,1,1,3,-3,A
1949-09-24,1949,Portsmouth,Bolton Wanderers,1-1,1,1,1,1,2,0,D
1949-09-24,1949,Stoke City,Chelsea,2-3,2,3,1,1,5,-1,A
1949-09-24,1949,Sunderland,West Bromwich Albion,2-1,2,1,1,1,3,1,H
1949-09-24,1949,Wolverhampton Wanderers,Huddersfield Town,7-1,7,1,1,1,8,6,H
1949-10-01,1949,Birmingham City,Bolton Wanderers,0-0,0,0,1,1,0,0,D
1949-10-01,1949,Blackpool,Fulham,0-0,0,0,1,1,0,0,D
1949-10-01,1949,Chelsea,Burnley,0-1,0,1,1,1,1,-1,A
1949-10-01,1949,Derby County,Arsenal,1-2,1,2,1,1,3,-1,A
1949-10-01,1949,Everton,Charlton Athletic,0-1,0,1,1,1,1,-1,A
1949-10-01,1949,Huddersfield Town,Aston Villa,1-0,1,0,1,1,1,1,H
1949-10-01,1949,Manchester United,Sunderland,1-3,1,3,1,1,4,-2,A
1949-10-01,1949,Middlesbrough,Manchester City,0-0,0,0,1,1,0,0,D
1949-10-01,1949,Newcastle United,Stoke City,4-1,4,1,1,1,5,3,H
1949-10-01,1949,Portsmouth,Wolverhampton Wanderers,1-1,1,1,1,1,2,0,D
1949-10-01,1949,West Bromwich Albion,Liverpool,0-1,0,1,1,1,1,-1,A
1949-10-08,1949,Arsenal,Everton,5-2,5,2,1,1,7,3,H
1949-10-08,1949,Birmingham City,Portsmouth,0-3,0,3,1,1,3,-3,A
1949-10-08,1949,Bolton Wanderers,Huddersfield Town,1-2,1,2,1,1,3,-1,A
1949-10-08,1949,Burnley,Newcastle United,1-2,1,2,1,1,3,-1,A
1949-10-08,1949,Chelsea,Manchester City,3-0,3,0,1,1,3,3,H
1949-10-08,1949,Derby County,Wolverhampton Wanderers,1-2,1,2,1,1,3,-1,A
1949-10-08,1949,Liverpool,Middlesbrough,2-0,2,0,1,1,2,2,H
1949-10-08,1949,Manchester United,Charlton Athletic,3-2,3,2,1,1,5,1,H
1949-10-08,1949,Stoke City,Fulham,0-2,0,2,1,1,2,-2,A
1949-10-08,1949,Sunderland,Blackpool,1-1,1,1,1,1,2,0,D
1949-10-08,1949,West Bromwich Albion,Aston Villa,1-1,1,1,1,1,2,0,D
1949-10-15,1949,Aston Villa,Manchester United,0-4,0,4,1,1,4,-4,A
1949-10-15,1949,Blackpool,Liverpool,0-0,0,0,1,1,0,0,D
1949-10-15,1949,Charlton Athletic,Chelsea,1-0,1,0,1,1,1,1,H
1949-10-15,1949,Everton,Bolton Wanderers,0-0,0,0,1,1,0,0,D
1949-10-15,1949,Fulham,Burnley,1-0,1,0,1,1,1,1,H
1949-10-15,1949,Huddersfield Town,Birmingham City,1-0,1,0,1,1,1,1,H
1949-10-15,1949,Manchester City,Stoke City,1-1,1,1,1,1,2,0,D
1949-10-15,1949,Middlesbrough,Arsenal,1-1,1,1,1,1,2,0,D
1949-10-15,1949,Newcastle United,Sunderland,2-2,2,2,1,1,4,0,D
1949-10-15,1949,Portsmouth,Derby County,3-1,3,1,1,1,4,2,H
1949-10-15,1949,Wolverhampton Wanderers,West Bromwich Albion,1-1,1,1,1,1,2,0,D
1949-10-22,1949,Arsenal,Blackpool,1-0,1,0,1,1,1,1,H
1949-10-22,1949,Birmingham City,Everton,0-0,0,0,1,1,0,0,D
1949-10-22,1949,Bolton Wanderers,Middlesbrough,1-2,1,2,1,1,3,-1,A
1949-10-22,1949,Burnley,Manchester City,0-0,0,0,1,1,0,0,D
1949-10-22,1949,Chelsea,Aston Villa,1-3,1,3,1,1,4,-2,A
1949-10-22,1949,Derby County,Huddersfield Town,4-2,4,2,1,1,6,2,H
1949-10-22,1949,Liverpool,Newcastle United,2-2,2,2,1,1,4,0,D
1949-10-22,1949,Manchester United,Wolverhampton Wanderers,3-0,3,0,1,1,3,3,H
1949-10-22,1949,Stoke City,Charlton Athletic,0-3,0,3,1,1,3,-3,A
1949-10-22,1949,Sunderland,Fulham,2-0,2,0,1,1,2,2,H
1949-10-22,1949,West Bromwich Albion,Portsmouth,3-0,3,0,1,1,3,3,H
1949-10-29,1949,Aston Villa,Stoke City,1-1,1,1,1,1,2,0,D
1949-10-29,1949,Blackpool,Bolton Wanderers,2-0,2,0,1,1,2,2,H
1949-10-29,1949,Charlton Athletic,Burnley,1-1,1,1,1,1,2,0,D
1949-10-29,1949,Everton,Derby County,1-2,1,2,1,1,3,-1,A
1949-10-29,1949,Fulham,Liverpool,0-1,0,1,1,1,1,-1,A
1949-10-29,1949,Huddersfield Town,West Bromwich Albion,1-1,1,1,1,1,2,0,D
1949-10-29,1949,Manchester City,Sunderland,2-1,2,1,1,1,3,1,H
1949-10-29,1949,Middlesbrough,Birmingham City,1-0,1,0,1,1,1,1,H
1949-10-29,1949,Newcastle United,Arsenal,0-3,0,3,1,1,3,-3,A
1949-10-29,1949,Portsmouth,Manchester United,0-0,0,0,1,1,0,0,D
1949-10-29,1949,Wolverhampton Wanderers,Chelsea,2-2,2,2,1,1,4,0,D
1949-11-05,1949,Arsenal,Fulham,2-1,2,1,1,1,3,1,H
1949-11-05,1949,Birmingham City,Blackpool,0-2,0,2,1,1,2,-2,A
1949-11-05,1949,Bolton Wanderers,Newcastle United,2-2,2,2,1,1,4,0,D
1949-11-05,1949,Burnley,Aston Villa,1-0,1,0,1,1,1,1,H
1949-11-05,1949,Chelsea,Portsmouth,1-4,1,4,1,1,5,-3,A
1949-11-05,1949,Derby County,Middlesbrough,1-0,1,0,1,1,1,1,H
1949-11-05,1949,Liverpool,Manchester City,4-0,4,0,1,1,4,4,H
1949-11-05,1949,Manchester United,Huddersfield Town,6-0,6,0,1,1,6,6,H
1949-11-05,1949,Stoke City,Wolverhampton Wanderers,2-1,2,1,1,1,3,1,H
1949-11-05,1949,Sunderland,Charlton Athletic,2-1,2,1,1,1,3,1,H
1949-11-05,1949,West Bromwich Albion,Everton,4-0,4,0,1,1,4,4,H
1949-11-12,1949,Aston Villa,Sunderland,2-0,2,0,1,1,2,2,H
1949-11-12,1949,Blackpool,Derby County,1-0,1,0,1,1,1,1,H
1949-11-12,1949,Charlton Athletic,Liverpool,1-3,1,3,1,1,4,-2,A
1949-11-12,1949,Everton,Manchester United,0-0,0,0,1,1,0,0,D
1949-11-12,1949,Fulham,Bolton Wanderers,3-0,3,0,1,1,3,3,H
1949-11-12,1949,Huddersfield Town,Chelsea,1-2,1,2,1,1,3,-1,A
1949-11-12,1949,Manchester City,Arsenal,0-2,0,2,1,1,2,-2,A
1949-11-12,1949,Middlesbrough,West Bromwich Albion,3-0,3,0,1,1,3,3,H
1949-11-12,1949,Newcastle United,Birmingham City,3-1,3,1,1,1,4,2,H
1949-11-12,1949,Portsmouth,Stoke City,0-0,0,0,1,1,0,0,D
1949-11-12,1949,Wolverhampton Wanderers,Burnley,0-0,0,0,1,1,0,0,D
1949-11-19,1949,Arsenal,Charlton Athletic,2-3,2,3,1,1,5,-1,A
1949-11-19,1949,Birmingham City,Fulham,1-1,1,1,1,1,2,0,D
1949-11-19,1949,Bolton Wanderers,Manchester City,3-0,3,0,1,1,3,3,H
1949-11-19,1949,Burnley,Portsmouth,2-1,2,1,1,1,3,1,H
1949-11-19,1949,Chelsea,Everton,3-2,3,2,1,1,5,1,H
1949-11-19,1949,Liverpool,Aston Villa,2-1,2,1,1,1,3,1,H
1949-11-19,1949,Manchester United,Middlesbrough,2-0,2,0,1,1,2,2,H
1949-11-19,1949,Stoke City,Huddersfield Town,0-0,0,0,1,1,0,0,D
1949-11-19,1949,Sunderland,Wolverhampton Wanderers,3-1,3,1,1,1,4,2,H
1949-11-26,1949,Aston Villa,Arsenal,1-1,1,1,1,1,2,0,D
1949-11-26,1949,Blackpool,Manchester United,3-3,3,3,1,1,6,0,D
1949-11-26,1949,Charlton Athletic,Bolton Wanderers,0-0,0,0,1,1,0,0,D
1949-11-26,1949,Everton,Stoke City,2-1,2,1,1,1,3,1,H
1949-11-26,1949,Fulham,Derby County,0-0,0,0,1,1,0,0,D
1949-11-26,1949,Huddersfield Town,Burnley,1-2,1,2,1,1,3,-1,A
1949-11-26,1949,Manchester City,Birmingham City,4-0,4,0,1,1,4,4,H
1949-11-26,1949,Middlesbrough,Chelsea,2-1,2,1,1,1,3,1,H
1949-11-26,1949,Newcastle United,West Bromwich Albion,5-1,5,1,1,1,6,4,H
1949-11-26,1949,Portsmouth,Sunderland,2-2,2,2,1,1,4,0,D
1949-11-26,1949,Wolverhampton Wanderers,Liverpool,1-1,1,1,1,1,2,0,D
1949-12-03,1949,Arsenal,Wolverhampton Wanderers,1-1,1,1,1,1,2,0,D
1949-12-03,1949,Birmingham City,Charlton Athletic,2-0,2,0,1,1,2,2,H
1949-12-03,1949,Bolton Wanderers,Aston Villa,1-1,1,1,1,1,2,0,D
1949-12-03,1949,Burnley,Everton,5-1,5,1,1,1,6,4,H
1949-12-03,1949,Chelsea,Blackpool,1-1,1,1,1,1,2,0,D
1949-12-03,1949,Derby County,Manchester City,7-0,7,0,1,1,7,7,H
1949-12-03,1949,Liverpool,Portsmouth,2-2,2,2,1,1,4,0,D
1949-12-03,1949,Manchester United,Newcastle United,1-1,1,1,1,1,2,0,D
1949-12-03,1949,Stoke City,Middlesbrough,1-0,1,0,1,1,1,1,H
1949-12-03,1949,Sunderland,Huddersfield Town,1-1,1,1,1,1,2,0,D
1949-12-03,1949,West Bromwich Albion,Fulham,4-1,4,1,1,1,5,3,H
1949-12-10,1949,Aston Villa,Birmingham City,1-1,1,1,1,1,2,0,D
1949-12-10,1949,Blackpool,Stoke City,4-2,4,2,1,1,6,2,H
1949-12-10,1949,Charlton Athletic,Derby County,1-3,1,3,1,1,4,-2,A
1949-12-10,1949,Everton,Sunderland,0-2,0,2,1,1,2,-2,A
1949-12-10,1949,Fulham,Manchester United,1-0,1,0,1,1,1,1,H
1949-12-10,1949,Huddersfield Town,Liverpool,3-2,3,2,1,1,5,1,H
1949-12-10,1949,Manchester City,West Bromwich Albion,1-1,1,1,1,1,2,0,D
1949-12-10,1949,Middlesbrough,Burnley,4-1,4,1,1,1,5,3,H
1949-12-10,1949,Newcastle United,Chelsea,2-2,2,2,1,1,4,0,D
1949-12-10,1949,Portsmouth,Arsenal,2-1,2,1,1,1,3,1,H
1949-12-10,1949,Wolverhampton Wanderers,Bolton Wanderers,1-1,1,1,1,1,2,0,D
1949-12-17,1949,Aston Villa,Manchester City,1-0,1,0,1,1,1,1,H
1949-12-17,1949,Burnley,Arsenal,0-0,0,0,1,1,0,0,D
1949-12-17,1949,Charlton Athletic,West Bromwich Albion,1-2,1,2,1,1,3,-1,A
1949-12-17,1949,Chelsea,Birmingham City,3-0,3,0,1,1,3,3,H
1949-12-17,1949,Everton,Middlesbrough,3-1,3,1,1,1,4,2,H
1949-12-17,1949,Huddersfield Town,Blackpool,0-1,0,1,1,1,1,-1,A
1949-12-17,1949,Manchester United,Derby County,0-1,0,1,1,1,1,-1,A
1949-12-17,1949,Portsmouth,Newcastle United,1-0,1,0,1,1,1,1,H
1949-12-17,1949,Stoke City,Bolton Wanderers,3-2,3,2,1,1,5,1,H
1949-12-17,1949,Sunderland,Liverpool,3-2,3,2,1,1,5,1,H
1949-12-17,1949,Wolverhampton Wanderers,Fulham,1-1,1,1,1,1,2,0,D
1949-12-24,1949,Arsenal,Sunderland,5-0,5,0,1,1,5,5,H
1949-12-24,1949,Birmingham City,Stoke City,1-0,1,0,1,1,1,1,H
1949-12-24,1949,Blackpool,Portsmouth,2-1,2,1,1,1,3,1,H
1949-12-24,1949,Bolton Wanderers,Burnley,0-1,0,1,1,1,1,-1,A
1949-12-24,1949,Derby County,Chelsea,2-2,2,2,1,1,4,0,D
1949-12-24,1949,Fulham,Aston Villa,3-0,3,0,1,1,3,3,H
1949-12-24,1949,Liverpool,Everton,3-1,3,1,1,1,4,2,H
1949-12-24,1949,Manchester City,Charlton Athletic,2-0,2,0,1,1,2,2,H
1949-12-24,1949,Middlesbrough,Huddersfield Town,3-0,3,0,1,1,3,3,H
1949-12-24,1949,Newcastle United,Wolverhampton Wanderers,2-0,2,0,1,1,2,2,H
1949-12-24,1949,West Bromwich Albion,Manchester United,1-2,1,2,1,1,3,-1,A
1949-12-26,1949,Birmingham City,Derby County,2-2,2,2,1,1,4,0,D
1949-12-26,1949,Bolton Wanderers,West Bromwich Albion,3-0,3,0,1,1,3,3,H
1949-12-26,1949,Burnley,Blackpool,0-0,0,0,1,1,0,0,D
1949-12-26,1949,Charlton Athletic,Portsmouth,1-2,1,2,1,1,3,-1,A
1949-12-26,1949,Chelsea,Liverpool,1-1,1,1,1,1,2,0,D
1949-12-26,1949,Everton,Fulham,1-1,1,1,1,1,2,0,D
1949-12-26,1949,Huddersfield Town,Manchester City,1-0,1,0,1,1,1,1,H
1949-12-26,1949,Manchester United,Arsenal,2-0,2,0,1,1,2,2,H
1949-12-26,1949,Newcastle United,Middlesbrough,0-1,0,1,1,1,1,-1,A
1949-12-26,1949,Sunderland,Stoke City,3-0,3,0,1,1,3,3,H
1949-12-26,1949,Wolverhampton Wanderers,Aston Villa,2-3,2,3,1,1,5,-1,A
1949-12-27,1949,Arsenal,Manchester United,0-0,0,0,1,1,0,0,D
1949-12-27,1949,Aston Villa,Wolverhampton Wanderers,1-4,1,4,1,1,5,-3,A
1949-12-27,1949,Blackpool,Burnley,2-0,2,0,1,1,2,2,H
1949-12-27,1949,Derby County,Birmingham City,4-1,4,1,1,1,5,3,H
1949-12-27,1949,Fulham,Everton,0-0,0,0,1,1,0,0,D
1949-12-27,1949,Liverpool,Chelsea,2-2,2,2,1,1,4,0,D
1949-12-27,1949,Manchester City,Huddersfield Town,1-2,1,2,1,1,3,-1,A
1949-12-27,1949,Middlesbrough,Newcastle United,1-0,1,0,1,1,1,1,H
1949-12-27,1949,Portsmouth,Charlton Athletic,1-0,1,0,1,1,1,1,H
1949-12-27,1949,Stoke City,Sunderland,2-1,2,1,1,1,3,1,H
1949-12-27,1949,West Bromwich Albion,Bolton Wanderers,2-1,2,1,1,1,3,1,H
1949-12-31,1949,Aston Villa,Newcastle United,0-1,0,1,1,1,1,-1,A
1949-12-31,1949,Burnley,Birmingham City,1-1,1,1,1,1,2,0,D
1949-12-31,1949,Charlton Athletic,Fulham,2-1,2,1,1,1,3,1,H
1949-12-31,1949,Chelsea,West Bromwich Albion,2-1,2,1,1,1,3,1,H
1949-12-31,1949,Huddersfield Town,Everton,1-2,1,2,1,1,3,-1,A
1949-12-31,1949,Liverpool,Arsenal,2-0,2,0,1,1,2,2,H
1949-12-31,1949,Manchester City,Manchester United,1-2,1,2,1,1,3,-1,A
1949-12-31,1949,Portsmouth,Middlesbrough,1-1,1,1,1,1,2,0,D
1949-12-31,1949,Stoke City,Derby County,1-3,1,3,1,1,4,-2,A
1949-12-31,1949,Sunderland,Bolton Wanderers,2-0,2,0,1,1,2,2,H
1949-12-31,1949,Wolverhampton Wanderers,Blackpool,3-0,3,0,1,1,3,3,H
1950-01-14,1949,Arsenal,Huddersfield Town,1-0,1,0,1,1,1,1,H
1950-01-14,1949,Birmingham City,Sunderland,1-2,1,2,1,1,3,-1,A
1950-01-14,1949,Blackpool,Aston Villa,1-0,1,0,1,1,1,1,H
1950-01-14,1949,Bolton Wanderers,Liverpool,3-2,3,2,1,1,5,1,H
1950-01-14,1949,Derby County,Burnley,1-1,1,1,1,1,2,0,D
1950-01-14,1949,Everton,Portsmouth,1-2,1,2,1,1,3,-1,A
1950-01-14,1949,Fulham,Manchester City,1-0,1,0,1,1,1,1,H
1950-01-14,1949,Manchester United,Chelsea,1-0,1,0,1,1,1,1,H
1950-01-14,1949,Middlesbrough,Wolverhampton Wanderers,2-0,2,0,1,1,2,2,H
1950-01-14,1949,Newcastle United,Charlton Athletic,1-0,1,0,1,1,1,1,H
1950-01-14,1949,West Bromwich Albion,Stoke City,0-0,0,0,1,1,0,0,D
1950-01-21,1949,Arsenal,Bolton Wanderers,1-1,1,1,1,1,2,0,D
1950-01-21,1949,Aston Villa,Middlesbrough,4-0,4,0,1,1,4,4,H
1950-01-21,1949,Burnley,West Bromwich Albion,0-0,0,0,1,1,0,0,D
1950-01-21,1949,Charlton Athletic,Blackpool,1-2,1,2,1,1,3,-1,A
1950-01-21,1949,Chelsea,Fulham,0-0,0,0,1,1,0,0,D
1950-01-21,1949,Liverpool,Birmingham City,2-0,2,0,1,1,2,2,H
1950-01-21,1949,Manchester City,Newcastle United,1-1,1,1,1,1,2,0,D
1950-01-21,1949,Portsmouth,Huddersfield Town,4-0,4,0,1,1,4,4,H
1950-01-21,1949,Stoke City,Manchester United,3-1,3,1,1,1,4,2,H
1950-01-21,1949,Sunderland,Derby County,6-1,6,1,1,1,7,5,H
1950-01-21,1949,Wolverhampton Wanderers,Everton,1-1,1,1,1,1,2,0,D
1950-02-04,1949,Birmingham City,Arsenal,2-1,2,1,1,1,3,1,H
1950-02-04,1949,Blackpool,Manchester City,0-0,0,0,1,1,0,0,D
1950-02-04,1949,Bolton Wanderers,Portsmouth,1-0,1,0,1,1,1,1,H
1950-02-04,1949,Chelsea,Stoke City,2-2,2,2,1,1,4,0,D
1950-02-04,1949,Derby County,Liverpool,2-2,2,2,1,1,4,0,D
1950-02-04,1949,Everton,Aston Villa,1-1,1,1,1,1,2,0,D
1950-02-04,1949,Huddersfield Town,Wolverhampton Wanderers,1-0,1,0,1,1,1,1,H
1950-02-04,1949,Manchester United,Burnley,3-2,3,2,1,1,5,1,H
1950-02-04,1949,Middlesbrough,Charlton Athletic,1-0,1,0,1,1,1,1,H
1950-02-04,1949,Newcastle United,Fulham,3-1,3,1,1,1,4,2,H
1950-02-04,1949,West Bromwich Albion,Sunderland,0-2,0,2,1,1,2,-2,A
1950-02-18,1949,Arsenal,Derby County,1-0,1,0,1,1,1,1,H
1950-02-18,1949,Aston Villa,Huddersfield Town,2-1,2,1,1,1,3,1,H
1950-02-18,1949,Bolton Wanderers,Birmingham City,1-0,1,0,1,1,1,1,H
1950-02-18,1949,Burnley,Chelsea,1-2,1,2,1,1,3,-1,A
1950-02-18,1949,Charlton Athletic,Everton,2-0,2,0,1,1,2,2,H
1950-02-18,1949,Fulham,Blackpool,1-0,1,0,1,1,1,1,H
1950-02-18,1949,Liverpool,West Bromwich Albion,2-1,2,1,1,1,3,1,H
1950-02-18,1949,Manchester City,Middlesbrough,0-1,0,1,1,1,1,-1,A
1950-02-18,1949,Stoke City,Newcastle United,1-0,1,0,1,1,1,1,H
1950-02-18,1949,Sunderland,Manchester United,2-2,2,2,1,1,4,0,D
1950-02-18,1949,Wolverhampton Wanderers,Portsmouth,1-0,1,0,1,1,1,1,H
1950-02-25,1949,Aston Villa,West Bromwich Albion,1-0,1,0,1,1,1,1,H
1950-02-25,1949,Blackpool,Sunderland,0-1,0,1,1,1,1,-1,A
1950-02-25,1949,Charlton Athletic,Manchester United,1-2,1,2,1,1,3,-1,A
1950-02-25,1949,Everton,Arsenal,0-1,0,1,1,1,1,-1,A
1950-02-25,1949,Fulham,Stoke City,2-2,2,2,1,1,4,0,D
1950-02-25,1949,Huddersfield Town,Bolton Wanderers,2-0,2,0,1,1,2,2,H
1950-02-25,1949,Manchester City,Chelsea,1-1,1,1,1,1,2,0,D
1950-02-25,1949,Middlesbrough,Liverpool,4-1,4,1,1,1,5,3,H
1950-02-25,1949,Newcastle United,Burnley,0-0,0,0,1,1,0,0,D
1950-02-25,1949,Portsmouth,Birmingham City,2-0,2,0,1,1,2,2,H
1950-02-25,1949,Wolverhampton Wanderers,Derby County,4-1,4,1,1,1,5,3,H
1950-03-04,1949,Birmingham City,Huddersfield Town,2-1,2,1,1,1,3,1,H
1950-03-04,1949,Burnley,Fulham,0-0,0,0,1,1,0,0,D
1950-03-04,1949,Stoke City,Manchester City,2-0,2,0,1,1,2,2,H
1950-03-04,1949,Sunderland,Newcastle United,2-2,2,2,1,1,4,0,D
1950-03-04,1949,West Bromwich Albion,Wolverhampton Wanderers,1-1,1,1,1,1,2,0,D
1950-03-08,1949,Arsenal,Middlesbrough,1-1,1,1,1,1,2,0,D
1950-03-08,1949,Bolton Wanderers,Everton,1-2,1,2,1,1,3,-1,A
1950-03-08,1949,Chelsea,Charlton Athletic,1-3,1,3,1,1,4,-2,A
1950-03-08,1949,Derby County,Portsmouth,2-1,2,1,1,1,3,1,H
1950-03-08,1949,Liverpool,Blackpool,0-1,0,1,1,1,1,-1,A
1950-03-08,1949,Manchester United,Aston Villa,7-0,7,0,1,1,7,7,H
1950-03-11,1949,Aston Villa,Liverpool,2-0,2,0,1,1,2,2,H
1950-03-11,1949,Blackpool,West Bromwich Albion,3-0,3,0,1,1,3,3,H
1950-03-11,1949,Charlton Athletic,Arsenal,1-1,1,1,1,1,2,0,D
1950-03-11,1949,Everton,Chelsea,1-1,1,1,1,1,2,0,D
1950-03-11,1949,Fulham,Birmingham City,0-0,0,0,1,1,0,0,D
1950-03-11,1949,Huddersfield Town,Stoke City,4-0,4,0,1,1,4,4,H
1950-03-11,1949,Manchester City,Bolton Wanderers,1-1,1,1,1,1,2,0,D
1950-03-11,1949,Middlesbrough,Manchester United,2-3,2,3,1,1,5,-1,A
1950-03-11,1949,Newcastle United,Derby County,2-1,2,1,1,1,3,1,H
1950-03-11,1949,Portsmouth,Burnley,2-1,2,1,1,1,3,1,H
1950-03-11,1949,Wolverhampton Wanderers,Sunderland,1-3,1,3,1,1,4,-2,A
1950-03-15,1949,Manchester United,Liverpool,0-0,0,0,1,1,0,0,D
1950-03-18,1949,Birmingham City,Manchester City,1-0,1,0,1,1,1,1,H
1950-03-18,1949,Bolton Wanderers,Charlton Athletic,3-0,3,0,1,1,3,3,H
1950-03-18,1949,Burnley,Huddersfield Town,1-0,1,0,1,1,1,1,H
1950-03-18,1949,Derby County,Fulham,2-1,2,1,1,1,3,1,H
1950-03-18,1949,Liverpool,Wolverhampton Wanderers,0-2,0,2,1,1,2,-2,A
1950-03-18,1949,Manchester United,Blackpool,1-2,1,2,1,1,3,-1,A
1950-03-18,1949,Stoke City,Everton,1-0,1,0,1,1,1,1,H
1950-03-18,1949,Sunderland,Portsmouth,1-1,1,1,1,1,2,0,D
1950-03-18,1949,West Bromwich Albion,Newcastle United,1-1,1,1,1,1,2,0,D
1950-03-25,1949,Aston Villa,Burnley,0-1,0,1,1,1,1,-1,A
1950-03-25,1949,Blackpool,Birmingham City,1-1,1,1,1,1,2,0,D
1950-03-25,1949,Charlton Athletic,Sunderland,2-2,2,2,1,1,4,0,D
1950-03-25,1949,Fulham,Arsenal,2-2,2,2,1,1,4,0,D
1950-03-25,1949,Huddersfield Town,Manchester United,3-1,3,1,1,1,4,2,H
1950-03-25,1949,Middlesbrough,Derby County,3-1,3,1,1,1,4,2,H
1950-03-25,1949,Newcastle United,Bolton Wanderers,3-1,3,1,1,1,4,2,H
1950-03-25,1949,Portsmouth,Chelsea,4-0,4,0,1,1,4,4,H
1950-03-25,1949,Wolverhampton Wanderers,Stoke City,2-1,2,1,1,1,3,1,H
1950-03-29,1949,Arsenal,Aston Villa,1-3,1,3,1,1,4,-2,A
1950-03-29,1949,Chelsea,Middlesbrough,2-1,2,1,1,1,3,1,H
1950-03-29,1949,Derby County,Newcastle United,1-1,1,1,1,1,2,0,D
1950-03-29,1949,Everton,West Bromwich Albion,1-2,1,2,1,1,3,-1,A
1950-03-29,1949,Manchester City,Liverpool,1-2,1,2,1,1,3,-1,A
1950-04-01,1949,Arsenal,Manchester City,4-1,4,1,1,1,5,3,H
1950-04-01,1949,Birmingham City,Newcastle United,0-2,0,2,1,1,2,-2,A
1950-04-01,1949,Bolton Wanderers,Fulham,2-1,2,1,1,1,3,1,H
1950-04-01,1949,Burnley,Wolverhampton Wanderers,0-1,0,1,1,1,1,-1,A
1950-04-01,1949,Chelsea,Huddersfield Town,3-1,3,1,1,1,4,2,H
1950-04-01,1949,Derby County,Blackpool,0-0,0,0,1,1,0,0,D
1950-04-01,1949,Liverpool,Charlton Athletic,1-0,1,0,1,1,1,1,H
1950-04-01,1949,Manchester United,Everton,1-1,1,1,1,1,2,0,D
1950-04-01,1949,Stoke City,Portsmouth,0-1,0,1,1,1,1,-1,A
1950-04-01,1949,Sunderland,Aston Villa,2-1,2,1,1,1,3,1,H
1950-04-01,1949,West Bromwich Albion,Middlesbrough,0-3,0,3,1,1,3,-3,A
1950-04-07,1949,Burnley,Liverpool,0-2,0,2,1,1,2,-2,A
1950-04-07,1949,Charlton Athletic,Aston Villa,1-4,1,4,1,1,5,-3,A
1950-04-07,1949,Chelsea,Bolton Wanderers,1-1,1,1,1,1,2,0,D
1950-04-07,1949,Derby County,West Bromwich Albion,3-1,3,1,1,1,4,2,H
1950-04-07,1949,Everton,Blackpool,3-0,3,0,1,1,3,3,H
1950-04-07,1949,Manchester United,Birmingham City,0-2,0,2,1,1,2,-2,A
1950-04-07,1949,Newcastle United,Huddersfield Town,0-0,0,0,1,1,0,0,D
1950-04-07,1949,Portsmouth,Fulham,3-0,3,0,1,1,3,3,H
1950-04-07,1949,Sunderland,Middlesbrough,2-0,2,0,1,1,2,2,H
1950-04-08,1949,Aston Villa,Chelsea,4-0,4,0,1,1,4,4,H
1950-04-08,1949,Blackpool,Arsenal,2-1,2,1,1,1,3,1,H
1950-04-08,1949,Charlton Athletic,Stoke City,2-0,2,0,1,1,2,2,H
1950-04-08,1949,Everton,Birmingham City,0-0,0,0,1,1,0,0,D
1950-04-08,1949,Fulham,Sunderland,0-3,0,3,1,1,3,-3,A
1950-04-08,1949,Huddersfield Town,Derby County,2-0,2,0,1,1,2,2,H
1950-04-08,1949,Manchester City,Burnley,1-0,1,0,1,1,1,1,H
1950-04-08,1949,Middlesbrough,Bolton Wanderers,2-0,2,0,1,1,2,2,H
1950-04-08,1949,Newcastle United,Liverpool,5-1,5,1,1,1,6,4,H
1950-04-08,1949,Portsmouth,West Bromwich Albion,0-1,0,1,1,1,1,-1,A
1950-04-08,1949,Wolverhampton Wanderers,Manchester United,1-1,1,1,1,1,2,0,D
1950-04-10,1949,Arsenal,Stoke City,6-0,6,0,1,1,6,6,H
1950-04-10,1949,Birmingham City,Manchester United,0-0,0,0,1,1,0,0,D
1950-04-10,1949,Blackpool,Everton,0-1,0,1,1,1,1,-1,A
1950-04-10,1949,Bolton Wanderers,Chelsea,1-0,1,0,1,1,1,1,H
1950-04-10,1949,Fulham,Portsmouth,0-1,0,1,1,1,1,-1,A
1950-04-10,1949,Liverpool,Burnley,0-1,0,1,1,1,1,-1,A
1950-04-10,1949,Manchester City,Wolverhampton Wanderers,2-1,2,1,1,1,3,1,H
1950-04-10,1949,Middlesbrough,Sunderland,2-0,2,0,1,1,2,2,H
1950-04-10,1949,West Bromwich Albion,Derby County,1-0,1,0,1,1,1,1,H
1950-04-11,1949,Aston Villa,Charlton Athletic,1-1,1,1,1,1,2,0,D
1950-04-11,1949,Huddersfield Town,Newcastle United,1-2,1,2,1,1,3,-1,A
1950-04-11,1949,Wolverhampton Wanderers,Manchester City,3-0,3,0,1,1,3,3,H
1950-04-15,1949,Arsenal,Newcastle United,4-2,4,2,1,1,6,2,H
1950-04-15,1949,Birmingham City,Middlesbrough,0-0,0,0,1,1,0,0,D
1950-04-15,1949,Bolton Wanderers,Blackpool,0-0,0,0,1,1,0,0,D
1950-04-15,1949,Burnley,Charlton Athletic,1-0,1,0,1,1,1,1,H
1950-04-15,1949,Chelsea,Wolverhampton Wanderers,0-0,0,0,1,1,0,0,D
1950-04-15,1949,Derby County,Everton,2-0,2,0,1,1,2,2,H
1950-04-15,1949,Liverpool,Fulham,1-1,1,1,1,1,2,0,D
1950-04-15,1949,Manchester United,Portsmouth,0-2,0,2,1,1,2,-2,A
1950-04-15,1949,Stoke City,Aston Villa,1-0,1,0,1,1,1,1,H
1950-04-15,1949,Sunderland,Manchester City,1-2,1,2,1,1,3,-1,A
1950-04-15,1949,West Bromwich Albion,Huddersfield Town,0-0,0,0,1,1,0,0,D
1950-04-22,1949,Aston Villa,Bolton Wanderers,3-0,3,0,1,1,3,3,H
1950-04-22,1949,Blackpool,Chelsea,0-0,0,0,1,1,0,0,D
1950-04-22,1949,Charlton Athletic,Birmingham City,2-0,2,0,1,1,2,2,H
1950-04-22,1949,Everton,Burnley,1-1,1,1,1,1,2,0,D
1950-04-22,1949,Fulham,West Bromwich Albion,0-1,0,1,1,1,1,-1,A
1950-04-22,1949,Huddersfield Town,Sunderland,3-1,3,1,1,1,4,2,H
1950-04-22,1949,Manchester City,Derby County,2-2,2,2,1,1,4,0,D
1950-04-22,1949,Middlesbrough,Stoke City,2-0,2,0,1,1,2,2,H
1950-04-22,1949,Newcastle United,Manchester United,2-1,2,1,1,1,3,1,H
1950-04-22,1949,Portsmouth,Liverpool,2-1,2,1,1,1,3,1,H
1950-04-22,1949,Wolverhampton Wanderers,Arsenal,3-0,3,0,1,1,3,3,H
1950-04-26,1949,West Bromwich Albion,Blackpool,1-0,1,0,1,1,1,1,H
1950-04-29,1949,Birmingham City,Aston Villa,2-2,2,2,1,1,4,0,D
1950-04-29,1949,Bolton Wanderers,Wolverhampton Wanderers,2-4,2,4,1,1,6,-2,A
1950-04-29,1949,Burnley,Middlesbrough,3-2,3,2,1,1,5,1,H
1950-04-29,1949,Chelsea,Newcastle United,1-3,1,3,1,1,4,-2,A
1950-04-29,1949,Derby County,Charlton Athletic,1-2,1,2,1,1,3,-1,A
1950-04-29,1949,Manchester United,Fulham,3-0,3,0,1,1,3,3,H
1950-04-29,1949,Stoke City,Blackpool,1-1,1,1,1,1,2,0,D
1950-04-29,1949,Sunderland,Everton,4-2,4,2,1,1,6,2,H
1950-04-29,1949,West Bromwich Albion,Manchester City,0-0,0,0,1,1,0,0,D
1950-05-03,1949,Arsenal,Portsmouth,2-0,2,0,1,1,2,2,H
1950-05-03,1949,Liverpool,Huddersfield Town,2-3,2,3,1,1,5,-1,A
1950-05-06,1949,Derby County,Bolton Wanderers,4-0,4,0,1,1,4,4,H
1950-05-06,1949,Everton,Manchester City,3-1,3,1,1,1,4,2,H
1950-05-06,1949,Fulham,Middlesbrough,1-2,1,2,1,1,3,-1,A
1950-05-06,1949,Newcastle United,Blackpool,3-0,3,0,1,1,3,3,H
1950-05-06,1949,Portsmouth,Aston Villa,5-1,5,1,1,1,6,4,H
1950-05-06,1949,Stoke City,Arsenal,2-5,2,5,1,1,7,-3,A
1950-05-06,1949,Sunderland,Chelsea,4-1,4,1,1,1,5,3,H
1950-05-06,1949,Wolverhampton Wanderers,Birmingham City,6-1,6,1,1,1,7,5,H
1950-08-19,1950,Aston Villa,West Bromwich Albion,2-0,2,0,1,1,2,2,H
1950-08-19,1950,Burnley,Arsenal,0-1,0,1,1,1,1,-1,A
1950-08-19,1950,Charlton Athletic,Bolton Wanderers,4-3,4,3,1,1,7,1,H
1950-08-19,1950,Chelsea,Sheffield Wednesday,4-0,4,0,1,1,4,4,H
1950-08-19,1950,Everton,Huddersfield Town,3-2,3,2,1,1,5,1,H
1950-08-19,1950,Manchester United,Fulham,1-0,1,0,1,1,1,1,H
1950-08-19,1950,Portsmouth,Middlesbrough,1-1,1,1,1,1,2,0,D
1950-08-19,1950,Stoke City,Newcastle United,1-2,1,2,1,1,3,-1,A
1950-08-19,1950,Sunderland,Derby County,1-0,1,0,1,1,1,1,H
1950-08-19,1950,Tottenham Hotspur,Blackpool,1-4,1,4,1,1,5,-3,A
1950-08-19,1950,Wolverhampton Wanderers,Liverpool,2-0,2,0,1,1,2,2,H
1950-08-21,1950,Aston Villa,Sunderland,3-1,3,1,1,1,4,2,H
1950-08-21,1950,Blackpool,Burnley,1-2,1,2,1,1,3,-1,A
1950-08-21,1950,Sheffield Wednesday,Portsmouth,2-1,2,1,1,1,3,1,H
1950-08-23,1950,Arsenal,Chelsea,0-0,0,0,1,1,0,0,D
1950-08-23,1950,Bolton Wanderers,Tottenham Hotspur,1-4,1,4,1,1,5,-3,A
1950-08-23,1950,Derby County,Wolverhampton Wanderers,1-2,1,2,1,1,3,-1,A
1950-08-23,1950,Fulham,Charlton Athletic,1-3,1,3,1,1,4,-2,A
1950-08-23,1950,Huddersfield Town,Stoke City,3-1,3,1,1,1,4,2,H
1950-08-23,1950,Liverpool,Manchester United,2-1,2,1,1,1,3,1,H
1950-08-23,1950,Middlesbrough,Everton,4-0,4,0,1,1,4,4,H
1950-08-23,1950,Newcastle United,West Bromwich Albion,1-1,1,1,1,1,2,0,D
1950-08-26,1950,Arsenal,Tottenham Hotspur,2-2,2,2,1,1,4,0,D
1950-08-26,1950,Blackpool,Charlton Athletic,0-0,0,0,1,1,0,0,D
1950-08-26,1950,Bolton Wanderers,Manchester United,1-0,1,0,1,1,1,1,H
1950-08-26,1950,Derby County,Aston Villa,4-2,4,2,1,1,6,2,H
1950-08-26,1950,Fulham,Wolverhampton Wanderers,2-1,2,1,1,1,3,1,H
1950-08-26,1950,Huddersfield Town,Portsmouth,2-1,2,1,1,1,3,1,H
1950-08-26,1950,Liverpool,Sunderland,4-0,4,0,1,1,4,4,H
1950-08-26,1950,Middlesbrough,Chelsea,3-0,3,0,1,1,3,3,H
1950-08-26,1950,Newcastle United,Everton,1-1,1,1,1,1,2,0,D
1950-08-26,1950,Sheffield Wednesday,Burnley,0-1,0,1,1,1,1,-1,A
1950-08-26,1950,West Bromwich Albion,Stoke City,1-1,1,1,1,1,2,0,D
1950-08-28,1950,Stoke City,Huddersfield Town,0-1,0,1,1,1,1,-1,A
1950-08-28,1950,Tottenham Hotspur,Bolton Wanderers,4-2,4,2,1,1,6,2,H
1950-08-28,1950,Wolverhampton Wanderers,Derby County,2-3,2,3,1,1,5,-1,A
1950-08-29,1950,Burnley,Blackpool,0-0,0,0,1,1,0,0,D
1950-08-30,1950,Charlton Athletic,Fulham,0-0,0,0,1,1,0,0,D
1950-08-30,1950,Chelsea,Arsenal,0-1,0,1,1,1,1,-1,A
1950-08-30,1950,Everton,Middlesbrough,3-2,3,2,1,1,5,1,H
1950-08-30,1950,Manchester United,Liverpool,1-0,1,0,1,1,1,1,H
1950-08-30,1950,Portsmouth,Sheffield Wednesday,4-1,4,1,1,1,5,3,H
1950-08-30,1950,Sunderland,Aston Villa,3-3,3,3,1,1,6,0,D
1950-08-30,1950,West Bromwich Albion,Newcastle United,1-2,1,2,1,1,3,-1,A
1950-09-02,1950,Arsenal,Sheffield Wednesday,3-0,3,0,1,1,3,3,H
1950-09-02,1950,Aston Villa,Liverpool,1-1,1,1,1,1,2,0,D
1950-09-02,1950,Burnley,Middlesbrough,3-1,3,1,1,1,4,2,H
1950-09-02,1950,Charlton Athletic,Tottenham Hotspur,1-1,1,1,1,1,2,0,D
1950-09-02,1950,Chelsea,Huddersfield Town,1-2,1,2,1,1,3,-1,A
1950-09-02,1950,Everton,West Bromwich Albion,0-3,0,3,1,1,3,-3,A
1950-09-02,1950,Manchester United,Blackpool,1-0,1,0,1,1,1,1,H
1950-09-02,1950,Portsmouth,Newcastle United,0-0,0,0,1,1,0,0,D
1950-09-02,1950,Stoke City,Derby County,4-1,4,1,1,1,5,3,H
1950-09-02,1950,Sunderland,Fulham,0-1,0,1,1,1,1,-1,A
1950-09-02,1950,Wolverhampton Wanderers,Bolton Wanderers,7-1,7,1,1,1,8,6,H
1950-09-04,1950,Aston Villa,Manchester United,1-3,1,3,1,1,4,-2,A
1950-09-04,1950,Blackpool,Fulham,4-0,4,0,1,1,4,4,H
1950-09-04,1950,Bolton Wanderers,Chelsea,1-0,1,0,1,1,1,1,H
1950-09-04,1950,Burnley,Portsmouth,1-1,1,1,1,1,2,0,D
1950-09-04,1950,Sheffield Wednesday,Stoke City,1-1,1,1,1,1,2,0,D
1950-09-06,1950,Arsenal,Everton,2-1,2,1,1,1,3,1,H
1950-09-06,1950,Derby County,Charlton Athletic,5-0,5,0,1,1,5,5,H
1950-09-06,1950,Liverpool,Tottenham Hotspur,2-1,2,1,1,1,3,1,H
1950-09-06,1950,Middlesbrough,West Bromwich Albion,2-1,2,1,1,1,3,1,H
1950-09-06,1950,Newcastle United,Huddersfield Town,6-0,6,0,1,1,6,6,H
1950-09-06,1950,Wolverhampton Wanderers,Sunderland,2-1,2,1,1,1,3,1,H
1950-09-09,1950,Blackpool,Wolverhampton Wanderers,1-1,1,1,1,1,2,0,D
1950-09-09,1950,Bolton Wanderers,Sunderland,1-2,1,2,1,1,3,-1,A
1950-09-09,1950,Fulham,Aston Villa,2-1,2,1,1,1,3,1,H
1950-09-09,1950,Huddersfield Town,Burnley,3-1,3,1,1,1,4,2,H
1950-09-09,1950,Liverpool,Derby County,1-0,1,0,1,1,1,1,H
1950-09-09,1950,Middlesbrough,Arsenal,2-1,2,1,1,1,3,1,H
1950-09-09,1950,Newcastle United,Chelsea,3-1,3,1,1,1,4,2,H
1950-09-09,1950,Sheffield Wednesday,Charlton Athletic,1-2,1,2,1,1,3,-1,A
1950-09-09,1950,Stoke City,Everton,2-0,2,0,1,1,2,2,H
1950-09-09,1950,Tottenham Hotspur,Manchester United,1-0,1,0,1,1,1,1,H
1950-09-09,1950,West Bromwich Albion,Portsmouth,5-0,5,0,1,1,5,5,H
1950-09-11,1950,Stoke City,Sheffield Wednesday,1-1,1,1,1,1,2,0,D
1950-09-13,1950,Everton,Arsenal,1-1,1,1,1,1,2,0,D
1950-09-13,1950,Fulham,Blackpool,2-2,2,2,1,1,4,0,D
1950-09-13,1950,Huddersfield Town,Newcastle United,0-0,0,0,1,1,0,0,D
1950-09-13,1950,Manchester United,Aston Villa,0-0,0,0,1,1,0,0,D
1950-09-13,1950,West Bromwich Albion,Middlesbrough,2-3,2,3,1,1,5,-1,A
1950-09-16,1950,Arsenal,Huddersfield Town,6-2,6,2,1,1,8,4,H
1950-09-16,1950,Aston Villa,Bolton Wanderers,0-1,0,1,1,1,1,-1,A
1950-09-16,1950,Burnley,Newcastle United,1-1,1,1,1,1,2,0,D
1950-09-16,1950,Chelsea,West Bromwich Albion,1-1,1,1,1,1,2,0,D
1950-09-16,1950,Derby County,Fulham,3-2,3,2,1,1,5,1,H
1950-09-16,1950,Everton,Liverpool,1-3,1,3,1,1,4,-2,A
1950-09-16,1950,Manchester United,Charlton Athletic,3-0,3,0,1,1,3,3,H
1950-09-16,1950,Portsmouth,Stoke City,5-1,5,1,1,1,6,4,H
1950-09-16,1950,Sheffield Wednesday,Middlesbrough,0-1,0,1,1,1,1,-1,A
1950-09-16,1950,Sunderland,Blackpool,0-2,0,2,1,1,2,-2,A
1950-09-16,1950,Wolverhampton Wanderers,Tottenham Hotspur,2-1,2,1,1,1,3,1,H
1950-09-23,1950,Blackpool,Aston Villa,1-1,1,1,1,1,2,0,D
1950-09-23,1950,Bolton Wanderers,Derby County,3-0,3,0,1,1,3,3,H
1950-09-23,1950,Charlton Athletic,Wolverhampton Wanderers,3-2,3,2,1,1,5,1,H
1950-09-23,1950,Everton,Portsmouth,1-5,1,5,1,1,6,-4,A
1950-09-23,1950,Fulham,Liverpool,2-1,2,1,1,1,3,1,H
1950-09-23,1950,Huddersfield Town,Sheffield Wednesday,3-4,3,4,1,1,7,-1,A
1950-09-23,1950,Middlesbrough,Manchester United,1-2,1,2,1,1,3,-1,A
1950-09-23,1950,Newcastle United,Arsenal,2-1,2,1,1,1,3,1,H
1950-09-23,1950,Stoke City,Chelsea,2-1,2,1,1,1,3,1,H
1950-09-23,1950,Tottenham Hotspur,Sunderland,1-1,1,1,1,1,2,0,D
1950-09-23,1950,West Bromwich Albion,Burnley,2-1,2,1,1,1,3,1,H
1950-09-30,1950,Arsenal,West Bromwich Albion,3-0,3,0,1,1,3,3,H
1950-09-30,1950,Aston Villa,Tottenham Hotspur,2-3,2,3,1,1,5,-1,A
1950-09-30,1950,Burnley,Stoke City,1-1,1,1,1,1,2,0,D
1950-09-30,1950,Chelsea,Everton,2-1,2,1,1,1,3,1,H
1950-09-30,1950,Derby County,Blackpool,4-1,4,1,1,1,5,3,H
1950-09-30,1950,Liverpool,Bolton Wanderers,3-3,3,3,1,1,6,0,D
1950-09-30,1950,Middlesbrough,Huddersfield Town,8-0,8,0,1,1,8,8,H
1950-09-30,1950,Portsmouth,Fulham,1-0,1,0,1,1,1,1,H
1950-09-30,1950,Sheffield Wednesday,Newcastle United,0-0,0,0,1,1,0,0,D
1950-09-30,1950,Sunderland,Charlton Athletic,4-2,4,2,1,1,6,2,H
1950-09-30,1950,Wolverhampton Wanderers,Manchester United,0-0,0,0,1,1,0,0,D
1950-10-07,1950,Aston Villa,Newcastle United,3-0,3,0,1,1,3,3,H
1950-10-07,1950,Blackpool,Chelsea,3-2,3,2,1,1,5,1,H
1950-10-07,1950,Bolton Wanderers,Portsmouth,4-0,4,0,1,1,4,4,H
1950-10-07,1950,Charlton Athletic,Arsenal,1-3,1,3,1,1,4,-2,A
1950-10-07,1950,Derby County,West Bromwich Albion,1-1,1,1,1,1,2,0,D
1950-10-07,1950,Fulham,Everton,1-5,1,5,1,1,6,-4,A
1950-10-07,1950,Liverpool,Stoke City,0-0,0,0,1,1,0,0,D
1950-10-07,1950,Manchester United,Sheffield Wednesday,3-1,3,1,1,1,4,2,H
1950-10-07,1950,Sunderland,Huddersfield Town,0-0,0,0,1,1,0,0,D
1950-10-07,1950,Tottenham Hotspur,Burnley,1-0,1,0,1,1,1,1,H
1950-10-07,1950,Wolverhampton Wanderers,Middlesbrough,3-4,3,4,1,1,7,-1,A
1950-10-14,1950,Arsenal,Manchester United,3-0,3,0,1,1,3,3,H
1950-10-14,1950,Burnley,Charlton Athletic,5-1,5,1,1,1,6,4,H
1950-10-14,1950,Chelsea,Tottenham Hotspur,0-2,0,2,1,1,2,-2,A
1950-10-14,1950,Everton,Bolton Wanderers,1-1,1,1,1,1,2,0,D
1950-10-14,1950,Huddersfield Town,Aston Villa,4-2,4,2,1,1,6,2,H
1950-10-14,1950,Middlesbrough,Sunderland,1-1,1,1,1,1,2,0,D
1950-10-14,1950,Newcastle United,Derby County,3-1,3,1,1,1,4,2,H
1950-10-14,1950,Portsmouth,Blackpool,2-0,2,0,1,1,2,2,H
1950-10-14,1950,Sheffield Wednesday,Wolverhampton Wanderers,2-2,2,2,1,1,4,0,D
1950-10-14,1950,Stoke City,Fulham,1-1,1,1,1,1,2,0,D
1950-10-14,1950,West Bromwich Albion,Liverpool,1-1,1,1,1,1,2,0,D
1950-10-21,1950,Aston Villa,Arsenal,1-1,1,1,1,1,2,0,D
1950-10-21,1950,Blackpool,West Bromwich Albion,2-1,2,1,1,1,3,1,H
1950-10-21,1950,Bolton Wanderers,Newcastle United,0-2,0,2,1,1,2,-2,A
1950-10-21,1950,Charlton Athletic,Everton,2-1,2,1,1,1,3,1,H
1950-10-21,1950,Derby County,Sheffield Wednesday,4-1,4,1,1,1,5,3,H
1950-10-21,1950,Fulham,Huddersfield Town,1-1,1,1,1,1,2,0,D
1950-10-21,1950,Liverpool,Middlesbrough,0-0,0,0,1,1,0,0,D
1950-10-21,1950,Manchester United,Portsmouth,0-0,0,0,1,1,0,0,D
1950-10-21,1950,Sunderland,Burnley,1-1,1,1,1,1,2,0,D
1950-10-21,1950,Tottenham Hotspur,Stoke City,6-1,6,1,1,1,7,5,H
1950-10-21,1950,Wolverhampton Wanderers,Chelsea,2-1,2,1,1,1,3,1,H
1950-10-28,1950,Arsenal,Derby County,3-1,3,1,1,1,4,2,H
1950-10-28,1950,Burnley,Aston Villa,2-0,2,0,1,1,2,2,H
1950-10-28,1950,Chelsea,Sunderland,3-0,3,0,1,1,3,3,H
1950-10-28,1950,Everton,Manchester United,1-4,1,4,1,1,5,-3,A
1950-10-28,1950,Huddersfield Town,Bolton Wanderers,0-4,0,4,1,1,4,-4,A
1950-10-28,1950,Middlesbrough,Fulham,1-1,1,1,1,1,2,0,D
1950-10-28,1950,Newcastle United,Blackpool,4-2,4,2,1,1,6,2,H
1950-10-28,1950,Portsmouth,Wolverhampton Wanderers,1-4,1,4,1,1,5,-3,A
1950-10-28,1950,Sheffield Wednesday,Liverpool,4-1,4,1,1,1,5,3,H
1950-10-28,1950,Stoke City,Charlton Athletic,2-0,2,0,1,1,2,2,H
1950-10-28,1950,West Bromwich Albion,Tottenham Hotspur,1-2,1,2,1,1,3,-1,A
1950-11-04,1950,Aston Villa,Middlesbrough,0-1,0,1,1,1,1,-1,A
1950-11-04,1950,Blackpool,Everton,4-0,4,0,1,1,4,4,H
1950-11-04,1950,Bolton Wanderers,Stoke City,1-1,1,1,1,1,2,0,D
1950-11-04,1950,Charlton Athletic,Chelsea,1-2,1,2,1,1,3,-1,A
1950-11-04,1950,Derby County,Huddersfield Town,3-0,3,0,1,1,3,3,H
1950-11-04,1950,Fulham,West Bromwich Albion,0-1,0,1,1,1,1,-1,A
1950-11-04,1950,Liverpool,Newcastle United,2-4,2,4,1,1,6,-2,A
1950-11-04,1950,Manchester United,Burnley,1-1,1,1,1,1,2,0,D
1950-11-04,1950,Sunderland,Sheffield Wednesday,5-1,5,1,1,1,6,4,H
1950-11-04,1950,Tottenham Hotspur,Portsmouth,5-1,5,1,1,1,6,4,H
1950-11-04,1950,Wolverhampton Wanderers,Arsenal,0-1,0,1,1,1,1,-1,A
1950-11-11,1950,Arsenal,Sunderland,5-1,5,1,1,1,6,4,H
1950-11-11,1950,Burnley,Wolverhampton Wanderers,2-0,2,0,1,1,2,2,H
1950-11-11,1950,Chelsea,Manchester United,1-0,1,0,1,1,1,1,H
1950-11-11,1950,Everton,Tottenham Hotspur,1-2,1,2,1,1,3,-1,A
1950-11-11,1950,Huddersfield Town,Liverpool,2-2,2,2,1,1,4,0,D
1950-11-11,1950,Middlesbrough,Derby County,1-1,1,1,1,1,2,0,D
1950-11-11,1950,Newcastle United,Fulham,1-2,1,2,1,1,3,-1,A
1950-11-11,1950,Portsmouth,Charlton Athletic,3-3,3,3,1,1,6,0,D
1950-11-11,1950,Sheffield Wednesday,Aston Villa,3-2,3,2,1,1,5,1,H
1950-11-11,1950,Stoke City,Blackpool,1-0,1,0,1,1,1,1,H
1950-11-11,1950,West Bromwich Albion,Bolton Wanderers,0-1,0,1,1,1,1,-1,A
1950-11-18,1950,Aston Villa,Chelsea,4-2,4,2,1,1,6,2,H
1950-11-18,1950,Blackpool,Huddersfield Town,3-1,3,1,1,1,4,2,H
1950-11-18,1950,Bolton Wanderers,Middlesbrough,0-2,0,2,1,1,2,-2,A
1950-11-18,1950,Charlton Athletic,West Bromwich Albion,2-3,2,3,1,1,5,-1,A
1950-11-18,1950,Derby County,Burnley,1-1,1,1,1,1,2,0,D
1950-11-18,1950,Fulham,Sheffield Wednesday,4-2,4,2,1,1,6,2,H
1950-11-18,1950,Liverpool,Arsenal,1-3,1,3,1,1,4,-2,A
1950-11-18,1950,Manchester United,Stoke City,0-0,0,0,1,1,0,0,D
1950-11-18,1950,Sunderland,Portsmouth,0-0,0,0,1,1,0,0,D
1950-11-18,1950,Tottenham Hotspur,Newcastle United,7-0,7,0,1,1,7,7,H
1950-11-18,1950,Wolverhampton Wanderers,Everton,4-0,4,0,1,1,4,4,H
1950-11-25,1950,Arsenal,Fulham,5-1,5,1,1,1,6,4,H
1950-11-25,1950,Burnley,Liverpool,1-1,1,1,1,1,2,0,D
1950-11-25,1950,Chelsea,Derby County,1-2,1,2,1,1,3,-1,A
1950-11-25,1950,Everton,Sunderland,3-1,3,1,1,1,4,2,H
1950-11-25,1950,Huddersfield Town,Tottenham Hotspur,3-2,3,2,1,1,5,1,H
1950-11-25,1950,Middlesbrough,Blackpool,4-3,4,3,1,1,7,1,H
1950-11-25,1950,Newcastle United,Charlton Athletic,3-2,3,2,1,1,5,1,H
1950-11-25,1950,Portsmouth,Aston Villa,3-3,3,3,1,1,6,0,D
1950-11-25,1950,Sheffield Wednesday,Bolton Wanderers,3-4,3,4,1,1,7,-1,A
1950-11-25,1950,Stoke City,Wolverhampton Wanderers,0-1,0,1,1,1,1,-1,A
1950-11-25,1950,West Bromwich Albion,Manchester United,0-1,0,1,1,1,1,-1,A
1950-12-02,1950,Aston Villa,Everton,3-3,3,3,1,1,6,0,D
1950-12-02,1950,Blackpool,Sheffield Wednesday,3-2,3,2,1,1,5,1,H
1950-12-02,1950,Bolton Wanderers,Arsenal,3-0,3,0,1,1,3,3,H
1950-12-02,1950,Charlton Athletic,Huddersfield Town,3-2,3,2,1,1,5,1,H
1950-12-02,1950,Derby County,Portsmouth,2-3,2,3,1,1,5,-1,A
1950-12-02,1950,Fulham,Burnley,4-1,4,1,1,1,5,3,H
1950-12-02,1950,Liverpool,Chelsea,1-0,1,0,1,1,1,1,H
1950-12-02,1950,Manchester United,Newcastle United,1-2,1,2,1,1,3,-1,A
1950-12-02,1950,Sunderland,Stoke City,1-1,1,1,1,1,2,0,D
1950-12-02,1950,Tottenham Hotspur,Middlesbrough,3-3,3,3,1,1,6,0,D
1950-12-02,1950,Wolverhampton Wanderers,West Bromwich Albion,3-1,3,1,1,1,4,2,H
1950-12-09,1950,Arsenal,Blackpool,4-4,4,4,1,1,8,0,D
1950-12-09,1950,Burnley,Bolton Wanderers,2-0,2,0,1,1,2,2,H
1950-12-09,1950,Chelsea,Fulham,2-0,2,0,1,1,2,2,H
1950-12-09,1950,Everton,Derby County,1-2,1,2,1,1,3,-1,A
1950-12-09,1950,Huddersfield Town,Manchester United,2-3,2,3,1,1,5,-1,A
1950-12-09,1950,Middlesbrough,Charlton Athletic,7-3,7,3,1,1,10,4,H
1950-12-09,1950,Newcastle United,Wolverhampton Wanderers,1-1,1,1,1,1,2,0,D
1950-12-09,1950,Portsmouth,Liverpool,1-3,1,3,1,1,4,-2,A
1950-12-09,1950,Sheffield Wednesday,Tottenham Hotspur,1-1,1,1,1,1,2,0,D
1950-12-09,1950,Stoke City,Aston Villa,1-0,1,0,1,1,1,1,H
1950-12-09,1950,West Bromwich Albion,Sunderland,3-1,3,1,1,1,4,2,H
1950-12-16,1950,Arsenal,Burnley,0-1,0,1,1,1,1,-1,A
1950-12-16,1950,Blackpool,Tottenham Hotspur,0-1,0,1,1,1,1,-1,A
1950-12-16,1950,Bolton Wanderers,Charlton Athletic,3-0,3,0,1,1,3,3,H
1950-12-16,1950,Derby County,Sunderland,6-5,6,5,1,1,11,1,H
1950-12-16,1950,Fulham,Manchester United,2-2,2,2,1,1,4,0,D
1950-12-16,1950,Huddersfield Town,Everton,1-2,1,2,1,1,3,-1,A
1950-12-16,1950,Liverpool,Wolverhampton Wanderers,1-4,1,4,1,1,5,-3,A
1950-12-16,1950,Middlesbrough,Portsmouth,3-1,3,1,1,1,4,2,H
1950-12-16,1950,Newcastle United,Stoke City,3-1,3,1,1,1,4,2,H
1950-12-16,1950,West Bromwich Albion,Aston Villa,2-0,2,0,1,1,2,2,H
1950-12-23,1950,Aston Villa,Derby County,1-1,1,1,1,1,2,0,D
1950-12-23,1950,Burnley,Sheffield Wednesday,1-0,1,0,1,1,1,1,H
1950-12-23,1950,Charlton Athletic,Blackpool,2-3,2,3,1,1,5,-1,A
1950-12-23,1950,Chelsea,Middlesbrough,1-1,1,1,1,1,2,0,D
1950-12-23,1950,Everton,Newcastle United,3-1,3,1,1,1,4,2,H
1950-12-23,1950,Manchester United,Bolton Wanderers,2-3,2,3,1,1,5,-1,A
1950-12-23,1950,Portsmouth,Huddersfield Town,1-0,1,0,1,1,1,1,H
1950-12-23,1950,Stoke City,West Bromwich Albion,1-1,1,1,1,1,2,0,D
1950-12-23,1950,Sunderland,Liverpool,2-1,2,1,1,1,3,1,H
1950-12-23,1950,Tottenham Hotspur,Arsenal,1-0,1,0,1,1,1,1,H
1950-12-23,1950,Wolverhampton Wanderers,Fulham,1-1,1,1,1,1,2,0,D
1950-12-25,1950,Arsenal,Stoke City,0-3,0,3,1,1,3,-3,A
1950-12-25,1950,Blackpool,Liverpool,3-0,3,0,1,1,3,3,H
1950-12-25,1950,Charlton Athletic,Aston Villa,2-2,2,2,1,1,4,0,D
1950-12-25,1950,Derby County,Tottenham Hotspur,1-1,1,1,1,1,2,0,D
1950-12-25,1950,Everton,Burnley,1-0,1,0,1,1,1,1,H
1950-12-25,1950,Fulham,Bolton Wanderers,0-1,0,1,1,1,1,-1,A
1950-12-25,1950,Huddersfield Town,Wolverhampton Wanderers,1-2,1,2,1,1,3,-1,A
1950-12-25,1950,Middlesbrough,Newcastle United,2-1,2,1,1,1,3,1,H
1950-12-25,1950,Portsmouth,Chelsea,1-3,1,3,1,1,4,-2,A
1950-12-25,1950,Sunderland,Manchester United,2-1,2,1,1,1,3,1,H
1950-12-25,1950,West Bromwich Albion,Sheffield Wednesday,1-3,1,3,1,1,4,-2,A
1950-12-26,1950,Aston Villa,Charlton Athletic,0-0,0,0,1,1,0,0,D
1950-12-26,1950,Bolton Wanderers,Fulham,0-1,0,1,1,1,1,-1,A
1950-12-26,1950,Burnley,Everton,1-1,1,1,1,1,2,0,D
1950-12-26,1950,Chelsea,Portsmouth,1-4,1,4,1,1,5,-3,A
1950-12-26,1950,Liverpool,Blackpool,1-0,1,0,1,1,1,1,H
1950-12-26,1950,Manchester United,Sunderland,3-5,3,5,1,1,8,-2,A
1950-12-26,1950,Sheffield Wednesday,West Bromwich Albion,3-0,3,0,1,1,3,3,H
1950-12-26,1950,Stoke City,Arsenal,1-0,1,0,1,1,1,1,H
1950-12-26,1950,Tottenham Hotspur,Derby County,2-1,2,1,1,1,3,1,H
1950-12-26,1950,Wolverhampton Wanderers,Huddersfield Town,3-1,3,1,1,1,4,2,H
1950-12-30,1950,Derby County,Stoke City,1-1,1,1,1,1,2,0,D
1950-12-30,1950,Fulham,Sunderland,1-1,1,1,1,1,2,0,D
1950-12-30,1950,Middlesbrough,Burnley,3-3,3,3,1,1,6,0,D
1950-12-30,1950,Sheffield Wednesday,Arsenal,0-2,0,2,1,1,2,-2,A
1950-12-30,1950,Tottenham Hotspur,Charlton Athletic,1-0,1,0,1,1,1,1,H
1950-12-30,1950,West Bromwich Albion,Everton,0-1,0,1,1,1,1,-1,A
1951-01-13,1950,Arsenal,Middlesbrough,3-1,3,1,1,1,4,2,H
1951-01-13,1950,Aston Villa,Fulham,3-0,3,0,1,1,3,3,H
1951-01-13,1950,Burnley,Huddersfield Town,0-1,0,1,1,1,1,-1,A
1951-01-13,1950,Charlton Athletic,Sheffield Wednesday,2-1,2,1,1,1,3,1,H
1951-01-13,1950,Chelsea,Newcastle United,3-1,3,1,1,1,4,2,H
1951-01-13,1950,Derby County,Liverpool,1-2,1,2,1,1,3,-1,A
1951-01-13,1950,Everton,Stoke City,0-3,0,3,1,1,3,-3,A
1951-01-13,1950,Manchester United,Tottenham Hotspur,2-1,2,1,1,1,3,1,H
1951-01-13,1950,Portsmouth,West Bromwich Albion,2-2,2,2,1,1,4,0,D
1951-01-13,1950,Sunderland,Bolton Wanderers,1-2,1,2,1,1,3,-1,A
1951-01-13,1950,Wolverhampton Wanderers,Blackpool,1-1,1,1,1,1,2,0,D
1951-01-20,1950,Blackpool,Sunderland,2-2,2,2,1,1,4,0,D
1951-01-20,1950,Bolton Wanderers,Aston Villa,1-0,1,0,1,1,1,1,H
1951-01-20,1950,Charlton Athletic,Manchester United,1-2,1,2,1,1,3,-1,A
1951-01-20,1950,Fulham,Derby County,3-5,3,5,1,1,8,-2,A
1951-01-20,1950,Huddersfield Town,Arsenal,2-2,2,2,1,1,4,0,D
1951-01-20,1950,Liverpool,Everton,0-2,0,2,1,1,2,-2,A
1951-01-20,1950,Middlesbrough,Sheffield Wednesday,2-1,2,1,1,1,3,1,H
1951-01-20,1950,Newcastle United,Burnley,2-1,2,1,1,1,3,1,H
1951-01-20,1950,Stoke City,Portsmouth,1-2,1,2,1,1,3,-1,A
1951-01-20,1950,Tottenham Hotspur,Wolverhampton Wanderers,2-1,2,1,1,1,3,1,H
1951-01-20,1950,West Bromwich Albion,Chelsea,1-1,1,1,1,1,2,0,D
1951-01-27,1950,Charlton Athletic,Liverpool,1-0,1,0,1,1,1,1,H
1951-02-03,1950,Arsenal,Newcastle United,0-0,0,0,1,1,0,0,D
1951-02-03,1950,Aston Villa,Blackpool,0-3,0,3,1,1,3,-3,A
1951-02-03,1950,Burnley,West Bromwich Albion,0-1,0,1,1,1,1,-1,A
1951-02-03,1950,Chelsea,Stoke City,1-1,1,1,1,1,2,0,D
1951-02-03,1950,Derby County,Bolton Wanderers,2-2,2,2,1,1,4,0,D
1951-02-03,1950,Liverpool,Fulham,2-0,2,0,1,1,2,2,H
1951-02-03,1950,Manchester United,Middlesbrough,1-0,1,0,1,1,1,1,H
1951-02-03,1950,Portsmouth,Everton,6-3,6,3,1,1,9,3,H
1951-02-03,1950,Sheffield Wednesday,Huddersfield Town,3-2,3,2,1,1,5,1,H
1951-02-03,1950,Sunderland,Tottenham Hotspur,0-0,0,0,1,1,0,0,D
1951-02-03,1950,Wolverhampton Wanderers,Charlton Athletic,2-3,2,3,1,1,5,-1,A
1951-02-10,1950,Bolton Wanderers,Burnley,1-1,1,1,1,1,2,0,D
1951-02-10,1950,Liverpool,Portsmouth,2-1,2,1,1,1,3,1,H
1951-02-17,1950,Blackpool,Derby County,3-1,3,1,1,1,4,2,H
1951-02-17,1950,Bolton Wanderers,Liverpool,2-1,2,1,1,1,3,1,H
1951-02-17,1950,Charlton Athletic,Sunderland,3-0,3,0,1,1,3,3,H
1951-02-17,1950,Everton,Chelsea,3-0,3,0,1,1,3,3,H
1951-02-17,1950,Huddersfield Town,Middlesbrough,2-3,2,3,1,1,5,-1,A
1951-02-17,1950,Manchester United,Wolverhampton Wanderers,2-1,2,1,1,1,3,1,H
1951-02-17,1950,Newcastle United,Sheffield Wednesday,2-0,2,0,1,1,2,2,H
1951-02-17,1950,Stoke City,Burnley,0-0,0,0,1,1,0,0,D
1951-02-17,1950,Tottenham Hotspur,Aston Villa,3-2,3,2,1,1,5,1,H
1951-02-17,1950,West Bromwich Albion,Arsenal,2-0,2,0,1,1,2,2,H
1951-02-24,1950,Arsenal,Charlton Athletic,2-5,2,5,1,1,7,-3,A
1951-02-24,1950,Burnley,Tottenham Hotspur,2-0,2,0,1,1,2,2,H
1951-02-24,1950,Portsmouth,Bolton Wanderers,2-1,2,1,1,1,3,1,H
1951-02-24,1950,Sheffield Wednesday,Chelsea,2-2,2,2,1,1,4,0,D
1951-02-24,1950,Stoke City,Liverpool,2-3,2,3,1,1,5,-1,A
1951-02-24,1950,West Bromwich Albion,Derby County,1-2,1,2,1,1,3,-1,A
1951-02-26,1950,Sheffield Wednesday,Manchester United,0-4,0,4,1,1,4,-4,A
1951-02-28,1950,Chelsea,Blackpool,0-2,0,2,1,1,2,-2,A
1951-02-28,1950,Everton,Fulham,1-0,1,0,1,1,1,1,H
1951-03-03,1950,Aston Villa,Huddersfield Town,0-1,0,1,1,1,1,-1,A
1951-03-03,1950,Blackpool,Portsmouth,3-0,3,0,1,1,3,3,H
1951-03-03,1950,Bolton Wanderers,Everton,2-0,2,0,1,1,2,2,H
1951-03-03,1950,Charlton Athletic,Burnley,0-0,0,0,1,1,0,0,D
1951-03-03,1950,Derby County,Newcastle United,1-2,1,2,1,1,3,-1,A
1951-03-03,1950,Fulham,Stoke City,2-0,2,0,1,1,2,2,H
1951-03-03,1950,Liverpool,West Bromwich Albion,1-1,1,1,1,1,2,0,D
1951-03-03,1950,Manchester United,Arsenal,3-1,3,1,1,1,4,2,H
1951-03-03,1950,Sunderland,Middlesbrough,2-1,2,1,1,1,3,1,H
1951-03-03,1950,Tottenham Hotspur,Chelsea,2-1,2,1,1,1,3,1,H
1951-03-03,1950,Wolverhampton Wanderers,Sheffield Wednesday,4-0,4,0,1,1,4,4,H
1951-03-07,1950,Huddersfield Town,Sunderland,3-4,3,4,1,1,7,-1,A
1951-03-10,1950,Arsenal,Aston Villa,2-1,2,1,1,1,3,1,H
1951-03-10,1950,Burnley,Sunderland,1-1,1,1,1,1,2,0,D
1951-03-10,1950,Everton,Charlton Athletic,0-0,0,0,1,1,0,0,D
1951-03-10,1950,Huddersfield Town,Fulham,1-2,1,2,1,1,3,-1,A
1951-03-10,1950,Middlesbrough,Liverpool,1-1,1,1,1,1,2,0,D
1951-03-10,1950,Portsmouth,Manchester United,0-0,0,0,1,1,0,0,D
1951-03-10,1950,Stoke City,Tottenham Hotspur,0-0,0,0,1,1,0,0,D
1951-03-17,1950,Aston Villa,Burnley,3-2,3,2,1,1,5,1,H
1951-03-17,1950,Blackpool,Newcastle United,2-2,2,2,1,1,4,0,D
1951-03-17,1950,Bolton Wanderers,Huddersfield Town,4-0,4,0,1,1,4,4,H
1951-03-17,1950,Charlton Athletic,Stoke City,2-0,2,0,1,1,2,2,H
1951-03-17,1950,Derby County,Arsenal,4-2,4,2,1,1,6,2,H
1951-03-17,1950,Fulham,Middlesbrough,2-0,2,0,1,1,2,2,H
1951-03-17,1950,Liverpool,Sheffield Wednesday,2-1,2,1,1,1,3,1,H
1951-03-17,1950,Manchester United,Everton,3-0,3,0,1,1,3,3,H
1951-03-17,1950,Sunderland,Chelsea,1-1,1,1,1,1,2,0,D
1951-03-17,1950,Tottenham Hotspur,West Bromwich Albion,5-0,5,0,1,1,5,5,H
1951-03-17,1950,Wolverhampton Wanderers,Portsmouth,2-3,2,3,1,1,5,-1,A
1951-03-23,1950,Arsenal,Portsmouth,0-1,0,1,1,1,1,-1,A
1951-03-23,1950,Blackpool,Bolton Wanderers,2-0,2,0,1,1,2,2,H
1951-03-23,1950,Burnley,Chelsea,2-1,2,1,1,1,3,1,H
1951-03-23,1950,Fulham,Tottenham Hotspur,0-1,0,1,1,1,1,-1,A
1951-03-23,1950,Liverpool,Charlton Athletic,1-0,1,0,1,1,1,1,H
1951-03-23,1950,Manchester United,Derby County,2-0,2,0,1,1,2,2,H
1951-03-23,1950,Middlesbrough,Stoke City,1-0,1,0,1,1,1,1,H
1951-03-23,1950,Newcastle United,Sunderland,2-2,2,2,1,1,4,0,D
1951-03-24,1950,Arsenal,Wolverhampton Wanderers,2-1,2,1,1,1,3,1,H
1951-03-24,1950,Burnley,Manchester United,1-2,1,2,1,1,3,-1,A
1951-03-24,1950,Chelsea,Charlton Athletic,2-3,2,3,1,1,5,-1,A
1951-03-24,1950,Everton,Blackpool,0-2,0,2,1,1,2,-2,A
1951-03-24,1950,Huddersfield Town,Derby County,2-0,2,0,1,1,2,2,H
1951-03-24,1950,Middlesbrough,Aston Villa,2-1,2,1,1,1,3,1,H
1951-03-24,1950,Newcastle United,Liverpool,1-1,1,1,1,1,2,0,D
1951-03-24,1950,Portsmouth,Tottenham Hotspur,1-1,1,1,1,1,2,0,D
1951-03-24,1950,Sheffield Wednesday,Sunderland,3-0,3,0,1,1,3,3,H
1951-03-24,1950,Stoke City,Bolton Wanderers,2-1,2,1,1,1,3,1,H
1951-03-24,1950,West Bromwich Albion,Fulham,0-0,0,0,1,1,0,0,D
1951-03-26,1950,Bolton Wanderers,Blackpool,1-2,1,2,1,1,3,-1,A
1951-03-26,1950,Chelsea,Burnley,0-2,0,2,1,1,2,-2,A
1951-03-26,1950,Derby County,Manchester United,2-4,2,4,1,1,6,-2,A
1951-03-26,1950,Everton,Sheffield Wednesday,0-0,0,0,1,1,0,0,D
1951-03-26,1950,Portsmouth,Arsenal,1-1,1,1,1,1,2,0,D
1951-03-26,1950,Stoke City,Middlesbrough,2-0,2,0,1,1,2,2,H
1951-03-26,1950,Sunderland,Newcastle United,2-1,2,1,1,1,3,1,H
1951-03-26,1950,Tottenham Hotspur,Fulham,2-1,2,1,1,1,3,1,H
1951-03-26,1950,West Bromwich Albion,Huddersfield Town,0-2,0,2,1,1,2,-2,A
1951-03-26,1950,Wolverhampton Wanderers,Aston Villa,2-3,2,3,1,1,5,-1,A
1951-03-27,1950,Aston Villa,Wolverhampton Wanderers,1-0,1,0,1,1,1,1,H
1951-03-27,1950,Huddersfield Town,West Bromwich Albion,1-2,1,2,1,1,3,-1,A
1951-03-31,1950,Aston Villa,Sheffield Wednesday,2-1,2,1,1,1,3,1,H
1951-03-31,1950,Blackpool,Stoke City,3-0,3,0,1,1,3,3,H
1951-03-31,1950,Bolton Wanderers,West Bromwich Albion,0-2,0,2,1,1,2,-2,A
1951-03-31,1950,Charlton Athletic,Portsmouth,0-1,0,1,1,1,1,-1,A
1951-03-31,1950,Derby County,Middlesbrough,6-0,6,0,1,1,6,6,H
1951-03-31,1950,Fulham,Newcastle United,1-1,1,1,1,1,2,0,D
1951-03-31,1950,Liverpool,Huddersfield Town,1-4,1,4,1,1,5,-3,A
1951-03-31,1950,Manchester United,Chelsea,4-1,4,1,1,1,5,3,H
1951-03-31,1950,Sunderland,Arsenal,0-2,0,2,1,1,2,-2,A
1951-03-31,1950,Tottenham Hotspur,Everton,3-0,3,0,1,1,3,3,H
1951-03-31,1950,Wolverhampton Wanderers,Burnley,0-1,0,1,1,1,1,-1,A
1951-04-04,1950,Newcastle United,Aston Villa,0-1,0,1,1,1,1,-1,A
1951-04-04,1950,West Bromwich Albion,Blackpool,1-3,1,3,1,1,4,-2,A
1951-04-07,1950,Arsenal,Liverpool,1-2,1,2,1,1,3,-1,A
1951-04-07,1950,Burnley,Derby County,1-0,1,0,1,1,1,1,H
1951-04-07,1950,Chelsea,Aston Villa,1-1,1,1,1,1,2,0,D
1951-04-07,1950,Everton,Wolverhampton Wanderers,1-1,1,1,1,1,2,0,D
1951-04-07,1950,Huddersfield Town,Blackpool,2-1,2,1,1,1,3,1,H
1951-04-07,1950,Middlesbrough,Bolton Wanderers,1-1,1,1,1,1,2,0,D
1951-04-07,1950,Newcastle United,Tottenham Hotspur,0-1,0,1,1,1,1,-1,A
1951-04-07,1950,Portsmouth,Sunderland,0-0,0,0,1,1,0,0,D
1951-04-07,1950,Sheffield Wednesday,Fulham,2-2,2,2,1,1,4,0,D
1951-04-07,1950,Stoke City,Manchester United,2-0,2,0,1,1,2,2,H
1951-04-07,1950,West Bromwich Albion,Charlton Athletic,3-0,3,0,1,1,3,3,H
1951-04-11,1950,Middlesbrough,Wolverhampton Wanderers,1-2,1,2,1,1,3,-1,A
1951-04-11,1950,Newcastle United,Portsmouth,0-0,0,0,1,1,0,0,D
1951-04-14,1950,Aston Villa,Portsmouth,3-3,3,3,1,1,6,0,D
1951-04-14,1950,Blackpool,Middlesbrough,2-1,2,1,1,1,3,1,H
1951-04-14,1950,Bolton Wanderers,Sheffield Wednesday,0-1,0,1,1,1,1,-1,A
1951-04-14,1950,Charlton Athletic,Newcastle United,1-3,1,3,1,1,4,-2,A
1951-04-14,1950,Derby County,Chelsea,1-0,1,0,1,1,1,1,H
1951-04-14,1950,Fulham,Arsenal,3-2,3,2,1,1,5,1,H
1951-04-14,1950,Liverpool,Burnley,1-0,1,0,1,1,1,1,H
1951-04-14,1950,Manchester United,West Bromwich Albion,3-0,3,0,1,1,3,3,H
1951-04-14,1950,Sunderland,Everton,4-0,4,0,1,1,4,4,H
1951-04-14,1950,Tottenham Hotspur,Huddersfield Town,0-2,0,2,1,1,2,-2,A
1951-04-14,1950,Wolverhampton Wanderers,Stoke City,2-3,2,3,1,1,5,-1,A
1951-04-18,1950,Huddersfield Town,Chelsea,2-1,2,1,1,1,3,1,H
1951-04-18,1950,Newcastle United,Bolton Wanderers,0-1,0,1,1,1,1,-1,A
1951-04-18,1950,Sheffield Wednesday,Derby County,4-3,4,3,1,1,7,1,H
1951-04-21,1950,Arsenal,Bolton Wanderers,1-1,1,1,1,1,2,0,D
1951-04-21,1950,Burnley,Fulham,0-2,0,2,1,1,2,-2,A
1951-04-21,1950,Chelsea,Liverpool,1-0,1,0,1,1,1,1,H
1951-04-21,1950,Everton,Aston Villa,1-2,1,2,1,1,3,-1,A
1951-04-21,1950,Huddersfield Town,Charlton Athletic,1-1,1,1,1,1,2,0,D
1951-04-21,1950,Middlesbrough,Tottenham Hotspur,1-1,1,1,1,1,2,0,D
1951-04-21,1950,Newcastle United,Manchester United,0-2,0,2,1,1,2,-2,A
1951-04-21,1950,Portsmouth,Derby County,2-2,2,2,1,1,4,0,D
1951-04-21,1950,Sheffield Wednesday,Blackpool,3-1,3,1,1,1,4,2,H
1951-04-21,1950,Stoke City,Sunderland,2-4,2,4,1,1,6,-2,A
1951-04-21,1950,West Bromwich Albion,Wolverhampton Wanderers,3-2,3,2,1,1,5,1,H
1951-04-25,1950,Chelsea,Wolverhampton Wanderers,2-1,2,1,1,1,3,1,H
1951-04-25,1950,Liverpool,Aston Villa,0-0,0,0,1,1,0,0,D
1951-04-28,1950,Bolton Wanderers,Wolverhampton Wanderers,2-1,2,1,1,1,3,1,H
1951-04-28,1950,Charlton Athletic,Middlesbrough,3-0,3,0,1,1,3,3,H
1951-04-28,1950,Derby County,Everton,0-1,0,1,1,1,1,-1,A
1951-04-28,1950,Fulham,Chelsea,1-2,1,2,1,1,3,-1,A
1951-04-28,1950,Manchester United,Huddersfield Town,6-0,6,0,1,1,6,6,H
1951-04-28,1950,Sunderland,West Bromwich Albion,1-1,1,1,1,1,2,0,D
1951-04-28,1950,Tottenham Hotspur,Sheffield Wednesday,1-0,1,0,1,1,1,1,H
1951-05-02,1950,Blackpool,Arsenal,0-1,0,1,1,1,1,-1,A
1951-05-02,1950,Fulham,Portsmouth,1-4,1,4,1,1,5,-3,A
1951-05-02,1950,Wolverhampton Wanderers,Newcastle United,0-1,0,1,1,1,1,-1,A
1951-05-05,1950,Aston Villa,Stoke City,6-2,6,2,1,1,8,4,H
1951-05-05,1950,Blackpool,Manchester United,1-1,1,1,1,1,2,0,D
1951-05-05,1950,Charlton Athletic,Derby County,1-2,1,2,1,1,3,-1,A
1951-05-05,1950,Chelsea,Bolton Wanderers,4-0,4,0,1,1,4,4,H
1951-05-05,1950,Newcastle United,Middlesbrough,1-0,1,0,1,1,1,1,H
1951-05-05,1950,Portsmouth,Burnley,2-1,2,1,1,1,3,1,H
1951-05-05,1950,Sheffield Wednesday,Everton,6-0,6,0,1,1,6,6,H
1951-05-05,1950,Sunderland,Wolverhampton Wanderers,0-0,0,0,1,1,0,0,D
1951-05-05,1950,Tottenham Hotspur,Liverpool,3-1,3,1,1,1,4,2,H
1951-08-18,1951,Arsenal,Huddersfield Town,2-2,2,2,1,1,4,0,D
1951-08-18,1951,Blackpool,Chelsea,1-2,1,2,1,1,3,-1,A
1951-08-18,1951,Bolton Wanderers,Aston Villa,5-2,5,2,1,1,7,3,H
1951-08-18,1951,Charlton Athletic,Burnley,1-0,1,0,1,1,1,1,H
1951-08-18,1951,Derby County,Sunderland,3-4,3,4,1,1,7,-1,A
1951-08-18,1951,Fulham,Preston North End,2-3,2,3,1,1,5,-1,A
1951-08-18,1951,Liverpool,Portsmouth,0-2,0,2,1,1,2,-2,A
1951-08-18,1951,Manchester City,Wolverhampton Wanderers,0-0,0,0,1,1,0,0,D
1951-08-18,1951,Middlesbrough,Tottenham Hotspur,2-1,2,1,1,1,3,1,H
1951-08-18,1951,Newcastle United,Stoke City,6-0,6,0,1,1,6,6,H
1951-08-18,1951,West Bromwich Albion,Manchester United,3-3,3,3,1,1,6,0,D
1951-08-20,1951,Stoke City,West Bromwich Albion,1-1,1,1,1,1,2,0,D
1951-08-20,1951,Tottenham Hotspur,Fulham,1-0,1,0,1,1,1,1,H
1951-08-21,1951,Burnley,Liverpool,0-0,0,0,1,1,0,0,D
1951-08-22,1951,Bolton Wanderers,Newcastle United,0-0,0,0,1,1,0,0,D
1951-08-22,1951,Chelsea,Arsenal,1-3,1,3,1,1,4,-2,A
1951-08-22,1951,Huddersfield Town,Manchester City,5-1,5,1,1,1,6,4,H
1951-08-22,1951,Manchester United,Middlesbrough,4-2,4,2,1,1,6,2,H
1951-08-22,1951,Portsmouth,Blackpool,1-3,1,3,1,1,4,-2,A
1951-08-22,1951,Preston North End,Charlton Athletic,3-0,3,0,1,1,3,3,H
1951-08-22,1951,Wolverhampton Wanderers,Derby County,1-2,1,2,1,1,3,-1,A
1951-08-25,1951,Aston Villa,Derby County,4-1,4,1,1,1,5,3,H
1951-08-25,1951,Burnley,Fulham,1-0,1,0,1,1,1,1,H
1951-08-25,1951,Chelsea,Liverpool,1-3,1,3,1,1,4,-2,A
1951-08-25,1951,Huddersfield Town,Blackpool,1-3,1,3,1,1,4,-2,A
1951-08-25,1951,Manchester United,Newcastle United,2-1,2,1,1,1,3,1,H
1951-08-25,1951,Portsmouth,Charlton Athletic,1-0,1,0,1,1,1,1,H
1951-08-25,1951,Preston North End,Middlesbrough,0-1,0,1,1,1,1,-1,A
1951-08-25,1951,Stoke City,Bolton Wanderers,1-2,1,2,1,1,3,-1,A
1951-08-25,1951,Sunderland,Manchester City,3-0,3,0,1,1,3,3,H
1951-08-25,1951,Tottenham Hotspur,West Bromwich Albion,3-1,3,1,1,1,4,2,H
1951-08-25,1951,Wolverhampton Wanderers,Arsenal,2-1,2,1,1,1,3,1,H
1951-08-27,1951,Aston Villa,Sunderland,2-1,2,1,1,1,3,1,H
1951-08-27,1951,Blackpool,Portsmouth,0-0,0,0,1,1,0,0,D
1951-08-29,1951,Arsenal,Chelsea,2-1,2,1,1,1,3,1,H
1951-08-29,1951,Charlton Athletic,Preston North End,4-2,4,2,1,1,6,2,H
1951-08-29,1951,Derby County,Wolverhampton Wanderers,1-3,1,3,1,1,4,-2,A
1951-08-29,1951,Fulham,Tottenham Hotspur,1-2,1,2,1,1,3,-1,A
1951-08-29,1951,Liverpool,Burnley,3-1,3,1,1,1,4,2,H
1951-08-29,1951,Manchester City,Huddersfield Town,3-0,3,0,1,1,3,3,H
1951-08-29,1951,Middlesbrough,Manchester United,1-4,1,4,1,1,5,-3,A
1951-08-29,1951,Newcastle United,Bolton Wanderers,0-1,0,1,1,1,1,-1,A
1951-08-29,1951,West Bromwich Albion,Stoke City,1-0,1,0,1,1,1,1,H
1951-09-01,1951,Arsenal,Sunderland,3-0,3,0,1,1,3,3,H
1951-09-01,1951,Blackpool,Wolverhampton Wanderers,3-2,3,2,1,1,5,1,H
1951-09-01,1951,Bolton Wanderers,Manchester United,1-0,1,0,1,1,1,1,H
1951-09-01,1951,Derby County,Stoke City,4-2,4,2,1,1,6,2,H
1951-09-01,1951,Fulham,Charlton Athletic,3-3,3,3,1,1,6,0,D
1951-09-01,1951,Liverpool,Huddersfield Town,2-1,2,1,1,1,3,1,H
1951-09-01,1951,Manchester City,Aston Villa,2-2,2,2,1,1,4,0,D
1951-09-01,1951,Middlesbrough,Burnley,5-0,5,0,1,1,5,5,H
1951-09-01,1951,Newcastle United,Tottenham Hotspur,7-2,7,2,1,1,9,5,H
1951-09-01,1951,Portsmouth,Chelsea,1-0,1,0,1,1,1,1,H
1951-09-01,1951,West Bromwich Albion,Preston North End,1-1,1,1,1,1,2,0,D
1951-09-03,1951,Bolton Wanderers,Middlesbrough,3-1,3,1,1,1,4,2,H
1951-09-03,1951,Burnley,Tottenham Hotspur,1-1,1,1,1,1,2,0,D
1951-09-03,1951,Stoke City,Fulham,1-1,1,1,1,1,2,0,D
1951-09-05,1951,Arsenal,Liverpool,0-0,0,0,1,1,0,0,D
1951-09-05,1951,Chelsea,Derby County,0-1,0,1,1,1,1,-1,A
1951-09-05,1951,Manchester United,Charlton Athletic,3-2,3,2,1,1,5,1,H
1951-09-05,1951,Portsmouth,Manchester City,1-0,1,0,1,1,1,1,H
1951-09-05,1951,Preston North End,Blackpool,3-1,3,1,1,1,4,2,H
1951-09-05,1951,Sunderland,Aston Villa,1-3,1,3,1,1,4,-2,A
1951-09-05,1951,West Bromwich Albion,Newcastle United,3-3,3,3,1,1,6,0,D
1951-09-08,1951,Aston Villa,Arsenal,1-0,1,0,1,1,1,1,H
1951-09-08,1951,Burnley,West Bromwich Albion,6-1,6,1,1,1,7,5,H
1951-09-08,1951,Charlton Athletic,Middlesbrough,4-3,4,3,1,1,7,1,H
1951-09-08,1951,Chelsea,Fulham,2-1,2,1,1,1,3,1,H
1951-09-08,1951,Derby County,Manchester City,1-3,1,3,1,1,4,-2,A
1951-09-08,1951,Huddersfield Town,Portsmouth,0-1,0,1,1,1,1,-1,A
1951-09-08,1951,Manchester United,Stoke City,4-0,4,0,1,1,4,4,H
1951-09-08,1951,Preston North End,Newcastle United,1-2,1,2,1,1,3,-1,A
1951-09-08,1951,Sunderland,Blackpool,1-3,1,3,1,1,4,-2,A
1951-09-08,1951,Tottenham Hotspur,Bolton Wanderers,2-1,2,1,1,1,3,1,H
1951-09-08,1951,Wolverhampton Wanderers,Liverpool,2-1,2,1,1,1,3,1,H
1951-09-10,1951,Aston Villa,Huddersfield Town,1-0,1,0,1,1,1,1,H
1951-09-10,1951,Blackpool,Preston North End,0-3,0,3,1,1,3,-3,A
1951-09-10,1951,Tottenham Hotspur,Burnley,1-1,1,1,1,1,2,0,D
1951-09-12,1951,Charlton Athletic,Manchester United,2-2,2,2,1,1,4,0,D
1951-09-12,1951,Fulham,Stoke City,5-0,5,0,1,1,5,5,H
1951-09-12,1951,Liverpool,Arsenal,0-0,0,0,1,1,0,0,D
1951-09-15,1951,Arsenal,Derby County,3-1,3,1,1,1,4,2,H
1951-09-15,1951,Blackpool,Aston Villa,0-3,0,3,1,1,3,-3,A
1951-09-15,1951,Bolton Wanderers,Preston North End,1-1,1,1,1,1,2,0,D
1951-09-15,1951,Chelsea,Huddersfield Town,2-1,2,1,1,1,3,1,H
1951-09-15,1951,Liverpool,Sunderland,2-2,2,2,1,1,4,0,D
1951-09-15,1951,Manchester City,Manchester United,1-2,1,2,1,1,3,-1,A
1951-09-15,1951,Middlesbrough,Fulham,2-0,2,0,1,1,2,2,H
1951-09-15,1951,Newcastle United,Burnley,7-1,7,1,1,1,8,6,H
1951-09-15,1951,Portsmouth,Wolverhampton Wanderers,2-3,2,3,1,1,5,-1,A
1951-09-15,1951,Stoke City,Tottenham Hotspur,1-6,1,6,1,1,7,-5,A
1951-09-15,1951,West Bromwich Albion,Charlton Athletic,1-1,1,1,1,1,2,0,D
1951-09-17,1951,Stoke City,Charlton Athletic,1-2,1,2,1,1,3,-1,A
1951-09-19,1951,Huddersfield Town,Aston Villa,3-1,3,1,1,1,4,2,H
1951-09-22,1951,Aston Villa,Liverpool,2-0,2,0,1,1,2,2,H
1951-09-22,1951,Burnley,Bolton Wanderers,1-3,1,3,1,1,4,-2,A
1951-09-22,1951,Charlton Athletic,Newcastle United,3-0,3,0,1,1,3,3,H
1951-09-22,1951,Derby County,Blackpool,1-1,1,1,1,1,2,0,D
1951-09-22,1951,Fulham,West Bromwich Albion,1-0,1,0,1,1,1,1,H
1951-09-22,1951,Huddersfield Town,Middlesbrough,1-0,1,0,1,1,1,1,H
1951-09-22,1951,Manchester City,Arsenal,0-2,0,2,1,1,2,-2,A
1951-09-22,1951,Preston North End,Stoke City,2-0,2,0,1,1,2,2,H
1951-09-22,1951,Sunderland,Portsmouth,3-1,3,1,1,1,4,2,H
1951-09-22,1951,Tottenham Hotspur,Manchester United,2-0,2,0,1,1,2,2,H
1951-09-22,1951,Wolverhampton Wanderers,Chelsea,5-3,5,3,1,1,8,2,H
1951-09-29,1951,Arsenal,Tottenham Hotspur,1-1,1,1,1,1,2,0,D
1951-09-29,1951,Blackpool,Manchester City,2-2,2,2,1,1,4,0,D
1951-09-29,1951,Bolton Wanderers,Charlton Athletic,2-1,2,1,1,1,3,1,H
1951-09-29,1951,Chelsea,Sunderland,2-1,2,1,1,1,3,1,H
1951-09-29,1951,Huddersfield Town,Wolverhampton Wanderers,1-7,1,7,1,1,8,-6,A
1951-09-29,1951,Liverpool,Derby County,2-0,2,0,1,1,2,2,H
1951-09-29,1951,Manchester United,Preston North End,1-2,1,2,1,1,3,-1,A
1951-09-29,1951,Newcastle United,Fulham,0-1,0,1,1,1,1,-1,A
1951-09-29,1951,Portsmouth,Aston Villa,2-0,2,0,1,1,2,2,H
1951-09-29,1951,Stoke City,Burnley,2-1,2,1,1,1,3,1,H
1951-09-29,1951,West Bromwich Albion,Middlesbrough,2-3,2,3,1,1,5,-1,A
1951-10-06,1951,Bolton Wanderers,Sunderland,1-1,1,1,1,1,2,0,D
1951-10-06,1951,Burnley,Blackpool,2-0,2,0,1,1,2,2,H
1951-10-06,1951,Charlton Athletic,Liverpool,2-0,2,0,1,1,2,2,H
1951-10-06,1951,Fulham,Portsmouth,2-3,2,3,1,1,5,-1,A
1951-10-06,1951,Manchester United,Derby County,2-1,2,1,1,1,3,1,H
1951-10-06,1951,Middlesbrough,Chelsea,0-0,0,0,1,1,0,0,D
1951-10-06,1951,Newcastle United,Wolverhampton Wanderers,3-1,3,1,1,1,4,2,H
1951-10-06,1951,Preston North End,Arsenal,2-0,2,0,1,1,2,2,H
1951-10-06,1951,Stoke City,Aston Villa,4-1,4,1,1,1,5,3,H
1951-10-06,1951,Tottenham Hotspur,Manchester City,1-2,1,2,1,1,3,-1,A
1951-10-06,1951,West Bromwich Albion,Huddersfield Town,0-0,0,0,1,1,0,0,D
1951-10-13,1951,Arsenal,Burnley,1-0,1,0,1,1,1,1,H
1951-10-13,1951,Aston Villa,Manchester United,2-5,2,5,1,1,7,-3,A
1951-10-13,1951,Blackpool,Charlton Athletic,1-2,1,2,1,1,3,-1,A
1951-10-13,1951,Chelsea,West Bromwich Albion,1-3,1,3,1,1,4,-2,A
1951-10-13,1951,Derby County,Tottenham Hotspur,4-2,4,2,1,1,6,2,H
1951-10-13,1951,Huddersfield Town,Newcastle United,2-4,2,4,1,1,6,-2,A
1951-10-13,1951,Liverpool,Fulham,4-0,4,0,1,1,4,4,H
1951-10-13,1951,Manchester City,Preston North End,1-0,1,0,1,1,1,1,H
1951-10-13,1951,Portsmouth,Middlesbrough,5-4,5,4,1,1,9,1,H
1951-10-13,1951,Sunderland,Stoke City,0-1,0,1,1,1,1,-1,A
1951-10-13,1951,Wolverhampton Wanderers,Bolton Wanderers,5-1,5,1,1,1,6,4,H
1951-10-20,1951,Bolton Wanderers,Huddersfield Town,2-1,2,1,1,1,3,1,H
1951-10-20,1951,Burnley,Manchester City,0-0,0,0,1,1,0,0,D
1951-10-20,1951,Charlton Athletic,Arsenal,1-3,1,3,1,1,4,-2,A
1951-10-20,1951,Fulham,Blackpool,1-2,1,2,1,1,3,-1,A
1951-10-20,1951,Manchester United,Sunderland,0-1,0,1,1,1,1,-1,A
1951-10-20,1951,Middlesbrough,Liverpool,3-3,3,3,1,1,6,0,D
1951-10-20,1951,Newcastle United,Chelsea,3-1,3,1,1,1,4,2,H
1951-10-20,1951,Preston North End,Derby County,0-1,0,1,1,1,1,-1,A
1951-10-20,1951,Stoke City,Wolverhampton Wanderers,1-0,1,0,1,1,1,1,H
1951-10-20,1951,Tottenham Hotspur,Aston Villa,2-0,2,0,1,1,2,2,H
1951-10-20,1951,West Bromwich Albion,Portsmouth,5-0,5,0,1,1,5,5,H
1951-10-27,1951,Arsenal,Fulham,4-3,4,3,1,1,7,1,H
1951-10-27,1951,Aston Villa,Preston North End,3-2,3,2,1,1,5,1,H
1951-10-27,1951,Blackpool,Middlesbrough,2-2,2,2,1,1,4,0,D
1951-10-27,1951,Chelsea,Bolton Wanderers,1-3,1,3,1,1,4,-2,A
1951-10-27,1951,Derby County,Burnley,1-0,1,0,1,1,1,1,H
1951-10-27,1951,Huddersfield Town,Stoke City,0-2,0,2,1,1,2,-2,A
1951-10-27,1951,Liverpool,West Bromwich Albion,2-5,2,5,1,1,7,-3,A
1951-10-27,1951,Manchester City,Charlton Athletic,4-2,4,2,1,1,6,2,H
1951-10-27,1951,Portsmouth,Newcastle United,3-1,3,1,1,1,4,2,H
1951-10-27,1951,Sunderland,Tottenham Hotspur,0-1,0,1,1,1,1,-1,A
1951-10-27,1951,Wolverhampton Wanderers,Manchester United,0-2,0,2,1,1,2,-2,A
1951-11-03,1951,Bolton Wanderers,Portsmouth,0-3,0,3,1,1,3,-3,A
1951-11-03,1951,Burnley,Aston Villa,2-1,2,1,1,1,3,1,H
1951-11-03,1951,Charlton Athletic,Derby County,3-3,3,3,1,1,6,0,D
1951-11-03,1951,Fulham,Manchester City,1-2,1,2,1,1,3,-1,A
1951-11-03,1951,Manchester United,Huddersfield Town,1-1,1,1,1,1,2,0,D
1951-11-03,1951,Middlesbrough,Arsenal,0-3,0,3,1,1,3,-3,A
1951-11-03,1951,Newcastle United,Liverpool,1-1,1,1,1,1,2,0,D
1951-11-03,1951,Preston North End,Sunderland,4-2,4,2,1,1,6,2,H
1951-11-03,1951,Stoke City,Chelsea,1-2,1,2,1,1,3,-1,A
1951-11-03,1951,Tottenham Hotspur,Wolverhampton Wanderers,4-2,4,2,1,1,6,2,H
1951-11-03,1951,West Bromwich Albion,Blackpool,1-1,1,1,1,1,2,0,D
1951-11-10,1951,Arsenal,West Bromwich Albion,6-3,6,3,1,1,9,3,H
1951-11-10,1951,Aston Villa,Charlton Athletic,0-2,0,2,1,1,2,-2,A
1951-11-10,1951,Blackpool,Newcastle United,6-3,6,3,1,1,9,3,H
1951-11-10,1951,Chelsea,Manchester United,4-2,4,2,1,1,6,2,H
1951-11-10,1951,Derby County,Fulham,5-0,5,0,1,1,5,5,H
1951-11-10,1951,Huddersfield Town,Tottenham Hotspur,1-1,1,1,1,1,2,0,D
1951-11-10,1951,Liverpool,Bolton Wanderers,1-1,1,1,1,1,2,0,D
1951-11-10,1951,Manchester City,Middlesbrough,2-1,2,1,1,1,3,1,H
1951-11-10,1951,Portsmouth,Stoke City,4-1,4,1,1,1,5,3,H
1951-11-10,1951,Sunderland,Burnley,0-0,0,0,1,1,0,0,D
1951-11-10,1951,Wolverhampton Wanderers,Preston North End,1-4,1,4,1,1,5,-3,A
1951-11-17,1951,Bolton Wanderers,Blackpool,1-0,1,0,1,1,1,1,H
1951-11-17,1951,Burnley,Wolverhampton Wanderers,2-2,2,2,1,1,4,0,D
1951-11-17,1951,Charlton Athletic,Sunderland,2-1,2,1,1,1,3,1,H
1951-11-17,1951,Fulham,Aston Villa,2-2,2,2,1,1,4,0,D
1951-11-17,1951,Manchester United,Portsmouth,1-3,1,3,1,1,4,-2,A
1951-11-17,1951,Middlesbrough,Derby County,0-0,0,0,1,1,0,0,D
1951-11-17,1951,Newcastle United,Arsenal,2-0,2,0,1,1,2,2,H
1951-11-17,1951,Preston North End,Huddersfield Town,5-2,5,2,1,1,7,3,H
1951-11-17,1951,Stoke City,Liverpool,1-2,1,2,1,1,3,-1,A
1951-11-17,1951,Tottenham Hotspur,Chelsea,3-2,3,2,1,1,5,1,H
1951-11-17,1951,West Bromwich Albion,Manchester City,3-2,3,2,1,1,5,1,H
1951-11-24,1951,Arsenal,Bolton Wanderers,4-2,4,2,1,1,6,2,H
1951-11-24,1951,Aston Villa,Middlesbrough,2-0,2,0,1,1,2,2,H
1951-11-24,1951,Blackpool,Stoke City,4-2,4,2,1,1,6,2,H
1951-11-24,1951,Chelsea,Preston North End,0-0,0,0,1,1,0,0,D
1951-11-24,1951,Derby County,West Bromwich Albion,2-1,2,1,1,1,3,1,H
1951-11-24,1951,Huddersfield Town,Burnley,1-3,1,3,1,1,4,-2,A
1951-11-24,1951,Liverpool,Manchester United,0-0,0,0,1,1,0,0,D
1951-11-24,1951,Manchester City,Newcastle United,2-3,2,3,1,1,5,-1,A
1951-11-24,1951,Portsmouth,Tottenham Hotspur,2-0,2,0,1,1,2,2,H
1951-11-24,1951,Sunderland,Fulham,2-2,2,2,1,1,4,0,D
1951-11-24,1951,Wolverhampton Wanderers,Charlton Athletic,2-2,2,2,1,1,4,0,D
1951-12-01,1951,Bolton Wanderers,Manchester City,2-1,2,1,1,1,3,1,H
1951-12-01,1951,Burnley,Chelsea,1-1,1,1,1,1,2,0,D
1951-12-01,1951,Charlton Athletic,Huddersfield Town,4-0,4,0,1,1,4,4,H
1951-12-01,1951,Fulham,Wolverhampton Wanderers,2-2,2,2,1,1,4,0,D
1951-12-01,1951,Manchester United,Blackpool,3-1,3,1,1,1,4,2,H
1951-12-01,1951,Middlesbrough,Sunderland,0-2,0,2,1,1,2,-2,A
1951-12-01,1951,Newcastle United,Derby County,2-1,2,1,1,1,3,1,H
1951-12-01,1951,Preston North End,Portsmouth,2-2,2,2,1,1,4,0,D
1951-12-01,1951,Stoke City,Arsenal,2-1,2,1,1,1,3,1,H
1951-12-01,1951,Tottenham Hotspur,Liverpool,2-3,2,3,1,1,5,-1,A
1951-12-01,1951,West Bromwich Albion,Aston Villa,1-2,1,2,1,1,3,-1,A
1951-12-08,1951,Arsenal,Manchester United,1-3,1,3,1,1,4,-2,A
1951-12-08,1951,Aston Villa,Newcastle United,2-2,2,2,1,1,4,0,D
1951-12-08,1951,Blackpool,Tottenham Hotspur,1-0,1,0,1,1,1,1,H
1951-12-08,1951,Chelsea,Charlton Athletic,1-0,1,0,1,1,1,1,H
1951-12-08,1951,Derby County,Bolton Wanderers,5-2,5,2,1,1,7,3,H
1951-12-08,1951,Huddersfield Town,Fulham,1-0,1,0,1,1,1,1,H
1951-12-08,1951,Liverpool,Preston North End,2-2,2,2,1,1,4,0,D
1951-12-08,1951,Manchester City,Stoke City,0-1,0,1,1,1,1,-1,A
1951-12-08,1951,Portsmouth,Burnley,2-2,2,2,1,1,4,0,D
1951-12-08,1951,Sunderland,West Bromwich Albion,3-3,3,3,1,1,6,0,D
1951-12-08,1951,Wolverhampton Wanderers,Middlesbrough,4-0,4,0,1,1,4,4,H
1951-12-15,1951,Aston Villa,Bolton Wanderers,1-1,1,1,1,1,2,0,D
1951-12-15,1951,Burnley,Charlton Athletic,1-0,1,0,1,1,1,1,H
1951-12-15,1951,Chelsea,Blackpool,2-1,2,1,1,1,3,1,H
1951-12-15,1951,Huddersfield Town,Arsenal,2-3,2,3,1,1,5,-1,A
1951-12-15,1951,Manchester United,West Bromwich Albion,5-1,5,1,1,1,6,4,H
1951-12-15,1951,Portsmouth,Liverpool,1-3,1,3,1,1,4,-2,A
1951-12-15,1951,Preston North End,Fulham,0-1,0,1,1,1,1,-1,A
1951-12-15,1951,Stoke City,Newcastle United,4-5,4,5,1,1,9,-1,A
1951-12-15,1951,Sunderland,Derby County,3-0,3,0,1,1,3,3,H
1951-12-15,1951,Tottenham Hotspur,Middlesbrough,3-1,3,1,1,1,4,2,H
1951-12-15,1951,Wolverhampton Wanderers,Manchester City,2-2,2,2,1,1,4,0,D
1951-12-22,1951,Arsenal,Wolverhampton Wanderers,2-2,2,2,1,1,4,0,D
1951-12-22,1951,Blackpool,Huddersfield Town,3-1,3,1,1,1,4,2,H
1951-12-22,1951,Bolton Wanderers,Stoke City,1-1,1,1,1,1,2,0,D
1951-12-22,1951,Charlton Athletic,Portsmouth,0-2,0,2,1,1,2,-2,A
1951-12-22,1951,Derby County,Aston Villa,1-1,1,1,1,1,2,0,D
1951-12-22,1951,Fulham,Burnley,1-2,1,2,1,1,3,-1,A
1951-12-22,1951,Liverpool,Chelsea,1-1,1,1,1,1,2,0,D
1951-12-22,1951,Manchester City,Sunderland,3-1,3,1,1,1,4,2,H
1951-12-22,1951,Middlesbrough,Preston North End,2-5,2,5,1,1,7,-3,A
1951-12-22,1951,Newcastle United,Manchester United,2-2,2,2,1,1,4,0,D
1951-12-22,1951,West Bromwich Albion,Tottenham Hotspur,3-1,3,1,1,1,4,2,H
1951-12-25,1951,Arsenal,Portsmouth,4-1,4,1,1,1,5,3,H
1951-12-25,1951,Aston Villa,Wolverhampton Wanderers,3-3,3,3,1,1,6,0,D
1951-12-25,1951,Bolton Wanderers,West Bromwich Albion,3-2,3,2,1,1,5,1,H
1951-12-25,1951,Burnley,Preston North End,0-2,0,2,1,1,2,-2,A
1951-12-25,1951,Charlton Athletic,Tottenham Hotspur,0-3,0,3,1,1,3,-3,A
1951-12-25,1951,Chelsea,Manchester City,0-3,0,3,1,1,3,-3,A
1951-12-25,1951,Huddersfield Town,Derby County,1-1,1,1,1,1,2,0,D
1951-12-25,1951,Liverpool,Blackpool,1-1,1,1,1,1,2,0,D
1951-12-25,1951,Manchester United,Fulham,3-2,3,2,1,1,5,1,H
1951-12-25,1951,Sunderland,Newcastle United,1-4,1,4,1,1,5,-3,A
1951-12-26,1951,Blackpool,Liverpool,2-0,2,0,1,1,2,2,H
1951-12-26,1951,Derby County,Huddersfield Town,2-1,2,1,1,1,3,1,H
1951-12-26,1951,Fulham,Manchester United,3-3,3,3,1,1,6,0,D
1951-12-26,1951,Manchester City,Chelsea,3-1,3,1,1,1,4,2,H
1951-12-26,1951,Middlesbrough,Stoke City,3-0,3,0,1,1,3,3,H
1951-12-26,1951,Newcastle United,Sunderland,2-2,2,2,1,1,4,0,D
1951-12-26,1951,Portsmouth,Arsenal,1-1,1,1,1,1,2,0,D
1951-12-26,1951,Tottenham Hotspur,Charlton Athletic,2-3,2,3,1,1,5,-1,A
1951-12-26,1951,West Bromwich Albion,Bolton Wanderers,3-2,3,2,1,1,5,1,H
1951-12-26,1951,Wolverhampton Wanderers,Aston Villa,1-2,1,2,1,1,3,-1,A
1951-12-29,1951,Aston Villa,Manchester City,1-2,1,2,1,1,3,-1,A
1951-12-29,1951,Burnley,Middlesbrough,7-1,7,1,1,1,8,6,H
1951-12-29,1951,Charlton Athletic,Fulham,3-0,3,0,1,1,3,3,H
1951-12-29,1951,Chelsea,Portsmouth,1-1,1,1,1,1,2,0,D
1951-12-29,1951,Huddersfield Town,Liverpool,1-2,1,2,1,1,3,-1,A
1951-12-29,1951,Manchester United,Bolton Wanderers,1-0,1,0,1,1,1,1,H
1951-12-29,1951,Preston North End,West Bromwich Albion,1-0,1,0,1,1,1,1,H
1951-12-29,1951,Stoke City,Derby County,3-1,3,1,1,1,4,2,H
1951-12-29,1951,Sunderland,Arsenal,4-1,4,1,1,1,5,3,H
1951-12-29,1951,Tottenham Hotspur,Newcastle United,2-1,2,1,1,1,3,1,H
1951-12-29,1951,Wolverhampton Wanderers,Blackpool,3-0,3,0,1,1,3,3,H
1952-01-01,1951,Manchester City,Portsmouth,0-1,0,1,1,1,1,-1,A
1952-01-01,1951,Preston North End,Burnley,1-2,1,2,1,1,3,-1,A
1952-01-01,1951,Sunderland,Wolverhampton Wanderers,1-1,1,1,1,1,2,0,D
1952-01-05,1951,Arsenal,Aston Villa,2-1,2,1,1,1,3,1,H
1952-01-05,1951,Blackpool,Sunderland,3-0,3,0,1,1,3,3,H
1952-01-05,1951,Bolton Wanderers,Tottenham Hotspur,1-1,1,1,1,1,2,0,D
1952-01-05,1951,Fulham,Chelsea,1-2,1,2,1,1,3,-1,A
1952-01-05,1951,Liverpool,Wolverhampton Wanderers,1-1,1,1,1,1,2,0,D
1952-01-05,1951,Manchester City,Derby County,4-2,4,2,1,1,6,2,H
1952-01-05,1951,Middlesbrough,Charlton Athletic,2-1,2,1,1,1,3,1,H
1952-01-05,1951,Newcastle United,Preston North End,3-0,3,0,1,1,3,3,H
1952-01-05,1951,Portsmouth,Huddersfield Town,3-1,3,1,1,1,4,2,H
1952-01-05,1951,Stoke City,Manchester United,0-0,0,0,1,1,0,0,D
1952-01-05,1951,West Bromwich Albion,Burnley,1-1,1,1,1,1,2,0,D
1952-01-19,1951,Aston Villa,Blackpool,4-0,4,0,1,1,4,4,H
1952-01-19,1951,Burnley,Newcastle United,2-1,2,1,1,1,3,1,H
1952-01-19,1951,Charlton Athletic,West Bromwich Albion,3-3,3,3,1,1,6,0,D
1952-01-19,1951,Derby County,Arsenal,1-2,1,2,1,1,3,-1,A
1952-01-19,1951,Fulham,Middlesbrough,6-0,6,0,1,1,6,6,H
1952-01-19,1951,Huddersfield Town,Chelsea,1-0,1,0,1,1,1,1,H
1952-01-19,1951,Manchester United,Manchester City,1-1,1,1,1,1,2,0,D
1952-01-19,1951,Preston North End,Bolton Wanderers,2-2,2,2,1,1,4,0,D
1952-01-19,1951,Sunderland,Liverpool,3-0,3,0,1,1,3,3,H
1952-01-19,1951,Tottenham Hotspur,Stoke City,2-0,2,0,1,1,2,2,H
1952-01-19,1951,Wolverhampton Wanderers,Portsmouth,1-1,1,1,1,1,2,0,D
1952-01-26,1951,Arsenal,Manchester City,2-2,2,2,1,1,4,0,D
1952-01-26,1951,Blackpool,Derby County,2-1,2,1,1,1,3,1,H
1952-01-26,1951,Bolton Wanderers,Burnley,1-4,1,4,1,1,5,-3,A
1952-01-26,1951,Chelsea,Wolverhampton Wanderers,0-1,0,1,1,1,1,-1,A
1952-01-26,1951,Liverpool,Aston Villa,1-2,1,2,1,1,3,-1,A
1952-01-26,1951,Manchester United,Tottenham Hotspur,2-0,2,0,1,1,2,2,H
1952-01-26,1951,Middlesbrough,Huddersfield Town,2-1,2,1,1,1,3,1,H
1952-01-26,1951,Newcastle United,Charlton Athletic,6-0,6,0,1,1,6,6,H
1952-01-26,1951,Portsmouth,Sunderland,0-2,0,2,1,1,2,-2,A
1952-01-26,1951,Stoke City,Preston North End,0-0,0,0,1,1,0,0,D
1952-01-26,1951,West Bromwich Albion,Fulham,0-2,0,2,1,1,2,-2,A
1952-02-02,1951,Bolton Wanderers,Derby County,1-2,1,2,1,1,3,-1,A
1952-02-09,1951,Aston Villa,Portsmouth,2-0,2,0,1,1,2,2,H
1952-02-09,1951,Burnley,Stoke City,4-0,4,0,1,1,4,4,H
1952-02-09,1951,Charlton Athletic,Bolton Wanderers,1-0,1,0,1,1,1,1,H
1952-02-09,1951,Derby County,Liverpool,1-1,1,1,1,1,2,0,D
1952-02-09,1951,Fulham,Newcastle United,1-1,1,1,1,1,2,0,D
1952-02-09,1951,Manchester City,Blackpool,0-0,0,0,1,1,0,0,D
1952-02-09,1951,Middlesbrough,West Bromwich Albion,0-1,0,1,1,1,1,-1,A
1952-02-09,1951,Preston North End,Manchester United,1-2,1,2,1,1,3,-1,A
1952-02-09,1951,Sunderland,Chelsea,4-1,4,1,1,1,5,3,H
1952-02-09,1951,Tottenham Hotspur,Arsenal,1-2,1,2,1,1,3,-1,A
1952-02-09,1951,Wolverhampton Wanderers,Huddersfield Town,0-0,0,0,1,1,0,0,D
1952-02-16,1951,Arsenal,Preston North End,3-3,3,3,1,1,6,0,D
1952-02-16,1951,Aston Villa,Stoke City,2-3,2,3,1,1,5,-1,A
1952-02-16,1951,Blackpool,Burnley,1-0,1,0,1,1,1,1,H
1952-02-16,1951,Chelsea,Middlesbrough,5-0,5,0,1,1,5,5,H
1952-02-16,1951,Derby County,Manchester United,0-3,0,3,1,1,3,-3,A
1952-02-16,1951,Huddersfield Town,West Bromwich Albion,3-0,3,0,1,1,3,3,H
1952-02-16,1951,Liverpool,Charlton Athletic,1-1,1,1,1,1,2,0,D
1952-02-16,1951,Manchester City,Tottenham Hotspur,1-1,1,1,1,1,2,0,D
1952-02-16,1951,Portsmouth,Fulham,4-0,4,0,1,1,4,4,H
1952-02-16,1951,Sunderland,Bolton Wanderers,0-2,0,2,1,1,2,-2,A
1952-02-16,1951,Wolverhampton Wanderers,Newcastle United,3-0,3,0,1,1,3,3,H
1952-02-23,1951,Tottenham Hotspur,Preston North End,1-0,1,0,1,1,1,1,H
1952-02-23,1951,Wolverhampton Wanderers,Sunderland,0-3,0,3,1,1,3,-3,A
1952-03-01,1951,Bolton Wanderers,Wolverhampton Wanderers,2-2,2,2,1,1,4,0,D
1952-03-01,1951,Burnley,Arsenal,0-1,0,1,1,1,1,-1,A
1952-03-01,1951,Charlton Athletic,Blackpool,2-0,2,0,1,1,2,2,H
1952-03-01,1951,Fulham,Liverpool,1-1,1,1,1,1,2,0,D
1952-03-01,1951,Manchester United,Aston Villa,1-1,1,1,1,1,2,0,D
1952-03-01,1951,Middlesbrough,Portsmouth,2-1,2,1,1,1,3,1,H
1952-03-01,1951,Newcastle United,Huddersfield Town,6-2,6,2,1,1,8,4,H
1952-03-01,1951,Preston North End,Manchester City,1-1,1,1,1,1,2,0,D
1952-03-01,1951,Stoke City,Sunderland,1-1,1,1,1,1,2,0,D
1952-03-01,1951,Tottenham Hotspur,Derby County,5-0,5,0,1,1,5,5,H
1952-03-01,1951,West Bromwich Albion,Chelsea,0-1,0,1,1,1,1,-1,A
1952-03-08,1951,Aston Villa,Tottenham Hotspur,0-3,0,3,1,1,3,-3,A
1952-03-08,1951,Blackpool,Fulham,4-2,4,2,1,1,6,2,H
1952-03-08,1951,Derby County,Preston North End,4-3,4,3,1,1,7,1,H
1952-03-08,1951,Huddersfield Town,Bolton Wanderers,0-2,0,2,1,1,2,-2,A
1952-03-08,1951,Liverpool,Middlesbrough,1-1,1,1,1,1,2,0,D
1952-03-08,1951,Sunderland,Manchester United,1-2,1,2,1,1,3,-1,A
1952-03-08,1951,Wolverhampton Wanderers,Stoke City,3-0,3,0,1,1,3,3,H
1952-03-12,1951,Chelsea,Newcastle United,1-0,1,0,1,1,1,1,H
1952-03-12,1951,Manchester City,Burnley,0-1,0,1,1,1,1,-1,A
1952-03-12,1951,Portsmouth,West Bromwich Albion,1-1,1,1,1,1,2,0,D
1952-03-13,1951,Arsenal,Charlton Athletic,2-1,2,1,1,1,3,1,H
1952-03-15,1951,Bolton Wanderers,Chelsea,3-0,3,0,1,1,3,3,H
1952-03-15,1951,Burnley,Derby County,0-1,0,1,1,1,1,-1,A
1952-03-15,1951,Charlton Athletic,Manchester City,0-0,0,0,1,1,0,0,D
1952-03-15,1951,Fulham,Arsenal,0-0,0,0,1,1,0,0,D
1952-03-15,1951,Manchester United,Wolverhampton Wanderers,2-0,2,0,1,1,2,2,H
1952-03-15,1951,Middlesbrough,Blackpool,1-0,1,0,1,1,1,1,H
1952-03-15,1951,Newcastle United,Portsmouth,3-3,3,3,1,1,6,0,D
1952-03-15,1951,Preston North End,Aston Villa,2-2,2,2,1,1,4,0,D
1952-03-15,1951,Stoke City,Huddersfield Town,0-0,0,0,1,1,0,0,D
1952-03-15,1951,Tottenham Hotspur,Sunderland,2-0,2,0,1,1,2,2,H
1952-03-15,1951,West Bromwich Albion,Liverpool,3-3,3,3,1,1,6,0,D
1952-03-22,1951,Arsenal,Middlesbrough,3-1,3,1,1,1,4,2,H
1952-03-22,1951,Aston Villa,Burnley,4-1,4,1,1,1,5,3,H
1952-03-22,1951,Blackpool,West Bromwich Albion,2-0,2,0,1,1,2,2,H
1952-03-22,1951,Chelsea,Stoke City,1-0,1,0,1,1,1,1,H
1952-03-22,1951,Derby County,Charlton Athletic,1-3,1,3,1,1,4,-2,A
1952-03-22,1951,Huddersfield Town,Manchester United,3-2,3,2,1,1,5,1,H
1952-03-22,1951,Liverpool,Newcastle United,3-0,3,0,1,1,3,3,H
1952-03-22,1951,Manchester City,Fulham,1-1,1,1,1,1,2,0,D
1952-03-22,1951,Portsmouth,Bolton Wanderers,3-0,3,0,1,1,3,3,H
1952-03-22,1951,Sunderland,Preston North End,0-0,0,0,1,1,0,0,D
1952-03-22,1951,Wolverhampton Wanderers,Tottenham Hotspur,1-1,1,1,1,1,2,0,D
1952-03-29,1951,Bolton Wanderers,Liverpool,1-1,1,1,1,1,2,0,D
1952-03-29,1951,Burnley,Sunderland,0-1,0,1,1,1,1,-1,A
1952-03-29,1951,Middlesbrough,Manchester City,2-2,2,2,1,1,4,0,D
1952-03-29,1951,Preston North End,Wolverhampton Wanderers,3-0,3,0,1,1,3,3,H
1952-03-29,1951,Stoke City,Portsmouth,2-0,2,0,1,1,2,2,H
1952-04-02,1951,Tottenham Hotspur,Huddersfield Town,1-0,1,0,1,1,1,1,H
1952-04-05,1951,Aston Villa,Fulham,4-1,4,1,1,1,5,3,H
1952-04-05,1951,Blackpool,Bolton Wanderers,1-0,1,0,1,1,1,1,H
1952-04-05,1951,Derby County,Middlesbrough,3-1,3,1,1,1,4,2,H
1952-04-05,1951,Huddersfield Town,Preston North End,2-0,2,0,1,1,2,2,H
1952-04-05,1951,Liverpool,Stoke City,2-1,2,1,1,1,3,1,H
1952-04-05,1951,Manchester City,West Bromwich Albion,1-2,1,2,1,1,3,-1,A
1952-04-05,1951,Portsmouth,Manchester United,1-0,1,0,1,1,1,1,H
1952-04-05,1951,Sunderland,Charlton Athletic,1-1,1,1,1,1,2,0,D
1952-04-05,1951,Wolverhampton Wanderers,Burnley,1-2,1,2,1,1,3,-1,A
1952-04-07,1951,Newcastle United,Blackpool,1-3,1,3,1,1,4,-2,A
1952-04-11,1951,Blackpool,Arsenal,0-0,0,0,1,1,0,0,D
1952-04-11,1951,Burnley,Manchester United,1-1,1,1,1,1,2,0,D
1952-04-11,1951,Fulham,Bolton Wanderers,1-2,1,2,1,1,3,-1,A
1952-04-11,1951,Manchester City,Liverpool,1-2,1,2,1,1,3,-1,A
1952-04-11,1951,Newcastle United,Middlesbrough,0-2,0,2,1,1,2,-2,A
1952-04-11,1951,Portsmouth,Derby County,3-1,3,1,1,1,4,2,H
1952-04-11,1951,Sunderland,Huddersfield Town,7-1,7,1,1,1,8,6,H
1952-04-12,1951,Bolton Wanderers,Arsenal,2-1,2,1,1,1,3,1,H
1952-04-12,1951,Burnley,Huddersfield Town,0-2,0,2,1,1,2,-2,A
1952-04-12,1951,Charlton Athletic,Wolverhampton Wanderers,1-0,1,0,1,1,1,1,H
1952-04-12,1951,Fulham,Sunderland,0-1,0,1,1,1,1,-1,A
1952-04-12,1951,Manchester United,Liverpool,4-0,4,0,1,1,4,4,H
1952-04-12,1951,Middlesbrough,Aston Villa,2-0,2,0,1,1,2,2,H
1952-04-12,1951,Newcastle United,Manchester City,1-0,1,0,1,1,1,1,H
1952-04-12,1951,Preston North End,Chelsea,1-0,1,0,1,1,1,1,H
1952-04-12,1951,Stoke City,Blackpool,2-3,2,3,1,1,5,-1,A
1952-04-12,1951,Tottenham Hotspur,Portsmouth,3-1,3,1,1,1,4,2,H
1952-04-12,1951,West Bromwich Albion,Derby County,1-0,1,0,1,1,1,1,H
1952-04-14,1951,Arsenal,Blackpool,4-1,4,1,1,1,5,3,H
1952-04-14,1951,Bolton Wanderers,Fulham,2-1,2,1,1,1,3,1,H
1952-04-14,1951,Charlton Athletic,Stoke City,4-0,4,0,1,1,4,4,H
1952-04-14,1951,Chelsea,Aston Villa,2-2,2,2,1,1,4,0,D
1952-04-14,1951,Derby County,Portsmouth,1-0,1,0,1,1,1,1,H
1952-04-14,1951,Liverpool,Manchester City,1-2,1,2,1,1,3,-1,A
1952-04-14,1951,Manchester United,Burnley,6-1,6,1,1,1,7,5,H
1952-04-14,1951,Middlesbrough,Newcastle United,2-1,2,1,1,1,3,1,H
1952-04-14,1951,Preston North End,Tottenham Hotspur,1-1,1,1,1,1,2,0,D
1952-04-14,1951,West Bromwich Albion,Wolverhampton Wanderers,2-1,2,1,1,1,3,1,H
1952-04-15,1951,Aston Villa,Chelsea,7-1,7,1,1,1,8,6,H
1952-04-15,1951,Huddersfield Town,Sunderland,2-2,2,2,1,1,4,0,D
1952-04-15,1951,Wolverhampton Wanderers,West Bromwich Albion,1-4,1,4,1,1,5,-3,A
1952-04-16,1951,Arsenal,Newcastle United,1-1,1,1,1,1,2,0,D
1952-04-19,1951,Arsenal,Stoke City,4-1,4,1,1,1,5,3,H
1952-04-19,1951,Aston Villa,West Bromwich Albion,2-0,2,0,1,1,2,2,H
1952-04-19,1951,Blackpool,Manchester United,2-2,2,2,1,1,4,0,D
1952-04-19,1951,Chelsea,Burnley,4-1,4,1,1,1,5,3,H
1952-04-19,1951,Derby County,Newcastle United,1-3,1,3,1,1,4,-2,A
1952-04-19,1951,Huddersfield Town,Charlton Athletic,1-0,1,0,1,1,1,1,H
1952-04-19,1951,Liverpool,Tottenham Hotspur,1-1,1,1,1,1,2,0,D
1952-04-19,1951,Manchester City,Bolton Wanderers,0-3,0,3,1,1,3,-3,A
1952-04-19,1951,Portsmouth,Preston North End,1-2,1,2,1,1,3,-1,A
1952-04-19,1951,Sunderland,Middlesbrough,3-1,3,1,1,1,4,2,H
1952-04-19,1951,Wolverhampton Wanderers,Fulham,2-2,2,2,1,1,4,0,D
1952-04-21,1951,Manchester United,Chelsea,3-0,3,0,1,1,3,3,H
1952-04-21,1951,West Bromwich Albion,Arsenal,3-1,3,1,1,1,4,2,H
1952-04-23,1951,Middlesbrough,Bolton Wanderers,2-0,2,0,1,1,2,2,H
1952-04-23,1951,Newcastle United,West Bromwich Albion,1-4,1,4,1,1,5,-3,A
1952-04-24,1951,Charlton Athletic,Aston Villa,0-1,0,1,1,1,1,-1,A
1952-04-26,1951,Burnley,Portsmouth,1-0,1,0,1,1,1,1,H
1952-04-26,1951,Charlton Athletic,Chelsea,1-1,1,1,1,1,2,0,D
1952-04-26,1951,Fulham,Huddersfield Town,1-0,1,0,1,1,1,1,H
1952-04-26,1951,Manchester United,Arsenal,6-1,6,1,1,1,7,5,H
1952-04-26,1951,Middlesbrough,Wolverhampton Wanderers,4-0,4,0,1,1,4,4,H
1952-04-26,1951,Newcastle United,Aston Villa,6-1,6,1,1,1,7,5,H
1952-04-26,1951,Preston North End,Liverpool,4-0,4,0,1,1,4,4,H
1952-04-26,1951,Stoke City,Manchester City,3-1,3,1,1,1,4,2,H
1952-04-26,1951,Tottenham Hotspur,Blackpool,2-0,2,0,1,1,2,2,H
1952-04-26,1951,West Bromwich Albion,Sunderland,1-1,1,1,1,1,2,0,D
1952-04-30,1951,Chelsea,Tottenham Hotspur,0-2,0,2,1,1,2,-2,A
1952-05-01,1951,Fulham,Derby County,3-0,3,0,1,1,3,3,H
1952-05-03,1951,Derby County,Chelsea,1-1,1,1,1,1,2,0,D
1952-05-03,1951,Stoke City,Middlesbrough,3-2,3,2,1,1,5,1,H
1952-08-23,1952,Aston Villa,Arsenal,1-2,1,2,1,1,3,-1,A
1952-08-23,1952,Bolton Wanderers,Derby County,2-0,2,0,1,1,2,2,H
1952-08-23,1952,Burnley,Middlesbrough,0-1,0,1,1,1,1,-1,A
1952-08-23,1952,Manchester United,Chelsea,2-0,2,0,1,1,2,2,H
1952-08-23,1952,Portsmouth,Blackpool,0-2,0,2,1,1,2,-2,A
1952-08-23,1952,Preston North End,Liverpool,1-1,1,1,1,1,2,0,D
1952-08-23,1952,Sheffield Wednesday,Newcastle United,2-2,2,2,1,1,4,0,D
1952-08-23,1952,Stoke City,Manchester City,2-1,2,1,1,1,3,1,H
1952-08-23,1952,Sunderland,Charlton Athletic,2-1,2,1,1,1,3,1,H
1952-08-23,1952,Tottenham Hotspur,West Bromwich Albion,3-4,3,4,1,1,7,-1,A
1952-08-23,1952,Wolverhampton Wanderers,Cardiff City,1-0,1,0,1,1,1,1,H
1952-08-25,1952,Blackpool,Preston North End,1-1,1,1,1,1,2,0,D
1952-08-25,1952,Wolverhampton Wanderers,Bolton Wanderers,3-1,3,1,1,1,4,2,H
1952-08-26,1952,Burnley,Stoke City,3-2,3,2,1,1,5,1,H
1952-08-27,1952,Arsenal,Manchester United,2-1,2,1,1,1,3,1,H
1952-08-27,1952,Charlton Athletic,Portsmouth,2-2,2,2,1,1,4,0,D
1952-08-27,1952,Chelsea,Derby County,1-1,1,1,1,1,2,0,D
1952-08-27,1952,Liverpool,Sheffield Wednesday,1-0,1,0,1,1,1,1,H
1952-08-27,1952,Manchester City,Tottenham Hotspur,0-1,0,1,1,1,1,-1,A
1952-08-27,1952,Middlesbrough,Cardiff City,3-0,3,0,1,1,3,3,H
1952-08-27,1952,West Bromwich Albion,Newcastle United,1-0,1,0,1,1,1,1,H
1952-08-30,1952,Arsenal,Sunderland,1-2,1,2,1,1,3,-1,A
1952-08-30,1952,Blackpool,Bolton Wanderers,3-0,3,0,1,1,3,3,H
1952-08-30,1952,Cardiff City,Sheffield Wednesday,4-0,4,0,1,1,4,4,H
1952-08-30,1952,Charlton Athletic,Wolverhampton Wanderers,2-2,2,2,1,1,4,0,D
1952-08-30,1952,Chelsea,Portsmouth,2-0,2,0,1,1,2,2,H
1952-08-30,1952,Derby County,Aston Villa,0-1,0,1,1,1,1,-1,A
1952-08-30,1952,Liverpool,Stoke City,3-2,3,2,1,1,5,1,H
1952-08-30,1952,Manchester City,Manchester United,2-1,2,1,1,1,3,1,H
1952-08-30,1952,Middlesbrough,Preston North End,1-1,1,1,1,1,2,0,D
1952-08-30,1952,Newcastle United,Tottenham Hotspur,1-1,1,1,1,1,2,0,D
1952-08-30,1952,West Bromwich Albion,Burnley,1-2,1,2,1,1,3,-1,A
1952-09-01,1952,Aston Villa,Sunderland,3-0,3,0,1,1,3,3,H
1952-09-01,1952,Bolton Wanderers,Wolverhampton Wanderers,2-1,2,1,1,1,3,1,H
1952-09-01,1952,Stoke City,Burnley,1-3,1,3,1,1,4,-2,A
1952-09-01,1952,Tottenham Hotspur,Manchester City,3-3,3,3,1,1,6,0,D
1952-09-03,1952,Cardiff City,Middlesbrough,1-1,1,1,1,1,2,0,D
1952-09-03,1952,Derby County,Chelsea,3-2,3,2,1,1,5,1,H
1952-09-03,1952,Manchester United,Arsenal,0-0,0,0,1,1,0,0,D
1952-09-03,1952,Portsmouth,Charlton Athletic,1-1,1,1,1,1,2,0,D
1952-09-03,1952,Sheffield Wednesday,Liverpool,0-2,0,2,1,1,2,-2,A
1952-09-06,1952,Aston Villa,Blackpool,1-5,1,5,1,1,6,-4,A
1952-09-06,1952,Bolton Wanderers,Chelsea,1-1,1,1,1,1,2,0,D
1952-09-06,1952,Burnley,Newcastle United,2-1,2,1,1,1,3,1,H
1952-09-06,1952,Manchester City,Liverpool,0-2,0,2,1,1,2,-2,A
1952-09-06,1952,Portsmouth,Manchester United,2-0,2,0,1,1,2,2,H
1952-09-06,1952,Preston North End,West Bromwich Albion,1-0,1,0,1,1,1,1,H
1952-09-06,1952,Sheffield Wednesday,Charlton Athletic,0-3,0,3,1,1,3,-3,A
1952-09-06,1952,Stoke City,Middlesbrough,1-0,1,0,1,1,1,1,H
1952-09-06,1952,Sunderland,Derby County,2-1,2,1,1,1,3,1,H
1952-09-06,1952,Tottenham Hotspur,Cardiff City,2-1,2,1,1,1,3,1,H
1952-09-06,1952,Wolverhampton Wanderers,Arsenal,1-1,1,1,1,1,2,0,D
1952-09-08,1952,Burnley,Manchester City,2-1,2,1,1,1,3,1,H
1952-09-08,1952,Wolverhampton Wanderers,Aston Villa,2-1,2,1,1,1,3,1,H
1952-09-10,1952,Arsenal,Portsmouth,3-1,3,1,1,1,4,2,H
1952-09-10,1952,Charlton Athletic,Bolton Wanderers,2-0,2,0,1,1,2,2,H
1952-09-10,1952,Chelsea,Blackpool,4-0,4,0,1,1,4,4,H
1952-09-10,1952,Derby County,Manchester United,2-3,2,3,1,1,5,-1,A
1952-09-10,1952,Liverpool,Tottenham Hotspur,2-1,2,1,1,1,3,1,H
1952-09-10,1952,Newcastle United,Sunderland,2-2,2,2,1,1,4,0,D
1952-09-10,1952,Preston North End,Stoke City,3-0,3,0,1,1,3,3,H
1952-09-10,1952,West Bromwich Albion,Cardiff City,1-0,1,0,1,1,1,1,H
1952-09-13,1952,Arsenal,Charlton Athletic,3-4,3,4,1,1,7,-1,A
1952-09-13,1952,Blackpool,Sunderland,2-0,2,0,1,1,2,2,H
1952-09-13,1952,Cardiff City,Burnley,0-0,0,0,1,1,0,0,D
1952-09-13,1952,Chelsea,Aston Villa,4-0,4,0,1,1,4,4,H
1952-09-13,1952,Derby County,Wolverhampton Wanderers,2-3,2,3,1,1,5,-1,A
1952-09-13,1952,Liverpool,Portsmouth,1-1,1,1,1,1,2,0,D
1952-09-13,1952,Manchester United,Bolton Wanderers,1-0,1,0,1,1,1,1,H
1952-09-13,1952,Middlesbrough,Manchester City,5-4,5,4,1,1,9,1,H
1952-09-13,1952,Newcastle United,Preston North End,4-3,4,3,1,1,7,1,H
1952-09-13,1952,Sheffield Wednesday,Tottenham Hotspur,2-0,2,0,1,1,2,2,H
1952-09-13,1952,West Bromwich Albion,Stoke City,3-2,3,2,1,1,5,1,H
1952-09-15,1952,Aston Villa,Wolverhampton Wanderers,0-1,0,1,1,1,1,-1,A
1952-09-15,1952,Blackpool,Chelsea,3-1,3,1,1,1,4,2,H
1952-09-15,1952,Stoke City,Preston North End,0-0,0,0,1,1,0,0,D
1952-09-15,1952,Tottenham Hotspur,Liverpool,3-1,3,1,1,1,4,2,H
1952-09-17,1952,Cardiff City,West Bromwich Albion,1-2,1,2,1,1,3,-1,A
1952-09-17,1952,Manchester City,Burnley,0-0,0,0,1,1,0,0,D
1952-09-17,1952,Portsmouth,Arsenal,2-2,2,2,1,1,4,0,D
1952-09-17,1952,Sheffield Wednesday,Middlesbrough,2-0,2,0,1,1,2,2,H
1952-09-17,1952,Sunderland,Newcastle United,0-2,0,2,1,1,2,-2,A
1952-09-20,1952,Aston Villa,Manchester United,3-3,3,3,1,1,6,0,D
1952-09-20,1952,Bolton Wanderers,Portsmouth,0-5,0,5,1,1,5,-5,A
1952-09-20,1952,Burnley,Sheffield Wednesday,1-1,1,1,1,1,2,0,D
1952-09-20,1952,Charlton Athletic,Derby County,3-1,3,1,1,1,4,2,H
1952-09-20,1952,Liverpool,Middlesbrough,4-1,4,1,1,1,5,3,H
1952-09-20,1952,Manchester City,West Bromwich Albion,0-1,0,1,1,1,1,-1,A
1952-09-20,1952,Preston North End,Cardiff City,2-3,2,3,1,1,5,-1,A
1952-09-20,1952,Stoke City,Newcastle United,1-0,1,0,1,1,1,1,H
1952-09-20,1952,Sunderland,Chelsea,2-1,2,1,1,1,3,1,H
1952-09-20,1952,Tottenham Hotspur,Arsenal,1-3,1,3,1,1,4,-2,A
1952-09-20,1952,Wolverhampton Wanderers,Blackpool,2-5,2,5,1,1,7,-3,A
1952-09-27,1952,Blackpool,Charlton Athletic,8-4,8,4,1,1,12,4,H
1952-09-27,1952,Cardiff City,Stoke City,2-0,2,0,1,1,2,2,H
1952-09-27,1952,Chelsea,Wolverhampton Wanderers,1-2,1,2,1,1,3,-1,A
1952-09-27,1952,Derby County,Arsenal,2-0,2,0,1,1,2,2,H
1952-09-27,1952,Manchester United,Sunderland,0-1,0,1,1,1,1,-1,A
1952-09-27,1952,Middlesbrough,Bolton Wanderers,1-2,1,2,1,1,3,-1,A
1952-09-27,1952,Newcastle United,Manchester City,2-0,2,0,1,1,2,2,H
1952-09-27,1952,Portsmouth,Aston Villa,1-1,1,1,1,1,2,0,D
1952-09-27,1952,Sheffield Wednesday,Preston North End,1-1,1,1,1,1,2,0,D
1952-09-27,1952,Tottenham Hotspur,Burnley,2-1,2,1,1,1,3,1,H
1952-09-27,1952,West Bromwich Albion,Liverpool,3-0,3,0,1,1,3,3,H
1952-10-04,1952,Arsenal,Blackpool,3-1,3,1,1,1,4,2,H
1952-10-04,1952,Aston Villa,Bolton Wanderers,1-1,1,1,1,1,2,0,D
1952-10-04,1952,Burnley,Derby County,1-2,1,2,1,1,3,-1,A
1952-10-04,1952,Charlton Athletic,Chelsea,2-2,2,2,1,1,4,0,D
1952-10-04,1952,Liverpool,Newcastle United,5-3,5,3,1,1,8,2,H
1952-10-04,1952,Manchester City,Cardiff City,2-2,2,2,1,1,4,0,D
1952-10-04,1952,Middlesbrough,West Bromwich Albion,4-2,4,2,1,1,6,2,H
1952-10-04,1952,Preston North End,Tottenham Hotspur,1-0,1,0,1,1,1,1,H
1952-10-04,1952,Stoke City,Sheffield Wednesday,1-3,1,3,1,1,4,-2,A
1952-10-04,1952,Sunderland,Portsmouth,1-1,1,1,1,1,2,0,D
1952-10-04,1952,Wolverhampton Wanderers,Manchester United,6-2,6,2,1,1,8,4,H
1952-10-11,1952,Arsenal,Sheffield Wednesday,2-2,2,2,1,1,4,0,D
1952-10-11,1952,Aston Villa,Middlesbrough,1-0,1,0,1,1,1,1,H
1952-10-11,1952,Blackpool,Burnley,4-2,4,2,1,1,6,2,H
1952-10-11,1952,Bolton Wanderers,Liverpool,2-2,2,2,1,1,4,0,D
1952-10-11,1952,Charlton Athletic,Cardiff City,3-1,3,1,1,1,4,2,H
1952-10-11,1952,Chelsea,Preston North End,5-3,5,3,1,1,8,2,H
1952-10-11,1952,Derby County,Tottenham Hotspur,0-0,0,0,1,1,0,0,D
1952-10-11,1952,Manchester United,Stoke City,0-2,0,2,1,1,2,-2,A
1952-10-11,1952,Portsmouth,Manchester City,2-1,2,1,1,1,3,1,H
1952-10-11,1952,Sunderland,West Bromwich Albion,1-0,1,0,1,1,1,1,H
1952-10-11,1952,Wolverhampton Wanderers,Newcastle United,2-0,2,0,1,1,2,2,H
1952-10-18,1952,Burnley,Chelsea,1-1,1,1,1,1,2,0,D
1952-10-18,1952,Liverpool,Aston Villa,0-2,0,2,1,1,2,-2,A
1952-10-18,1952,Manchester City,Bolton Wanderers,1-2,1,2,1,1,3,-1,A
1952-10-18,1952,Middlesbrough,Sunderland,1-2,1,2,1,1,3,-1,A
1952-10-18,1952,Newcastle United,Charlton Athletic,3-2,3,2,1,1,5,1,H
1952-10-18,1952,Preston North End,Manchester United,0-5,0,5,1,1,5,-5,A
1952-10-18,1952,Sheffield Wednesday,Derby County,2-0,2,0,1,1,2,2,H
1952-10-18,1952,Stoke City,Portsmouth,2-4,2,4,1,1,6,-2,A
1952-10-18,1952,Tottenham Hotspur,Blackpool,4-0,4,0,1,1,4,4,H
1952-10-18,1952,West Bromwich Albion,Wolverhampton Wanderers,1-1,1,1,1,1,2,0,D
1952-10-25,1952,Arsenal,Newcastle United,3-0,3,0,1,1,3,3,H
1952-10-25,1952,Aston Villa,Manchester City,0-0,0,0,1,1,0,0,D
1952-10-25,1952,Blackpool,Sheffield Wednesday,0-1,0,1,1,1,1,-1,A
1952-10-25,1952,Bolton Wanderers,Stoke City,2-1,2,1,1,1,3,1,H
1952-10-25,1952,Charlton Athletic,West Bromwich Albion,0-0,0,0,1,1,0,0,D
1952-10-25,1952,Chelsea,Tottenham Hotspur,2-1,2,1,1,1,3,1,H
1952-10-25,1952,Derby County,Cardiff City,1-1,1,1,1,1,2,0,D
1952-10-25,1952,Manchester United,Burnley,1-3,1,3,1,1,4,-2,A
1952-10-25,1952,Portsmouth,Preston North End,2-5,2,5,1,1,7,-3,A
1952-10-25,1952,Sunderland,Liverpool,3-1,3,1,1,1,4,2,H
1952-10-25,1952,Wolverhampton Wanderers,Middlesbrough,3-3,3,3,1,1,6,0,D
1952-11-01,1952,Burnley,Portsmouth,3-2,3,2,1,1,5,1,H
1952-11-01,1952,Cardiff City,Blackpool,2-2,2,2,1,1,4,0,D
1952-11-01,1952,Liverpool,Wolverhampton Wanderers,2-1,2,1,1,1,3,1,H
1952-11-01,1952,Manchester City,Sunderland,2-5,2,5,1,1,7,-3,A
1952-11-01,1952,Middlesbrough,Charlton Athletic,1-0,1,0,1,1,1,1,H
1952-11-01,1952,Newcastle United,Derby County,1-0,1,0,1,1,1,1,H
1952-11-01,1952,Preston North End,Bolton Wanderers,2-2,2,2,1,1,4,0,D
1952-11-01,1952,Sheffield Wednesday,Chelsea,1-0,1,0,1,1,1,1,H
1952-11-01,1952,Stoke City,Aston Villa,1-4,1,4,1,1,5,-3,A
1952-11-01,1952,Tottenham Hotspur,Manchester United,1-2,1,2,1,1,3,-1,A
1952-11-01,1952,West Bromwich Albion,Arsenal,2-0,2,0,1,1,2,2,H
1952-11-08,1952,Arsenal,Middlesbrough,2-1,2,1,1,1,3,1,H
1952-11-08,1952,Aston Villa,Preston North End,1-0,1,0,1,1,1,1,H
1952-11-08,1952,Blackpool,Newcastle United,0-2,0,2,1,1,2,-2,A
1952-11-08,1952,Bolton Wanderers,Burnley,1-2,1,2,1,1,3,-1,A
1952-11-08,1952,Charlton Athletic,Liverpool,3-2,3,2,1,1,5,1,H
1952-11-08,1952,Chelsea,Cardiff City,0-2,0,2,1,1,2,-2,A
1952-11-08,1952,Derby County,West Bromwich Albion,1-1,1,1,1,1,2,0,D
1952-11-08,1952,Manchester United,Sheffield Wednesday,1-1,1,1,1,1,2,0,D
1952-11-08,1952,Portsmouth,Tottenham Hotspur,2-1,2,1,1,1,3,1,H
1952-11-08,1952,Sunderland,Stoke City,1-1,1,1,1,1,2,0,D
1952-11-08,1952,Wolverhampton Wanderers,Manchester City,7-3,7,3,1,1,10,4,H
1952-11-15,1952,Burnley,Aston Villa,1-0,1,0,1,1,1,1,H
1952-11-15,1952,Cardiff City,Manchester United,1-2,1,2,1,1,3,-1,A
1952-11-15,1952,Liverpool,Arsenal,1-5,1,5,1,1,6,-4,A
1952-11-15,1952,Manchester City,Charlton Athletic,5-1,5,1,1,1,6,4,H
1952-11-15,1952,Middlesbrough,Derby County,1-0,1,0,1,1,1,1,H
1952-11-15,1952,Newcastle United,Chelsea,2-1,2,1,1,1,3,1,H
1952-11-15,1952,Preston North End,Sunderland,3-2,3,2,1,1,5,1,H
1952-11-15,1952,Sheffield Wednesday,Portsmouth,3-4,3,4,1,1,7,-1,A
1952-11-15,1952,Stoke City,Wolverhampton Wanderers,1-2,1,2,1,1,3,-1,A
1952-11-15,1952,Tottenham Hotspur,Bolton Wanderers,1-1,1,1,1,1,2,0,D
1952-11-15,1952,West Bromwich Albion,Blackpool,0-1,0,1,1,1,1,-1,A
1952-11-22,1952,Arsenal,Manchester City,3-1,3,1,1,1,4,2,H
1952-11-22,1952,Aston Villa,Tottenham Hotspur,0-3,0,3,1,1,3,-3,A
1952-11-22,1952,Blackpool,Middlesbrough,1-1,1,1,1,1,2,0,D
1952-11-22,1952,Bolton Wanderers,Sheffield Wednesday,1-1,1,1,1,1,2,0,D
1952-11-22,1952,Charlton Athletic,Stoke City,5-1,5,1,1,1,6,4,H
1952-11-22,1952,Chelsea,West Bromwich Albion,0-2,0,2,1,1,2,-2,A
1952-11-22,1952,Derby County,Liverpool,3-2,3,2,1,1,5,1,H
1952-11-22,1952,Manchester United,Newcastle United,2-2,2,2,1,1,4,0,D
1952-11-22,1952,Portsmouth,Cardiff City,0-2,0,2,1,1,2,-2,A
1952-11-22,1952,Sunderland,Burnley,2-1,2,1,1,1,3,1,H
1952-11-22,1952,Wolverhampton Wanderers,Preston North End,0-2,0,2,1,1,2,-2,A
1952-11-29,1952,Burnley,Wolverhampton Wanderers,0-0,0,0,1,1,0,0,D
1952-11-29,1952,Liverpool,Blackpool,2-2,2,2,1,1,4,0,D
1952-11-29,1952,Manchester City,Derby County,1-0,1,0,1,1,1,1,H
1952-11-29,1952,Middlesbrough,Chelsea,4-0,4,0,1,1,4,4,H
1952-11-29,1952,Newcastle United,Portsmouth,1-0,1,0,1,1,1,1,H
1952-11-29,1952,Preston North End,Charlton Athletic,2-1,2,1,1,1,3,1,H
1952-11-29,1952,Sheffield Wednesday,Aston Villa,2-2,2,2,1,1,4,0,D
1952-11-29,1952,Stoke City,Arsenal,1-1,1,1,1,1,2,0,D
1952-11-29,1952,Tottenham Hotspur,Sunderland,2-2,2,2,1,1,4,0,D
1952-11-29,1952,West Bromwich Albion,Manchester United,3-1,3,1,1,1,4,2,H
1952-12-06,1952,Blackpool,Manchester City,4-1,4,1,1,1,5,3,H
1952-12-06,1952,Bolton Wanderers,Newcastle United,4-2,4,2,1,1,6,2,H
1952-12-06,1952,Derby County,Stoke City,4-0,4,0,1,1,4,4,H
1952-12-06,1952,Manchester United,Middlesbrough,3-2,3,2,1,1,5,1,H
1952-12-06,1952,Portsmouth,West Bromwich Albion,1-2,1,2,1,1,3,-1,A
1952-12-06,1952,Sunderland,Sheffield Wednesday,2-1,2,1,1,1,3,1,H
1952-12-06,1952,Wolverhampton Wanderers,Tottenham Hotspur,0-0,0,0,1,1,0,0,D
1952-12-13,1952,Burnley,Arsenal,1-1,1,1,1,1,2,0,D
1952-12-13,1952,Cardiff City,Sunderland,4-1,4,1,1,1,5,3,H
1952-12-13,1952,Liverpool,Manchester United,1-2,1,2,1,1,3,-1,A
1952-12-13,1952,Manchester City,Chelsea,4-0,4,0,1,1,4,4,H
1952-12-13,1952,Middlesbrough,Portsmouth,3-2,3,2,1,1,5,1,H
1952-12-13,1952,Newcastle United,Aston Villa,2-1,2,1,1,1,3,1,H
1952-12-13,1952,Preston North End,Derby County,3-0,3,0,1,1,3,3,H
1952-12-13,1952,Sheffield Wednesday,Wolverhampton Wanderers,2-3,2,3,1,1,5,-1,A
1952-12-13,1952,Stoke City,Blackpool,4-0,4,0,1,1,4,4,H
1952-12-13,1952,Tottenham Hotspur,Charlton Athletic,2-0,2,0,1,1,2,2,H
1952-12-13,1952,West Bromwich Albion,Bolton Wanderers,0-1,0,1,1,1,1,-1,A
1952-12-20,1952,Arsenal,Aston Villa,3-1,3,1,1,1,4,2,H
1952-12-20,1952,Blackpool,Portsmouth,3-2,3,2,1,1,5,1,H
1952-12-20,1952,Cardiff City,Wolverhampton Wanderers,0-0,0,0,1,1,0,0,D
1952-12-20,1952,Charlton Athletic,Sunderland,3-1,3,1,1,1,4,2,H
1952-12-20,1952,Chelsea,Manchester United,2-3,2,3,1,1,5,-1,A
1952-12-20,1952,Derby County,Bolton Wanderers,4-3,4,3,1,1,7,1,H
1952-12-20,1952,Liverpool,Preston North End,2-2,2,2,1,1,4,0,D
1952-12-20,1952,Manchester City,Stoke City,2-1,2,1,1,1,3,1,H
1952-12-20,1952,Middlesbrough,Burnley,2-2,2,2,1,1,4,0,D
1952-12-20,1952,Newcastle United,Sheffield Wednesday,1-5,1,5,1,1,6,-4,A
1952-12-20,1952,West Bromwich Albion,Tottenham Hotspur,2-1,2,1,1,1,3,1,H
1952-12-25,1952,Blackpool,Manchester United,0-0,0,0,1,1,0,0,D
1952-12-25,1952,Bolton Wanderers,Arsenal,4-6,4,6,1,1,10,-2,A
1952-12-25,1952,Burnley,Liverpool,2-0,2,0,1,1,2,2,H
1952-12-25,1952,Newcastle United,Cardiff City,3-0,3,0,1,1,3,3,H
1952-12-25,1952,Tottenham Hotspur,Middlesbrough,7-1,7,1,1,1,8,6,H
1952-12-26,1952,Aston Villa,Charlton Athletic,1-1,1,1,1,1,2,0,D
1952-12-26,1952,Derby County,Portsmouth,3-0,3,0,1,1,3,3,H
1952-12-26,1952,Liverpool,Burnley,1-1,1,1,1,1,2,0,D
1952-12-26,1952,Manchester United,Blackpool,2-1,2,1,1,1,3,1,H
1952-12-26,1952,Preston North End,Manchester City,6-2,6,2,1,1,8,4,H
1952-12-26,1952,Sheffield Wednesday,West Bromwich Albion,4-5,4,5,1,1,9,-1,A
1952-12-26,1952,Stoke City,Chelsea,1-1,1,1,1,1,2,0,D
1952-12-26,1952,Wolverhampton Wanderers,Sunderland,1-1,1,1,1,1,2,0,D
1952-12-27,1952,Cardiff City,Newcastle United,0-0,0,0,1,1,0,0,D
1952-12-27,1952,Chelsea,Stoke City,0-0,0,0,1,1,0,0,D
1952-12-27,1952,Middlesbrough,Tottenham Hotspur,0-4,0,4,1,1,4,-4,A
1952-12-27,1952,Portsmouth,Derby County,2-2,2,2,1,1,4,0,D
1952-12-27,1952,Sunderland,Wolverhampton Wanderers,5-2,5,2,1,1,7,3,H
1952-12-27,1952,West Bromwich Albion,Sheffield Wednesday,0-1,0,1,1,1,1,-1,A
1953-01-01,1952,Bolton Wanderers,Charlton Athletic,1-2,1,2,1,1,3,-1,A
1953-01-01,1952,Manchester United,Derby County,1-0,1,0,1,1,1,1,H
1953-01-01,1952,Middlesbrough,Sheffield Wednesday,2-2,2,2,1,1,4,0,D
1953-01-01,1952,Newcastle United,West Bromwich Albion,3-5,3,5,1,1,8,-2,A
1953-01-01,1952,Preston North End,Blackpool,4-2,4,2,1,1,6,2,H
1953-01-01,1952,Sunderland,Aston Villa,2-2,2,2,1,1,4,0,D
1953-01-03,1952,Aston Villa,Derby County,3-0,3,0,1,1,3,3,H
1953-01-03,1952,Bolton Wanderers,Blackpool,4-0,4,0,1,1,4,4,H
1953-01-03,1952,Burnley,West Bromwich Albion,5-0,5,0,1,1,5,5,H
1953-01-03,1952,Manchester United,Manchester City,1-1,1,1,1,1,2,0,D
1953-01-03,1952,Portsmouth,Chelsea,2-0,2,0,1,1,2,2,H
1953-01-03,1952,Preston North End,Middlesbrough,3-0,3,0,1,1,3,3,H
1953-01-03,1952,Sheffield Wednesday,Cardiff City,2-0,2,0,1,1,2,2,H
1953-01-03,1952,Stoke City,Liverpool,3-1,3,1,1,1,4,2,H
1953-01-03,1952,Sunderland,Arsenal,3-1,3,1,1,1,4,2,H
1953-01-03,1952,Tottenham Hotspur,Newcastle United,3-2,3,2,1,1,5,1,H
1953-01-03,1952,Wolverhampton Wanderers,Charlton Athletic,1-2,1,2,1,1,3,-1,A
1953-01-17,1952,Arsenal,Wolverhampton Wanderers,5-3,5,3,1,1,8,2,H
1953-01-17,1952,Blackpool,Aston Villa,1-1,1,1,1,1,2,0,D
1953-01-17,1952,Cardiff City,Tottenham Hotspur,0-0,0,0,1,1,0,0,D
1953-01-17,1952,Charlton Athletic,Sheffield Wednesday,3-0,3,0,1,1,3,3,H
1953-01-17,1952,Chelsea,Bolton Wanderers,1-0,1,0,1,1,1,1,H
1953-01-17,1952,Derby County,Sunderland,3-1,3,1,1,1,4,2,H
1953-01-17,1952,Liverpool,Manchester City,0-1,0,1,1,1,1,-1,A
1953-01-17,1952,Manchester United,Portsmouth,1-0,1,0,1,1,1,1,H
1953-01-17,1952,Middlesbrough,Stoke City,0-0,0,0,1,1,0,0,D
1953-01-17,1952,Newcastle United,Burnley,0-0,0,0,1,1,0,0,D
1953-01-17,1952,West Bromwich Albion,Preston North End,2-1,2,1,1,1,3,1,H
1953-01-24,1952,Aston Villa,Chelsea,1-1,1,1,1,1,2,0,D
1953-01-24,1952,Bolton Wanderers,Manchester United,2-1,2,1,1,1,3,1,H
1953-01-24,1952,Burnley,Cardiff City,0-0,0,0,1,1,0,0,D
1953-01-24,1952,Charlton Athletic,Arsenal,2-2,2,2,1,1,4,0,D
1953-01-24,1952,Manchester City,Middlesbrough,5-1,5,1,1,1,6,4,H
1953-01-24,1952,Portsmouth,Liverpool,3-1,3,1,1,1,4,2,H
1953-01-24,1952,Preston North End,Newcastle United,2-1,2,1,1,1,3,1,H
1953-01-24,1952,Stoke City,West Bromwich Albion,5-1,5,1,1,1,6,4,H
1953-01-24,1952,Sunderland,Blackpool,1-1,1,1,1,1,2,0,D
1953-01-24,1952,Tottenham Hotspur,Sheffield Wednesday,2-1,2,1,1,1,3,1,H
1953-01-24,1952,Wolverhampton Wanderers,Derby County,3-1,3,1,1,1,4,2,H
1953-01-31,1952,Wolverhampton Wanderers,Sheffield Wednesday,3-1,3,1,1,1,4,2,H
1953-02-07,1952,Arsenal,Tottenham Hotspur,4-0,4,0,1,1,4,4,H
1953-02-07,1952,Blackpool,Wolverhampton Wanderers,2-0,2,0,1,1,2,2,H
1953-02-07,1952,Cardiff City,Preston North End,0-2,0,2,1,1,2,-2,A
1953-02-07,1952,Chelsea,Sunderland,3-2,3,2,1,1,5,1,H
1953-02-07,1952,Derby County,Charlton Athletic,1-1,1,1,1,1,2,0,D
1953-02-07,1952,Manchester United,Aston Villa,3-1,3,1,1,1,4,2,H
1953-02-07,1952,Middlesbrough,Liverpool,2-3,2,3,1,1,5,-1,A
1953-02-07,1952,Newcastle United,Stoke City,1-2,1,2,1,1,3,-1,A
1953-02-07,1952,Portsmouth,Bolton Wanderers,3-1,3,1,1,1,4,2,H
1953-02-07,1952,Sheffield Wednesday,Burnley,2-4,2,4,1,1,6,-2,A
1953-02-07,1952,West Bromwich Albion,Manchester City,2-1,2,1,1,1,3,1,H
1953-02-14,1952,Liverpool,West Bromwich Albion,3-0,3,0,1,1,3,3,H
1953-02-14,1952,Manchester City,Newcastle United,2-1,2,1,1,1,3,1,H
1953-02-14,1952,Preston North End,Sheffield Wednesday,1-0,1,0,1,1,1,1,H
1953-02-14,1952,Stoke City,Cardiff City,0-0,0,0,1,1,0,0,D
1953-02-17,1952,Burnley,Tottenham Hotspur,3-2,3,2,1,1,5,1,H
1953-02-18,1952,Arsenal,Derby County,6-2,6,2,1,1,8,4,H
1953-02-18,1952,Aston Villa,Portsmouth,6-0,6,0,1,1,6,6,H
1953-02-18,1952,Bolton Wanderers,Middlesbrough,5-3,5,3,1,1,8,2,H
1953-02-18,1952,Sunderland,Manchester United,2-2,2,2,1,1,4,0,D
1953-02-18,1952,Wolverhampton Wanderers,Chelsea,2-2,2,2,1,1,4,0,D
1953-02-21,1952,Blackpool,Arsenal,3-2,3,2,1,1,5,1,H
1953-02-21,1952,Bolton Wanderers,Aston Villa,0-0,0,0,1,1,0,0,D
1953-02-21,1952,Cardiff City,Manchester City,6-0,6,0,1,1,6,6,H
1953-02-21,1952,Chelsea,Charlton Athletic,0-1,0,1,1,1,1,-1,A
1953-02-21,1952,Derby County,Burnley,1-3,1,3,1,1,4,-2,A
1953-02-21,1952,Manchester United,Wolverhampton Wanderers,0-3,0,3,1,1,3,-3,A
1953-02-21,1952,Newcastle United,Liverpool,1-2,1,2,1,1,3,-1,A
1953-02-21,1952,Portsmouth,Sunderland,5-2,5,2,1,1,7,3,H
1953-02-21,1952,Sheffield Wednesday,Stoke City,1-0,1,0,1,1,1,1,H
1953-02-21,1952,Tottenham Hotspur,Preston North End,4-4,4,4,1,1,8,0,D
1953-02-21,1952,West Bromwich Albion,Middlesbrough,3-0,3,0,1,1,3,3,H
1953-02-23,1952,Charlton Athletic,Blackpool,2-0,2,0,1,1,2,2,H
1953-02-28,1952,Cardiff City,Charlton Athletic,0-1,0,1,1,1,1,-1,A
1953-02-28,1952,Manchester City,Portsmouth,2-1,2,1,1,1,3,1,H
1953-02-28,1952,Newcastle United,Wolverhampton Wanderers,1-1,1,1,1,1,2,0,D
1953-02-28,1952,Preston North End,Chelsea,2-1,2,1,1,1,3,1,H
1953-02-28,1952,Stoke City,Manchester United,3-1,3,1,1,1,4,2,H
1953-02-28,1952,West Bromwich Albion,Sunderland,1-1,1,1,1,1,2,0,D
1953-03-02,1952,Sheffield Wednesday,Arsenal,1-4,1,4,1,1,5,-3,A
1953-03-03,1952,Burnley,Blackpool,0-1,0,1,1,1,1,-1,A
1953-03-04,1952,Liverpool,Bolton Wanderers,0-0,0,0,1,1,0,0,D
1953-03-04,1952,Middlesbrough,Aston Villa,1-0,1,0,1,1,1,1,H
1953-03-07,1952,Arsenal,Cardiff City,0-1,0,1,1,1,1,-1,A
1953-03-07,1952,Aston Villa,Liverpool,4-0,4,0,1,1,4,4,H
1953-03-07,1952,Blackpool,Tottenham Hotspur,2-0,2,0,1,1,2,2,H
1953-03-07,1952,Bolton Wanderers,Manchester City,1-0,1,0,1,1,1,1,H
1953-03-07,1952,Charlton Athletic,Newcastle United,0-0,0,0,1,1,0,0,D
1953-03-07,1952,Chelsea,Burnley,0-2,0,2,1,1,2,-2,A
1953-03-07,1952,Derby County,Sheffield Wednesday,2-1,2,1,1,1,3,1,H
1953-03-07,1952,Manchester United,Preston North End,5-2,5,2,1,1,7,3,H
1953-03-07,1952,Portsmouth,Stoke City,1-1,1,1,1,1,2,0,D
1953-03-07,1952,Sunderland,Middlesbrough,1-1,1,1,1,1,2,0,D
1953-03-07,1952,Wolverhampton Wanderers,West Bromwich Albion,2-0,2,0,1,1,2,2,H
1953-03-11,1952,Cardiff City,Bolton Wanderers,1-0,1,0,1,1,1,1,H
1953-03-12,1952,Tottenham Hotspur,Derby County,5-2,5,2,1,1,7,3,H
1953-03-14,1952,Burnley,Manchester United,2-1,2,1,1,1,3,1,H
1953-03-14,1952,Cardiff City,Derby County,2-0,2,0,1,1,2,2,H
1953-03-14,1952,Liverpool,Sunderland,2-0,2,0,1,1,2,2,H
1953-03-14,1952,Manchester City,Aston Villa,4-1,4,1,1,1,5,3,H
1953-03-14,1952,Middlesbrough,Wolverhampton Wanderers,1-1,1,1,1,1,2,0,D
1953-03-14,1952,Newcastle United,Arsenal,2-2,2,2,1,1,4,0,D
1953-03-14,1952,Preston North End,Portsmouth,4-0,4,0,1,1,4,4,H
1953-03-14,1952,Sheffield Wednesday,Blackpool,2-0,2,0,1,1,2,2,H
1953-03-14,1952,Stoke City,Bolton Wanderers,1-2,1,2,1,1,3,-1,A
1953-03-14,1952,Tottenham Hotspur,Chelsea,2-3,2,3,1,1,5,-1,A
1953-03-14,1952,West Bromwich Albion,Charlton Athletic,3-1,3,1,1,1,4,2,H
1953-03-18,1952,Charlton Athletic,Aston Villa,5-1,5,1,1,1,6,4,H
1953-03-19,1952,Arsenal,Preston North End,1-1,1,1,1,1,2,0,D
1953-03-21,1952,Arsenal,West Bromwich Albion,2-2,2,2,1,1,4,0,D
1953-03-21,1952,Charlton Athletic,Middlesbrough,2-0,2,0,1,1,2,2,H
1953-03-21,1952,Chelsea,Sheffield Wednesday,1-0,1,0,1,1,1,1,H
1953-03-21,1952,Derby County,Newcastle United,0-2,0,2,1,1,2,-2,A
1953-03-21,1952,Portsmouth,Burnley,2-1,2,1,1,1,3,1,H
1953-03-21,1952,Sunderland,Manchester City,3-3,3,3,1,1,6,0,D
1953-03-21,1952,Wolverhampton Wanderers,Liverpool,3-0,3,0,1,1,3,3,H
1953-03-23,1952,Chelsea,Liverpool,3-0,3,0,1,1,3,3,H
1953-03-25,1952,Aston Villa,Stoke City,1-1,1,1,1,1,2,0,D
1953-03-25,1952,Blackpool,Cardiff City,0-1,0,1,1,1,1,-1,A
1953-03-25,1952,Bolton Wanderers,Preston North End,0-3,0,3,1,1,3,-3,A
1953-03-25,1952,Manchester United,Tottenham Hotspur,3-2,3,2,1,1,5,1,H
1953-03-28,1952,Burnley,Bolton Wanderers,0-1,0,1,1,1,1,-1,A
1953-03-28,1952,Cardiff City,Chelsea,3-3,3,3,1,1,6,0,D
1953-03-28,1952,Liverpool,Charlton Athletic,1-2,1,2,1,1,3,-1,A
1953-03-28,1952,Manchester City,Wolverhampton Wanderers,3-1,3,1,1,1,4,2,H
1953-03-28,1952,Middlesbrough,Arsenal,2-0,2,0,1,1,2,2,H
1953-03-28,1952,Newcastle United,Blackpool,0-1,0,1,1,1,1,-1,A
1953-03-28,1952,Preston North End,Aston Villa,1-3,1,3,1,1,4,-2,A
1953-03-28,1952,Sheffield Wednesday,Manchester United,0-0,0,0,1,1,0,0,D
1953-03-28,1952,Stoke City,Sunderland,3-0,3,0,1,1,3,3,H
1953-03-28,1952,Tottenham Hotspur,Portsmouth,3-3,3,3,1,1,6,0,D
1953-03-28,1952,West Bromwich Albion,Derby County,2-2,2,2,1,1,4,0,D
1953-04-03,1952,Blackpool,Derby County,2-1,2,1,1,1,3,1,H
1953-04-03,1952,Bolton Wanderers,Sunderland,5-0,5,0,1,1,5,5,H
1953-04-03,1952,Burnley,Preston North End,2-2,2,2,1,1,4,0,D
1953-04-03,1952,Charlton Athletic,Manchester United,2-2,2,2,1,1,4,0,D
1953-04-03,1952,Chelsea,Arsenal,1-1,1,1,1,1,2,0,D
1953-04-03,1952,Liverpool,Cardiff City,2-1,2,1,1,1,3,1,H
1953-04-03,1952,Manchester City,Sheffield Wednesday,3-1,3,1,1,1,4,2,H
1953-04-03,1952,Newcastle United,Middlesbrough,1-0,1,0,1,1,1,1,H
1953-04-03,1952,Portsmouth,Wolverhampton Wanderers,2-2,2,2,1,1,4,0,D
1953-04-03,1952,Tottenham Hotspur,Stoke City,1-0,1,0,1,1,1,1,H
1953-04-04,1952,Arsenal,Liverpool,5-3,5,3,1,1,8,2,H
1953-04-04,1952,Aston Villa,Burnley,2-0,2,0,1,1,2,2,H
1953-04-04,1952,Blackpool,West Bromwich Albion,2-0,2,0,1,1,2,2,H
1953-04-04,1952,Bolton Wanderers,Tottenham Hotspur,2-3,2,3,1,1,5,-1,A
1953-04-04,1952,Charlton Athletic,Manchester City,1-2,1,2,1,1,3,-1,A
1953-04-04,1952,Chelsea,Newcastle United,1-2,1,2,1,1,3,-1,A
1953-04-04,1952,Derby County,Middlesbrough,3-3,3,3,1,1,6,0,D
1953-04-04,1952,Manchester United,Cardiff City,1-4,1,4,1,1,5,-3,A
1953-04-04,1952,Portsmouth,Sheffield Wednesday,5-2,5,2,1,1,7,3,H
1953-04-04,1952,Sunderland,Preston North End,2-2,2,2,1,1,4,0,D
1953-04-04,1952,Wolverhampton Wanderers,Stoke City,3-0,3,0,1,1,3,3,H
1953-04-06,1952,Arsenal,Chelsea,2-0,2,0,1,1,2,2,H
1953-04-06,1952,Cardiff City,Liverpool,4-0,4,0,1,1,4,4,H
1953-04-06,1952,Derby County,Blackpool,1-1,1,1,1,1,2,0,D
1953-04-06,1952,Manchester United,Charlton Athletic,3-2,3,2,1,1,5,1,H
1953-04-06,1952,Middlesbrough,Newcastle United,2-1,2,1,1,1,3,1,H
1953-04-06,1952,Preston North End,Burnley,2-1,2,1,1,1,3,1,H
1953-04-06,1952,Sheffield Wednesday,Manchester City,1-1,1,1,1,1,2,0,D
1953-04-06,1952,Stoke City,Tottenham Hotspur,2-0,2,0,1,1,2,2,H
1953-04-06,1952,Sunderland,Bolton Wanderers,2-0,2,0,1,1,2,2,H
1953-04-06,1952,West Bromwich Albion,Aston Villa,3-2,3,2,1,1,5,1,H
1953-04-06,1952,Wolverhampton Wanderers,Portsmouth,4-1,4,1,1,1,5,3,H
1953-04-07,1952,Aston Villa,West Bromwich Albion,1-1,1,1,1,1,2,0,D
1953-04-11,1952,Burnley,Sunderland,5-1,5,1,1,1,6,4,H
1953-04-11,1952,Cardiff City,Portsmouth,0-1,0,1,1,1,1,-1,A
1953-04-11,1952,Liverpool,Derby County,1-1,1,1,1,1,2,0,D
1953-04-11,1952,Manchester City,Arsenal,2-4,2,4,1,1,6,-2,A
1953-04-11,1952,Middlesbrough,Blackpool,5-1,5,1,1,1,6,4,H
1953-04-11,1952,Newcastle United,Manchester United,1-2,1,2,1,1,3,-1,A
1953-04-11,1952,Preston North End,Wolverhampton Wanderers,1-1,1,1,1,1,2,0,D
1953-04-11,1952,Sheffield Wednesday,Bolton Wanderers,1-1,1,1,1,1,2,0,D
1953-04-11,1952,Stoke City,Charlton Athletic,1-0,1,0,1,1,1,1,H
1953-04-11,1952,Tottenham Hotspur,Aston Villa,1-1,1,1,1,1,2,0,D
1953-04-11,1952,West Bromwich Albion,Chelsea,0-1,0,1,1,1,1,-1,A
1953-04-15,1952,Arsenal,Bolton Wanderers,4-1,4,1,1,1,5,3,H
1953-04-15,1952,Blackpool,Stoke City,1-1,1,1,1,1,2,0,D
1953-04-18,1952,Arsenal,Stoke City,3-1,3,1,1,1,4,2,H
1953-04-18,1952,Aston Villa,Sheffield Wednesday,4-3,4,3,1,1,7,1,H
1953-04-18,1952,Blackpool,Liverpool,3-1,3,1,1,1,4,2,H
1953-04-18,1952,Bolton Wanderers,Cardiff City,0-1,0,1,1,1,1,-1,A
1953-04-18,1952,Charlton Athletic,Preston North End,2-1,2,1,1,1,3,1,H
1953-04-18,1952,Chelsea,Middlesbrough,1-1,1,1,1,1,2,0,D
1953-04-18,1952,Derby County,Manchester City,5-0,5,0,1,1,5,5,H
1953-04-18,1952,Manchester United,West Bromwich Albion,2-2,2,2,1,1,4,0,D
1953-04-18,1952,Portsmouth,Newcastle United,5-1,5,1,1,1,6,4,H
1953-04-18,1952,Sunderland,Tottenham Hotspur,1-1,1,1,1,1,2,0,D
1953-04-18,1952,Wolverhampton Wanderers,Burnley,5-1,5,1,1,1,6,4,H
1953-04-20,1952,Manchester United,Liverpool,3-1,3,1,1,1,4,2,H
1953-04-22,1952,Bolton Wanderers,West Bromwich Albion,0-1,0,1,1,1,1,-1,A
1953-04-22,1952,Cardiff City,Arsenal,0-0,0,0,1,1,0,0,D
1953-04-22,1952,Charlton Athletic,Burnley,0-0,0,0,1,1,0,0,D
1953-04-22,1952,Manchester City,Preston North End,0-2,0,2,1,1,2,-2,A
1953-04-25,1952,Burnley,Charlton Athletic,2-0,2,0,1,1,2,2,H
1953-04-25,1952,Cardiff City,Aston Villa,1-2,1,2,1,1,3,-1,A
1953-04-25,1952,Liverpool,Chelsea,2-0,2,0,1,1,2,2,H
1953-04-25,1952,Manchester City,Blackpool,5-0,5,0,1,1,5,5,H
1953-04-25,1952,Middlesbrough,Manchester United,5-0,5,0,1,1,5,5,H
1953-04-25,1952,Newcastle United,Bolton Wanderers,2-3,2,3,1,1,5,-1,A
1953-04-25,1952,Preston North End,Arsenal,2-0,2,0,1,1,2,2,H
1953-04-25,1952,Sheffield Wednesday,Sunderland,4-0,4,0,1,1,4,4,H
1953-04-25,1952,Stoke City,Derby County,1-2,1,2,1,1,3,-1,A
1953-04-25,1952,Tottenham Hotspur,Wolverhampton Wanderers,3-2,3,2,1,1,5,1,H
1953-04-25,1952,West Bromwich Albion,Portsmouth,2-0,2,0,1,1,2,2,H
1953-04-27,1952,Sunderland,Cardiff City,4-2,4,2,1,1,6,2,H
1953-04-29,1952,Aston Villa,Cardiff City,2-0,2,0,1,1,2,2,H
1953-04-29,1952,Chelsea,Manchester City,3-1,3,1,1,1,4,2,H
1953-04-29,1952,Derby County,Preston North End,0-1,0,1,1,1,1,-1,A
1953-04-30,1952,Charlton Athletic,Tottenham Hotspur,3-2,3,2,1,1,5,1,H
1953-05-01,1952,Arsenal,Burnley,3-2,3,2,1,1,5,1,H
1953-05-01,1952,Aston Villa,Newcastle United,0-1,0,1,1,1,1,-1,A
1953-05-02,1952,Portsmouth,Middlesbrough,1-4,1,4,1,1,5,-3,A
1953-08-19,1953,Burnley,Wolverhampton Wanderers,4-1,4,1,1,1,5,3,H
1953-08-19,1953,Charlton Athletic,Sunderland,5-3,5,3,1,1,8,2,H
1953-08-19,1953,Liverpool,Portsmouth,3-1,3,1,1,1,4,2,H
1953-08-19,1953,Manchester United,Chelsea,1-1,1,1,1,1,2,0,D
1953-08-19,1953,Middlesbrough,Cardiff City,0-0,0,0,1,1,0,0,D
1953-08-19,1953,Preston North End,Huddersfield Town,1-2,1,2,1,1,3,-1,A
1953-08-19,1953,Sheffield Wednesday,Manchester City,2-0,2,0,1,1,2,2,H
1953-08-19,1953,Tottenham Hotspur,Aston Villa,1-0,1,0,1,1,1,1,H
1953-08-19,1953,West Bromwich Albion,Arsenal,2-0,2,0,1,1,2,2,H
1953-08-22,1953,Arsenal,Huddersfield Town,0-0,0,0,1,1,0,0,D
1953-08-22,1953,Blackpool,Chelsea,2-1,2,1,1,1,3,1,H
1953-08-22,1953,Cardiff City,Aston Villa,2-1,2,1,1,1,3,1,H
1953-08-22,1953,Charlton Athletic,Burnley,3-1,3,1,1,1,4,2,H
1953-08-22,1953,Liverpool,Manchester United,4-4,4,4,1,1,8,0,D
1953-08-22,1953,Manchester City,Wolverhampton Wanderers,0-4,0,4,1,1,4,-4,A
1953-08-22,1953,Middlesbrough,Preston North End,0-4,0,4,1,1,4,-4,A
1953-08-22,1953,Newcastle United,Sunderland,2-1,2,1,1,1,3,1,H
1953-08-22,1953,Portsmouth,Sheffield United,3-4,3,4,1,1,7,-1,A
1953-08-22,1953,Sheffield Wednesday,Tottenham Hotspur,2-1,2,1,1,1,3,1,H
1953-08-22,1953,West Bromwich Albion,Bolton Wanderers,1-1,1,1,1,1,2,0,D
1953-08-24,1953,Aston Villa,Manchester City,3-0,3,0,1,1,3,3,H
1953-08-24,1953,Sheffield United,Arsenal,1-0,1,0,1,1,1,1,H
1953-08-25,1953,Burnley,Blackpool,2-1,2,1,1,1,3,1,H
1953-08-25,1953,Chelsea,Portsmouth,4-3,4,3,1,1,7,1,H
1953-08-26,1953,Bolton Wanderers,Middlesbrough,3-2,3,2,1,1,5,1,H
1953-08-26,1953,Huddersfield Town,Cardiff City,2-0,2,0,1,1,2,2,H
1953-08-26,1953,Liverpool,Newcastle United,2-2,2,2,1,1,4,0,D
1953-08-26,1953,Manchester United,West Bromwich Albion,1-3,1,3,1,1,4,-2,A
1953-08-26,1953,Preston North End,Sheffield Wednesday,6-0,6,0,1,1,6,6,H
1953-08-26,1953,Sunderland,Wolverhampton Wanderers,3-2,3,2,1,1,5,1,H
1953-08-26,1953,Tottenham Hotspur,Charlton Athletic,3-1,3,1,1,1,4,2,H
1953-08-29,1953,Aston Villa,Arsenal,2-1,2,1,1,1,3,1,H
1953-08-29,1953,Bolton Wanderers,Liverpool,2-0,2,0,1,1,2,2,H
1953-08-29,1953,Burnley,Sheffield Wednesday,4-1,4,1,1,1,5,3,H
1953-08-29,1953,Chelsea,Charlton Athletic,3-1,3,1,1,1,4,2,H
1953-08-29,1953,Huddersfield Town,Portsmouth,5-1,5,1,1,1,6,4,H
1953-08-29,1953,Manchester United,Newcastle United,1-1,1,1,1,1,2,0,D
1953-08-29,1953,Preston North End,West Bromwich Albion,0-2,0,2,1,1,2,-2,A
1953-08-29,1953,Sheffield United,Blackpool,3-4,3,4,1,1,7,-1,A
1953-08-29,1953,Sunderland,Manchester City,4-5,4,5,1,1,9,-1,A
1953-08-29,1953,Tottenham Hotspur,Middlesbrough,4-1,4,1,1,1,5,3,H
1953-08-29,1953,Wolverhampton Wanderers,Cardiff City,3-1,3,1,1,1,4,2,H
1953-08-31,1953,Blackpool,Burnley,2-0,2,0,1,1,2,2,H
1953-08-31,1953,Wolverhampton Wanderers,Sunderland,3-1,3,1,1,1,4,2,H
1953-09-01,1953,Arsenal,Sheffield United,1-1,1,1,1,1,2,0,D
1953-09-02,1953,Cardiff City,Huddersfield Town,2-1,2,1,1,1,3,1,H
1953-09-02,1953,Manchester City,Aston Villa,0-1,0,1,1,1,1,-1,A
1953-09-02,1953,Middlesbrough,Bolton Wanderers,3-2,3,2,1,1,5,1,H
1953-09-02,1953,Newcastle United,Liverpool,4-0,4,0,1,1,4,4,H
1953-09-02,1953,Portsmouth,Chelsea,3-2,3,2,1,1,5,1,H
1953-09-02,1953,Sheffield Wednesday,Preston North End,4-2,4,2,1,1,6,2,H
1953-09-02,1953,West Bromwich Albion,Manchester United,2-0,2,0,1,1,2,2,H
1953-09-03,1953,Charlton Athletic,Tottenham Hotspur,0-1,0,1,1,1,1,-1,A
1953-09-05,1953,Arsenal,Wolverhampton Wanderers,2-3,2,3,1,1,5,-1,A
1953-09-05,1953,Blackpool,Huddersfield Town,3-1,3,1,1,1,4,2,H
1953-09-05,1953,Cardiff City,Sunderland,1-1,1,1,1,1,2,0,D
1953-09-05,1953,Chelsea,Sheffield United,1-2,1,2,1,1,3,-1,A
1953-09-05,1953,Liverpool,Preston North End,1-5,1,5,1,1,6,-4,A
1953-09-05,1953,Manchester City,Manchester United,2-0,2,0,1,1,2,2,H
1953-09-05,1953,Middlesbrough,Burnley,1-3,1,3,1,1,4,-2,A
1953-09-05,1953,Newcastle United,Bolton Wanderers,2-3,2,3,1,1,5,-1,A
1953-09-05,1953,Portsmouth,Aston Villa,2-1,2,1,1,1,3,1,H
1953-09-05,1953,Sheffield Wednesday,Charlton Athletic,1-2,1,2,1,1,3,-1,A
1953-09-05,1953,West Bromwich Albion,Tottenham Hotspur,3-0,3,0,1,1,3,3,H
1953-09-07,1953,Blackpool,Portsmouth,1-1,1,1,1,1,2,0,D
1953-09-07,1953,Burnley,Tottenham Hotspur,4-2,4,2,1,1,6,2,H
1953-09-07,1953,Sheffield United,Cardiff City,0-1,0,1,1,1,1,-1,A
1953-09-07,1953,Sheffield Wednesday,Aston Villa,3-1,3,1,1,1,4,2,H
1953-09-07,1953,Wolverhampton Wanderers,Liverpool,2-1,2,1,1,1,3,1,H
1953-09-08,1953,Arsenal,Chelsea,1-2,1,2,1,1,3,-1,A
1953-09-09,1953,Bolton Wanderers,Sheffield Wednesday,2-1,2,1,1,1,3,1,H
1953-09-09,1953,Huddersfield Town,Manchester City,1-1,1,1,1,1,2,0,D
1953-09-09,1953,Manchester United,Middlesbrough,2-2,2,2,1,1,4,0,D
1953-09-09,1953,Preston North End,Charlton Athletic,2-0,2,0,1,1,2,2,H
1953-09-09,1953,West Bromwich Albion,Newcastle United,2-2,2,2,1,1,4,0,D
1953-09-12,1953,Aston Villa,Blackpool,2-1,2,1,1,1,3,1,H
1953-09-12,1953,Bolton Wanderers,Manchester United,0-0,0,0,1,1,0,0,D
1953-09-12,1953,Burnley,West Bromwich Albion,1-4,1,4,1,1,5,-3,A
1953-09-12,1953,Charlton Athletic,Middlesbrough,8-1,8,1,1,1,9,7,H
1953-09-12,1953,Huddersfield Town,Chelsea,3-1,3,1,1,1,4,2,H
1953-09-12,1953,Manchester City,Cardiff City,1-1,1,1,1,1,2,0,D
1953-09-12,1953,Preston North End,Newcastle United,2-2,2,2,1,1,4,0,D
1953-09-12,1953,Sheffield United,Sheffield Wednesday,2-0,2,0,1,1,2,2,H
1953-09-12,1953,Sunderland,Arsenal,7-1,7,1,1,1,8,6,H
1953-09-12,1953,Tottenham Hotspur,Liverpool,2-1,2,1,1,1,3,1,H
1953-09-12,1953,Wolverhampton Wanderers,Portsmouth,4-3,4,3,1,1,7,1,H
1953-09-14,1953,Aston Villa,Sunderland,3-1,3,1,1,1,4,2,H
1953-09-15,1953,Chelsea,Arsenal,0-2,0,2,1,1,2,-2,A
1953-09-16,1953,Cardiff City,Sheffield United,2-0,2,0,1,1,2,2,H
1953-09-16,1953,Liverpool,Wolverhampton Wanderers,1-1,1,1,1,1,2,0,D
1953-09-16,1953,Manchester City,Huddersfield Town,0-1,0,1,1,1,1,-1,A
1953-09-16,1953,Middlesbrough,Manchester United,1-4,1,4,1,1,5,-3,A
1953-09-16,1953,Newcastle United,West Bromwich Albion,3-7,3,7,1,1,10,-4,A
1953-09-16,1953,Portsmouth,Blackpool,4-4,4,4,1,1,8,0,D
1953-09-16,1953,Sheffield Wednesday,Bolton Wanderers,2-1,2,1,1,1,3,1,H
1953-09-16,1953,Tottenham Hotspur,Burnley,2-3,2,3,1,1,5,-1,A
1953-09-17,1953,Charlton Athletic,Preston North End,2-1,2,1,1,1,3,1,H
1953-09-19,1953,Arsenal,Manchester City,2-2,2,2,1,1,4,0,D
1953-09-19,1953,Blackpool,Wolverhampton Wanderers,0-0,0,0,1,1,0,0,D
1953-09-19,1953,Cardiff City,Bolton Wanderers,1-1,1,1,1,1,2,0,D
1953-09-19,1953,Chelsea,Aston Villa,1-2,1,2,1,1,3,-1,A
1953-09-19,1953,Liverpool,Burnley,4-0,4,0,1,1,4,4,H
1953-09-19,1953,Manchester United,Preston North End,1-0,1,0,1,1,1,1,H
1953-09-19,1953,Middlesbrough,Sheffield Wednesday,4-1,4,1,1,1,5,3,H
1953-09-19,1953,Newcastle United,Tottenham Hotspur,1-3,1,3,1,1,4,-2,A
1953-09-19,1953,Portsmouth,Sunderland,4-1,4,1,1,1,5,3,H
1953-09-19,1953,Sheffield United,Huddersfield Town,3-6,3,6,1,1,9,-3,A
1953-09-19,1953,West Bromwich Albion,Charlton Athletic,2-3,2,3,1,1,5,-1,A
1953-09-23,1953,Sheffield Wednesday,Newcastle United,3-0,3,0,1,1,3,3,H
1953-09-26,1953,Aston Villa,Sheffield United,4-0,4,0,1,1,4,4,H
1953-09-26,1953,Burnley,Newcastle United,1-2,1,2,1,1,3,-1,A
1953-09-26,1953,Cardiff City,Arsenal,0-3,0,3,1,1,3,-3,A
1953-09-26,1953,Charlton Athletic,Liverpool,6-0,6,0,1,1,6,6,H
1953-09-26,1953,Huddersfield Town,Middlesbrough,2-1,2,1,1,1,3,1,H
1953-09-26,1953,Manchester City,Portsmouth,2-1,2,1,1,1,3,1,H
1953-09-26,1953,Preston North End,Bolton Wanderers,3-1,3,1,1,1,4,2,H
1953-09-26,1953,Sheffield Wednesday,West Bromwich Albion,2-3,2,3,1,1,5,-1,A
1953-09-26,1953,Sunderland,Blackpool,3-2,3,2,1,1,5,1,H
1953-09-26,1953,Tottenham Hotspur,Manchester United,1-1,1,1,1,1,2,0,D
1953-09-26,1953,Wolverhampton Wanderers,Chelsea,8-1,8,1,1,1,9,7,H
1953-10-03,1953,Arsenal,Preston North End,3-2,3,2,1,1,5,1,H
1953-10-03,1953,Blackpool,Manchester City,2-0,2,0,1,1,2,2,H
1953-10-03,1953,Bolton Wanderers,Tottenham Hotspur,2-0,2,0,1,1,2,2,H
1953-10-03,1953,Chelsea,Sunderland,2-2,2,2,1,1,4,0,D
1953-10-03,1953,Huddersfield Town,Aston Villa,4-0,4,0,1,1,4,4,H
1953-10-03,1953,Liverpool,Sheffield Wednesday,2-2,2,2,1,1,4,0,D
1953-10-03,1953,Manchester United,Burnley,1-2,1,2,1,1,3,-1,A
1953-10-03,1953,Newcastle United,Charlton Athletic,0-2,0,2,1,1,2,-2,A
1953-10-03,1953,Portsmouth,Cardiff City,1-1,1,1,1,1,2,0,D
1953-10-03,1953,Sheffield United,Wolverhampton Wanderers,3-3,3,3,1,1,6,0,D
1953-10-03,1953,West Bromwich Albion,Middlesbrough,2-1,2,1,1,1,3,1,H
1953-10-10,1953,Bolton Wanderers,Manchester City,3-2,3,2,1,1,5,1,H
1953-10-10,1953,Burnley,Portsmouth,1-0,1,0,1,1,1,1,H
1953-10-10,1953,Charlton Athletic,Blackpool,4-2,4,2,1,1,6,2,H
1953-10-10,1953,Liverpool,Aston Villa,6-1,6,1,1,1,7,5,H
1953-10-10,1953,Manchester United,Sunderland,1-0,1,0,1,1,1,1,H
1953-10-10,1953,Middlesbrough,Sheffield United,2-0,2,0,1,1,2,2,H
1953-10-10,1953,Newcastle United,Wolverhampton Wanderers,1-2,1,2,1,1,3,-1,A
1953-10-10,1953,Preston North End,Cardiff City,1-2,1,2,1,1,3,-1,A
1953-10-10,1953,Sheffield Wednesday,Chelsea,2-0,2,0,1,1,2,2,H
1953-10-10,1953,Tottenham Hotspur,Arsenal,1-4,1,4,1,1,5,-3,A
1953-10-10,1953,West Bromwich Albion,Huddersfield Town,4-0,4,0,1,1,4,4,H
1953-10-17,1953,Arsenal,Burnley,2-5,2,5,1,1,7,-3,A
1953-10-17,1953,Aston Villa,Newcastle United,1-2,1,2,1,1,3,-1,A
1953-10-17,1953,Blackpool,Sheffield Wednesday,1-2,1,2,1,1,3,-1,A
1953-10-17,1953,Cardiff City,Tottenham Hotspur,1-0,1,0,1,1,1,1,H
1953-10-17,1953,Chelsea,Middlesbrough,1-1,1,1,1,1,2,0,D
1953-10-17,1953,Huddersfield Town,Liverpool,2-0,2,0,1,1,2,2,H
1953-10-17,1953,Manchester City,Preston North End,1-4,1,4,1,1,5,-3,A
1953-10-17,1953,Portsmouth,Charlton Athletic,3-1,3,1,1,1,4,2,H
1953-10-17,1953,Sheffield United,West Bromwich Albion,1-2,1,2,1,1,3,-1,A
1953-10-17,1953,Sunderland,Bolton Wanderers,1-2,1,2,1,1,3,-1,A
1953-10-17,1953,Wolverhampton Wanderers,Manchester United,3-1,3,1,1,1,4,2,H
1953-10-24,1953,Bolton Wanderers,Wolverhampton Wanderers,1-1,1,1,1,1,2,0,D
1953-10-24,1953,Burnley,Cardiff City,3-0,3,0,1,1,3,3,H
1953-10-24,1953,Charlton Athletic,Arsenal,1-5,1,5,1,1,6,-4,A
1953-10-24,1953,Liverpool,Sheffield United,3-0,3,0,1,1,3,3,H
1953-10-24,1953,Manchester United,Aston Villa,1-0,1,0,1,1,1,1,H
1953-10-24,1953,Middlesbrough,Blackpool,0-1,0,1,1,1,1,-1,A
1953-10-24,1953,Newcastle United,Huddersfield Town,0-2,0,2,1,1,2,-2,A
1953-10-24,1953,Preston North End,Sunderland,6-2,6,2,1,1,8,4,H
1953-10-24,1953,Sheffield Wednesday,Portsmouth,4-4,4,4,1,1,8,0,D
1953-10-24,1953,Tottenham Hotspur,Manchester City,3-0,3,0,1,1,3,3,H
1953-10-24,1953,West Bromwich Albion,Chelsea,5-2,5,2,1,1,7,3,H
1953-10-31,1953,Arsenal,Sheffield Wednesday,4-1,4,1,1,1,5,3,H
1953-10-31,1953,Aston Villa,Bolton Wanderers,2-2,2,2,1,1,4,0,D
1953-10-31,1953,Blackpool,West Bromwich Albion,4-1,4,1,1,1,5,3,H
1953-10-31,1953,Cardiff City,Charlton Athletic,5-0,5,0,1,1,5,5,H
1953-10-31,1953,Chelsea,Liverpool,5-2,5,2,1,1,7,3,H
1953-10-31,1953,Huddersfield Town,Manchester United,0-0,0,0,1,1,0,0,D
1953-10-31,1953,Manchester City,Burnley,3-2,3,2,1,1,5,1,H
1953-10-31,1953,Portsmouth,Middlesbrough,0-2,0,2,1,1,2,-2,A
1953-10-31,1953,Sheffield United,Newcastle United,3-1,3,1,1,1,4,2,H
1953-10-31,1953,Sunderland,Tottenham Hotspur,4-3,4,3,1,1,7,1,H
1953-10-31,1953,Wolverhampton Wanderers,Preston North End,1-0,1,0,1,1,1,1,H
1953-11-07,1953,Bolton Wanderers,Portsmouth,6-1,6,1,1,1,7,5,H
1953-11-07,1953,Burnley,Sheffield United,2-1,2,1,1,1,3,1,H
1953-11-07,1953,Charlton Athletic,Huddersfield Town,2-1,2,1,1,1,3,1,H
1953-11-07,1953,Liverpool,Manchester City,2-2,2,2,1,1,4,0,D
1953-11-07,1953,Manchester United,Arsenal,2-2,2,2,1,1,4,0,D
1953-11-07,1953,Middlesbrough,Wolverhampton Wanderers,3-3,3,3,1,1,6,0,D
1953-11-07,1953,Newcastle United,Cardiff City,4-0,4,0,1,1,4,4,H
1953-11-07,1953,Preston North End,Blackpool,2-3,2,3,1,1,5,-1,A
1953-11-07,1953,Tottenham Hotspur,Chelsea,2-1,2,1,1,1,3,1,H
1953-11-07,1953,West Bromwich Albion,Sunderland,2-0,2,0,1,1,2,2,H
1953-11-14,1953,Arsenal,Bolton Wanderers,4-3,4,3,1,1,7,1,H
1953-11-14,1953,Aston Villa,Middlesbrough,5-3,5,3,1,1,8,2,H
1953-11-14,1953,Blackpool,Tottenham Hotspur,1-0,1,0,1,1,1,1,H
1953-11-14,1953,Cardiff City,Manchester United,1-6,1,6,1,1,7,-5,A
1953-11-14,1953,Chelsea,Burnley,2-1,2,1,1,1,3,1,H
1953-11-14,1953,Huddersfield Town,Sheffield Wednesday,2-0,2,0,1,1,2,2,H
1953-11-14,1953,Manchester City,Newcastle United,0-0,0,0,1,1,0,0,D
1953-11-14,1953,Portsmouth,Preston North End,1-3,1,3,1,1,4,-2,A
1953-11-14,1953,Sheffield United,Charlton Athletic,1-1,1,1,1,1,2,0,D
1953-11-14,1953,Sunderland,Liverpool,3-2,3,2,1,1,5,1,H
1953-11-14,1953,Wolverhampton Wanderers,West Bromwich Albion,1-0,1,0,1,1,1,1,H
1953-11-21,1953,Bolton Wanderers,Chelsea,2-2,2,2,1,1,4,0,D
1953-11-21,1953,Burnley,Aston Villa,3-2,3,2,1,1,5,1,H
1953-11-21,1953,Charlton Athletic,Wolverhampton Wanderers,0-2,0,2,1,1,2,-2,A
1953-11-21,1953,Liverpool,Arsenal,1-2,1,2,1,1,3,-1,A
1953-11-21,1953,Manchester United,Blackpool,4-1,4,1,1,1,5,3,H
1953-11-21,1953,Middlesbrough,Manchester City,0-1,0,1,1,1,1,-1,A
1953-11-21,1953,Newcastle United,Portsmouth,1-1,1,1,1,1,2,0,D
1953-11-21,1953,Preston North End,Sheffield United,2-1,2,1,1,1,3,1,H
1953-11-21,1953,Sheffield Wednesday,Sunderland,2-2,2,2,1,1,4,0,D
1953-11-21,1953,Tottenham Hotspur,Huddersfield Town,1-0,1,0,1,1,1,1,H
1953-11-21,1953,West Bromwich Albion,Cardiff City,6-1,6,1,1,1,7,5,H
1953-11-28,1953,Arsenal,Newcastle United,2-1,2,1,1,1,3,1,H
1953-11-28,1953,Aston Villa,Charlton Athletic,2-1,2,1,1,1,3,1,H
1953-11-28,1953,Blackpool,Bolton Wanderers,0-0,0,0,1,1,0,0,D
1953-11-28,1953,Cardiff City,Liverpool,3-1,3,1,1,1,4,2,H
1953-11-28,1953,Chelsea,Preston North End,1-0,1,0,1,1,1,1,H
1953-11-28,1953,Huddersfield Town,Burnley,3-1,3,1,1,1,4,2,H
1953-11-28,1953,Manchester City,West Bromwich Albion,2-3,2,3,1,1,5,-1,A
1953-11-28,1953,Portsmouth,Manchester United,1-1,1,1,1,1,2,0,D
1953-11-28,1953,Sheffield United,Tottenham Hotspur,5-2,5,2,1,1,7,3,H
1953-11-28,1953,Sunderland,Middlesbrough,0-2,0,2,1,1,2,-2,A
1953-11-28,1953,Wolverhampton Wanderers,Sheffield Wednesday,4-1,4,1,1,1,5,3,H
1953-12-05,1953,Bolton Wanderers,Huddersfield Town,0-0,0,0,1,1,0,0,D
1953-12-05,1953,Burnley,Sunderland,5-1,5,1,1,1,6,4,H
1953-12-05,1953,Charlton Athletic,Manchester City,2-1,2,1,1,1,3,1,H
1953-12-05,1953,Liverpool,Blackpool,5-2,5,2,1,1,7,3,H
1953-12-05,1953,Manchester United,Sheffield United,2-2,2,2,1,1,4,0,D
1953-12-05,1953,Middlesbrough,Arsenal,2-0,2,0,1,1,2,2,H
1953-12-05,1953,Newcastle United,Chelsea,1-1,1,1,1,1,2,0,D
1953-12-05,1953,Preston North End,Aston Villa,1-1,1,1,1,1,2,0,D
1953-12-05,1953,Sheffield Wednesday,Cardiff City,2-1,2,1,1,1,3,1,H
1953-12-05,1953,Tottenham Hotspur,Wolverhampton Wanderers,2-3,2,3,1,1,5,-1,A
1953-12-05,1953,West Bromwich Albion,Portsmouth,2-3,2,3,1,1,5,-1,A
1953-12-12,1953,Arsenal,West Bromwich Albion,2-2,2,2,1,1,4,0,D
1953-12-12,1953,Aston Villa,Tottenham Hotspur,1-2,1,2,1,1,3,-1,A
1953-12-12,1953,Blackpool,Newcastle United,1-3,1,3,1,1,4,-2,A
1953-12-12,1953,Cardiff City,Middlesbrough,1-0,1,0,1,1,1,1,H
1953-12-12,1953,Chelsea,Manchester United,3-1,3,1,1,1,4,2,H
1953-12-12,1953,Huddersfield Town,Preston North End,2-2,2,2,1,1,4,0,D
1953-12-12,1953,Manchester City,Sheffield Wednesday,3-2,3,2,1,1,5,1,H
1953-12-12,1953,Portsmouth,Liverpool,5-1,5,1,1,1,6,4,H
1953-12-12,1953,Sheffield United,Bolton Wanderers,3-0,3,0,1,1,3,3,H
1953-12-12,1953,Sunderland,Charlton Athletic,2-1,2,1,1,1,3,1,H
1953-12-12,1953,Wolverhampton Wanderers,Burnley,1-2,1,2,1,1,3,-1,A
1953-12-19,1953,Aston Villa,Cardiff City,1-2,1,2,1,1,3,-1,A
1953-12-19,1953,Bolton Wanderers,West Bromwich Albion,2-1,2,1,1,1,3,1,H
1953-12-19,1953,Burnley,Charlton Athletic,2-0,2,0,1,1,2,2,H
1953-12-19,1953,Chelsea,Blackpool,5-1,5,1,1,1,6,4,H
1953-12-19,1953,Huddersfield Town,Arsenal,2-2,2,2,1,1,4,0,D
1953-12-19,1953,Manchester United,Liverpool,5-1,5,1,1,1,6,4,H
1953-12-19,1953,Preston North End,Middlesbrough,1-0,1,0,1,1,1,1,H
1953-12-19,1953,Sheffield United,Portsmouth,3-1,3,1,1,1,4,2,H
1953-12-19,1953,Sunderland,Newcastle United,1-1,1,1,1,1,2,0,D
1953-12-19,1953,Tottenham Hotspur,Sheffield Wednesday,3-1,3,1,1,1,4,2,H
1953-12-19,1953,Wolverhampton Wanderers,Manchester City,3-1,3,1,1,1,4,2,H
1953-12-24,1953,Wolverhampton Wanderers,Aston Villa,1-2,1,2,1,1,3,-1,A
1953-12-25,1953,Burnley,Preston North End,2-1,2,1,1,1,3,1,H
1953-12-25,1953,Charlton Athletic,Bolton Wanderers,1-0,1,0,1,1,1,1,H
1953-12-25,1953,Manchester United,Sheffield Wednesday,5-2,5,2,1,1,7,3,H
1953-12-25,1953,Middlesbrough,Newcastle United,2-3,2,3,1,1,5,-1,A
1953-12-25,1953,Sheffield United,Manchester City,2-2,2,2,1,1,4,0,D
1953-12-25,1953,Sunderland,Huddersfield Town,1-1,1,1,1,1,2,0,D
1953-12-25,1953,Tottenham Hotspur,Portsmouth,1-1,1,1,1,1,2,0,D
1953-12-25,1953,West Bromwich Albion,Liverpool,5-2,5,2,1,1,7,3,H
1953-12-26,1953,Aston Villa,Wolverhampton Wanderers,1-2,1,2,1,1,3,-1,A
1953-12-26,1953,Blackpool,Arsenal,2-2,2,2,1,1,4,0,D
1953-12-26,1953,Bolton Wanderers,Charlton Athletic,3-1,3,1,1,1,4,2,H
1953-12-26,1953,Chelsea,Cardiff City,2-0,2,0,1,1,2,2,H
1953-12-26,1953,Huddersfield Town,Sunderland,2-1,2,1,1,1,3,1,H
1953-12-26,1953,Liverpool,West Bromwich Albion,0-0,0,0,1,1,0,0,D
1953-12-26,1953,Manchester City,Sheffield United,2-1,2,1,1,1,3,1,H
1953-12-26,1953,Newcastle United,Middlesbrough,2-3,2,3,1,1,5,-1,A
1953-12-26,1953,Portsmouth,Tottenham Hotspur,1-1,1,1,1,1,2,0,D
1953-12-26,1953,Preston North End,Burnley,2-1,2,1,1,1,3,1,H
1953-12-26,1953,Sheffield Wednesday,Manchester United,0-1,0,1,1,1,1,-1,A
1953-12-28,1953,Arsenal,Blackpool,1-1,1,1,1,1,2,0,D
1953-12-28,1953,Cardiff City,Chelsea,0-0,0,0,1,1,0,0,D
1954-01-01,1953,Bolton Wanderers,Sheffield United,2-1,2,1,1,1,3,1,H
1954-01-01,1953,Newcastle United,Blackpool,2-1,2,1,1,1,3,1,H
1954-01-01,1953,Sunderland,Aston Villa,2-0,2,0,1,1,2,2,H
1954-01-02,1953,Blackpool,Sheffield United,2-2,2,2,1,1,4,0,D
1954-01-02,1953,Cardiff City,Wolverhampton Wanderers,1-3,1,3,1,1,4,-2,A
1954-01-02,1953,Charlton Athletic,Chelsea,1-1,1,1,1,1,2,0,D
1954-01-02,1953,Liverpool,Bolton Wanderers,1-2,1,2,1,1,3,-1,A
1954-01-02,1953,Manchester City,Sunderland,2-1,2,1,1,1,3,1,H
1954-01-02,1953,Middlesbrough,Tottenham Hotspur,3-0,3,0,1,1,3,3,H
1954-01-02,1953,Newcastle United,Manchester United,1-2,1,2,1,1,3,-1,A
1954-01-02,1953,Portsmouth,Huddersfield Town,5-2,5,2,1,1,7,3,H
1954-01-02,1953,Sheffield Wednesday,Burnley,2-0,2,0,1,1,2,2,H
1954-01-02,1953,West Bromwich Albion,Preston North End,3-2,3,2,1,1,5,1,H
1954-01-16,1953,Aston Villa,Portsmouth,1-1,1,1,1,1,2,0,D
1954-01-16,1953,Bolton Wanderers,Newcastle United,2-2,2,2,1,1,4,0,D
1954-01-16,1953,Burnley,Middlesbrough,5-0,5,0,1,1,5,5,H
1954-01-16,1953,Charlton Athletic,Sheffield Wednesday,4-2,4,2,1,1,6,2,H
1954-01-16,1953,Huddersfield Town,Blackpool,0-0,0,0,1,1,0,0,D
1954-01-16,1953,Manchester United,Manchester City,1-1,1,1,1,1,2,0,D
1954-01-16,1953,Preston North End,Liverpool,2-1,2,1,1,1,3,1,H
1954-01-16,1953,Sheffield United,Chelsea,1-3,1,3,1,1,4,-2,A
1954-01-16,1953,Sunderland,Cardiff City,5-0,5,0,1,1,5,5,H
1954-01-16,1953,Tottenham Hotspur,West Bromwich Albion,0-1,0,1,1,1,1,-1,A
1954-01-16,1953,Wolverhampton Wanderers,Arsenal,0-2,0,2,1,1,2,-2,A
1954-01-23,1953,Arsenal,Sunderland,1-4,1,4,1,1,5,-3,A
1954-01-23,1953,Blackpool,Aston Villa,3-2,3,2,1,1,5,1,H
1954-01-23,1953,Cardiff City,Manchester City,0-3,0,3,1,1,3,-3,A
1954-01-23,1953,Chelsea,Huddersfield Town,2-2,2,2,1,1,4,0,D
1954-01-23,1953,Liverpool,Tottenham Hotspur,2-2,2,2,1,1,4,0,D
1954-01-23,1953,Manchester United,Bolton Wanderers,1-5,1,5,1,1,6,-4,A
1954-01-23,1953,Middlesbrough,Charlton Athletic,0-2,0,2,1,1,2,-2,A
1954-01-23,1953,Newcastle United,Preston North End,0-4,0,4,1,1,4,-4,A
1954-01-23,1953,Portsmouth,Wolverhampton Wanderers,2-0,2,0,1,1,2,2,H
1954-01-23,1953,Sheffield Wednesday,Sheffield United,3-2,3,2,1,1,5,1,H
1954-01-23,1953,West Bromwich Albion,Burnley,0-0,0,0,1,1,0,0,D
1954-02-06,1953,Aston Villa,Chelsea,2-2,2,2,1,1,4,0,D
1954-02-06,1953,Bolton Wanderers,Cardiff City,3-0,3,0,1,1,3,3,H
1954-02-06,1953,Burnley,Liverpool,1-1,1,1,1,1,2,0,D
1954-02-06,1953,Charlton Athletic,West Bromwich Albion,1-1,1,1,1,1,2,0,D
1954-02-06,1953,Huddersfield Town,Sheffield United,2-2,2,2,1,1,4,0,D
1954-02-06,1953,Manchester City,Arsenal,0-0,0,0,1,1,0,0,D
1954-02-06,1953,Preston North End,Manchester United,1-3,1,3,1,1,4,-2,A
1954-02-06,1953,Sheffield Wednesday,Middlesbrough,4-2,4,2,1,1,6,2,H
1954-02-06,1953,Sunderland,Portsmouth,3-1,3,1,1,1,4,2,H
1954-02-06,1953,Tottenham Hotspur,Newcastle United,3-0,3,0,1,1,3,3,H
1954-02-06,1953,Wolverhampton Wanderers,Blackpool,4-1,4,1,1,1,5,3,H
1954-02-13,1953,Arsenal,Cardiff City,1-1,1,1,1,1,2,0,D
1954-02-13,1953,Blackpool,Sunderland,3-0,3,0,1,1,3,3,H
1954-02-13,1953,Bolton Wanderers,Preston North End,0-2,0,2,1,1,2,-2,A
1954-02-13,1953,Chelsea,Wolverhampton Wanderers,4-2,4,2,1,1,6,2,H
1954-02-13,1953,Liverpool,Charlton Athletic,2-3,2,3,1,1,5,-1,A
1954-02-13,1953,Manchester United,Tottenham Hotspur,2-0,2,0,1,1,2,2,H
1954-02-13,1953,Middlesbrough,Huddersfield Town,0-3,0,3,1,1,3,-3,A
1954-02-13,1953,Newcastle United,Burnley,3-1,3,1,1,1,4,2,H
1954-02-13,1953,Portsmouth,Manchester City,4-1,4,1,1,1,5,3,H
1954-02-13,1953,West Bromwich Albion,Sheffield Wednesday,4-2,4,2,1,1,6,2,H
1954-02-20,1953,Aston Villa,Huddersfield Town,2-2,2,2,1,1,4,0,D
1954-02-20,1953,Burnley,Manchester United,2-0,2,0,1,1,2,2,H
1954-02-20,1953,Sunderland,Chelsea,1-2,1,2,1,1,3,-1,A
1954-02-20,1953,Wolverhampton Wanderers,Sheffield United,6-1,6,1,1,1,7,5,H
1954-02-24,1953,Manchester City,Blackpool,1-4,1,4,1,1,5,-3,A
1954-02-24,1953,Middlesbrough,West Bromwich Albion,1-1,1,1,1,1,2,0,D
1954-02-24,1953,Preston North End,Arsenal,0-1,0,1,1,1,1,-1,A
1954-02-24,1953,Sheffield Wednesday,Liverpool,1-1,1,1,1,1,2,0,D
1954-02-25,1953,Charlton Athletic,Newcastle United,0-0,0,0,1,1,0,0,D
1954-02-27,1953,Arsenal,Tottenham Hotspur,0-3,0,3,1,1,3,-3,A
1954-02-27,1953,Aston Villa,Liverpool,2-1,2,1,1,1,3,1,H
1954-02-27,1953,Blackpool,Charlton Athletic,3-1,3,1,1,1,4,2,H
1954-02-27,1953,Cardiff City,Preston North End,2-1,2,1,1,1,3,1,H
1954-02-27,1953,Chelsea,Sheffield Wednesday,0-1,0,1,1,1,1,-1,A
1954-02-27,1953,Huddersfield Town,West Bromwich Albion,0-2,0,2,1,1,2,-2,A
1954-02-27,1953,Manchester City,Bolton Wanderers,3-0,3,0,1,1,3,3,H
1954-02-27,1953,Portsmouth,Burnley,3-2,3,2,1,1,5,1,H
1954-02-27,1953,Sheffield United,Middlesbrough,2-2,2,2,1,1,4,0,D
1954-02-27,1953,Sunderland,Manchester United,0-2,0,2,1,1,2,-2,A
1954-02-27,1953,Wolverhampton Wanderers,Newcastle United,3-2,3,2,1,1,5,1,H
1954-03-03,1953,Cardiff City,Portsmouth,3-2,3,2,1,1,5,1,H
1954-03-03,1953,Tottenham Hotspur,Bolton Wanderers,3-2,3,2,1,1,5,1,H
1954-03-06,1953,Bolton Wanderers,Sunderland,3-1,3,1,1,1,4,2,H
1954-03-06,1953,Burnley,Arsenal,2-1,2,1,1,1,3,1,H
1954-03-06,1953,Charlton Athletic,Portsmouth,3-1,3,1,1,1,4,2,H
1954-03-06,1953,Liverpool,Huddersfield Town,1-3,1,3,1,1,4,-2,A
1954-03-06,1953,Manchester United,Wolverhampton Wanderers,1-0,1,0,1,1,1,1,H
1954-03-06,1953,Middlesbrough,Chelsea,3-3,3,3,1,1,6,0,D
1954-03-06,1953,Newcastle United,Aston Villa,0-1,0,1,1,1,1,-1,A
1954-03-06,1953,Preston North End,Manchester City,4-0,4,0,1,1,4,4,H
1954-03-06,1953,Sheffield Wednesday,Blackpool,1-2,1,2,1,1,3,-1,A
1954-03-06,1953,Tottenham Hotspur,Cardiff City,0-1,0,1,1,1,1,-1,A
1954-03-06,1953,West Bromwich Albion,Sheffield United,2-2,2,2,1,1,4,0,D
1954-03-13,1953,Arsenal,Charlton Athletic,3-3,3,3,1,1,6,0,D
1954-03-13,1953,Aston Villa,Manchester United,2-2,2,2,1,1,4,0,D
1954-03-13,1953,Blackpool,Middlesbrough,0-0,0,0,1,1,0,0,D
1954-03-13,1953,Cardiff City,Burnley,1-0,1,0,1,1,1,1,H
1954-03-13,1953,Huddersfield Town,Newcastle United,3-2,3,2,1,1,5,1,H
1954-03-13,1953,Sheffield United,Liverpool,3-1,3,1,1,1,4,2,H
1954-03-17,1953,Chelsea,West Bromwich Albion,5-0,5,0,1,1,5,5,H
1954-03-17,1953,Manchester City,Tottenham Hotspur,4-1,4,1,1,1,5,3,H
1954-03-20,1953,Bolton Wanderers,Aston Villa,3-0,3,0,1,1,3,3,H
1954-03-20,1953,Burnley,Manchester City,3-1,3,1,1,1,4,2,H
1954-03-20,1953,Charlton Athletic,Cardiff City,3-2,3,2,1,1,5,1,H
1954-03-20,1953,Liverpool,Chelsea,1-1,1,1,1,1,2,0,D
1954-03-20,1953,Manchester United,Huddersfield Town,3-1,3,1,1,1,4,2,H
1954-03-20,1953,Middlesbrough,Portsmouth,2-2,2,2,1,1,4,0,D
1954-03-20,1953,Newcastle United,Sheffield United,4-1,4,1,1,1,5,3,H
1954-03-20,1953,Preston North End,Wolverhampton Wanderers,0-1,0,1,1,1,1,-1,A
1954-03-20,1953,Sheffield Wednesday,Arsenal,2-1,2,1,1,1,3,1,H
1954-03-20,1953,Tottenham Hotspur,Sunderland,0-3,0,3,1,1,3,-3,A
1954-03-20,1953,West Bromwich Albion,Blackpool,2-1,2,1,1,1,3,1,H
1954-03-24,1953,Wolverhampton Wanderers,Bolton Wanderers,1-1,1,1,1,1,2,0,D
1954-03-27,1953,Arsenal,Manchester United,3-1,3,1,1,1,4,2,H
1954-03-27,1953,Cardiff City,Newcastle United,2-1,2,1,1,1,3,1,H
1954-03-27,1953,Chelsea,Tottenham Hotspur,1-0,1,0,1,1,1,1,H
1954-03-27,1953,Huddersfield Town,Charlton Athletic,4-1,4,1,1,1,5,3,H
1954-03-27,1953,Portsmouth,Bolton Wanderers,3-2,3,2,1,1,5,1,H
1954-03-27,1953,Sheffield United,Burnley,2-1,2,1,1,1,3,1,H
1954-03-27,1953,Wolverhampton Wanderers,Middlesbrough,2-4,2,4,1,1,6,-2,A
1954-03-31,1953,Aston Villa,Sheffield Wednesday,2-1,2,1,1,1,3,1,H
1954-03-31,1953,Blackpool,Preston North End,4-2,4,2,1,1,6,2,H
1954-03-31,1953,Sunderland,West Bromwich Albion,2-1,2,1,1,1,3,1,H
1954-04-03,1953,Bolton Wanderers,Arsenal,3-1,3,1,1,1,4,2,H
1954-04-03,1953,Burnley,Chelsea,1-2,1,2,1,1,3,-1,A
1954-04-03,1953,Charlton Athletic,Sheffield United,3-0,3,0,1,1,3,3,H
1954-04-03,1953,Liverpool,Sunderland,4-3,4,3,1,1,7,1,H
1954-04-03,1953,Manchester United,Cardiff City,2-3,2,3,1,1,5,-1,A
1954-04-03,1953,Middlesbrough,Aston Villa,2-1,2,1,1,1,3,1,H
1954-04-03,1953,Newcastle United,Manchester City,4-3,4,3,1,1,7,1,H
1954-04-03,1953,Preston North End,Portsmouth,4-0,4,0,1,1,4,4,H
1954-04-03,1953,Sheffield Wednesday,Huddersfield Town,1-4,1,4,1,1,5,-3,A
1954-04-03,1953,Tottenham Hotspur,Blackpool,2-2,2,2,1,1,4,0,D
1954-04-03,1953,West Bromwich Albion,Wolverhampton Wanderers,0-1,0,1,1,1,1,-1,A
1954-04-06,1953,Arsenal,Aston Villa,1-1,1,1,1,1,2,0,D
1954-04-07,1953,Manchester City,Liverpool,0-2,0,2,1,1,2,-2,A
1954-04-07,1953,Portsmouth,Sheffield Wednesday,2-1,2,1,1,1,3,1,H
1954-04-07,1953,Sunderland,Preston North End,2-2,2,2,1,1,4,0,D
1954-04-10,1953,Arsenal,Liverpool,3-0,3,0,1,1,3,3,H
1954-04-10,1953,Aston Villa,Burnley,5-1,5,1,1,1,6,4,H
1954-04-10,1953,Blackpool,Manchester United,2-0,2,0,1,1,2,2,H
1954-04-10,1953,Cardiff City,West Bromwich Albion,2-0,2,0,1,1,2,2,H
1954-04-10,1953,Chelsea,Bolton Wanderers,2-0,2,0,1,1,2,2,H
1954-04-10,1953,Huddersfield Town,Tottenham Hotspur,2-5,2,5,1,1,7,-3,A
1954-04-10,1953,Manchester City,Middlesbrough,5-2,5,2,1,1,7,3,H
1954-04-10,1953,Portsmouth,Newcastle United,2-0,2,0,1,1,2,2,H
1954-04-10,1953,Sheffield United,Preston North End,1-1,1,1,1,1,2,0,D
1954-04-10,1953,Sunderland,Sheffield Wednesday,2-4,2,4,1,1,6,-2,A
1954-04-10,1953,Wolverhampton Wanderers,Charlton Athletic,5-0,5,0,1,1,5,5,H
1954-04-16,1953,Arsenal,Portsmouth,3-0,3,0,1,1,3,3,H
1954-04-16,1953,Blackpool,Cardiff City,4-1,4,1,1,1,5,3,H
1954-04-16,1953,Bolton Wanderers,Burnley,0-0,0,0,1,1,0,0,D
1954-04-16,1953,Chelsea,Manchester City,0-1,0,1,1,1,1,-1,A
1954-04-16,1953,Manchester United,Charlton Athletic,2-0,2,0,1,1,2,2,H
1954-04-16,1953,Middlesbrough,Liverpool,0-1,0,1,1,1,1,-1,A
1954-04-16,1953,Newcastle United,Sheffield Wednesday,3-0,3,0,1,1,3,3,H
1954-04-16,1953,Preston North End,Tottenham Hotspur,2-1,2,1,1,1,3,1,H
1954-04-16,1953,Sunderland,Sheffield United,2-2,2,2,1,1,4,0,D
1954-04-17,1953,Bolton Wanderers,Blackpool,3-2,3,2,1,1,5,1,H
1954-04-17,1953,Burnley,Huddersfield Town,2-1,2,1,1,1,3,1,H
1954-04-17,1953,Charlton Athletic,Aston Villa,1-1,1,1,1,1,2,0,D
1954-04-17,1953,Liverpool,Cardiff City,0-1,0,1,1,1,1,-1,A
1954-04-17,1953,Manchester United,Portsmouth,2-0,2,0,1,1,2,2,H
1954-04-17,1953,Middlesbrough,Sunderland,0-0,0,0,1,1,0,0,D
1954-04-17,1953,Newcastle United,Arsenal,5-2,5,2,1,1,7,3,H
1954-04-17,1953,Preston North End,Chelsea,1-0,1,0,1,1,1,1,H
1954-04-17,1953,Sheffield Wednesday,Wolverhampton Wanderers,0-0,0,0,1,1,0,0,D
1954-04-17,1953,Tottenham Hotspur,Sheffield United,2-1,2,1,1,1,3,1,H
1954-04-17,1953,West Bromwich Albion,Manchester City,1-0,1,0,1,1,1,1,H
1954-04-19,1953,Burnley,Bolton Wanderers,1-1,1,1,1,1,2,0,D
1954-04-19,1953,Cardiff City,Blackpool,0-1,0,1,1,1,1,-1,A
1954-04-19,1953,Charlton Athletic,Manchester United,1-0,1,0,1,1,1,1,H
1954-04-19,1953,Liverpool,Middlesbrough,4-1,4,1,1,1,5,3,H
1954-04-19,1953,Manchester City,Chelsea,1-1,1,1,1,1,2,0,D
1954-04-19,1953,Portsmouth,Arsenal,1-1,1,1,1,1,2,0,D
1954-04-19,1953,Sheffield United,Sunderland,1-3,1,3,1,1,4,-2,A
1954-04-19,1953,Tottenham Hotspur,Preston North End,2-6,2,6,1,1,8,-4,A
1954-04-19,1953,West Bromwich Albion,Aston Villa,1-1,1,1,1,1,2,0,D
1954-04-19,1953,Wolverhampton Wanderers,Huddersfield Town,4-0,4,0,1,1,4,4,H
1954-04-20,1953,Aston Villa,West Bromwich Albion,6-1,6,1,1,1,7,5,H
1954-04-20,1953,Huddersfield Town,Wolverhampton Wanderers,2-1,2,1,1,1,3,1,H
1954-04-24,1953,Arsenal,Middlesbrough,3-1,3,1,1,1,4,2,H
1954-04-24,1953,Aston Villa,Preston North End,1-0,1,0,1,1,1,1,H
1954-04-24,1953,Blackpool,Liverpool,3-0,3,0,1,1,3,3,H
1954-04-24,1953,Cardiff City,Sheffield Wednesday,2-2,2,2,1,1,4,0,D
1954-04-24,1953,Chelsea,Newcastle United,1-2,1,2,1,1,3,-1,A
1954-04-24,1953,Huddersfield Town,Bolton Wanderers,2-1,2,1,1,1,3,1,H
1954-04-24,1953,Manchester City,Charlton Athletic,3-0,3,0,1,1,3,3,H
1954-04-24,1953,Portsmouth,West Bromwich Albion,3-0,3,0,1,1,3,3,H
1954-04-24,1953,Sheffield United,Manchester United,1-3,1,3,1,1,4,-2,A
1954-04-24,1953,Sunderland,Burnley,2-1,2,1,1,1,3,1,H
1954-04-24,1953,Wolverhampton Wanderers,Tottenham Hotspur,2-0,2,0,1,1,2,2,H
1954-04-26,1953,Sheffield United,Aston Villa,2-1,2,1,1,1,3,1,H
1954-08-21,1954,Arsenal,Newcastle United,1-3,1,3,1,1,4,-2,A
1954-08-21,1954,Aston Villa,Tottenham Hotspur,2-4,2,4,1,1,6,-2,A
1954-08-21,1954,Bolton Wanderers,Charlton Athletic,3-2,3,2,1,1,5,1,H
1954-08-21,1954,Burnley,Cardiff City,1-0,1,0,1,1,1,1,H
1954-08-21,1954,Huddersfield Town,Blackpool,1-3,1,3,1,1,4,-2,A
1954-08-21,1954,Leicester City,Chelsea,1-1,1,1,1,1,2,0,D
1954-08-21,1954,Manchester United,Portsmouth,1-3,1,3,1,1,4,-2,A
1954-08-21,1954,Preston North End,Manchester City,5-0,5,0,1,1,5,5,H
1954-08-21,1954,Sheffield United,Everton,2-5,2,5,1,1,7,-3,A
1954-08-21,1954,Sunderland,West Bromwich Albion,4-2,4,2,1,1,6,2,H
1954-08-21,1954,Wolverhampton Wanderers,Sheffield Wednesday,4-2,4,2,1,1,6,2,H
1954-08-23,1954,Aston Villa,Sunderland,2-2,2,2,1,1,4,0,D
1954-08-23,1954,Blackpool,Bolton Wanderers,2-3,2,3,1,1,5,-1,A
1954-08-23,1954,Chelsea,Burnley,1-0,1,0,1,1,1,1,H
1954-08-23,1954,Sheffield Wednesday,Manchester United,2-4,2,4,1,1,6,-2,A
1954-08-25,1954,Cardiff City,Preston North End,2-5,2,5,1,1,7,-3,A
1954-08-25,1954,Everton,Arsenal,1-0,1,0,1,1,1,1,H
1954-08-25,1954,Manchester City,Sheffield United,5-2,5,2,1,1,7,3,H
1954-08-25,1954,Newcastle United,West Bromwich Albion,3-0,3,0,1,1,3,3,H
1954-08-25,1954,Portsmouth,Huddersfield Town,4-2,4,2,1,1,6,2,H
1954-08-25,1954,Tottenham Hotspur,Wolverhampton Wanderers,3-2,3,2,1,1,5,1,H
1954-08-26,1954,Charlton Athletic,Leicester City,2-3,2,3,1,1,5,-1,A
1954-08-28,1954,Blackpool,Manchester United,2-4,2,4,1,1,6,-2,A
1954-08-28,1954,Cardiff City,Leicester City,2-1,2,1,1,1,3,1,H
1954-08-28,1954,Charlton Athletic,Huddersfield Town,2-1,2,1,1,1,3,1,H
1954-08-28,1954,Chelsea,Bolton Wanderers,3-2,3,2,1,1,5,1,H
1954-08-28,1954,Everton,Preston North End,1-0,1,0,1,1,1,1,H
1954-08-28,1954,Manchester City,Burnley,0-0,0,0,1,1,0,0,D
1954-08-28,1954,Newcastle United,Sheffield United,1-2,1,2,1,1,3,-1,A
1954-08-28,1954,Portsmouth,Wolverhampton Wanderers,0-0,0,0,1,1,0,0,D
1954-08-28,1954,Sheffield Wednesday,Aston Villa,6-3,6,3,1,1,9,3,H
1954-08-28,1954,Tottenham Hotspur,Sunderland,0-1,0,1,1,1,1,-1,A
1954-08-28,1954,West Bromwich Albion,Arsenal,3-1,3,1,1,1,4,2,H
1954-08-30,1954,Huddersfield Town,Portsmouth,2-1,2,1,1,1,3,1,H
1954-08-30,1954,Leicester City,Charlton Athletic,0-1,0,1,1,1,1,-1,A
1954-08-30,1954,Sheffield United,Manchester City,0-2,0,2,1,1,2,-2,A
1954-08-30,1954,Wolverhampton Wanderers,Tottenham Hotspur,4-2,4,2,1,1,6,2,H
1954-08-31,1954,Arsenal,Everton,2-0,2,0,1,1,2,2,H
1954-08-31,1954,Burnley,Chelsea,1-1,1,1,1,1,2,0,D
1954-09-01,1954,Bolton Wanderers,Blackpool,3-0,3,0,1,1,3,3,H
1954-09-01,1954,Manchester United,Sheffield Wednesday,2-0,2,0,1,1,2,2,H
1954-09-01,1954,Preston North End,Cardiff City,7-1,7,1,1,1,8,6,H
1954-09-01,1954,Sunderland,Aston Villa,0-0,0,0,1,1,0,0,D
1954-09-01,1954,West Bromwich Albion,Newcastle United,4-2,4,2,1,1,6,2,H
1954-09-04,1954,Arsenal,Tottenham Hotspur,2-0,2,0,1,1,2,2,H
1954-09-04,1954,Aston Villa,Portsmouth,1-0,1,0,1,1,1,1,H
1954-09-04,1954,Burnley,Everton,0-2,0,2,1,1,2,-2,A
1954-09-04,1954,Chelsea,Cardiff City,1-1,1,1,1,1,2,0,D
1954-09-04,1954,Huddersfield Town,Bolton Wanderers,2-0,2,0,1,1,2,2,H
1954-09-04,1954,Leicester City,Manchester City,0-2,0,2,1,1,2,-2,A
1954-09-04,1954,Manchester United,Charlton Athletic,3-1,3,1,1,1,4,2,H
1954-09-04,1954,Preston North End,Newcastle United,3-3,3,3,1,1,6,0,D
1954-09-04,1954,Sheffield United,West Bromwich Albion,1-2,1,2,1,1,3,-1,A
1954-09-04,1954,Sunderland,Sheffield Wednesday,2-0,2,0,1,1,2,2,H
1954-09-04,1954,Wolverhampton Wanderers,Blackpool,1-0,1,0,1,1,1,1,H
1954-09-06,1954,Bolton Wanderers,Portsmouth,3-1,3,1,1,1,4,2,H
1954-09-06,1954,Burnley,Leicester City,3-1,3,1,1,1,4,2,H
1954-09-06,1954,Chelsea,Preston North End,0-1,0,1,1,1,1,-1,A
1954-09-06,1954,Sheffield Wednesday,Huddersfield Town,4-1,4,1,1,1,5,3,H
1954-09-08,1954,Cardiff City,Sheffield United,1-1,1,1,1,1,2,0,D
1954-09-08,1954,Everton,West Bromwich Albion,1-2,1,2,1,1,3,-1,A
1954-09-08,1954,Manchester City,Arsenal,2-1,2,1,1,1,3,1,H
1954-09-08,1954,Newcastle United,Aston Villa,5-3,5,3,1,1,8,2,H
1954-09-08,1954,Tottenham Hotspur,Manchester United,0-2,0,2,1,1,2,-2,A
1954-09-08,1954,Wolverhampton Wanderers,Sunderland,2-0,2,0,1,1,2,2,H
1954-09-11,1954,Arsenal,Sheffield United,4-0,4,0,1,1,4,4,H
1954-09-11,1954,Blackpool,Aston Villa,0-1,0,1,1,1,1,-1,A
1954-09-11,1954,Bolton Wanderers,Manchester United,1-1,1,1,1,1,2,0,D
1954-09-11,1954,Cardiff City,Huddersfield Town,1-1,1,1,1,1,2,0,D
1954-09-11,1954,Charlton Athletic,Wolverhampton Wanderers,1-3,1,3,1,1,4,-2,A
1954-09-11,1954,Everton,Leicester City,2-2,2,2,1,1,4,0,D
1954-09-11,1954,Manchester City,Chelsea,1-1,1,1,1,1,2,0,D
1954-09-11,1954,Newcastle United,Burnley,2-1,2,1,1,1,3,1,H
1954-09-11,1954,Portsmouth,Sunderland,2-2,2,2,1,1,4,0,D
1954-09-11,1954,Sheffield Wednesday,Tottenham Hotspur,2-2,2,2,1,1,4,0,D
1954-09-11,1954,West Bromwich Albion,Preston North End,2-0,2,0,1,1,2,2,H
1954-09-13,1954,Aston Villa,Newcastle United,1-2,1,2,1,1,3,-1,A
1954-09-13,1954,Huddersfield Town,Sheffield Wednesday,3-0,3,0,1,1,3,3,H
1954-09-13,1954,Leicester City,Burnley,2-2,2,2,1,1,4,0,D
1954-09-13,1954,Sheffield United,Cardiff City,1-3,1,3,1,1,4,-2,A
1954-09-14,1954,Arsenal,Manchester City,2-3,2,3,1,1,5,-1,A
1954-09-15,1954,Manchester United,Tottenham Hotspur,2-1,2,1,1,1,3,1,H
1954-09-15,1954,Portsmouth,Bolton Wanderers,1-0,1,0,1,1,1,1,H
1954-09-15,1954,Preston North End,Chelsea,1-2,1,2,1,1,3,-1,A
1954-09-15,1954,Sunderland,Wolverhampton Wanderers,0-0,0,0,1,1,0,0,D
1954-09-15,1954,West Bromwich Albion,Everton,3-3,3,3,1,1,6,0,D
1954-09-16,1954,Charlton Athletic,Blackpool,3-3,3,3,1,1,6,0,D
1954-09-18,1954,Aston Villa,Charlton Athletic,1-2,1,2,1,1,3,-1,A
1954-09-18,1954,Burnley,West Bromwich Albion,0-2,0,2,1,1,2,-2,A
1954-09-18,1954,Cardiff City,Manchester City,3-0,3,0,1,1,3,3,H
1954-09-18,1954,Chelsea,Everton,0-2,0,2,1,1,2,-2,A
1954-09-18,1954,Leicester City,Newcastle United,3-2,3,2,1,1,5,1,H
1954-09-18,1954,Manchester United,Huddersfield Town,1-1,1,1,1,1,2,0,D
1954-09-18,1954,Preston North End,Arsenal,3-1,3,1,1,1,4,2,H
1954-09-18,1954,Sheffield United,Sheffield Wednesday,1-0,1,0,1,1,1,1,H
1954-09-18,1954,Sunderland,Blackpool,2-0,2,0,1,1,2,2,H
1954-09-18,1954,Tottenham Hotspur,Portsmouth,1-1,1,1,1,1,2,0,D
1954-09-18,1954,Wolverhampton Wanderers,Bolton Wanderers,1-2,1,2,1,1,3,-1,A
1954-09-20,1954,Blackpool,Charlton Athletic,1-1,1,1,1,1,2,0,D
1954-09-20,1954,Sheffield United,Chelsea,1-2,1,2,1,1,3,-1,A
1954-09-25,1954,Arsenal,Burnley,4-0,4,0,1,1,4,4,H
1954-09-25,1954,Blackpool,Tottenham Hotspur,5-1,5,1,1,1,6,4,H
1954-09-25,1954,Bolton Wanderers,Aston Villa,3-3,3,3,1,1,6,0,D
1954-09-25,1954,Charlton Athletic,Sunderland,1-3,1,3,1,1,4,-2,A
1954-09-25,1954,Everton,Cardiff City,1-1,1,1,1,1,2,0,D
1954-09-25,1954,Huddersfield Town,Wolverhampton Wanderers,2-0,2,0,1,1,2,2,H
1954-09-25,1954,Manchester City,Manchester United,3-2,3,2,1,1,5,1,H
1954-09-25,1954,Newcastle United,Chelsea,1-3,1,3,1,1,4,-2,A
1954-09-25,1954,Portsmouth,Sheffield Wednesday,2-1,2,1,1,1,3,1,H
1954-09-25,1954,Sheffield United,Preston North End,0-5,0,5,1,1,5,-5,A
1954-09-25,1954,West Bromwich Albion,Leicester City,6-4,6,4,1,1,10,2,H
1954-10-02,1954,Aston Villa,Huddersfield Town,0-0,0,0,1,1,0,0,D
1954-10-02,1954,Burnley,Sheffield United,2-1,2,1,1,1,3,1,H
1954-10-02,1954,Cardiff City,Newcastle United,4-2,4,2,1,1,6,2,H
1954-10-02,1954,Chelsea,West Bromwich Albion,3-3,3,3,1,1,6,0,D
1954-10-02,1954,Leicester City,Arsenal,3-3,3,3,1,1,6,0,D
1954-10-02,1954,Manchester City,Everton,1-0,1,0,1,1,1,1,H
1954-10-02,1954,Preston North End,Portsmouth,1-1,1,1,1,1,2,0,D
1954-10-02,1954,Sheffield Wednesday,Blackpool,2-1,2,1,1,1,3,1,H
1954-10-02,1954,Sunderland,Bolton Wanderers,1-1,1,1,1,1,2,0,D
1954-10-02,1954,Tottenham Hotspur,Charlton Athletic,1-4,1,4,1,1,5,-3,A
1954-10-02,1954,Wolverhampton Wanderers,Manchester United,4-2,4,2,1,1,6,2,H
1954-10-09,1954,Aston Villa,Everton,0-2,0,2,1,1,2,-2,A
1954-10-09,1954,Blackpool,Preston North End,1-2,1,2,1,1,3,-1,A
1954-10-09,1954,Bolton Wanderers,Leicester City,4-1,4,1,1,1,5,3,H
1954-10-09,1954,Charlton Athletic,Burnley,3-1,3,1,1,1,4,2,H
1954-10-09,1954,Huddersfield Town,Chelsea,1-0,1,0,1,1,1,1,H
1954-10-09,1954,Manchester United,Cardiff City,5-2,5,2,1,1,7,3,H
1954-10-09,1954,Portsmouth,Sheffield United,6-2,6,2,1,1,8,4,H
1954-10-09,1954,Sheffield Wednesday,Arsenal,1-2,1,2,1,1,3,-1,A
1954-10-09,1954,Sunderland,Newcastle United,4-2,4,2,1,1,6,2,H
1954-10-09,1954,Tottenham Hotspur,West Bromwich Albion,3-1,3,1,1,1,4,2,H
1954-10-09,1954,Wolverhampton Wanderers,Manchester City,2-2,2,2,1,1,4,0,D
1954-10-16,1954,Arsenal,Portsmouth,0-1,0,1,1,1,1,-1,A
1954-10-16,1954,Burnley,Bolton Wanderers,2-0,2,0,1,1,2,2,H
1954-10-16,1954,Chelsea,Manchester United,5-6,5,6,1,1,11,-1,A
1954-10-16,1954,Everton,Sunderland,1-0,1,0,1,1,1,1,H
1954-10-16,1954,Leicester City,Huddersfield Town,1-3,1,3,1,1,4,-2,A
1954-10-16,1954,Manchester City,Aston Villa,2-4,2,4,1,1,6,-2,A
1954-10-16,1954,Newcastle United,Tottenham Hotspur,4-4,4,4,1,1,8,0,D
1954-10-16,1954,Preston North End,Charlton Athletic,1-2,1,2,1,1,3,-1,A
1954-10-16,1954,Sheffield United,Blackpool,2-1,2,1,1,1,3,1,H
1954-10-16,1954,West Bromwich Albion,Sheffield Wednesday,1-2,1,2,1,1,3,-1,A
1954-10-16,1954,Wolverhampton Wanderers,Cardiff City,1-1,1,1,1,1,2,0,D
1954-10-23,1954,Aston Villa,Arsenal,2-1,2,1,1,1,3,1,H
1954-10-23,1954,Blackpool,Chelsea,1-0,1,0,1,1,1,1,H
1954-10-23,1954,Bolton Wanderers,Manchester City,2-2,2,2,1,1,4,0,D
1954-10-23,1954,Charlton Athletic,Cardiff City,4-1,4,1,1,1,5,3,H
1954-10-23,1954,Huddersfield Town,Everton,2-1,2,1,1,1,3,1,H
1954-10-23,1954,Manchester United,Newcastle United,2-2,2,2,1,1,4,0,D
1954-10-23,1954,Portsmouth,Leicester City,2-1,2,1,1,1,3,1,H
1954-10-23,1954,Sheffield Wednesday,Burnley,1-1,1,1,1,1,2,0,D
1954-10-23,1954,Sunderland,Sheffield United,2-2,2,2,1,1,4,0,D
1954-10-23,1954,Tottenham Hotspur,Preston North End,3-1,3,1,1,1,4,2,H
1954-10-23,1954,Wolverhampton Wanderers,West Bromwich Albion,4-0,4,0,1,1,4,4,H
1954-10-30,1954,Arsenal,Sunderland,1-3,1,3,1,1,4,-2,A
1954-10-30,1954,Burnley,Portsmouth,1-0,1,0,1,1,1,1,H
1954-10-30,1954,Cardiff City,Bolton Wanderers,2-2,2,2,1,1,4,0,D
1954-10-30,1954,Chelsea,Charlton Athletic,1-2,1,2,1,1,3,-1,A
1954-10-30,1954,Everton,Manchester United,4-2,4,2,1,1,6,2,H
1954-10-30,1954,Leicester City,Blackpool,2-2,2,2,1,1,4,0,D
1954-10-30,1954,Manchester City,Huddersfield Town,2-4,2,4,1,1,6,-2,A
1954-10-30,1954,Newcastle United,Wolverhampton Wanderers,2-3,2,3,1,1,5,-1,A
1954-10-30,1954,Preston North End,Sheffield Wednesday,6-0,6,0,1,1,6,6,H
1954-10-30,1954,Sheffield United,Tottenham Hotspur,4-1,4,1,1,1,5,3,H
1954-10-30,1954,West Bromwich Albion,Aston Villa,2-3,2,3,1,1,5,-1,A
1954-11-06,1954,Aston Villa,Leicester City,2-5,2,5,1,1,7,-3,A
1954-11-06,1954,Blackpool,Newcastle United,2-0,2,0,1,1,2,2,H
1954-11-06,1954,Bolton Wanderers,Arsenal,2-2,2,2,1,1,4,0,D
1954-11-06,1954,Charlton Athletic,West Bromwich Albion,1-3,1,3,1,1,4,-2,A
1954-11-06,1954,Huddersfield Town,Sheffield United,1-2,1,2,1,1,3,-1,A
1954-11-06,1954,Manchester United,Preston North End,2-1,2,1,1,1,3,1,H
1954-11-06,1954,Portsmouth,Everton,5-0,5,0,1,1,5,5,H
1954-11-06,1954,Sheffield Wednesday,Manchester City,2-4,2,4,1,1,6,-2,A
1954-11-06,1954,Sunderland,Chelsea,3-3,3,3,1,1,6,0,D
1954-11-06,1954,Tottenham Hotspur,Cardiff City,0-2,0,2,1,1,2,-2,A
1954-11-06,1954,Wolverhampton Wanderers,Burnley,5-0,5,0,1,1,5,5,H
1954-11-13,1954,Arsenal,Huddersfield Town,3-5,3,5,1,1,8,-2,A
1954-11-13,1954,Burnley,Aston Villa,2-0,2,0,1,1,2,2,H
1954-11-13,1954,Cardiff City,Sheffield Wednesday,5-3,5,3,1,1,8,2,H
1954-11-13,1954,Chelsea,Tottenham Hotspur,2-1,2,1,1,1,3,1,H
1954-11-13,1954,Everton,Blackpool,0-1,0,1,1,1,1,-1,A
1954-11-13,1954,Leicester City,Sunderland,1-1,1,1,1,1,2,0,D
1954-11-13,1954,Manchester City,Portsmouth,1-2,1,2,1,1,3,-1,A
1954-11-13,1954,Newcastle United,Charlton Athletic,3-1,3,1,1,1,4,2,H
1954-11-13,1954,Preston North End,Wolverhampton Wanderers,3-3,3,3,1,1,6,0,D
1954-11-13,1954,Sheffield United,Manchester United,3-0,3,0,1,1,3,3,H
1954-11-13,1954,West Bromwich Albion,Bolton Wanderers,0-0,0,0,1,1,0,0,D
1954-11-20,1954,Aston Villa,Preston North End,1-3,1,3,1,1,4,-2,A
1954-11-20,1954,Blackpool,Manchester City,1-3,1,3,1,1,4,-2,A
1954-11-20,1954,Bolton Wanderers,Newcastle United,2-1,2,1,1,1,3,1,H
1954-11-20,1954,Charlton Athletic,Everton,5-0,5,0,1,1,5,5,H
1954-11-20,1954,Huddersfield Town,West Bromwich Albion,3-3,3,3,1,1,6,0,D
1954-11-20,1954,Manchester United,Arsenal,2-1,2,1,1,1,3,1,H
1954-11-20,1954,Portsmouth,Cardiff City,1-3,1,3,1,1,4,-2,A
1954-11-20,1954,Sheffield Wednesday,Chelsea,1-1,1,1,1,1,2,0,D
1954-11-20,1954,Sunderland,Burnley,2-2,2,2,1,1,4,0,D
1954-11-20,1954,Tottenham Hotspur,Leicester City,5-1,5,1,1,1,6,4,H
1954-11-20,1954,Wolverhampton Wanderers,Sheffield United,4-1,4,1,1,1,5,3,H
1954-11-27,1954,Arsenal,Wolverhampton Wanderers,1-1,1,1,1,1,2,0,D
1954-11-27,1954,Burnley,Tottenham Hotspur,1-2,1,2,1,1,3,-1,A
1954-11-27,1954,Cardiff City,Blackpool,1-2,1,2,1,1,3,-1,A
1954-11-27,1954,Chelsea,Portsmouth,4-1,4,1,1,1,5,3,H
1954-11-27,1954,Everton,Bolton Wanderers,0-0,0,0,1,1,0,0,D
1954-11-27,1954,Leicester City,Sheffield Wednesday,4-3,4,3,1,1,7,1,H
1954-11-27,1954,Manchester City,Charlton Athletic,1-5,1,5,1,1,6,-4,A
1954-11-27,1954,Newcastle United,Huddersfield Town,2-2,2,2,1,1,4,0,D
1954-11-27,1954,Preston North End,Sunderland,3-1,3,1,1,1,4,2,H
1954-11-27,1954,Sheffield United,Aston Villa,1-3,1,3,1,1,4,-2,A
1954-11-27,1954,West Bromwich Albion,Manchester United,2-0,2,0,1,1,2,2,H
1954-12-04,1954,Aston Villa,Cardiff City,0-2,0,2,1,1,2,-2,A
1954-12-04,1954,Blackpool,Arsenal,2-2,2,2,1,1,4,0,D
1954-12-04,1954,Charlton Athletic,Sheffield United,3-1,3,1,1,1,4,2,H
1954-12-04,1954,Huddersfield Town,Burnley,0-1,0,1,1,1,1,-1,A
1954-12-04,1954,Manchester United,Leicester City,3-1,3,1,1,1,4,2,H
1954-12-04,1954,Portsmouth,West Bromwich Albion,6-1,6,1,1,1,7,5,H
1954-12-04,1954,Sheffield Wednesday,Newcastle United,0-3,0,3,1,1,3,-3,A
1954-12-04,1954,Sunderland,Manchester City,3-2,3,2,1,1,5,1,H
1954-12-04,1954,Tottenham Hotspur,Everton,1-3,1,3,1,1,4,-2,A
1954-12-04,1954,Wolverhampton Wanderers,Chelsea,3-4,3,4,1,1,7,-1,A
1954-12-11,1954,Arsenal,Charlton Athletic,3-1,3,1,1,1,4,2,H
1954-12-11,1954,Burnley,Manchester United,2-4,2,4,1,1,6,-2,A
1954-12-11,1954,Cardiff City,Sunderland,0-1,0,1,1,1,1,-1,A
1954-12-11,1954,Chelsea,Aston Villa,4-0,4,0,1,1,4,4,H
1954-12-11,1954,Everton,Sheffield Wednesday,3-1,3,1,1,1,4,2,H
1954-12-11,1954,Leicester City,Wolverhampton Wanderers,1-2,1,2,1,1,3,-1,A
1954-12-11,1954,Manchester City,Tottenham Hotspur,0-0,0,0,1,1,0,0,D
1954-12-11,1954,Newcastle United,Portsmouth,2-1,2,1,1,1,3,1,H
1954-12-11,1954,Preston North End,Huddersfield Town,2-3,2,3,1,1,5,-1,A
1954-12-11,1954,Sheffield United,Bolton Wanderers,2-0,2,0,1,1,2,2,H
1954-12-11,1954,West Bromwich Albion,Blackpool,0-1,0,1,1,1,1,-1,A
1954-12-18,1954,Blackpool,Huddersfield Town,1-1,1,1,1,1,2,0,D
1954-12-18,1954,Cardiff City,Burnley,0-3,0,3,1,1,3,-3,A
1954-12-18,1954,Charlton Athletic,Bolton Wanderers,2-0,2,0,1,1,2,2,H
1954-12-18,1954,Chelsea,Leicester City,3-1,3,1,1,1,4,2,H
1954-12-18,1954,Everton,Sheffield United,2-3,2,3,1,1,5,-1,A
1954-12-18,1954,Manchester City,Preston North End,3-1,3,1,1,1,4,2,H
1954-12-18,1954,Newcastle United,Arsenal,5-1,5,1,1,1,6,4,H
1954-12-18,1954,Portsmouth,Manchester United,0-0,0,0,1,1,0,0,D
1954-12-18,1954,Sheffield Wednesday,Wolverhampton Wanderers,2-2,2,2,1,1,4,0,D
1954-12-18,1954,Tottenham Hotspur,Aston Villa,1-1,1,1,1,1,2,0,D
1954-12-18,1954,West Bromwich Albion,Sunderland,2-2,2,2,1,1,4,0,D
1954-12-25,1954,Arsenal,Chelsea,1-0,1,0,1,1,1,1,H
1954-12-25,1954,Blackpool,Portsmouth,2-2,2,2,1,1,4,0,D
1954-12-25,1954,Bolton Wanderers,Tottenham Hotspur,1-2,1,2,1,1,3,-1,A
1954-12-25,1954,Burnley,Preston North End,2-2,2,2,1,1,4,0,D
1954-12-25,1954,Cardiff City,West Bromwich Albion,3-2,3,2,1,1,5,1,H
1954-12-25,1954,Charlton Athletic,Sheffield Wednesday,3-0,3,0,1,1,3,3,H
1954-12-25,1954,Manchester City,Newcastle United,3-1,3,1,1,1,4,2,H
1954-12-25,1954,Sheffield United,Leicester City,1-1,1,1,1,1,2,0,D
1954-12-25,1954,Sunderland,Huddersfield Town,1-1,1,1,1,1,2,0,D
1954-12-25,1954,Wolverhampton Wanderers,Everton,1-3,1,3,1,1,4,-2,A
1954-12-27,1954,Chelsea,Arsenal,1-1,1,1,1,1,2,0,D
1954-12-27,1954,Everton,Wolverhampton Wanderers,3-2,3,2,1,1,5,1,H
1954-12-27,1954,Huddersfield Town,Sunderland,1-1,1,1,1,1,2,0,D
1954-12-27,1954,Leicester City,Sheffield United,0-1,0,1,1,1,1,-1,A
1954-12-27,1954,Manchester United,Aston Villa,0-1,0,1,1,1,1,-1,A
1954-12-27,1954,Newcastle United,Manchester City,2-0,2,0,1,1,2,2,H
1954-12-27,1954,Portsmouth,Blackpool,3-0,3,0,1,1,3,3,H
1954-12-27,1954,Preston North End,Burnley,0-1,0,1,1,1,1,-1,A
1954-12-27,1954,Sheffield Wednesday,Charlton Athletic,2-2,2,2,1,1,4,0,D
1954-12-27,1954,Tottenham Hotspur,Bolton Wanderers,2-0,2,0,1,1,2,2,H
1954-12-27,1954,West Bromwich Albion,Cardiff City,1-0,1,0,1,1,1,1,H
1954-12-28,1954,Aston Villa,Manchester United,2-1,2,1,1,1,3,1,H
1955-01-01,1954,Arsenal,West Bromwich Albion,2-2,2,2,1,1,4,0,D
1955-01-01,1954,Aston Villa,Sheffield Wednesday,0-0,0,0,1,1,0,0,D
1955-01-01,1954,Bolton Wanderers,Chelsea,2-5,2,5,1,1,7,-3,A
1955-01-01,1954,Burnley,Manchester City,2-0,2,0,1,1,2,2,H
1955-01-01,1954,Huddersfield Town,Charlton Athletic,0-0,0,0,1,1,0,0,D
1955-01-01,1954,Leicester City,Cardiff City,2-1,2,1,1,1,3,1,H
1955-01-01,1954,Manchester United,Blackpool,4-1,4,1,1,1,5,3,H
1955-01-01,1954,Preston North End,Everton,0-0,0,0,1,1,0,0,D
1955-01-01,1954,Sheffield United,Newcastle United,6-2,6,2,1,1,8,4,H
1955-01-01,1954,Sunderland,Tottenham Hotspur,1-1,1,1,1,1,2,0,D
1955-01-01,1954,Wolverhampton Wanderers,Portsmouth,2-2,2,2,1,1,4,0,D
1955-01-15,1954,Blackpool,Wolverhampton Wanderers,0-2,0,2,1,1,2,-2,A
1955-01-15,1954,Everton,Burnley,1-1,1,1,1,1,2,0,D
1955-01-15,1954,Manchester City,Leicester City,2-2,2,2,1,1,4,0,D
1955-01-15,1954,Sheffield Wednesday,Sunderland,1-2,1,2,1,1,3,-1,A
1955-01-15,1954,Tottenham Hotspur,Arsenal,0-1,0,1,1,1,1,-1,A
1955-01-22,1954,Aston Villa,Blackpool,3-1,3,1,1,1,4,2,H
1955-01-22,1954,Burnley,Newcastle United,0-1,0,1,1,1,1,-1,A
1955-01-22,1954,Chelsea,Manchester City,0-2,0,2,1,1,2,-2,A
1955-01-22,1954,Manchester United,Bolton Wanderers,1-1,1,1,1,1,2,0,D
1955-01-22,1954,Preston North End,West Bromwich Albion,3-1,3,1,1,1,4,2,H
1955-01-22,1954,Sunderland,Portsmouth,2-2,2,2,1,1,4,0,D
1955-01-22,1954,Tottenham Hotspur,Sheffield Wednesday,7-2,7,2,1,1,9,5,H
1955-01-22,1954,Wolverhampton Wanderers,Charlton Athletic,2-1,2,1,1,1,3,1,H
1955-02-05,1954,Arsenal,Preston North End,2-0,2,0,1,1,2,2,H
1955-02-05,1954,Blackpool,Sunderland,0-0,0,0,1,1,0,0,D
1955-02-05,1954,Bolton Wanderers,Wolverhampton Wanderers,6-1,6,1,1,1,7,5,H
1955-02-05,1954,Charlton Athletic,Aston Villa,6-1,6,1,1,1,7,5,H
1955-02-05,1954,Everton,Chelsea,1-1,1,1,1,1,2,0,D
1955-02-05,1954,Huddersfield Town,Manchester United,1-3,1,3,1,1,4,-2,A
1955-02-05,1954,Manchester City,Cardiff City,4-1,4,1,1,1,5,3,H
1955-02-05,1954,Newcastle United,Leicester City,2-0,2,0,1,1,2,2,H
1955-02-05,1954,Portsmouth,Tottenham Hotspur,0-3,0,3,1,1,3,-3,A
1955-02-05,1954,Sheffield Wednesday,Sheffield United,1-2,1,2,1,1,3,-1,A
1955-02-05,1954,West Bromwich Albion,Burnley,2-2,2,2,1,1,4,0,D
1955-02-12,1954,Aston Villa,Bolton Wanderers,3-0,3,0,1,1,3,3,H
1955-02-12,1954,Burnley,Arsenal,3-0,3,0,1,1,3,3,H
1955-02-12,1954,Cardiff City,Everton,4-3,4,3,1,1,7,1,H
1955-02-12,1954,Chelsea,Newcastle United,4-3,4,3,1,1,7,1,H
1955-02-12,1954,Leicester City,West Bromwich Albion,6-3,6,3,1,1,9,3,H
1955-02-12,1954,Manchester United,Manchester City,0-5,0,5,1,1,5,-5,A
1955-02-12,1954,Preston North End,Sheffield United,1-2,1,2,1,1,3,-1,A
1955-02-12,1954,Sheffield Wednesday,Portsmouth,1-3,1,3,1,1,4,-2,A
1955-02-12,1954,Sunderland,Charlton Athletic,1-2,1,2,1,1,3,-1,A
1955-02-12,1954,Tottenham Hotspur,Blackpool,3-2,3,2,1,1,5,1,H
1955-02-12,1954,Wolverhampton Wanderers,Huddersfield Town,6-4,6,4,1,1,10,2,H
1955-02-19,1954,Arsenal,Leicester City,1-1,1,1,1,1,2,0,D
1955-02-19,1954,Blackpool,Sheffield Wednesday,2-1,2,1,1,1,3,1,H
1955-02-19,1954,Portsmouth,Preston North End,2-0,2,0,1,1,2,2,H
1955-02-19,1954,Sheffield United,Burnley,1-0,1,0,1,1,1,1,H
1955-02-23,1954,Everton,Manchester City,1-0,1,0,1,1,1,1,H
1955-02-23,1954,Huddersfield Town,Aston Villa,1-2,1,2,1,1,3,-1,A
1955-02-23,1954,Manchester United,Wolverhampton Wanderers,2-4,2,4,1,1,6,-2,A
1955-02-26,1954,Arsenal,Sheffield Wednesday,3-2,3,2,1,1,5,1,H
1955-02-26,1954,Burnley,Charlton Athletic,3-0,3,0,1,1,3,3,H
1955-02-26,1954,Cardiff City,Manchester United,3-0,3,0,1,1,3,3,H
1955-02-26,1954,Chelsea,Huddersfield Town,4-1,4,1,1,1,5,3,H
1955-02-26,1954,Newcastle United,Sunderland,1-2,1,2,1,1,3,-1,A
1955-02-26,1954,Preston North End,Blackpool,3-1,3,1,1,1,4,2,H
1955-03-02,1954,Bolton Wanderers,Sunderland,3-0,3,0,1,1,3,3,H
1955-03-05,1954,Aston Villa,Chelsea,3-2,3,2,1,1,5,1,H
1955-03-05,1954,Blackpool,West Bromwich Albion,3-1,3,1,1,1,4,2,H
1955-03-05,1954,Bolton Wanderers,Sheffield United,1-0,1,0,1,1,1,1,H
1955-03-05,1954,Charlton Athletic,Arsenal,1-1,1,1,1,1,2,0,D
1955-03-05,1954,Huddersfield Town,Preston North End,0-4,0,4,1,1,4,-4,A
1955-03-05,1954,Manchester United,Burnley,1-0,1,0,1,1,1,1,H
1955-03-05,1954,Portsmouth,Newcastle United,3-1,3,1,1,1,4,2,H
1955-03-05,1954,Sheffield Wednesday,Everton,2-2,2,2,1,1,4,0,D
1955-03-05,1954,Sunderland,Cardiff City,1-1,1,1,1,1,2,0,D
1955-03-05,1954,Tottenham Hotspur,Manchester City,2-2,2,2,1,1,4,0,D
1955-03-05,1954,Wolverhampton Wanderers,Leicester City,5-0,5,0,1,1,5,5,H
1955-03-09,1954,Bolton Wanderers,Preston North End,2-1,2,1,1,1,3,1,H
1955-03-09,1954,West Bromwich Albion,Chelsea,2-4,2,4,1,1,6,-2,A
1955-03-12,1954,Arsenal,Aston Villa,2-0,2,0,1,1,2,2,H
1955-03-12,1954,Burnley,Sheffield Wednesday,2-0,2,0,1,1,2,2,H
1955-03-12,1954,Cardiff City,Charlton Athletic,4-3,4,3,1,1,7,1,H
1955-03-12,1954,Chelsea,Blackpool,0-0,0,0,1,1,0,0,D
1955-03-12,1954,Leicester City,Portsmouth,4-0,4,0,1,1,4,4,H
1955-03-12,1954,Preston North End,Tottenham Hotspur,1-0,1,0,1,1,1,1,H
1955-03-12,1954,West Bromwich Albion,Sheffield United,3-3,3,3,1,1,6,0,D
1955-03-14,1954,Sheffield United,Sunderland,1-0,1,0,1,1,1,1,H
1955-03-16,1954,Manchester City,Bolton Wanderers,4-2,4,2,1,1,6,2,H
1955-03-16,1954,West Bromwich Albion,Wolverhampton Wanderers,1-0,1,0,1,1,1,1,H
1955-03-19,1954,Aston Villa,West Bromwich Albion,3-0,3,0,1,1,3,3,H
1955-03-19,1954,Blackpool,Leicester City,2-0,2,0,1,1,2,2,H
1955-03-19,1954,Bolton Wanderers,Cardiff City,0-0,0,0,1,1,0,0,D
1955-03-19,1954,Charlton Athletic,Chelsea,0-2,0,2,1,1,2,-2,A
1955-03-19,1954,Huddersfield Town,Manchester City,0-0,0,0,1,1,0,0,D
1955-03-19,1954,Manchester United,Everton,1-2,1,2,1,1,3,-1,A
1955-03-19,1954,Portsmouth,Burnley,0-2,0,2,1,1,2,-2,A
1955-03-19,1954,Sheffield Wednesday,Preston North End,2-0,2,0,1,1,2,2,H
1955-03-19,1954,Sunderland,Arsenal,0-1,0,1,1,1,1,-1,A
1955-03-19,1954,Tottenham Hotspur,Sheffield United,5-0,5,0,1,1,5,5,H
1955-03-19,1954,Wolverhampton Wanderers,Newcastle United,2-2,2,2,1,1,4,0,D
1955-03-23,1954,Cardiff City,Chelsea,0-1,0,1,1,1,1,-1,A
1955-03-23,1954,Everton,Huddersfield Town,4-0,4,0,1,1,4,4,H
1955-03-26,1954,Arsenal,Bolton Wanderers,3-0,3,0,1,1,3,3,H
1955-03-26,1954,Burnley,Wolverhampton Wanderers,1-0,1,0,1,1,1,1,H
1955-03-26,1954,Cardiff City,Tottenham Hotspur,1-2,1,2,1,1,3,-1,A
1955-03-26,1954,Everton,Portsmouth,2-3,2,3,1,1,5,-1,A
1955-03-26,1954,Leicester City,Aston Villa,4-2,4,2,1,1,6,2,H
1955-03-26,1954,Preston North End,Manchester United,0-2,0,2,1,1,2,-2,A
1955-03-26,1954,Sheffield United,Huddersfield Town,2-2,2,2,1,1,4,0,D
1955-03-26,1954,West Bromwich Albion,Charlton Athletic,2-1,2,1,1,1,3,1,H
1955-03-29,1954,Chelsea,Sunderland,2-1,2,1,1,1,3,1,H
1955-03-30,1954,Manchester City,Sheffield Wednesday,2-2,2,2,1,1,4,0,D
1955-04-02,1954,Aston Villa,Burnley,3-1,3,1,1,1,4,2,H
1955-04-02,1954,Blackpool,Everton,4-0,4,0,1,1,4,4,H
1955-04-02,1954,Bolton Wanderers,West Bromwich Albion,2-4,2,4,1,1,6,-2,A
1955-04-02,1954,Charlton Athletic,Newcastle United,1-1,1,1,1,1,2,0,D
1955-04-02,1954,Huddersfield Town,Arsenal,0-1,0,1,1,1,1,-1,A
1955-04-02,1954,Manchester United,Sheffield United,5-0,5,0,1,1,5,5,H
1955-04-02,1954,Portsmouth,Manchester City,1-0,1,0,1,1,1,1,H
1955-04-02,1954,Sheffield Wednesday,Cardiff City,1-1,1,1,1,1,2,0,D
1955-04-02,1954,Sunderland,Leicester City,1-1,1,1,1,1,2,0,D
1955-04-02,1954,Tottenham Hotspur,Chelsea,2-4,2,4,1,1,6,-2,A
1955-04-02,1954,Wolverhampton Wanderers,Preston North End,1-1,1,1,1,1,2,0,D
1955-04-08,1954,Arsenal,Cardiff City,2-0,2,0,1,1,2,2,H
1955-04-08,1954,Bolton Wanderers,Sheffield Wednesday,2-2,2,2,1,1,4,0,D
1955-04-08,1954,Burnley,Blackpool,0-1,0,1,1,1,1,-1,A
1955-04-08,1954,Chelsea,Sheffield United,1-1,1,1,1,1,2,0,D
1955-04-08,1954,Everton,Newcastle United,1-2,1,2,1,1,3,-1,A
1955-04-08,1954,Manchester City,West Bromwich Albion,4-0,4,0,1,1,4,4,H
1955-04-08,1954,Portsmouth,Charlton Athletic,2-0,2,0,1,1,2,2,H
1955-04-08,1954,Preston North End,Leicester City,2-4,2,4,1,1,6,-2,A
1955-04-08,1954,Sunderland,Manchester United,4-3,4,3,1,1,7,1,H
1955-04-09,1954,Arsenal,Blackpool,3-0,3,0,1,1,3,3,H
1955-04-09,1954,Burnley,Huddersfield Town,1-1,1,1,1,1,2,0,D
1955-04-09,1954,Cardiff City,Aston Villa,0-1,0,1,1,1,1,-1,A
1955-04-09,1954,Chelsea,Wolverhampton Wanderers,1-0,1,0,1,1,1,1,H
1955-04-09,1954,Everton,Tottenham Hotspur,1-0,1,0,1,1,1,1,H
1955-04-09,1954,Leicester City,Manchester United,1-0,1,0,1,1,1,1,H
1955-04-09,1954,Manchester City,Sunderland,1-0,1,0,1,1,1,1,H
1955-04-09,1954,Newcastle United,Sheffield Wednesday,5-0,5,0,1,1,5,5,H
1955-04-09,1954,Preston North End,Bolton Wanderers,2-2,2,2,1,1,4,0,D
1955-04-09,1954,Sheffield United,Charlton Athletic,5-0,5,0,1,1,5,5,H
1955-04-09,1954,West Bromwich Albion,Portsmouth,3-1,3,1,1,1,4,2,H
1955-04-11,1954,Blackpool,Burnley,1-0,1,0,1,1,1,1,H
1955-04-11,1954,Cardiff City,Arsenal,1-2,1,2,1,1,3,-1,A
1955-04-11,1954,Charlton Athletic,Portsmouth,2-2,2,2,1,1,4,0,D
1955-04-11,1954,Leicester City,Preston North End,0-1,0,1,1,1,1,-1,A
1955-04-11,1954,Manchester United,Sunderland,2-2,2,2,1,1,4,0,D
1955-04-11,1954,Newcastle United,Everton,4-0,4,0,1,1,4,4,H
1955-04-11,1954,Sheffield Wednesday,Bolton Wanderers,3-2,3,2,1,1,5,1,H
1955-04-11,1954,Tottenham Hotspur,Huddersfield Town,1-1,1,1,1,1,2,0,D
1955-04-11,1954,West Bromwich Albion,Manchester City,2-1,2,1,1,1,3,1,H
1955-04-11,1954,Wolverhampton Wanderers,Aston Villa,1-0,1,0,1,1,1,1,H
1955-04-12,1954,Aston Villa,Wolverhampton Wanderers,4-2,4,2,1,1,6,2,H
1955-04-12,1954,Huddersfield Town,Tottenham Hotspur,1-0,1,0,1,1,1,1,H
1955-04-16,1954,Aston Villa,Sheffield United,3-1,3,1,1,1,4,2,H
1955-04-16,1954,Blackpool,Cardiff City,0-0,0,0,1,1,0,0,D
1955-04-16,1954,Bolton Wanderers,Everton,2-0,2,0,1,1,2,2,H
1955-04-16,1954,Charlton Athletic,Manchester City,1-1,1,1,1,1,2,0,D
1955-04-16,1954,Huddersfield Town,Newcastle United,2-0,2,0,1,1,2,2,H
1955-04-16,1954,Manchester United,West Bromwich Albion,3-0,3,0,1,1,3,3,H
1955-04-16,1954,Portsmouth,Chelsea,0-0,0,0,1,1,0,0,D
1955-04-16,1954,Sheffield Wednesday,Leicester City,1-0,1,0,1,1,1,1,H
1955-04-16,1954,Sunderland,Preston North End,2-1,2,1,1,1,3,1,H
1955-04-16,1954,Tottenham Hotspur,Burnley,0-3,0,3,1,1,3,-3,A
1955-04-16,1954,Wolverhampton Wanderers,Arsenal,3-1,3,1,1,1,4,2,H
1955-04-18,1954,Newcastle United,Manchester United,2-0,2,0,1,1,2,2,H
1955-04-18,1954,Sheffield United,Arsenal,1-1,1,1,1,1,2,0,D
1955-04-20,1954,Leicester City,Everton,2-2,2,2,1,1,4,0,D
1955-04-20,1954,Manchester City,Wolverhampton Wanderers,3-0,3,0,1,1,3,3,H
1955-04-20,1954,Newcastle United,Preston North End,3-3,3,3,1,1,6,0,D
1955-04-23,1954,Arsenal,Manchester United,2-3,2,3,1,1,5,-1,A
1955-04-23,1954,Burnley,Sunderland,0-1,0,1,1,1,1,-1,A
1955-04-23,1954,Cardiff City,Portsmouth,1-1,1,1,1,1,2,0,D
1955-04-23,1954,Chelsea,Sheffield Wednesday,3-0,3,0,1,1,3,3,H
1955-04-23,1954,Everton,Charlton Athletic,2-2,2,2,1,1,4,0,D
1955-04-23,1954,Leicester City,Tottenham Hotspur,2-0,2,0,1,1,2,2,H
1955-04-23,1954,Manchester City,Blackpool,1-6,1,6,1,1,7,-5,A
1955-04-23,1954,Newcastle United,Bolton Wanderers,0-0,0,0,1,1,0,0,D
1955-04-23,1954,Preston North End,Aston Villa,0-3,0,3,1,1,3,-3,A
1955-04-23,1954,Sheffield United,Wolverhampton Wanderers,1-2,1,2,1,1,3,-1,A
1955-04-23,1954,West Bromwich Albion,Huddersfield Town,2-1,2,1,1,1,3,1,H
1955-04-25,1954,Newcastle United,Blackpool,1-1,1,1,1,1,2,0,D
1955-04-26,1954,Charlton Athletic,Manchester United,1-1,1,1,1,1,2,0,D
1955-04-27,1954,Bolton Wanderers,Huddersfield Town,1-0,1,0,1,1,1,1,H
1955-04-27,1954,Newcastle United,Cardiff City,3-0,3,0,1,1,3,3,H
1955-04-27,1954,Portsmouth,Aston Villa,2-2,2,2,1,1,4,0,D
1955-04-27,1954,West Bromwich Albion,Tottenham Hotspur,1-2,1,2,1,1,3,-1,A
1955-04-30,1954,Aston Villa,Manchester City,2-0,2,0,1,1,2,2,H
1955-04-30,1954,Blackpool,Sheffield United,1-2,1,2,1,1,3,-1,A
1955-04-30,1954,Bolton Wanderers,Burnley,0-1,0,1,1,1,1,-1,A
1955-04-30,1954,Cardiff City,Wolverhampton Wanderers,3-2,3,2,1,1,5,1,H
1955-04-30,1954,Charlton Athletic,Preston North End,0-4,0,4,1,1,4,-4,A
1955-04-30,1954,Huddersfield Town,Leicester City,3-1,3,1,1,1,4,2,H
1955-04-30,1954,Manchester United,Chelsea,2-1,2,1,1,1,3,1,H
1955-04-30,1954,Portsmouth,Arsenal,2-1,2,1,1,1,3,1,H
1955-04-30,1954,Sheffield Wednesday,West Bromwich Albion,5-0,5,0,1,1,5,5,H
1955-04-30,1954,Sunderland,Everton,3-0,3,0,1,1,3,3,H
1955-04-30,1954,Tottenham Hotspur,Newcastle United,2-1,2,1,1,1,3,1,H
1955-05-02,1954,Huddersfield Town,Cardiff City,2-0,2,0,1,1,2,2,H
1955-05-02,1954,Sheffield United,Portsmouth,5-2,5,2,1,1,7,3,H
1955-05-04,1954,Everton,Aston Villa,0-1,0,1,1,1,1,-1,A
1955-05-04,1954,Leicester City,Bolton Wanderers,4-0,4,0,1,1,4,4,H
1955-05-05,1954,Charlton Athletic,Tottenham Hotspur,1-2,1,2,1,1,3,-1,A
1955-08-20,1955,Birmingham City,Manchester United,2-2,2,2,1,1,4,0,D
1955-08-20,1955,Blackpool,Arsenal,3-1,3,1,1,1,4,2,H
1955-08-20,1955,Cardiff City,Sunderland,3-1,3,1,1,1,4,2,H
1955-08-20,1955,Charlton Athletic,Luton Town,2-2,2,2,1,1,4,0,D
1955-08-20,1955,Chelsea,Bolton Wanderers,0-2,0,2,1,1,2,-2,A
1955-08-20,1955,Everton,Preston North End,0-4,0,4,1,1,4,-4,A
1955-08-20,1955,Huddersfield Town,Portsmouth,1-0,1,0,1,1,1,1,H
1955-08-20,1955,Manchester City,Aston Villa,2-2,2,2,1,1,4,0,D
1955-08-20,1955,Newcastle United,Sheffield United,4-2,4,2,1,1,6,2,H
1955-08-20,1955,Tottenham Hotspur,Burnley,0-1,0,1,1,1,1,-1,A
1955-08-20,1955,West Bromwich Albion,Wolverhampton Wanderers,1-1,1,1,1,1,2,0,D
1955-08-22,1955,Burnley,Blackpool,0-2,0,2,1,1,2,-2,A
1955-08-22,1955,Sheffield United,Charlton Athletic,0-0,0,0,1,1,0,0,D
1955-08-23,1955,Arsenal,Cardiff City,3-1,3,1,1,1,4,2,H
1955-08-24,1955,Huddersfield Town,Chelsea,1-3,1,3,1,1,4,-2,A
1955-08-24,1955,Manchester United,Tottenham Hotspur,2-2,2,2,1,1,4,0,D
1955-08-24,1955,Newcastle United,Birmingham City,2-2,2,2,1,1,4,0,D
1955-08-24,1955,Portsmouth,Wolverhampton Wanderers,2-1,2,1,1,1,3,1,H
1955-08-24,1955,Preston North End,Luton Town,2-1,2,1,1,1,3,1,H
1955-08-24,1955,Sunderland,Aston Villa,5-1,5,1,1,1,6,4,H
1955-08-24,1955,West Bromwich Albion,Everton,2-0,2,0,1,1,2,2,H
1955-08-27,1955,Arsenal,Chelsea,1-1,1,1,1,1,2,0,D
1955-08-27,1955,Aston Villa,Cardiff City,2-0,2,0,1,1,2,2,H
1955-08-27,1955,Bolton Wanderers,Charlton Athletic,1-3,1,3,1,1,4,-2,A
1955-08-27,1955,Burnley,Everton,0-1,0,1,1,1,1,-1,A
1955-08-27,1955,Luton Town,Tottenham Hotspur,2-1,2,1,1,1,3,1,H
1955-08-27,1955,Manchester United,West Bromwich Albion,3-1,3,1,1,1,4,2,H
1955-08-27,1955,Portsmouth,Blackpool,3-3,3,3,1,1,6,0,D
1955-08-27,1955,Preston North End,Newcastle United,4-3,4,3,1,1,7,1,H
1955-08-27,1955,Sheffield United,Birmingham City,0-3,0,3,1,1,3,-3,A
1955-08-27,1955,Sunderland,Huddersfield Town,4-1,4,1,1,1,5,3,H
1955-08-27,1955,Wolverhampton Wanderers,Manchester City,7-2,7,2,1,1,9,5,H
1955-08-29,1955,Aston Villa,Sunderland,1-4,1,4,1,1,5,-3,A
1955-08-29,1955,Blackpool,Burnley,1-1,1,1,1,1,2,0,D
1955-08-29,1955,Chelsea,Huddersfield Town,0-0,0,0,1,1,0,0,D
1955-08-31,1955,Birmingham City,Newcastle United,3-1,3,1,1,1,4,2,H
1955-08-31,1955,Cardiff City,Bolton Wanderers,1-0,1,0,1,1,1,1,H
1955-08-31,1955,Everton,West Bromwich Albion,2-0,2,0,1,1,2,2,H
1955-08-31,1955,Luton Town,Preston North End,2-1,2,1,1,1,3,1,H
1955-08-31,1955,Manchester City,Arsenal,2-2,2,2,1,1,4,0,D
1955-08-31,1955,Tottenham Hotspur,Manchester United,1-2,1,2,1,1,3,-1,A
1955-08-31,1955,Wolverhampton Wanderers,Portsmouth,3-1,3,1,1,1,4,2,H
1955-09-01,1955,Charlton Athletic,Sheffield United,3-2,3,2,1,1,5,1,H
1955-09-03,1955,Birmingham City,Preston North End,0-3,0,3,1,1,3,-3,A
1955-09-03,1955,Blackpool,Sunderland,7-3,7,3,1,1,10,4,H
1955-09-03,1955,Bolton Wanderers,Arsenal,4-1,4,1,1,1,5,3,H
1955-09-03,1955,Cardiff City,Wolverhampton Wanderers,1-9,1,9,1,1,10,-8,A
1955-09-03,1955,Chelsea,Portsmouth,1-5,1,5,1,1,6,-4,A
1955-09-03,1955,Everton,Luton Town,0-1,0,1,1,1,1,-1,A
1955-09-03,1955,Huddersfield Town,Aston Villa,1-1,1,1,1,1,2,0,D
1955-09-03,1955,Manchester City,Manchester United,1-0,1,0,1,1,1,1,H
1955-09-03,1955,Newcastle United,Burnley,3-1,3,1,1,1,4,2,H
1955-09-03,1955,Tottenham Hotspur,Charlton Athletic,2-3,2,3,1,1,5,-1,A
1955-09-03,1955,West Bromwich Albion,Sheffield United,2-1,2,1,1,1,3,1,H
1955-09-05,1955,Aston Villa,Birmingham City,0-0,0,0,1,1,0,0,D
1955-09-05,1955,Blackpool,Chelsea,2-1,2,1,1,1,3,1,H
1955-09-05,1955,Burnley,Luton Town,3-1,3,1,1,1,4,2,H
1955-09-05,1955,Sheffield United,Tottenham Hotspur,2-0,2,0,1,1,2,2,H
1955-09-06,1955,Arsenal,Manchester City,0-0,0,0,1,1,0,0,D
1955-09-07,1955,Bolton Wanderers,Cardiff City,4-0,4,0,1,1,4,4,H
1955-09-07,1955,Manchester United,Everton,2-1,2,1,1,1,3,1,H
1955-09-07,1955,Preston North End,Charlton Athletic,2-2,2,2,1,1,4,0,D
1955-09-07,1955,West Bromwich Albion,Newcastle United,1-1,1,1,1,1,2,0,D
1955-09-10,1955,Aston Villa,Blackpool,1-1,1,1,1,1,2,0,D
1955-09-10,1955,Burnley,Birmingham City,3-2,3,2,1,1,5,1,H
1955-09-10,1955,Charlton Athletic,Everton,0-2,0,2,1,1,2,-2,A
1955-09-10,1955,Luton Town,Newcastle United,4-2,4,2,1,1,6,2,H
1955-09-10,1955,Manchester City,Cardiff City,3-1,3,1,1,1,4,2,H
1955-09-10,1955,Portsmouth,Bolton Wanderers,3-3,3,3,1,1,6,0,D
1955-09-10,1955,Preston North End,West Bromwich Albion,0-1,0,1,1,1,1,-1,A
1955-09-10,1955,Sheffield United,Manchester United,1-0,1,0,1,1,1,1,H
1955-09-10,1955,Sunderland,Chelsea,4-3,4,3,1,1,7,1,H
1955-09-10,1955,Tottenham Hotspur,Arsenal,3-1,3,1,1,1,4,2,H
1955-09-10,1955,Wolverhampton Wanderers,Huddersfield Town,4-0,4,0,1,1,4,4,H
1955-09-14,1955,Everton,Manchester United,4-2,4,2,1,1,6,2,H
1955-09-15,1955,Charlton Athletic,Preston North End,2-1,2,1,1,1,3,1,H
1955-09-17,1955,Arsenal,Portsmouth,1-3,1,3,1,1,4,-2,A
1955-09-17,1955,Birmingham City,Luton Town,0-0,0,0,1,1,0,0,D
1955-09-17,1955,Blackpool,Wolverhampton Wanderers,2-1,2,1,1,1,3,1,H
1955-09-17,1955,Bolton Wanderers,Sunderland,0-3,0,3,1,1,3,-3,A
1955-09-17,1955,Cardiff City,Sheffield United,3-2,3,2,1,1,5,1,H
1955-09-17,1955,Chelsea,Aston Villa,0-0,0,0,1,1,0,0,D
1955-09-17,1955,Everton,Tottenham Hotspur,2-1,2,1,1,1,3,1,H
1955-09-17,1955,Huddersfield Town,Manchester City,3-3,3,3,1,1,6,0,D
1955-09-17,1955,Manchester United,Preston North End,3-2,3,2,1,1,5,1,H
1955-09-17,1955,Newcastle United,Charlton Athletic,4-1,4,1,1,1,5,3,H
1955-09-17,1955,West Bromwich Albion,Burnley,1-0,1,0,1,1,1,1,H
1955-09-21,1955,Birmingham City,Aston Villa,2-2,2,2,1,1,4,0,D
1955-09-24,1955,Aston Villa,Bolton Wanderers,0-2,0,2,1,1,2,-2,A
1955-09-24,1955,Burnley,Manchester United,0-0,0,0,1,1,0,0,D
1955-09-24,1955,Cardiff City,Huddersfield Town,1-2,1,2,1,1,3,-1,A
1955-09-24,1955,Charlton Athletic,Birmingham City,2-0,2,0,1,1,2,2,H
1955-09-24,1955,Luton Town,West Bromwich Albion,0-2,0,2,1,1,2,-2,A
1955-09-24,1955,Manchester City,Blackpool,2-0,2,0,1,1,2,2,H
1955-09-24,1955,Portsmouth,Everton,1-0,1,0,1,1,1,1,H
1955-09-24,1955,Preston North End,Sheffield United,0-2,0,2,1,1,2,-2,A
1955-09-24,1955,Sunderland,Arsenal,3-1,3,1,1,1,4,2,H
1955-09-24,1955,Tottenham Hotspur,Newcastle United,3-1,3,1,1,1,4,2,H
1955-09-24,1955,Wolverhampton Wanderers,Chelsea,2-1,2,1,1,1,3,1,H
1955-10-01,1955,Arsenal,Aston Villa,1-0,1,0,1,1,1,1,H
1955-10-01,1955,Birmingham City,Tottenham Hotspur,3-0,3,0,1,1,3,3,H
1955-10-01,1955,Blackpool,Cardiff City,2-1,2,1,1,1,3,1,H
1955-10-01,1955,Bolton Wanderers,Wolverhampton Wanderers,2-1,2,1,1,1,3,1,H
1955-10-01,1955,Chelsea,Manchester City,2-1,2,1,1,1,3,1,H
1955-10-01,1955,Huddersfield Town,Preston North End,2-2,2,2,1,1,4,0,D
1955-10-01,1955,Manchester United,Luton Town,3-1,3,1,1,1,4,2,H
1955-10-01,1955,Newcastle United,Everton,1-2,1,2,1,1,3,-1,A
1955-10-01,1955,Portsmouth,Sunderland,2-1,2,1,1,1,3,1,H
1955-10-01,1955,Sheffield United,Burnley,1-2,1,2,1,1,3,-1,A
1955-10-01,1955,West Bromwich Albion,Charlton Athletic,3-3,3,3,1,1,6,0,D
1955-10-08,1955,Birmingham City,Sunderland,1-2,1,2,1,1,3,-1,A
1955-10-08,1955,Burnley,Huddersfield Town,2-0,2,0,1,1,2,2,H
1955-10-08,1955,Charlton Athletic,Chelsea,1-2,1,2,1,1,3,-1,A
1955-10-08,1955,Everton,Arsenal,1-1,1,1,1,1,2,0,D
1955-10-08,1955,Luton Town,Blackpool,3-1,3,1,1,1,4,2,H
1955-10-08,1955,Manchester United,Wolverhampton Wanderers,4-3,4,3,1,1,7,1,H
1955-10-08,1955,Newcastle United,Portsmouth,2-1,2,1,1,1,3,1,H
1955-10-08,1955,Preston North End,Cardiff City,1-2,1,2,1,1,3,-1,A
1955-10-08,1955,Sheffield United,Manchester City,1-1,1,1,1,1,2,0,D
1955-10-08,1955,Tottenham Hotspur,Bolton Wanderers,0-3,0,3,1,1,3,-3,A
1955-10-08,1955,West Bromwich Albion,Aston Villa,1-0,1,0,1,1,1,1,H
1955-10-15,1955,Arsenal,Newcastle United,1-0,1,0,1,1,1,1,H
1955-10-15,1955,Aston Villa,Manchester United,4-4,4,4,1,1,8,0,D
1955-10-15,1955,Blackpool,Charlton Athletic,5-0,5,0,1,1,5,5,H
1955-10-15,1955,Bolton Wanderers,Everton,1-1,1,1,1,1,2,0,D
1955-10-15,1955,Cardiff City,Burnley,2-2,2,2,1,1,4,0,D
1955-10-15,1955,Chelsea,Tottenham Hotspur,2-0,2,0,1,1,2,2,H
1955-10-15,1955,Huddersfield Town,Luton Town,0-2,0,2,1,1,2,-2,A
1955-10-15,1955,Manchester City,Preston North End,0-2,0,2,1,1,2,-2,A
1955-10-15,1955,Portsmouth,Birmingham City,0-5,0,5,1,1,5,-5,A
1955-10-15,1955,Sunderland,West Bromwich Albion,2-1,2,1,1,1,3,1,H
1955-10-15,1955,Wolverhampton Wanderers,Sheffield United,3-2,3,2,1,1,5,1,H
1955-10-22,1955,Birmingham City,Manchester City,4-3,4,3,1,1,7,1,H
1955-10-22,1955,Burnley,Bolton Wanderers,2-0,2,0,1,1,2,2,H
1955-10-22,1955,Charlton Athletic,Portsmouth,6-1,6,1,1,1,7,5,H
1955-10-22,1955,Everton,Aston Villa,2-1,2,1,1,1,3,1,H
1955-10-22,1955,Luton Town,Arsenal,0-0,0,0,1,1,0,0,D
1955-10-22,1955,Manchester United,Huddersfield Town,3-0,3,0,1,1,3,3,H
1955-10-22,1955,Newcastle United,Wolverhampton Wanderers,3-1,3,1,1,1,4,2,H
1955-10-22,1955,Preston North End,Chelsea,2-3,2,3,1,1,5,-1,A
1955-10-22,1955,Sheffield United,Blackpool,2-1,2,1,1,1,3,1,H
1955-10-22,1955,Tottenham Hotspur,Sunderland,2-3,2,3,1,1,5,-1,A
1955-10-22,1955,West Bromwich Albion,Cardiff City,2-1,2,1,1,1,3,1,H
1955-10-29,1955,Arsenal,Charlton Athletic,2-4,2,4,1,1,6,-2,A
1955-10-29,1955,Aston Villa,Newcastle United,3-0,3,0,1,1,3,3,H
1955-10-29,1955,Blackpool,Preston North End,2-6,2,6,1,1,8,-4,A
1955-10-29,1955,Bolton Wanderers,Luton Town,4-0,4,0,1,1,4,4,H
1955-10-29,1955,Cardiff City,Manchester United,0-1,0,1,1,1,1,-1,A
1955-10-29,1955,Chelsea,Burnley,0-0,0,0,1,1,0,0,D
1955-10-29,1955,Huddersfield Town,Sheffield United,1-2,1,2,1,1,3,-1,A
1955-10-29,1955,Manchester City,West Bromwich Albion,2-0,2,0,1,1,2,2,H
1955-10-29,1955,Portsmouth,Tottenham Hotspur,4-1,4,1,1,1,5,3,H
1955-10-29,1955,Sunderland,Everton,0-0,0,0,1,1,0,0,D
1955-10-29,1955,Wolverhampton Wanderers,Birmingham City,1-0,1,0,1,1,1,1,H
1955-11-05,1955,Birmingham City,Chelsea,3-0,3,0,1,1,3,3,H
1955-11-05,1955,Burnley,Aston Villa,2-0,2,0,1,1,2,2,H
1955-11-05,1955,Charlton Athletic,Manchester City,5-2,5,2,1,1,7,3,H
1955-11-05,1955,Everton,Huddersfield Town,5-2,5,2,1,1,7,3,H
1955-11-05,1955,Luton Town,Wolverhampton Wanderers,5-1,5,1,1,1,6,4,H
1955-11-05,1955,Manchester United,Arsenal,1-1,1,1,1,1,2,0,D
1955-11-05,1955,Newcastle United,Blackpool,1-2,1,2,1,1,3,-1,A
1955-11-05,1955,Preston North End,Sunderland,2-2,2,2,1,1,4,0,D
1955-11-05,1955,Sheffield United,Portsmouth,1-3,1,3,1,1,4,-2,A
1955-11-05,1955,Tottenham Hotspur,Cardiff City,1-1,1,1,1,1,2,0,D
1955-11-05,1955,West Bromwich Albion,Bolton Wanderers,2-0,2,0,1,1,2,2,H
1955-11-12,1955,Arsenal,Sheffield United,2-1,2,1,1,1,3,1,H
1955-11-12,1955,Aston Villa,Luton Town,1-0,1,0,1,1,1,1,H
1955-11-12,1955,Blackpool,Birmingham City,2-0,2,0,1,1,2,2,H
1955-11-12,1955,Bolton Wanderers,Manchester United,3-1,3,1,1,1,4,2,H
1955-11-12,1955,Cardiff City,Everton,3-1,3,1,1,1,4,2,H
1955-11-12,1955,Chelsea,West Bromwich Albion,2-0,2,0,1,1,2,2,H
1955-11-12,1955,Huddersfield Town,Newcastle United,2-6,2,6,1,1,8,-4,A
1955-11-12,1955,Manchester City,Tottenham Hotspur,1-2,1,2,1,1,3,-1,A
1955-11-12,1955,Portsmouth,Preston North End,0-2,0,2,1,1,2,-2,A
1955-11-12,1955,Sunderland,Burnley,4-4,4,4,1,1,8,0,D
1955-11-12,1955,Wolverhampton Wanderers,Charlton Athletic,2-0,2,0,1,1,2,2,H
1955-11-19,1955,Birmingham City,Huddersfield Town,5-0,5,0,1,1,5,5,H
1955-11-19,1955,Burnley,Portsmouth,3-0,3,0,1,1,3,3,H
1955-11-19,1955,Charlton Athletic,Aston Villa,3-1,3,1,1,1,4,2,H
1955-11-19,1955,Everton,Manchester City,1-1,1,1,1,1,2,0,D
1955-11-19,1955,Luton Town,Sunderland,8-2,8,2,1,1,10,6,H
1955-11-19,1955,Manchester United,Chelsea,3-0,3,0,1,1,3,3,H
1955-11-19,1955,Newcastle United,Cardiff City,4-0,4,0,1,1,4,4,H
1955-11-19,1955,Preston North End,Arsenal,0-1,0,1,1,1,1,-1,A
1955-11-19,1955,Sheffield United,Bolton Wanderers,1-3,1,3,1,1,4,-2,A
1955-11-19,1955,Tottenham Hotspur,Wolverhampton Wanderers,2-1,2,1,1,1,3,1,H
1955-11-19,1955,West Bromwich Albion,Blackpool,1-2,1,2,1,1,3,-1,A
1955-11-26,1955,Arsenal,Burnley,0-1,0,1,1,1,1,-1,A
1955-11-26,1955,Aston Villa,Tottenham Hotspur,0-2,0,2,1,1,2,-2,A
1955-11-26,1955,Blackpool,Manchester United,0-0,0,0,1,1,0,0,D
1955-11-26,1955,Bolton Wanderers,Preston North End,0-0,0,0,1,1,0,0,D
1955-11-26,1955,Cardiff City,Birmingham City,2-1,2,1,1,1,3,1,H
1955-11-26,1955,Chelsea,Sheffield United,1-0,1,0,1,1,1,1,H
1955-11-26,1955,Huddersfield Town,West Bromwich Albion,1-0,1,0,1,1,1,1,H
1955-11-26,1955,Manchester City,Newcastle United,1-2,1,2,1,1,3,-1,A
1955-11-26,1955,Portsmouth,Luton Town,0-0,0,0,1,1,0,0,D
1955-11-26,1955,Sunderland,Charlton Athletic,3-2,3,2,1,1,5,1,H
1955-11-26,1955,Wolverhampton Wanderers,Everton,1-0,1,0,1,1,1,1,H
1955-12-03,1955,Birmingham City,Arsenal,4-0,4,0,1,1,4,4,H
1955-12-03,1955,Burnley,Manchester City,2-2,2,2,1,1,4,0,D
1955-12-03,1955,Charlton Athletic,Huddersfield Town,4-1,4,1,1,1,5,3,H
1955-12-03,1955,Everton,Chelsea,3-3,3,3,1,1,6,0,D
1955-12-03,1955,Luton Town,Cardiff City,3-0,3,0,1,1,3,3,H
1955-12-03,1955,Manchester United,Sunderland,2-1,2,1,1,1,3,1,H
1955-12-03,1955,Newcastle United,Bolton Wanderers,3-0,3,0,1,1,3,3,H
1955-12-03,1955,Preston North End,Wolverhampton Wanderers,2-0,2,0,1,1,2,2,H
1955-12-03,1955,Sheffield United,Aston Villa,2-2,2,2,1,1,4,0,D
1955-12-03,1955,Tottenham Hotspur,Blackpool,1-1,1,1,1,1,2,0,D
1955-12-03,1955,West Bromwich Albion,Portsmouth,4-0,4,0,1,1,4,4,H
1955-12-10,1955,Arsenal,West Bromwich Albion,2-0,2,0,1,1,2,2,H
1955-12-10,1955,Aston Villa,Preston North End,3-2,3,2,1,1,5,1,H
1955-12-10,1955,Blackpool,Everton,4-0,4,0,1,1,4,4,H
1955-12-10,1955,Bolton Wanderers,Birmingham City,6-0,6,0,1,1,6,6,H
1955-12-10,1955,Cardiff City,Charlton Athletic,3-1,3,1,1,1,4,2,H
1955-12-10,1955,Chelsea,Newcastle United,2-1,2,1,1,1,3,1,H
1955-12-10,1955,Huddersfield Town,Tottenham Hotspur,1-0,1,0,1,1,1,1,H
1955-12-10,1955,Manchester City,Luton Town,3-2,3,2,1,1,5,1,H
1955-12-10,1955,Portsmouth,Manchester United,3-2,3,2,1,1,5,1,H
1955-12-10,1955,Sunderland,Sheffield United,3-2,3,2,1,1,5,1,H
1955-12-10,1955,Wolverhampton Wanderers,Burnley,3-1,3,1,1,1,4,2,H
1955-12-17,1955,Arsenal,Blackpool,4-1,4,1,1,1,5,3,H
1955-12-17,1955,Aston Villa,Manchester City,0-3,0,3,1,1,3,-3,A
1955-12-17,1955,Bolton Wanderers,Chelsea,4-0,4,0,1,1,4,4,H
1955-12-17,1955,Burnley,Tottenham Hotspur,2-0,2,0,1,1,2,2,H
1955-12-17,1955,Luton Town,Charlton Athletic,2-1,2,1,1,1,3,1,H
1955-12-17,1955,Manchester United,Birmingham City,2-1,2,1,1,1,3,1,H
1955-12-17,1955,Portsmouth,Huddersfield Town,5-2,5,2,1,1,7,3,H
1955-12-17,1955,Preston North End,Everton,0-1,0,1,1,1,1,-1,A
1955-12-17,1955,Sheffield United,Newcastle United,2-1,2,1,1,1,3,1,H
1955-12-17,1955,Sunderland,Cardiff City,1-1,1,1,1,1,2,0,D
1955-12-17,1955,Wolverhampton Wanderers,West Bromwich Albion,3-2,3,2,1,1,5,1,H
1955-12-24,1955,Birmingham City,Sheffield United,0-2,0,2,1,1,2,-2,A
1955-12-24,1955,Blackpool,Portsmouth,2-3,2,3,1,1,5,-1,A
1955-12-24,1955,Cardiff City,Aston Villa,1-0,1,0,1,1,1,1,H
1955-12-24,1955,Charlton Athletic,Bolton Wanderers,3-1,3,1,1,1,4,2,H
1955-12-24,1955,Chelsea,Arsenal,2-0,2,0,1,1,2,2,H
1955-12-24,1955,Everton,Burnley,1-1,1,1,1,1,2,0,D
1955-12-24,1955,Huddersfield Town,Sunderland,4-0,4,0,1,1,4,4,H
1955-12-24,1955,Manchester City,Wolverhampton Wanderers,2-2,2,2,1,1,4,0,D
1955-12-24,1955,Newcastle United,Preston North End,5-0,5,0,1,1,5,5,H
1955-12-24,1955,Tottenham Hotspur,Luton Town,2-1,2,1,1,1,3,1,H
1955-12-24,1955,West Bromwich Albion,Manchester United,1-4,1,4,1,1,5,-3,A
1955-12-26,1955,Aston Villa,Portsmouth,1-3,1,3,1,1,4,-2,A
1955-12-26,1955,Birmingham City,Everton,6-2,6,2,1,1,8,4,H
1955-12-26,1955,Blackpool,Huddersfield Town,4-2,4,2,1,1,6,2,H
1955-12-26,1955,Bolton Wanderers,Manchester City,1-3,1,3,1,1,4,-2,A
1955-12-26,1955,Burnley,Preston North End,1-2,1,2,1,1,3,-1,A
1955-12-26,1955,Cardiff City,Chelsea,1-1,1,1,1,1,2,0,D
1955-12-26,1955,Manchester United,Charlton Athletic,5-1,5,1,1,1,6,4,H
1955-12-26,1955,Sheffield United,Luton Town,0-4,0,4,1,1,4,-4,A
1955-12-26,1955,Sunderland,Newcastle United,1-6,1,6,1,1,7,-5,A
1955-12-26,1955,Tottenham Hotspur,West Bromwich Albion,4-1,4,1,1,1,5,3,H
1955-12-26,1955,Wolverhampton Wanderers,Arsenal,3-3,3,3,1,1,6,0,D
1955-12-27,1955,Arsenal,Wolverhampton Wanderers,2-2,2,2,1,1,4,0,D
1955-12-27,1955,Charlton Athletic,Manchester United,3-0,3,0,1,1,3,3,H
1955-12-27,1955,Chelsea,Cardiff City,2-1,2,1,1,1,3,1,H
1955-12-27,1955,Everton,Birmingham City,5-1,5,1,1,1,6,4,H
1955-12-27,1955,Huddersfield Town,Blackpool,3-1,3,1,1,1,4,2,H
1955-12-27,1955,Luton Town,Sheffield United,2-1,2,1,1,1,3,1,H
1955-12-27,1955,Manchester City,Bolton Wanderers,2-0,2,0,1,1,2,2,H
1955-12-27,1955,Newcastle United,Sunderland,3-1,3,1,1,1,4,2,H
1955-12-27,1955,Portsmouth,Aston Villa,2-2,2,2,1,1,4,0,D
1955-12-27,1955,Preston North End,Burnley,4-2,4,2,1,1,6,2,H
1955-12-27,1955,West Bromwich Albion,Tottenham Hotspur,1-0,1,0,1,1,1,1,H
1955-12-31,1955,Arsenal,Bolton Wanderers,3-1,3,1,1,1,4,2,H
1955-12-31,1955,Aston Villa,Huddersfield Town,3-0,3,0,1,1,3,3,H
1955-12-31,1955,Burnley,Newcastle United,3-1,3,1,1,1,4,2,H
1955-12-31,1955,Charlton Athletic,Tottenham Hotspur,1-2,1,2,1,1,3,-1,A
1955-12-31,1955,Luton Town,Everton,2-2,2,2,1,1,4,0,D
1955-12-31,1955,Manchester United,Manchester City,2-1,2,1,1,1,3,1,H
1955-12-31,1955,Portsmouth,Chelsea,4-4,4,4,1,1,8,0,D
1955-12-31,1955,Preston North End,Birmingham City,1-1,1,1,1,1,2,0,D
1955-12-31,1955,Sheffield United,West Bromwich Albion,2-2,2,2,1,1,4,0,D
1955-12-31,1955,Sunderland,Blackpool,0-0,0,0,1,1,0,0,D
1955-12-31,1955,Wolverhampton Wanderers,Cardiff City,0-2,0,2,1,1,2,-2,A
1956-01-02,1955,Bolton Wanderers,Huddersfield Town,2-2,2,2,1,1,4,0,D
1956-01-02,1955,Manchester City,Portsmouth,4-1,4,1,1,1,5,3,H
1956-01-02,1955,Newcastle United,West Bromwich Albion,0-3,0,3,1,1,3,-3,A
1956-01-02,1955,Sunderland,Wolverhampton Wanderers,1-1,1,1,1,1,2,0,D
1956-01-14,1955,Arsenal,Tottenham Hotspur,0-1,0,1,1,1,1,-1,A
1956-01-14,1955,Birmingham City,Burnley,1-2,1,2,1,1,3,-1,A
1956-01-14,1955,Blackpool,Aston Villa,6-0,6,0,1,1,6,6,H
1956-01-14,1955,Bolton Wanderers,Portsmouth,4-0,4,0,1,1,4,4,H
1956-01-14,1955,Cardiff City,Manchester City,4-1,4,1,1,1,5,3,H
1956-01-14,1955,Chelsea,Sunderland,2-3,2,3,1,1,5,-1,A
1956-01-14,1955,Everton,Charlton Athletic,3-2,3,2,1,1,5,1,H
1956-01-14,1955,Huddersfield Town,Wolverhampton Wanderers,1-3,1,3,1,1,4,-2,A
1956-01-14,1955,Manchester United,Sheffield United,3-1,3,1,1,1,4,2,H
1956-01-14,1955,Newcastle United,Luton Town,4-0,4,0,1,1,4,4,H
1956-01-14,1955,West Bromwich Albion,Preston North End,3-2,3,2,1,1,5,1,H
1956-01-21,1955,Aston Villa,Chelsea,1-4,1,4,1,1,5,-3,A
1956-01-21,1955,Burnley,West Bromwich Albion,1-2,1,2,1,1,3,-1,A
1956-01-21,1955,Charlton Athletic,Newcastle United,0-2,0,2,1,1,2,-2,A
1956-01-21,1955,Luton Town,Birmingham City,0-1,0,1,1,1,1,-1,A
1956-01-21,1955,Manchester City,Huddersfield Town,1-0,1,0,1,1,1,1,H
1956-01-21,1955,Portsmouth,Arsenal,5-2,5,2,1,1,7,3,H
1956-01-21,1955,Preston North End,Manchester United,3-1,3,1,1,1,4,2,H
1956-01-21,1955,Sheffield United,Cardiff City,2-1,2,1,1,1,3,1,H
1956-01-21,1955,Sunderland,Bolton Wanderers,0-0,0,0,1,1,0,0,D
1956-01-21,1955,Tottenham Hotspur,Everton,1-1,1,1,1,1,2,0,D
1956-01-21,1955,Wolverhampton Wanderers,Blackpool,2-3,2,3,1,1,5,-1,A
1956-02-04,1955,Arsenal,Sunderland,3-1,3,1,1,1,4,2,H
1956-02-04,1955,Birmingham City,Charlton Athletic,4-0,4,0,1,1,4,4,H
1956-02-04,1955,Blackpool,Manchester City,0-1,0,1,1,1,1,-1,A
1956-02-04,1955,Chelsea,Wolverhampton Wanderers,2-3,2,3,1,1,5,-1,A
1956-02-04,1955,Everton,Portsmouth,0-2,0,2,1,1,2,-2,A
1956-02-04,1955,Huddersfield Town,Cardiff City,1-2,1,2,1,1,3,-1,A
1956-02-04,1955,Manchester United,Burnley,2-0,2,0,1,1,2,2,H
1956-02-04,1955,Newcastle United,Tottenham Hotspur,1-2,1,2,1,1,3,-1,A
1956-02-04,1955,Sheffield United,Preston North End,3-1,3,1,1,1,4,2,H
1956-02-04,1955,West Bromwich Albion,Luton Town,3-1,3,1,1,1,4,2,H
1956-02-11,1955,Aston Villa,Arsenal,1-1,1,1,1,1,2,0,D
1956-02-11,1955,Burnley,Sheffield United,1-1,1,1,1,1,2,0,D
1956-02-11,1955,Cardiff City,Blackpool,1-0,1,0,1,1,1,1,H
1956-02-11,1955,Charlton Athletic,West Bromwich Albion,5-1,5,1,1,1,6,4,H
1956-02-11,1955,Everton,Newcastle United,0-0,0,0,1,1,0,0,D
1956-02-11,1955,Luton Town,Manchester United,0-2,0,2,1,1,2,-2,A
1956-02-11,1955,Manchester City,Chelsea,2-2,2,2,1,1,4,0,D
1956-02-11,1955,Preston North End,Huddersfield Town,1-2,1,2,1,1,3,-1,A
1956-02-11,1955,Sunderland,Portsmouth,4-2,4,2,1,1,6,2,H
1956-02-11,1955,Tottenham Hotspur,Birmingham City,0-1,0,1,1,1,1,-1,A
1956-02-11,1955,Wolverhampton Wanderers,Bolton Wanderers,4-2,4,2,1,1,6,2,H
1956-02-18,1955,Blackpool,Luton Town,3-2,3,2,1,1,5,1,H
1956-02-18,1955,Bolton Wanderers,Aston Villa,1-0,1,0,1,1,1,1,H
1956-02-18,1955,Cardiff City,Preston North End,3-1,3,1,1,1,4,2,H
1956-02-18,1955,Huddersfield Town,Burnley,1-0,1,0,1,1,1,1,H
1956-02-18,1955,Wolverhampton Wanderers,Manchester United,0-2,0,2,1,1,2,-2,A
1956-02-21,1955,Arsenal,Everton,3-2,3,2,1,1,5,1,H
1956-02-22,1955,Chelsea,Charlton Athletic,3-1,3,1,1,1,4,2,H
1956-02-22,1955,Portsmouth,Newcastle United,0-2,0,2,1,1,2,-2,A
1956-02-25,1955,Birmingham City,Portsmouth,3-2,3,2,1,1,5,1,H
1956-02-25,1955,Burnley,Cardiff City,0-2,0,2,1,1,2,-2,A
1956-02-25,1955,Charlton Athletic,Blackpool,1-2,1,2,1,1,3,-1,A
1956-02-25,1955,Everton,Bolton Wanderers,1-0,1,0,1,1,1,1,H
1956-02-25,1955,Luton Town,Huddersfield Town,1-2,1,2,1,1,3,-1,A
1956-02-25,1955,Manchester United,Aston Villa,1-0,1,0,1,1,1,1,H
1956-02-25,1955,Newcastle United,Arsenal,2-0,2,0,1,1,2,2,H
1956-02-25,1955,Preston North End,Manchester City,0-3,0,3,1,1,3,-3,A
1956-02-25,1955,Tottenham Hotspur,Chelsea,4-0,4,0,1,1,4,4,H
1956-02-25,1955,West Bromwich Albion,Sunderland,3-0,3,0,1,1,3,3,H
1956-03-03,1955,Aston Villa,Charlton Athletic,1-1,1,1,1,1,2,0,D
1956-03-03,1955,Blackpool,West Bromwich Albion,5-1,5,1,1,1,6,4,H
1956-03-03,1955,Bolton Wanderers,Sheffield United,2-1,2,1,1,1,3,1,H
1956-03-03,1955,Chelsea,Manchester United,2-4,2,4,1,1,6,-2,A
1956-03-03,1955,Portsmouth,Burnley,3-1,3,1,1,1,4,2,H
1956-03-06,1955,Arsenal,Preston North End,3-2,3,2,1,1,5,1,H
1956-03-07,1955,Cardiff City,Newcastle United,1-1,1,1,1,1,2,0,D
1956-03-07,1955,Huddersfield Town,Birmingham City,1-1,1,1,1,1,2,0,D
1956-03-07,1955,Manchester City,Everton,3-0,3,0,1,1,3,3,H
1956-03-07,1955,Sunderland,Luton Town,1-2,1,2,1,1,3,-1,A
1956-03-10,1955,Birmingham City,Wolverhampton Wanderers,0-0,0,0,1,1,0,0,D
1956-03-10,1955,Burnley,Chelsea,5-0,5,0,1,1,5,5,H
1956-03-10,1955,Charlton Athletic,Arsenal,2-0,2,0,1,1,2,2,H
1956-03-10,1955,Everton,Sunderland,1-2,1,2,1,1,3,-1,A
1956-03-10,1955,Luton Town,Bolton Wanderers,0-0,0,0,1,1,0,0,D
1956-03-10,1955,Manchester United,Cardiff City,1-1,1,1,1,1,2,0,D
1956-03-10,1955,Newcastle United,Aston Villa,2-3,2,3,1,1,5,-1,A
1956-03-10,1955,Preston North End,Blackpool,3-3,3,3,1,1,6,0,D
1956-03-10,1955,Sheffield United,Huddersfield Town,3-1,3,1,1,1,4,2,H
1956-03-10,1955,Tottenham Hotspur,Portsmouth,1-1,1,1,1,1,2,0,D
1956-03-10,1955,West Bromwich Albion,Manchester City,0-4,0,4,1,1,4,-4,A
1956-03-17,1955,Arsenal,Manchester United,1-1,1,1,1,1,2,0,D
1956-03-17,1955,Blackpool,Newcastle United,5-1,5,1,1,1,6,4,H
1956-03-17,1955,Bolton Wanderers,West Bromwich Albion,4-0,4,0,1,1,4,4,H
1956-03-17,1955,Huddersfield Town,Everton,1-0,1,0,1,1,1,1,H
1956-03-17,1955,Portsmouth,Sheffield United,1-1,1,1,1,1,2,0,D
1956-03-17,1955,Wolverhampton Wanderers,Luton Town,1-2,1,2,1,1,3,-1,A
1956-03-19,1955,Aston Villa,Burnley,2-0,2,0,1,1,2,2,H
1956-03-21,1955,Bolton Wanderers,Tottenham Hotspur,3-2,3,2,1,1,5,1,H
1956-03-21,1955,Chelsea,Birmingham City,1-2,1,2,1,1,3,-1,A
1956-03-21,1955,Manchester City,Charlton Athletic,0-2,0,2,1,1,2,-2,A
1956-03-21,1955,Sunderland,Preston North End,2-2,2,2,1,1,4,0,D
1956-03-24,1955,Birmingham City,Blackpool,1-2,1,2,1,1,3,-1,A
1956-03-24,1955,Burnley,Sunderland,4-0,4,0,1,1,4,4,H
1956-03-24,1955,Charlton Athletic,Wolverhampton Wanderers,0-2,0,2,1,1,2,-2,A
1956-03-24,1955,Everton,Cardiff City,2-0,2,0,1,1,2,2,H
1956-03-24,1955,Luton Town,Aston Villa,2-1,2,1,1,1,3,1,H
1956-03-24,1955,Manchester United,Bolton Wanderers,1-0,1,0,1,1,1,1,H
1956-03-24,1955,Newcastle United,Huddersfield Town,1-1,1,1,1,1,2,0,D
1956-03-24,1955,Preston North End,Portsmouth,2-1,2,1,1,1,3,1,H
1956-03-24,1955,Sheffield United,Arsenal,0-2,0,2,1,1,2,-2,A
1956-03-24,1955,Tottenham Hotspur,Manchester City,2-1,2,1,1,1,3,1,H
1956-03-24,1955,West Bromwich Albion,Chelsea,3-0,3,0,1,1,3,3,H
1956-03-30,1955,Blackpool,Bolton Wanderers,0-0,0,0,1,1,0,0,D
1956-03-30,1955,Charlton Athletic,Burnley,2-1,2,1,1,1,3,1,H
1956-03-30,1955,Everton,Sheffield United,1-4,1,4,1,1,5,-3,A
1956-03-30,1955,Luton Town,Chelsea,2-2,2,2,1,1,4,0,D
1956-03-30,1955,Manchester United,Newcastle United,5-2,5,2,1,1,7,3,H
1956-03-30,1955,Portsmouth,Cardiff City,1-1,1,1,1,1,2,0,D
1956-03-30,1955,Sunderland,Manchester City,0-3,0,3,1,1,3,-3,A
1956-03-30,1955,Tottenham Hotspur,Preston North End,0-4,0,4,1,1,4,-4,A
1956-03-31,1955,Arsenal,Luton Town,3-0,3,0,1,1,3,3,H
1956-03-31,1955,Aston Villa,Everton,2-0,2,0,1,1,2,2,H
1956-03-31,1955,Blackpool,Sheffield United,1-1,1,1,1,1,2,0,D
1956-03-31,1955,Bolton Wanderers,Burnley,0-1,0,1,1,1,1,-1,A
1956-03-31,1955,Cardiff City,West Bromwich Albion,1-3,1,3,1,1,4,-2,A
1956-03-31,1955,Chelsea,Preston North End,0-1,0,1,1,1,1,-1,A
1956-03-31,1955,Huddersfield Town,Manchester United,0-2,0,2,1,1,2,-2,A
1956-03-31,1955,Manchester City,Birmingham City,1-1,1,1,1,1,2,0,D
1956-03-31,1955,Portsmouth,Charlton Athletic,4-0,4,0,1,1,4,4,H
1956-03-31,1955,Sunderland,Tottenham Hotspur,3-2,3,2,1,1,5,1,H
1956-03-31,1955,Wolverhampton Wanderers,Newcastle United,2-1,2,1,1,1,3,1,H
1956-04-02,1955,Arsenal,Huddersfield Town,2-0,2,0,1,1,2,2,H
1956-04-02,1955,Birmingham City,West Bromwich Albion,2-0,2,0,1,1,2,2,H
1956-04-02,1955,Bolton Wanderers,Blackpool,1-3,1,3,1,1,4,-2,A
1956-04-02,1955,Burnley,Charlton Athletic,2-1,2,1,1,1,3,1,H
1956-04-02,1955,Cardiff City,Portsmouth,2-3,2,3,1,1,5,-1,A
1956-04-02,1955,Chelsea,Luton Town,0-0,0,0,1,1,0,0,D
1956-04-02,1955,Manchester City,Sunderland,4-2,4,2,1,1,6,2,H
1956-04-02,1955,Newcastle United,Manchester United,0-0,0,0,1,1,0,0,D
1956-04-02,1955,Preston North End,Tottenham Hotspur,3-3,3,3,1,1,6,0,D
1956-04-02,1955,Sheffield United,Everton,1-1,1,1,1,1,2,0,D
1956-04-02,1955,Wolverhampton Wanderers,Aston Villa,0-0,0,0,1,1,0,0,D
1956-04-03,1955,Aston Villa,Wolverhampton Wanderers,0-0,0,0,1,1,0,0,D
1956-04-03,1955,Huddersfield Town,Arsenal,0-1,0,1,1,1,1,-1,A
1956-04-03,1955,West Bromwich Albion,Birmingham City,0-2,0,2,1,1,2,-2,A
1956-04-07,1955,Birmingham City,Cardiff City,2-1,2,1,1,1,3,1,H
1956-04-07,1955,Burnley,Arsenal,0-1,0,1,1,1,1,-1,A
1956-04-07,1955,Charlton Athletic,Sunderland,2-1,2,1,1,1,3,1,H
1956-04-07,1955,Everton,Wolverhampton Wanderers,2-1,2,1,1,1,3,1,H
1956-04-07,1955,Luton Town,Portsmouth,1-0,1,0,1,1,1,1,H
1956-04-07,1955,Manchester United,Blackpool,2-1,2,1,1,1,3,1,H
1956-04-07,1955,Newcastle United,Manchester City,3-1,3,1,1,1,4,2,H
1956-04-07,1955,Preston North End,Bolton Wanderers,0-1,0,1,1,1,1,-1,A
1956-04-07,1955,Sheffield United,Chelsea,2-1,2,1,1,1,3,1,H
1956-04-07,1955,Tottenham Hotspur,Aston Villa,4-3,4,3,1,1,7,1,H
1956-04-07,1955,West Bromwich Albion,Huddersfield Town,1-2,1,2,1,1,3,-1,A
1956-04-11,1955,Manchester City,Sheffield United,3-1,3,1,1,1,4,2,H
1956-04-14,1955,Arsenal,Birmingham City,1-0,1,0,1,1,1,1,H
1956-04-14,1955,Aston Villa,Sheffield United,3-2,3,2,1,1,5,1,H
1956-04-14,1955,Blackpool,Tottenham Hotspur,0-2,0,2,1,1,2,-2,A
1956-04-14,1955,Bolton Wanderers,Newcastle United,3-2,3,2,1,1,5,1,H
1956-04-14,1955,Cardiff City,Luton Town,2-0,2,0,1,1,2,2,H
1956-04-14,1955,Chelsea,Everton,6-1,6,1,1,1,7,5,H
1956-04-14,1955,Huddersfield Town,Charlton Athletic,4-0,4,0,1,1,4,4,H
1956-04-14,1955,Manchester City,Burnley,1-3,1,3,1,1,4,-2,A
1956-04-14,1955,Portsmouth,West Bromwich Albion,1-1,1,1,1,1,2,0,D
1956-04-14,1955,Sunderland,Manchester United,2-2,2,2,1,1,4,0,D
1956-04-14,1955,Wolverhampton Wanderers,Preston North End,2-1,2,1,1,1,3,1,H
1956-04-18,1955,Sunderland,Birmingham City,1-0,1,0,1,1,1,1,H
1956-04-18,1955,Wolverhampton Wanderers,Tottenham Hotspur,5-1,5,1,1,1,6,4,H
1956-04-21,1955,Birmingham City,Bolton Wanderers,5-2,5,2,1,1,7,3,H
1956-04-21,1955,Burnley,Wolverhampton Wanderers,1-2,1,2,1,1,3,-1,A
1956-04-21,1955,Charlton Athletic,Cardiff City,0-0,0,0,1,1,0,0,D
1956-04-21,1955,Everton,Blackpool,1-0,1,0,1,1,1,1,H
1956-04-21,1955,Luton Town,Manchester City,3-2,3,2,1,1,5,1,H
1956-04-21,1955,Manchester United,Portsmouth,1-0,1,0,1,1,1,1,H
1956-04-21,1955,Newcastle United,Chelsea,1-1,1,1,1,1,2,0,D
1956-04-21,1955,Preston North End,Aston Villa,0-1,0,1,1,1,1,-1,A
1956-04-21,1955,Sheffield United,Sunderland,2-3,2,3,1,1,5,-1,A
1956-04-21,1955,Tottenham Hotspur,Huddersfield Town,1-2,1,2,1,1,3,-1,A
1956-04-21,1955,West Bromwich Albion,Arsenal,2-1,2,1,1,1,3,1,H
1956-04-23,1955,Cardiff City,Tottenham Hotspur,0-0,0,0,1,1,0,0,D
1956-04-28,1955,Aston Villa,West Bromwich Albion,3-0,3,0,1,1,3,3,H
1956-04-28,1955,Cardiff City,Arsenal,1-2,1,2,1,1,3,-1,A
1956-04-28,1955,Chelsea,Blackpool,2-1,2,1,1,1,3,1,H
1956-04-28,1955,Huddersfield Town,Bolton Wanderers,3-1,3,1,1,1,4,2,H
1956-04-28,1955,Luton Town,Burnley,2-3,2,3,1,1,5,-1,A
1956-04-28,1955,Portsmouth,Manchester City,2-4,2,4,1,1,6,-2,A
1956-04-28,1955,Tottenham Hotspur,Sheffield United,3-1,3,1,1,1,4,2,H
1956-04-28,1955,Wolverhampton Wanderers,Sunderland,3-1,3,1,1,1,4,2,H
1956-05-02,1955,Sheffield United,Wolverhampton Wanderers,3-3,3,3,1,1,6,0,D
1956-08-18,1956,Arsenal,Cardiff City,0-0,0,0,1,1,0,0,D
1956-08-18,1956,Aston Villa,Charlton Athletic,3-1,3,1,1,1,4,2,H
1956-08-18,1956,Bolton Wanderers,Blackpool,4-1,4,1,1,1,5,3,H
1956-08-18,1956,Burnley,Chelsea,2-0,2,0,1,1,2,2,H
1956-08-18,1956,Leeds United,Everton,5-1,5,1,1,1,6,4,H
1956-08-18,1956,Luton Town,Sunderland,6-2,6,2,1,1,8,4,H
1956-08-18,1956,Manchester United,Birmingham City,2-2,2,2,1,1,4,0,D
1956-08-18,1956,Newcastle United,Portsmouth,2-1,2,1,1,1,3,1,H
1956-08-18,1956,Preston North End,Tottenham Hotspur,1-4,1,4,1,1,5,-3,A
1956-08-18,1956,Sheffield Wednesday,West Bromwich Albion,4-2,4,2,1,1,6,2,H
1956-08-18,1956,Wolverhampton Wanderers,Manchester City,5-1,5,1,1,1,6,4,H
1956-08-20,1956,Preston North End,Manchester United,1-3,1,3,1,1,4,-2,A
1956-08-21,1956,Arsenal,Burnley,2-0,2,0,1,1,2,2,H
1956-08-22,1956,Birmingham City,Portsmouth,3-1,3,1,1,1,4,2,H
1956-08-22,1956,Cardiff City,Newcastle United,5-2,5,2,1,1,7,3,H
1956-08-22,1956,Everton,Blackpool,2-3,2,3,1,1,5,-1,A
1956-08-22,1956,Luton Town,Wolverhampton Wanderers,1-0,1,0,1,1,1,1,H
1956-08-22,1956,Manchester City,Tottenham Hotspur,2-2,2,2,1,1,4,0,D
1956-08-22,1956,Sheffield Wednesday,Chelsea,4-0,4,0,1,1,4,4,H
1956-08-22,1956,Sunderland,Bolton Wanderers,3-0,3,0,1,1,3,3,H
1956-08-22,1956,West Bromwich Albion,Aston Villa,2-0,2,0,1,1,2,2,H
1956-08-23,1956,Charlton Athletic,Leeds United,1-2,1,2,1,1,3,-1,A
1956-08-25,1956,Birmingham City,Arsenal,4-2,4,2,1,1,6,2,H
1956-08-25,1956,Blackpool,Wolverhampton Wanderers,3-2,3,2,1,1,5,1,H
1956-08-25,1956,Cardiff City,Burnley,3-3,3,3,1,1,6,0,D
1956-08-25,1956,Charlton Athletic,Luton Town,1-2,1,2,1,1,3,-1,A
1956-08-25,1956,Chelsea,Preston North End,1-0,1,0,1,1,1,1,H
1956-08-25,1956,Everton,Bolton Wanderers,2-2,2,2,1,1,4,0,D
1956-08-25,1956,Manchester City,Aston Villa,1-1,1,1,1,1,2,0,D
1956-08-25,1956,Portsmouth,Sheffield Wednesday,3-1,3,1,1,1,4,2,H
1956-08-25,1956,Sunderland,Newcastle United,1-2,1,2,1,1,3,-1,A
1956-08-25,1956,Tottenham Hotspur,Leeds United,5-1,5,1,1,1,6,4,H
1956-08-25,1956,West Bromwich Albion,Manchester United,2-3,2,3,1,1,5,-1,A
1956-08-27,1956,Aston Villa,West Bromwich Albion,0-0,0,0,1,1,0,0,D
1956-08-27,1956,Blackpool,Everton,5-2,5,2,1,1,7,3,H
1956-08-28,1956,Burnley,Arsenal,3-1,3,1,1,1,4,2,H
1956-08-29,1956,Leeds United,Charlton Athletic,4-0,4,0,1,1,4,4,H
1956-08-29,1956,Manchester United,Preston North End,3-2,3,2,1,1,5,1,H
1956-08-29,1956,Newcastle United,Cardiff City,1-0,1,0,1,1,1,1,H
1956-08-29,1956,Portsmouth,Birmingham City,3-4,3,4,1,1,7,-1,A
1956-08-29,1956,Tottenham Hotspur,Manchester City,3-2,3,2,1,1,5,1,H
1956-08-29,1956,Wolverhampton Wanderers,Luton Town,5-4,5,4,1,1,9,1,H
1956-09-01,1956,Arsenal,West Bromwich Albion,4-1,4,1,1,1,5,3,H
1956-09-01,1956,Aston Villa,Blackpool,3-2,3,2,1,1,5,1,H
1956-09-01,1956,Bolton Wanderers,Tottenham Hotspur,1-0,1,0,1,1,1,1,H
1956-09-01,1956,Burnley,Birmingham City,2-0,2,0,1,1,2,2,H
1956-09-01,1956,Leeds United,Chelsea,0-0,0,0,1,1,0,0,D
1956-09-01,1956,Luton Town,Manchester City,3-2,3,2,1,1,5,1,H
1956-09-01,1956,Manchester United,Portsmouth,3-0,3,0,1,1,3,3,H
1956-09-01,1956,Preston North End,Cardiff City,6-0,6,0,1,1,6,6,H
1956-09-01,1956,Sheffield Wednesday,Newcastle United,4-0,4,0,1,1,4,4,H
1956-09-01,1956,Sunderland,Charlton Athletic,8-1,8,1,1,1,9,7,H
1956-09-01,1956,Wolverhampton Wanderers,Everton,2-1,2,1,1,1,3,1,H
1956-09-03,1956,Blackpool,Tottenham Hotspur,4-1,4,1,1,1,5,3,H
1956-09-03,1956,Burnley,Everton,2-1,2,1,1,1,3,1,H
1956-09-04,1956,Arsenal,Preston North End,1-2,1,2,1,1,3,-1,A
1956-09-05,1956,Birmingham City,Newcastle United,6-1,6,1,1,1,7,5,H
1956-09-05,1956,Bolton Wanderers,Sunderland,2-1,2,1,1,1,3,1,H
1956-09-05,1956,Cardiff City,Sheffield Wednesday,2-1,2,1,1,1,3,1,H
1956-09-05,1956,Chelsea,Manchester United,1-2,1,2,1,1,3,-1,A
1956-09-05,1956,Luton Town,Aston Villa,0-0,0,0,1,1,0,0,D
1956-09-05,1956,Manchester City,Leeds United,1-0,1,0,1,1,1,1,H
1956-09-05,1956,West Bromwich Albion,Portsmouth,2-1,2,1,1,1,3,1,H
1956-09-08,1956,Birmingham City,Preston North End,3-0,3,0,1,1,3,3,H
1956-09-08,1956,Blackpool,Luton Town,4-0,4,0,1,1,4,4,H
1956-09-08,1956,Cardiff City,Chelsea,1-1,1,1,1,1,2,0,D
1956-09-08,1956,Charlton Athletic,Sheffield Wednesday,4-4,4,4,1,1,8,0,D
1956-09-08,1956,Everton,Aston Villa,0-4,0,4,1,1,4,-4,A
1956-09-08,1956,Leeds United,Bolton Wanderers,3-2,3,2,1,1,5,1,H
1956-09-08,1956,Manchester City,Sunderland,3-1,3,1,1,1,4,2,H
1956-09-08,1956,Newcastle United,Manchester United,1-1,1,1,1,1,2,0,D
1956-09-08,1956,Portsmouth,Arsenal,2-3,2,3,1,1,5,-1,A
1956-09-08,1956,Tottenham Hotspur,Wolverhampton Wanderers,4-1,4,1,1,1,5,3,H
1956-09-08,1956,West Bromwich Albion,Burnley,2-2,2,2,1,1,4,0,D
1956-09-10,1956,Preston North End,Arsenal,3-0,3,0,1,1,3,3,H
1956-09-12,1956,Bolton Wanderers,Charlton Athletic,2-0,2,0,1,1,2,2,H
1956-09-12,1956,Everton,Burnley,1-0,1,0,1,1,1,1,H
1956-09-12,1956,Leeds United,Manchester City,2-0,2,0,1,1,2,2,H
1956-09-12,1956,Sheffield Wednesday,Cardiff City,5-3,5,3,1,1,8,2,H
1956-09-12,1956,Wolverhampton Wanderers,Sunderland,2-2,2,2,1,1,4,0,D
1956-09-15,1956,Arsenal,Newcastle United,0-1,0,1,1,1,1,-1,A
1956-09-15,1956,Aston Villa,Tottenham Hotspur,2-4,2,4,1,1,6,-2,A
1956-09-15,1956,Bolton Wanderers,Cardiff City,2-0,2,0,1,1,2,2,H
1956-09-15,1956,Burnley,Portsmouth,1-1,1,1,1,1,2,0,D
1956-09-15,1956,Charlton Athletic,Manchester City,1-0,1,0,1,1,1,1,H
1956-09-15,1956,Chelsea,Birmingham City,1-0,1,0,1,1,1,1,H
1956-09-15,1956,Luton Town,Everton,2-0,2,0,1,1,2,2,H
1956-09-15,1956,Manchester United,Sheffield Wednesday,4-1,4,1,1,1,5,3,H
1956-09-15,1956,Preston North End,West Bromwich Albion,3-2,3,2,1,1,5,1,H
1956-09-15,1956,Sunderland,Blackpool,5-2,5,2,1,1,7,3,H
1956-09-15,1956,Wolverhampton Wanderers,Leeds United,1-2,1,2,1,1,3,-1,A
1956-09-19,1956,Chelsea,Sheffield Wednesday,0-0,0,0,1,1,0,0,D
1956-09-20,1956,Charlton Athletic,Bolton Wanderers,2-1,2,1,1,1,3,1,H
1956-09-22,1956,Birmingham City,Cardiff City,2-1,2,1,1,1,3,1,H
1956-09-22,1956,Blackpool,Charlton Athletic,3-2,3,2,1,1,5,1,H
1956-09-22,1956,Bolton Wanderers,Wolverhampton Wanderers,0-3,0,3,1,1,3,-3,A
1956-09-22,1956,Everton,Sunderland,2-1,2,1,1,1,3,1,H
1956-09-22,1956,Leeds United,Aston Villa,1-0,1,0,1,1,1,1,H
1956-09-22,1956,Manchester United,Manchester City,2-0,2,0,1,1,2,2,H
1956-09-22,1956,Newcastle United,Burnley,1-1,1,1,1,1,2,0,D
1956-09-22,1956,Portsmouth,Preston North End,2-2,2,2,1,1,4,0,D
1956-09-22,1956,Sheffield Wednesday,Arsenal,2-4,2,4,1,1,6,-2,A
1956-09-22,1956,Tottenham Hotspur,Luton Town,5-0,5,0,1,1,5,5,H
1956-09-22,1956,West Bromwich Albion,Chelsea,2-1,2,1,1,1,3,1,H
1956-09-29,1956,Arsenal,Manchester United,1-2,1,2,1,1,3,-1,A
1956-09-29,1956,Aston Villa,Bolton Wanderers,0-0,0,0,1,1,0,0,D
1956-09-29,1956,Burnley,Sheffield Wednesday,4-1,4,1,1,1,5,3,H
1956-09-29,1956,Cardiff City,West Bromwich Albion,0-0,0,0,1,1,0,0,D
1956-09-29,1956,Charlton Athletic,Everton,1-2,1,2,1,1,3,-1,A
1956-09-29,1956,Chelsea,Portsmouth,3-3,3,3,1,1,6,0,D
1956-09-29,1956,Luton Town,Leeds United,2-2,2,2,1,1,4,0,D
1956-09-29,1956,Manchester City,Blackpool,0-3,0,3,1,1,3,-3,A
1956-09-29,1956,Preston North End,Newcastle United,1-0,1,0,1,1,1,1,H
1956-09-29,1956,Sunderland,Tottenham Hotspur,0-2,0,2,1,1,2,-2,A
1956-09-29,1956,Wolverhampton Wanderers,Birmingham City,3-0,3,0,1,1,3,3,H
1956-10-06,1956,Arsenal,Manchester City,7-3,7,3,1,1,10,4,H
1956-10-06,1956,Birmingham City,Bolton Wanderers,0-0,0,0,1,1,0,0,D
1956-10-06,1956,Burnley,Blackpool,2-2,2,2,1,1,4,0,D
1956-10-06,1956,Cardiff City,Leeds United,4-1,4,1,1,1,5,3,H
1956-10-06,1956,Chelsea,Tottenham Hotspur,2-4,2,4,1,1,6,-2,A
1956-10-06,1956,Manchester United,Charlton Athletic,4-2,4,2,1,1,6,2,H
1956-10-06,1956,Newcastle United,Luton Town,2-2,2,2,1,1,4,0,D
1956-10-06,1956,Portsmouth,Aston Villa,5-1,5,1,1,1,6,4,H
1956-10-06,1956,Preston North End,Everton,0-0,0,0,1,1,0,0,D
1956-10-06,1956,Sheffield Wednesday,Sunderland,3-2,3,2,1,1,5,1,H
1956-10-06,1956,West Bromwich Albion,Wolverhampton Wanderers,1-1,1,1,1,1,2,0,D
1956-10-13,1956,Aston Villa,Newcastle United,3-1,3,1,1,1,4,2,H
1956-10-13,1956,Blackpool,Preston North End,4-0,4,0,1,1,4,4,H
1956-10-13,1956,Bolton Wanderers,West Bromwich Albion,1-1,1,1,1,1,2,0,D
1956-10-13,1956,Charlton Athletic,Arsenal,1-3,1,3,1,1,4,-2,A
1956-10-13,1956,Everton,Chelsea,0-3,0,3,1,1,3,-3,A
1956-10-13,1956,Leeds United,Birmingham City,1-1,1,1,1,1,2,0,D
1956-10-13,1956,Luton Town,Sheffield Wednesday,2-0,2,0,1,1,2,2,H
1956-10-13,1956,Manchester City,Burnley,0-1,0,1,1,1,1,-1,A
1956-10-13,1956,Sunderland,Manchester United,1-3,1,3,1,1,4,-2,A
1956-10-13,1956,Tottenham Hotspur,Cardiff City,5-0,5,0,1,1,5,5,H
1956-10-13,1956,Wolverhampton Wanderers,Portsmouth,6-0,6,0,1,1,6,6,H
1956-10-20,1956,Arsenal,Tottenham Hotspur,3-1,3,1,1,1,4,2,H
1956-10-20,1956,Birmingham City,Luton Town,3-0,3,0,1,1,3,3,H
1956-10-20,1956,Burnley,Leeds United,0-0,0,0,1,1,0,0,D
1956-10-20,1956,Chelsea,Wolverhampton Wanderers,3-3,3,3,1,1,6,0,D
1956-10-20,1956,Manchester United,Everton,2-5,2,5,1,1,7,-3,A
1956-10-20,1956,Newcastle United,Manchester City,0-3,0,3,1,1,3,-3,A
1956-10-20,1956,Portsmouth,Charlton Athletic,1-0,1,0,1,1,1,1,H
1956-10-20,1956,Preston North End,Bolton Wanderers,2-2,2,2,1,1,4,0,D
1956-10-20,1956,Sheffield Wednesday,Blackpool,1-2,1,2,1,1,3,-1,A
1956-10-20,1956,West Bromwich Albion,Sunderland,2-0,2,0,1,1,2,2,H
1956-10-27,1956,Aston Villa,Birmingham City,3-1,3,1,1,1,4,2,H
1956-10-27,1956,Blackpool,Manchester United,2-2,2,2,1,1,4,0,D
1956-10-27,1956,Bolton Wanderers,Chelsea,2-2,2,2,1,1,4,0,D
1956-10-27,1956,Charlton Athletic,Newcastle United,1-1,1,1,1,1,2,0,D
1956-10-27,1956,Everton,Arsenal,4-0,4,0,1,1,4,4,H
1956-10-27,1956,Leeds United,Preston North End,1-2,1,2,1,1,3,-1,A
1956-10-27,1956,Luton Town,West Bromwich Albion,0-1,0,1,1,1,1,-1,A
1956-10-27,1956,Manchester City,Sheffield Wednesday,4-2,4,2,1,1,6,2,H
1956-10-27,1956,Sunderland,Portsmouth,3-3,3,3,1,1,6,0,D
1956-10-27,1956,Tottenham Hotspur,Burnley,2-0,2,0,1,1,2,2,H
1956-10-27,1956,Wolverhampton Wanderers,Cardiff City,3-1,3,1,1,1,4,2,H
1956-11-03,1956,Arsenal,Aston Villa,2-1,2,1,1,1,3,1,H
1956-11-03,1956,Birmingham City,Blackpool,2-2,2,2,1,1,4,0,D
1956-11-03,1956,Burnley,Luton Town,1-1,1,1,1,1,2,0,D
1956-11-03,1956,Cardiff City,Manchester City,1-1,1,1,1,1,2,0,D
1956-11-03,1956,Chelsea,Charlton Athletic,1-3,1,3,1,1,4,-2,A
1956-11-03,1956,Manchester United,Wolverhampton Wanderers,3-0,3,0,1,1,3,3,H
1956-11-03,1956,Newcastle United,Leeds United,2-3,2,3,1,1,5,-1,A
1956-11-03,1956,Portsmouth,Tottenham Hotspur,2-3,2,3,1,1,5,-1,A
1956-11-03,1956,Preston North End,Sunderland,6-0,6,0,1,1,6,6,H
1956-11-03,1956,Sheffield Wednesday,Bolton Wanderers,1-2,1,2,1,1,3,-1,A
1956-11-03,1956,West Bromwich Albion,Everton,3-0,3,0,1,1,3,3,H
1956-11-10,1956,Aston Villa,Burnley,1-0,1,0,1,1,1,1,H
1956-11-10,1956,Blackpool,West Bromwich Albion,0-1,0,1,1,1,1,-1,A
1956-11-10,1956,Bolton Wanderers,Manchester United,2-0,2,0,1,1,2,2,H
1956-11-10,1956,Charlton Athletic,Cardiff City,0-2,0,2,1,1,2,-2,A
1956-11-10,1956,Everton,Portsmouth,2-2,2,2,1,1,4,0,D
1956-11-10,1956,Leeds United,Sheffield Wednesday,3-1,3,1,1,1,4,2,H
1956-11-10,1956,Luton Town,Preston North End,1-1,1,1,1,1,2,0,D
1956-11-10,1956,Manchester City,Birmingham City,3-1,3,1,1,1,4,2,H
1956-11-10,1956,Sunderland,Chelsea,1-3,1,3,1,1,4,-2,A
1956-11-10,1956,Tottenham Hotspur,Newcastle United,3-1,3,1,1,1,4,2,H
1956-11-10,1956,Wolverhampton Wanderers,Arsenal,5-2,5,2,1,1,7,3,H
1956-11-17,1956,Arsenal,Bolton Wanderers,3-0,3,0,1,1,3,3,H
1956-11-17,1956,Birmingham City,Charlton Athletic,4-2,4,2,1,1,6,2,H
1956-11-17,1956,Burnley,Wolverhampton Wanderers,3-0,3,0,1,1,3,3,H
1956-11-17,1956,Cardiff City,Sunderland,1-0,1,0,1,1,1,1,H
1956-11-17,1956,Chelsea,Luton Town,4-1,4,1,1,1,5,3,H
1956-11-17,1956,Manchester United,Leeds United,3-2,3,2,1,1,5,1,H
1956-11-17,1956,Newcastle United,Everton,0-0,0,0,1,1,0,0,D
1956-11-17,1956,Portsmouth,Blackpool,0-0,0,0,1,1,0,0,D
1956-11-17,1956,Preston North End,Aston Villa,3-3,3,3,1,1,6,0,D
1956-11-17,1956,Sheffield Wednesday,Tottenham Hotspur,4-1,4,1,1,1,5,3,H
1956-11-17,1956,West Bromwich Albion,Manchester City,1-1,1,1,1,1,2,0,D
1956-11-24,1956,Aston Villa,Chelsea,1-1,1,1,1,1,2,0,D
1956-11-24,1956,Blackpool,Newcastle United,2-3,2,3,1,1,5,-1,A
1956-11-24,1956,Bolton Wanderers,Burnley,3-0,3,0,1,1,3,3,H
1956-11-24,1956,Charlton Athletic,West Bromwich Albion,3-2,3,2,1,1,5,1,H
1956-11-24,1956,Everton,Sheffield Wednesday,1-0,1,0,1,1,1,1,H
1956-11-24,1956,Leeds United,Arsenal,3-3,3,3,1,1,6,0,D
1956-11-24,1956,Luton Town,Cardiff City,3-0,3,0,1,1,3,3,H
1956-11-24,1956,Manchester City,Portsmouth,5-1,5,1,1,1,6,4,H
1956-11-24,1956,Sunderland,Birmingham City,0-1,0,1,1,1,1,-1,A
1956-11-24,1956,Tottenham Hotspur,Manchester United,2-2,2,2,1,1,4,0,D
1956-11-24,1956,Wolverhampton Wanderers,Preston North End,4-3,4,3,1,1,7,1,H
1956-12-01,1956,Arsenal,Sunderland,1-1,1,1,1,1,2,0,D
1956-12-01,1956,Birmingham City,Tottenham Hotspur,0-0,0,0,1,1,0,0,D
1956-12-01,1956,Burnley,Charlton Athletic,2-1,2,1,1,1,3,1,H
1956-12-01,1956,Cardiff City,Everton,1-0,1,0,1,1,1,1,H
1956-12-01,1956,Chelsea,Blackpool,2-2,2,2,1,1,4,0,D
1956-12-01,1956,Manchester United,Luton Town,3-1,3,1,1,1,4,2,H
1956-12-01,1956,Newcastle United,Wolverhampton Wanderers,2-1,2,1,1,1,3,1,H
1956-12-01,1956,Portsmouth,Bolton Wanderers,1-1,1,1,1,1,2,0,D
1956-12-01,1956,Preston North End,Manchester City,3-1,3,1,1,1,4,2,H
1956-12-01,1956,Sheffield Wednesday,Aston Villa,2-1,2,1,1,1,3,1,H
1956-12-01,1956,West Bromwich Albion,Leeds United,0-0,0,0,1,1,0,0,D
1956-12-08,1956,Aston Villa,Manchester United,1-3,1,3,1,1,4,-2,A
1956-12-08,1956,Blackpool,Cardiff City,3-1,3,1,1,1,4,2,H
1956-12-08,1956,Bolton Wanderers,Newcastle United,3-1,3,1,1,1,4,2,H
1956-12-08,1956,Charlton Athletic,Preston North End,3-4,3,4,1,1,7,-1,A
1956-12-08,1956,Everton,Birmingham City,2-0,2,0,1,1,2,2,H
1956-12-08,1956,Leeds United,Portsmouth,4-1,4,1,1,1,5,3,H
1956-12-08,1956,Luton Town,Arsenal,1-2,1,2,1,1,3,-1,A
1956-12-08,1956,Manchester City,Chelsea,5-4,5,4,1,1,9,1,H
1956-12-08,1956,Sunderland,Burnley,2-1,2,1,1,1,3,1,H
1956-12-08,1956,Tottenham Hotspur,West Bromwich Albion,2-2,2,2,1,1,4,0,D
1956-12-08,1956,Wolverhampton Wanderers,Sheffield Wednesday,2-1,2,1,1,1,3,1,H
1956-12-15,1956,Birmingham City,Manchester United,3-1,3,1,1,1,4,2,H
1956-12-15,1956,Blackpool,Bolton Wanderers,4-2,4,2,1,1,6,2,H
1956-12-15,1956,Cardiff City,Arsenal,2-3,2,3,1,1,5,-1,A
1956-12-15,1956,Charlton Athletic,Aston Villa,0-2,0,2,1,1,2,-2,A
1956-12-15,1956,Chelsea,Burnley,2-0,2,0,1,1,2,2,H
1956-12-15,1956,Everton,Leeds United,2-1,2,1,1,1,3,1,H
1956-12-15,1956,Manchester City,Wolverhampton Wanderers,2-3,2,3,1,1,5,-1,A
1956-12-15,1956,Portsmouth,Newcastle United,2-2,2,2,1,1,4,0,D
1956-12-15,1956,Sunderland,Luton Town,1-0,1,0,1,1,1,1,H
1956-12-15,1956,Tottenham Hotspur,Preston North End,1-1,1,1,1,1,2,0,D
1956-12-15,1956,West Bromwich Albion,Sheffield Wednesday,1-4,1,4,1,1,5,-3,A
1956-12-22,1956,Arsenal,Birmingham City,4-0,4,0,1,1,4,4,H
1956-12-22,1956,Burnley,Cardiff City,6-2,6,2,1,1,8,4,H
1956-12-22,1956,Luton Town,Charlton Athletic,4-2,4,2,1,1,6,2,H
1956-12-22,1956,Newcastle United,Sunderland,6-2,6,2,1,1,8,4,H
1956-12-22,1956,Wolverhampton Wanderers,Blackpool,4-1,4,1,1,1,5,3,H
1956-12-25,1956,Birmingham City,Sheffield Wednesday,4-0,4,0,1,1,4,4,H
1956-12-25,1956,Blackpool,Leeds United,1-1,1,1,1,1,2,0,D
1956-12-25,1956,Burnley,Preston North End,2-2,2,2,1,1,4,0,D
1956-12-25,1956,Charlton Athletic,Wolverhampton Wanderers,2-1,2,1,1,1,3,1,H
1956-12-25,1956,Chelsea,Arsenal,1-1,1,1,1,1,2,0,D
1956-12-25,1956,Manchester City,Bolton Wanderers,1-3,1,3,1,1,4,-2,A
1956-12-25,1956,Sunderland,Aston Villa,1-0,1,0,1,1,1,1,H
1956-12-25,1956,Tottenham Hotspur,Everton,6-0,6,0,1,1,6,6,H
1956-12-25,1956,West Bromwich Albion,Newcastle United,1-0,1,0,1,1,1,1,H
1956-12-26,1956,Arsenal,Chelsea,2-0,2,0,1,1,2,2,H
1956-12-26,1956,Bolton Wanderers,Manchester City,1-0,1,0,1,1,1,1,H
1956-12-26,1956,Everton,Tottenham Hotspur,1-1,1,1,1,1,2,0,D
1956-12-26,1956,Leeds United,Blackpool,5-0,5,0,1,1,5,5,H
1956-12-26,1956,Manchester United,Cardiff City,3-1,3,1,1,1,4,2,H
1956-12-26,1956,Newcastle United,West Bromwich Albion,5-2,5,2,1,1,7,3,H
1956-12-26,1956,Preston North End,Burnley,1-0,1,0,1,1,1,1,H
1956-12-29,1956,Birmingham City,Burnley,2-0,2,0,1,1,2,2,H
1956-12-29,1956,Blackpool,Aston Villa,0-0,0,0,1,1,0,0,D
1956-12-29,1956,Cardiff City,Preston North End,2-3,2,3,1,1,5,-1,A
1956-12-29,1956,Charlton Athletic,Sunderland,3-2,3,2,1,1,5,1,H
1956-12-29,1956,Chelsea,Leeds United,1-1,1,1,1,1,2,0,D
1956-12-29,1956,Everton,Wolverhampton Wanderers,3-1,3,1,1,1,4,2,H
1956-12-29,1956,Manchester City,Luton Town,3-2,3,2,1,1,5,1,H
1956-12-29,1956,Newcastle United,Sheffield Wednesday,1-2,1,2,1,1,3,-1,A
1956-12-29,1956,Portsmouth,Manchester United,1-3,1,3,1,1,4,-2,A
1956-12-29,1956,Tottenham Hotspur,Bolton Wanderers,4-0,4,0,1,1,4,4,H
1956-12-29,1956,West Bromwich Albion,Arsenal,0-2,0,2,1,1,2,-2,A
1957-01-01,1956,Manchester United,Chelsea,3-0,3,0,1,1,3,3,H
1957-01-01,1956,Newcastle United,Birmingham City,3-2,3,2,1,1,5,1,H
1957-01-01,1956,Sunderland,Wolverhampton Wanderers,2-3,2,3,1,1,5,-1,A
1957-01-12,1956,Arsenal,Portsmouth,1-1,1,1,1,1,2,0,D
1957-01-12,1956,Aston Villa,Everton,5-1,5,1,1,1,6,4,H
1957-01-12,1956,Bolton Wanderers,Leeds United,5-3,5,3,1,1,8,2,H
1957-01-12,1956,Burnley,West Bromwich Albion,1-0,1,0,1,1,1,1,H
1957-01-12,1956,Chelsea,Cardiff City,1-2,1,2,1,1,3,-1,A
1957-01-12,1956,Luton Town,Blackpool,0-2,0,2,1,1,2,-2,A
1957-01-12,1956,Manchester United,Newcastle United,6-1,6,1,1,1,7,5,H
1957-01-12,1956,Preston North End,Birmingham City,1-0,1,0,1,1,1,1,H
1957-01-12,1956,Sheffield Wednesday,Charlton Athletic,3-1,3,1,1,1,4,2,H
1957-01-12,1956,Sunderland,Manchester City,1-1,1,1,1,1,2,0,D
1957-01-12,1956,Wolverhampton Wanderers,Tottenham Hotspur,3-0,3,0,1,1,3,3,H
1957-01-19,1956,Birmingham City,Chelsea,0-1,0,1,1,1,1,-1,A
1957-01-19,1956,Blackpool,Sunderland,1-2,1,2,1,1,3,-1,A
1957-01-19,1956,Cardiff City,Bolton Wanderers,2-0,2,0,1,1,2,2,H
1957-01-19,1956,Everton,Luton Town,2-1,2,1,1,1,3,1,H
1957-01-19,1956,Leeds United,Wolverhampton Wanderers,0-0,0,0,1,1,0,0,D
1957-01-19,1956,Manchester City,Charlton Athletic,5-1,5,1,1,1,6,4,H
1957-01-19,1956,Newcastle United,Arsenal,3-1,3,1,1,1,4,2,H
1957-01-19,1956,Portsmouth,Burnley,1-0,1,0,1,1,1,1,H
1957-01-19,1956,Sheffield Wednesday,Manchester United,2-1,2,1,1,1,3,1,H
1957-01-19,1956,Tottenham Hotspur,Aston Villa,3-0,3,0,1,1,3,3,H
1957-01-19,1956,West Bromwich Albion,Preston North End,0-0,0,0,1,1,0,0,D
1957-02-02,1956,Arsenal,Sheffield Wednesday,6-3,6,3,1,1,9,3,H
1957-02-02,1956,Aston Villa,Leeds United,1-1,1,1,1,1,2,0,D
1957-02-02,1956,Burnley,Newcastle United,3-2,3,2,1,1,5,1,H
1957-02-02,1956,Cardiff City,Birmingham City,1-2,1,2,1,1,3,-1,A
1957-02-02,1956,Charlton Athletic,Blackpool,0-4,0,4,1,1,4,-4,A
1957-02-02,1956,Chelsea,West Bromwich Albion,2-4,2,4,1,1,6,-2,A
1957-02-02,1956,Luton Town,Tottenham Hotspur,1-3,1,3,1,1,4,-2,A
1957-02-02,1956,Manchester City,Manchester United,2-4,2,4,1,1,6,-2,A
1957-02-02,1956,Preston North End,Portsmouth,7-1,7,1,1,1,8,6,H
1957-02-02,1956,Sunderland,Everton,1-1,1,1,1,1,2,0,D
1957-02-02,1956,Wolverhampton Wanderers,Bolton Wanderers,3-2,3,2,1,1,5,1,H
1957-02-04,1956,Aston Villa,Manchester City,2-2,2,2,1,1,4,0,D
1957-02-09,1956,Birmingham City,Wolverhampton Wanderers,2-2,2,2,1,1,4,0,D
1957-02-09,1956,Blackpool,Manchester City,4-1,4,1,1,1,5,3,H
1957-02-09,1956,Bolton Wanderers,Aston Villa,0-0,0,0,1,1,0,0,D
1957-02-09,1956,Everton,Charlton Athletic,5-0,5,0,1,1,5,5,H
1957-02-09,1956,Leeds United,Luton Town,1-2,1,2,1,1,3,-1,A
1957-02-09,1956,Manchester United,Arsenal,6-2,6,2,1,1,8,4,H
1957-02-09,1956,Newcastle United,Preston North End,1-2,1,2,1,1,3,-1,A
1957-02-09,1956,Portsmouth,Chelsea,2-2,2,2,1,1,4,0,D
1957-02-09,1956,Sheffield Wednesday,Burnley,0-0,0,0,1,1,0,0,D
1957-02-09,1956,Tottenham Hotspur,Sunderland,5-2,5,2,1,1,7,3,H
1957-02-09,1956,West Bromwich Albion,Cardiff City,1-2,1,2,1,1,3,-1,A
1957-02-16,1956,Leeds United,Cardiff City,3-0,3,0,1,1,3,3,H
1957-02-16,1956,Luton Town,Newcastle United,4-1,4,1,1,1,5,3,H
1957-02-16,1956,Sunderland,Sheffield Wednesday,5-2,5,2,1,1,7,3,H
1957-02-16,1956,Wolverhampton Wanderers,Charlton Athletic,7-3,7,3,1,1,10,4,H
1957-02-18,1956,Aston Villa,Portsmouth,2-2,2,2,1,1,4,0,D
1957-02-18,1956,Charlton Athletic,Manchester United,1-5,1,5,1,1,6,-4,A
1957-02-20,1956,Bolton Wanderers,Birmingham City,3-1,3,1,1,1,4,2,H
1957-02-20,1956,Tottenham Hotspur,Chelsea,3-4,3,4,1,1,7,-1,A
1957-02-23,1956,Arsenal,Everton,2-0,2,0,1,1,2,2,H
1957-02-23,1956,Cardiff City,Wolverhampton Wanderers,2-2,2,2,1,1,4,0,D
1957-02-23,1956,Chelsea,Bolton Wanderers,2-2,2,2,1,1,4,0,D
1957-02-23,1956,Manchester United,Blackpool,0-2,0,2,1,1,2,-2,A
1957-02-23,1956,Newcastle United,Charlton Athletic,3-1,3,1,1,1,4,2,H
1957-02-23,1956,Preston North End,Leeds United,3-0,3,0,1,1,3,3,H
1957-02-23,1956,Sheffield Wednesday,Manchester City,2-2,2,2,1,1,4,0,D
1957-02-23,1956,West Bromwich Albion,Luton Town,4-0,4,0,1,1,4,4,H
1957-02-27,1956,Everton,Preston North End,1-4,1,4,1,1,5,-3,A
1957-03-02,1956,Blackpool,Sheffield Wednesday,3-1,3,1,1,1,4,2,H
1957-03-02,1956,Bolton Wanderers,Preston North End,2-3,2,3,1,1,5,-1,A
1957-03-02,1956,Charlton Athletic,Portsmouth,1-3,1,3,1,1,4,-2,A
1957-03-02,1956,Leeds United,Tottenham Hotspur,1-1,1,1,1,1,2,0,D
1957-03-02,1956,Manchester City,Newcastle United,1-2,1,2,1,1,3,-1,A
1957-03-02,1956,Wolverhampton Wanderers,Chelsea,3-1,3,1,1,1,4,2,H
1957-03-06,1956,Everton,Manchester United,1-2,1,2,1,1,3,-1,A
1957-03-09,1956,Arsenal,Luton Town,1-3,1,3,1,1,4,-2,A
1957-03-09,1956,Birmingham City,Everton,1-3,1,3,1,1,4,-2,A
1957-03-09,1956,Burnley,Sunderland,2-0,2,0,1,1,2,2,H
1957-03-09,1956,Cardiff City,Blackpool,3-4,3,4,1,1,7,-1,A
1957-03-09,1956,Chelsea,Manchester City,4-2,4,2,1,1,6,2,H
1957-03-09,1956,Manchester United,Aston Villa,1-1,1,1,1,1,2,0,D
1957-03-09,1956,Newcastle United,Bolton Wanderers,4-0,4,0,1,1,4,4,H
1957-03-09,1956,Portsmouth,Leeds United,2-5,2,5,1,1,7,-3,A
1957-03-09,1956,Preston North End,Charlton Athletic,4-3,4,3,1,1,7,1,H
1957-03-09,1956,Sheffield Wednesday,Wolverhampton Wanderers,2-1,2,1,1,1,3,1,H
1957-03-09,1956,West Bromwich Albion,Tottenham Hotspur,1-1,1,1,1,1,2,0,D
1957-03-11,1956,Leeds United,Burnley,1-1,1,1,1,1,2,0,D
1957-03-13,1956,Aston Villa,Cardiff City,4-1,4,1,1,1,5,3,H
1957-03-13,1956,Portsmouth,Luton Town,2-2,2,2,1,1,4,0,D
1957-03-13,1956,Sunderland,West Bromwich Albion,1-4,1,4,1,1,5,-3,A
1957-03-13,1956,Tottenham Hotspur,Arsenal,1-3,1,3,1,1,4,-2,A
1957-03-16,1956,Aston Villa,Arsenal,0-0,0,0,1,1,0,0,D
1957-03-16,1956,Blackpool,Birmingham City,3-1,3,1,1,1,4,2,H
1957-03-16,1956,Bolton Wanderers,Sheffield Wednesday,3-2,3,2,1,1,5,1,H
1957-03-16,1956,Charlton Athletic,Chelsea,3-1,3,1,1,1,4,2,H
1957-03-16,1956,Everton,West Bromwich Albion,0-1,0,1,1,1,1,-1,A
1957-03-16,1956,Leeds United,Newcastle United,0-0,0,0,1,1,0,0,D
1957-03-16,1956,Luton Town,Burnley,0-2,0,2,1,1,2,-2,A
1957-03-16,1956,Manchester City,Cardiff City,4-1,4,1,1,1,5,3,H
1957-03-16,1956,Sunderland,Preston North End,0-0,0,0,1,1,0,0,D
1957-03-16,1956,Tottenham Hotspur,Portsmouth,2-0,2,0,1,1,2,2,H
1957-03-16,1956,Wolverhampton Wanderers,Manchester United,1-1,1,1,1,1,2,0,D
1957-03-20,1956,Luton Town,Portsmouth,1-0,1,0,1,1,1,1,H
1957-03-20,1956,Manchester City,Arsenal,2-3,2,3,1,1,5,-1,A
1957-03-23,1956,Arsenal,Wolverhampton Wanderers,0-0,0,0,1,1,0,0,D
1957-03-23,1956,Cardiff City,Charlton Athletic,2-3,2,3,1,1,5,-1,A
1957-03-23,1956,Chelsea,Sunderland,0-2,0,2,1,1,2,-2,A
1957-03-23,1956,Newcastle United,Tottenham Hotspur,2-2,2,2,1,1,4,0,D
1957-03-23,1956,Portsmouth,Everton,3-2,3,2,1,1,5,1,H
1957-03-23,1956,Preston North End,Luton Town,2-0,2,0,1,1,2,2,H
1957-03-25,1956,Manchester United,Bolton Wanderers,0-2,0,2,1,1,2,-2,A
1957-03-26,1956,Sheffield Wednesday,Leeds United,2-3,2,3,1,1,5,-1,A
1957-03-30,1956,Aston Villa,Preston North End,2-0,2,0,1,1,2,2,H
1957-03-30,1956,Blackpool,Portsmouth,5-0,5,0,1,1,5,5,H
1957-03-30,1956,Bolton Wanderers,Arsenal,2-1,2,1,1,1,3,1,H
1957-03-30,1956,Charlton Athletic,Birmingham City,1-0,1,0,1,1,1,1,H
1957-03-30,1956,Everton,Newcastle United,2-1,2,1,1,1,3,1,H
1957-03-30,1956,Leeds United,Manchester United,1-2,1,2,1,1,3,-1,A
1957-03-30,1956,Luton Town,Chelsea,0-4,0,4,1,1,4,-4,A
1957-03-30,1956,Manchester City,West Bromwich Albion,2-1,2,1,1,1,3,1,H
1957-03-30,1956,Sunderland,Cardiff City,1-1,1,1,1,1,2,0,D
1957-03-30,1956,Tottenham Hotspur,Sheffield Wednesday,1-1,1,1,1,1,2,0,D
1957-03-30,1956,Wolverhampton Wanderers,Burnley,1-2,1,2,1,1,3,-1,A
1957-04-03,1956,Cardiff City,Aston Villa,1-0,1,0,1,1,1,1,H
1957-04-03,1956,Luton Town,Birmingham City,0-0,0,0,1,1,0,0,D
1957-04-03,1956,West Bromwich Albion,Blackpool,1-3,1,3,1,1,4,-2,A
1957-04-06,1956,Arsenal,Leeds United,1-0,1,0,1,1,1,1,H
1957-04-06,1956,Birmingham City,Sunderland,1-2,1,2,1,1,3,-1,A
1957-04-06,1956,Burnley,Bolton Wanderers,1-0,1,0,1,1,1,1,H
1957-04-06,1956,Cardiff City,Luton Town,0-0,0,0,1,1,0,0,D
1957-04-06,1956,Chelsea,Aston Villa,1-1,1,1,1,1,2,0,D
1957-04-06,1956,Manchester United,Tottenham Hotspur,0-0,0,0,1,1,0,0,D
1957-04-06,1956,Newcastle United,Blackpool,2-1,2,1,1,1,3,1,H
1957-04-06,1956,Portsmouth,Manchester City,0-1,0,1,1,1,1,-1,A
1957-04-06,1956,Preston North End,Wolverhampton Wanderers,1-0,1,0,1,1,1,1,H
1957-04-06,1956,Sheffield Wednesday,Everton,2-2,2,2,1,1,4,0,D
1957-04-06,1956,West Bromwich Albion,Charlton Athletic,2-2,2,2,1,1,4,0,D
1957-04-08,1956,Aston Villa,Sunderland,2-2,2,2,1,1,4,0,D
1957-04-09,1956,Sheffield Wednesday,Portsmouth,3-1,3,1,1,1,4,2,H
1957-04-10,1956,Birmingham City,Aston Villa,1-2,1,2,1,1,3,-1,A
1957-04-13,1956,Aston Villa,Sheffield Wednesday,5-0,5,0,1,1,5,5,H
1957-04-13,1956,Blackpool,Chelsea,1-0,1,0,1,1,1,1,H
1957-04-13,1956,Bolton Wanderers,Portsmouth,1-1,1,1,1,1,2,0,D
1957-04-13,1956,Charlton Athletic,Burnley,1-2,1,2,1,1,3,-1,A
1957-04-13,1956,Everton,Cardiff City,0-0,0,0,1,1,0,0,D
1957-04-13,1956,Leeds United,West Bromwich Albion,0-0,0,0,1,1,0,0,D
1957-04-13,1956,Luton Town,Manchester United,0-2,0,2,1,1,2,-2,A
1957-04-13,1956,Manchester City,Preston North End,0-2,0,2,1,1,2,-2,A
1957-04-13,1956,Sunderland,Arsenal,1-0,1,0,1,1,1,1,H
1957-04-13,1956,Tottenham Hotspur,Birmingham City,5-1,5,1,1,1,6,4,H
1957-04-13,1956,Wolverhampton Wanderers,Newcastle United,2-0,2,0,1,1,2,2,H
1957-04-15,1956,Burnley,Aston Villa,2-1,2,1,1,1,3,1,H
1957-04-15,1956,Wolverhampton Wanderers,West Bromwich Albion,5-2,5,2,1,1,7,3,H
1957-04-19,1956,Arsenal,Blackpool,1-1,1,1,1,1,2,0,D
1957-04-19,1956,Bolton Wanderers,Luton Town,2-2,2,2,1,1,4,0,D
1957-04-19,1956,Burnley,Manchester United,1-3,1,3,1,1,4,-2,A
1957-04-19,1956,Charlton Athletic,Tottenham Hotspur,1-1,1,1,1,1,2,0,D
1957-04-19,1956,Manchester City,Everton,2-4,2,4,1,1,6,-2,A
1957-04-19,1956,Newcastle United,Chelsea,1-2,1,2,1,1,3,-1,A
1957-04-19,1956,Portsmouth,Cardiff City,1-0,1,0,1,1,1,1,H
1957-04-19,1956,Preston North End,Sheffield Wednesday,1-0,1,0,1,1,1,1,H
1957-04-19,1956,Sunderland,Leeds United,2-0,2,0,1,1,2,2,H
1957-04-20,1956,Arsenal,Charlton Athletic,3-1,3,1,1,1,4,2,H
1957-04-20,1956,Birmingham City,Leeds United,6-2,6,2,1,1,8,4,H
1957-04-20,1956,Burnley,Manchester City,0-3,0,3,1,1,3,-3,A
1957-04-20,1956,Cardiff City,Tottenham Hotspur,0-3,0,3,1,1,3,-3,A
1957-04-20,1956,Chelsea,Everton,5-1,5,1,1,1,6,4,H
1957-04-20,1956,Manchester United,Sunderland,4-0,4,0,1,1,4,4,H
1957-04-20,1956,Newcastle United,Aston Villa,1-2,1,2,1,1,3,-1,A
1957-04-20,1956,Portsmouth,Wolverhampton Wanderers,1-0,1,0,1,1,1,1,H
1957-04-20,1956,Preston North End,Blackpool,0-0,0,0,1,1,0,0,D
1957-04-20,1956,Sheffield Wednesday,Luton Town,3-0,3,0,1,1,3,3,H
1957-04-20,1956,West Bromwich Albion,Bolton Wanderers,3-2,3,2,1,1,5,1,H
1957-04-22,1956,Aston Villa,Wolverhampton Wanderers,4-0,4,0,1,1,4,4,H
1957-04-22,1956,Blackpool,Arsenal,2-4,2,4,1,1,6,-2,A
1957-04-22,1956,Cardiff City,Portsmouth,0-2,0,2,1,1,2,-2,A
1957-04-22,1956,Chelsea,Newcastle United,6-2,6,2,1,1,8,4,H
1957-04-22,1956,Everton,Manchester City,1-1,1,1,1,1,2,0,D
1957-04-22,1956,Leeds United,Sunderland,3-1,3,1,1,1,4,2,H
1957-04-22,1956,Luton Town,Bolton Wanderers,1-0,1,0,1,1,1,1,H
1957-04-22,1956,Manchester United,Burnley,2-0,2,0,1,1,2,2,H
1957-04-22,1956,Sheffield Wednesday,Preston North End,3-1,3,1,1,1,4,2,H
1957-04-22,1956,Tottenham Hotspur,Charlton Athletic,6-2,6,2,1,1,8,4,H
1957-04-22,1956,West Bromwich Albion,Birmingham City,0-0,0,0,1,1,0,0,D
1957-04-23,1956,Birmingham City,West Bromwich Albion,2-0,2,0,1,1,2,2,H
1957-04-23,1956,Wolverhampton Wanderers,Aston Villa,3-0,3,0,1,1,3,3,H
1957-04-27,1956,Aston Villa,Luton Town,1-3,1,3,1,1,4,-2,A
1957-04-27,1956,Birmingham City,Manchester City,3-3,3,3,1,1,6,0,D
1957-04-27,1956,Bolton Wanderers,Everton,1-1,1,1,1,1,2,0,D
1957-04-27,1956,Cardiff City,Manchester United,2-3,2,3,1,1,5,-1,A
1957-04-27,1956,Portsmouth,West Bromwich Albion,0-1,0,1,1,1,1,-1,A
1957-04-27,1956,Preston North End,Chelsea,1-0,1,0,1,1,1,1,H
1957-04-27,1956,Tottenham Hotspur,Blackpool,2-1,2,1,1,1,3,1,H
1957-04-29,1956,Burnley,Tottenham Hotspur,1-0,1,0,1,1,1,1,H
1957-04-29,1956,Manchester United,West Bromwich Albion,1-1,1,1,1,1,2,0,D
1957-04-29,1956,Sheffield Wednesday,Birmingham City,3-0,3,0,1,1,3,3,H
1957-05-01,1956,Blackpool,Burnley,1-0,1,0,1,1,1,1,H
1957-05-01,1956,Portsmouth,Sunderland,3-2,3,2,1,1,5,1,H
1957-08-24,1957,Birmingham City,Aston Villa,3-1,3,1,1,1,4,2,H
1957-08-24,1957,Blackpool,Leeds United,3-0,3,0,1,1,3,3,H
1957-08-24,1957,Everton,Wolverhampton Wanderers,1-0,1,0,1,1,1,1,H
1957-08-24,1957,Leicester City,Manchester United,0-3,0,3,1,1,3,-3,A
1957-08-24,1957,Luton Town,Bolton Wanderers,1-0,1,0,1,1,1,1,H
1957-08-24,1957,Nottingham Forest,Preston North End,2-1,2,1,1,1,3,1,H
1957-08-24,1957,Portsmouth,Burnley,0-0,0,0,1,1,0,0,D
1957-08-24,1957,Sunderland,Arsenal,0-1,0,1,1,1,1,-1,A
1957-08-24,1957,Tottenham Hotspur,Chelsea,1-1,1,1,1,1,2,0,D
1957-08-24,1957,West Bromwich Albion,Newcastle United,2-1,2,1,1,1,3,1,H
1957-08-26,1957,Aston Villa,Leeds United,2-0,2,0,1,1,2,2,H
1957-08-26,1957,Blackpool,Luton Town,1-2,1,2,1,1,3,-1,A
1957-08-27,1957,Arsenal,West Bromwich Albion,2-2,2,2,1,1,4,0,D
1957-08-27,1957,Burnley,Preston North End,2-0,2,0,1,1,2,2,H
1957-08-28,1957,Chelsea,Manchester City,2-3,2,3,1,1,5,-1,A
1957-08-28,1957,Leicester City,Sunderland,4-1,4,1,1,1,5,3,H
1957-08-28,1957,Manchester United,Everton,3-0,3,0,1,1,3,3,H
1957-08-28,1957,Nottingham Forest,Birmingham City,1-1,1,1,1,1,2,0,D
1957-08-28,1957,Portsmouth,Tottenham Hotspur,5-1,5,1,1,1,6,4,H
1957-08-28,1957,Wolverhampton Wanderers,Bolton Wanderers,6-1,6,1,1,1,7,5,H
1957-08-31,1957,Arsenal,Luton Town,2-0,2,0,1,1,2,2,H
1957-08-31,1957,Aston Villa,Everton,0-1,0,1,1,1,1,-1,A
1957-08-31,1957,Bolton Wanderers,Blackpool,3-0,3,0,1,1,3,3,H
1957-08-31,1957,Burnley,West Bromwich Albion,2-2,2,2,1,1,4,0,D
1957-08-31,1957,Chelsea,Birmingham City,5-1,5,1,1,1,6,4,H
1957-08-31,1957,Leeds United,Leicester City,2-1,2,1,1,1,3,1,H
1957-08-31,1957,Manchester United,Manchester City,4-1,4,1,1,1,5,3,H
1957-08-31,1957,Newcastle United,Tottenham Hotspur,3-1,3,1,1,1,4,2,H
1957-08-31,1957,Preston North End,Portsmouth,4-0,4,0,1,1,4,4,H
1957-08-31,1957,Sheffield Wednesday,Nottingham Forest,1-2,1,2,1,1,3,-1,A
1957-08-31,1957,Wolverhampton Wanderers,Sunderland,5-0,5,0,1,1,5,5,H
1957-09-04,1957,Birmingham City,Nottingham Forest,0-2,0,2,1,1,2,-2,A
1957-09-04,1957,Bolton Wanderers,Wolverhampton Wanderers,1-1,1,1,1,1,2,0,D
1957-09-04,1957,Everton,Manchester United,3-3,3,3,1,1,6,0,D
1957-09-04,1957,Leeds United,Aston Villa,4-0,4,0,1,1,4,4,H
1957-09-04,1957,Luton Town,Blackpool,2-0,2,0,1,1,2,2,H
1957-09-04,1957,Manchester City,Chelsea,5-2,5,2,1,1,7,3,H
1957-09-04,1957,Preston North End,Burnley,2-1,2,1,1,1,3,1,H
1957-09-04,1957,Sheffield Wednesday,Newcastle United,1-0,1,0,1,1,1,1,H
1957-09-04,1957,Sunderland,Leicester City,3-2,3,2,1,1,5,1,H
1957-09-04,1957,Tottenham Hotspur,Portsmouth,3-5,3,5,1,1,8,-2,A
1957-09-04,1957,West Bromwich Albion,Arsenal,1-2,1,2,1,1,3,-1,A
1957-09-07,1957,Birmingham City,Newcastle United,1-4,1,4,1,1,5,-3,A
1957-09-07,1957,Blackpool,Arsenal,1-0,1,0,1,1,1,1,H
1957-09-07,1957,Everton,Chelsea,3-0,3,0,1,1,3,3,H
1957-09-07,1957,Leicester City,Bolton Wanderers,2-3,2,3,1,1,5,-1,A
1957-09-07,1957,Luton Town,Wolverhampton Wanderers,3-1,3,1,1,1,4,2,H
1957-09-07,1957,Manchester United,Leeds United,5-0,5,0,1,1,5,5,H
1957-09-07,1957,Nottingham Forest,Manchester City,2-1,2,1,1,1,3,1,H
1957-09-07,1957,Portsmouth,Sheffield Wednesday,3-2,3,2,1,1,5,1,H
1957-09-07,1957,Sunderland,Aston Villa,1-1,1,1,1,1,2,0,D
1957-09-07,1957,Tottenham Hotspur,Burnley,3-1,3,1,1,1,4,2,H
1957-09-07,1957,West Bromwich Albion,Preston North End,4-1,4,1,1,1,5,3,H
1957-09-09,1957,Blackpool,Manchester United,1-4,1,4,1,1,5,-3,A
1957-09-09,1957,Burnley,Nottingham Forest,3-1,3,1,1,1,4,2,H
1957-09-10,1957,Arsenal,Everton,2-3,2,3,1,1,5,-1,A
1957-09-11,1957,Birmingham City,Tottenham Hotspur,0-0,0,0,1,1,0,0,D
1957-09-11,1957,Bolton Wanderers,Sunderland,2-2,2,2,1,1,4,0,D
1957-09-11,1957,Chelsea,West Bromwich Albion,2-2,2,2,1,1,4,0,D
1957-09-11,1957,Leeds United,Luton Town,0-2,0,2,1,1,2,-2,A
1957-09-11,1957,Manchester City,Preston North End,2-0,2,0,1,1,2,2,H
1957-09-11,1957,Newcastle United,Portsmouth,2-0,2,0,1,1,2,2,H
1957-09-11,1957,Sheffield Wednesday,Leicester City,2-1,2,1,1,1,3,1,H
1957-09-14,1957,Arsenal,Leicester City,3-1,3,1,1,1,4,2,H
1957-09-14,1957,Aston Villa,Luton Town,2-0,2,0,1,1,2,2,H
1957-09-14,1957,Bolton Wanderers,Manchester United,4-0,4,0,1,1,4,4,H
1957-09-14,1957,Burnley,Birmingham City,3-1,3,1,1,1,4,2,H
1957-09-14,1957,Everton,Sunderland,3-1,3,1,1,1,4,2,H
1957-09-14,1957,Leeds United,Nottingham Forest,1-2,1,2,1,1,3,-1,A
1957-09-14,1957,Manchester City,Portsmouth,2-1,2,1,1,1,3,1,H
1957-09-14,1957,Newcastle United,Chelsea,1-3,1,3,1,1,4,-2,A
1957-09-14,1957,Preston North End,Tottenham Hotspur,3-1,3,1,1,1,4,2,H
1957-09-14,1957,Sheffield Wednesday,West Bromwich Albion,1-2,1,2,1,1,3,-1,A
1957-09-14,1957,Wolverhampton Wanderers,Blackpool,3-1,3,1,1,1,4,2,H
1957-09-16,1957,Wolverhampton Wanderers,Aston Villa,2-1,2,1,1,1,3,1,H
1957-09-18,1957,Leicester City,Sheffield Wednesday,4-1,4,1,1,1,5,3,H
1957-09-18,1957,Luton Town,Leeds United,1-1,1,1,1,1,2,0,D
1957-09-18,1957,Manchester United,Blackpool,1-2,1,2,1,1,3,-1,A
1957-09-18,1957,Nottingham Forest,Burnley,7-0,7,0,1,1,7,7,H
1957-09-18,1957,Portsmouth,Newcastle United,2-2,2,2,1,1,4,0,D
1957-09-18,1957,Preston North End,Manchester City,6-1,6,1,1,1,7,5,H
1957-09-18,1957,Sunderland,Bolton Wanderers,1-2,1,2,1,1,3,-1,A
1957-09-18,1957,Tottenham Hotspur,Birmingham City,7-1,7,1,1,1,8,6,H
1957-09-18,1957,West Bromwich Albion,Chelsea,1-1,1,1,1,1,2,0,D
1957-09-21,1957,Birmingham City,Preston North End,3-1,3,1,1,1,4,2,H
1957-09-21,1957,Blackpool,Aston Villa,1-1,1,1,1,1,2,0,D
1957-09-21,1957,Chelsea,Burnley,6-1,6,1,1,1,7,5,H
1957-09-21,1957,Leeds United,Bolton Wanderers,2-1,2,1,1,1,3,1,H
1957-09-21,1957,Leicester City,Wolverhampton Wanderers,2-3,2,3,1,1,5,-1,A
1957-09-21,1957,Luton Town,Everton,0-1,0,1,1,1,1,-1,A
1957-09-21,1957,Manchester United,Arsenal,4-2,4,2,1,1,6,2,H
1957-09-21,1957,Portsmouth,Nottingham Forest,1-4,1,4,1,1,5,-3,A
1957-09-21,1957,Sunderland,Newcastle United,2-0,2,0,1,1,2,2,H
1957-09-21,1957,Tottenham Hotspur,Sheffield Wednesday,4-2,4,2,1,1,6,2,H
1957-09-21,1957,West Bromwich Albion,Manchester City,9-2,9,2,1,1,11,7,H
1957-09-23,1957,Aston Villa,Wolverhampton Wanderers,2-3,2,3,1,1,5,-1,A
1957-09-25,1957,Leeds United,Sunderland,2-1,2,1,1,1,3,1,H
1957-09-25,1957,Newcastle United,Sheffield Wednesday,0-0,0,0,1,1,0,0,D
1957-09-28,1957,Arsenal,Leeds United,2-1,2,1,1,1,3,1,H
1957-09-28,1957,Aston Villa,Leicester City,5-1,5,1,1,1,6,4,H
1957-09-28,1957,Bolton Wanderers,Portsmouth,1-0,1,0,1,1,1,1,H
1957-09-28,1957,Burnley,Newcastle United,0-2,0,2,1,1,2,-2,A
1957-09-28,1957,Manchester City,Tottenham Hotspur,5-1,5,1,1,1,6,4,H
1957-09-28,1957,Nottingham Forest,West Bromwich Albion,0-2,0,2,1,1,2,-2,A
1957-09-28,1957,Preston North End,Chelsea,5-2,5,2,1,1,7,3,H
1957-09-28,1957,Sheffield Wednesday,Birmingham City,5-3,5,3,1,1,8,2,H
1957-09-28,1957,Sunderland,Luton Town,3-0,3,0,1,1,3,3,H
1957-09-28,1957,Wolverhampton Wanderers,Manchester United,3-1,3,1,1,1,4,2,H
1957-10-01,1957,West Bromwich Albion,Birmingham City,0-0,0,0,1,1,0,0,D
1957-10-02,1957,Arsenal,Aston Villa,4-0,4,0,1,1,4,4,H
1957-10-02,1957,Wolverhampton Wanderers,Tottenham Hotspur,4-0,4,0,1,1,4,4,H
1957-10-05,1957,Birmingham City,Manchester City,4-0,4,0,1,1,4,4,H
1957-10-05,1957,Blackpool,Sunderland,7-0,7,0,1,1,7,7,H
1957-10-05,1957,Bolton Wanderers,Arsenal,0-1,0,1,1,1,1,-1,A
1957-10-05,1957,Chelsea,Sheffield Wednesday,1-0,1,0,1,1,1,1,H
1957-10-05,1957,Leeds United,Wolverhampton Wanderers,1-1,1,1,1,1,2,0,D
1957-10-05,1957,Leicester City,Everton,2-2,2,2,1,1,4,0,D
1957-10-05,1957,Luton Town,Burnley,3-2,3,2,1,1,5,1,H
1957-10-05,1957,Manchester United,Aston Villa,4-1,4,1,1,1,5,3,H
1957-10-05,1957,Newcastle United,Preston North End,0-2,0,2,1,1,2,-2,A
1957-10-05,1957,Tottenham Hotspur,Nottingham Forest,3-4,3,4,1,1,7,-1,A
1957-10-05,1957,West Bromwich Albion,Portsmouth,3-1,3,1,1,1,4,2,H
1957-10-09,1957,Manchester City,Sheffield Wednesday,2-0,2,0,1,1,2,2,H
1957-10-12,1957,Birmingham City,Wolverhampton Wanderers,1-5,1,5,1,1,6,-4,A
1957-10-12,1957,Burnley,Sunderland,6-0,6,0,1,1,6,6,H
1957-10-12,1957,Chelsea,Aston Villa,4-2,4,2,1,1,6,2,H
1957-10-12,1957,Manchester City,Leicester City,4-3,4,3,1,1,7,1,H
1957-10-12,1957,Newcastle United,Everton,2-3,2,3,1,1,5,-1,A
1957-10-12,1957,Nottingham Forest,Manchester United,1-2,1,2,1,1,3,-1,A
1957-10-12,1957,Portsmouth,Leeds United,1-2,1,2,1,1,3,-1,A
1957-10-12,1957,Preston North End,Luton Town,1-0,1,0,1,1,1,1,H
1957-10-12,1957,Sheffield Wednesday,Blackpool,0-3,0,3,1,1,3,-3,A
1957-10-12,1957,Tottenham Hotspur,Arsenal,3-1,3,1,1,1,4,2,H
1957-10-12,1957,West Bromwich Albion,Bolton Wanderers,2-2,2,2,1,1,4,0,D
1957-10-16,1957,Everton,Arsenal,2-2,2,2,1,1,4,0,D
1957-10-19,1957,Arsenal,Birmingham City,1-3,1,3,1,1,4,-2,A
1957-10-19,1957,Aston Villa,Newcastle United,4-3,4,3,1,1,7,1,H
1957-10-19,1957,Blackpool,Manchester City,2-5,2,5,1,1,7,-3,A
1957-10-19,1957,Bolton Wanderers,Tottenham Hotspur,3-2,3,2,1,1,5,1,H
1957-10-19,1957,Everton,Burnley,1-1,1,1,1,1,2,0,D
1957-10-19,1957,Leeds United,West Bromwich Albion,1-1,1,1,1,1,2,0,D
1957-10-19,1957,Leicester City,Nottingham Forest,3-1,3,1,1,1,4,2,H
1957-10-19,1957,Luton Town,Sheffield Wednesday,2-0,2,0,1,1,2,2,H
1957-10-19,1957,Manchester United,Portsmouth,0-3,0,3,1,1,3,-3,A
1957-10-19,1957,Sunderland,Preston North End,0-0,0,0,1,1,0,0,D
1957-10-19,1957,Wolverhampton Wanderers,Chelsea,2-1,2,1,1,1,3,1,H
1957-10-26,1957,Birmingham City,Bolton Wanderers,5-1,5,1,1,1,6,4,H
1957-10-26,1957,Burnley,Aston Villa,3-0,3,0,1,1,3,3,H
1957-10-26,1957,Chelsea,Arsenal,0-0,0,0,1,1,0,0,D
1957-10-26,1957,Manchester City,Luton Town,2-2,2,2,1,1,4,0,D
1957-10-26,1957,Newcastle United,Wolverhampton Wanderers,1-1,1,1,1,1,2,0,D
1957-10-26,1957,Nottingham Forest,Blackpool,1-2,1,2,1,1,3,-1,A
1957-10-26,1957,Portsmouth,Leicester City,2-0,2,0,1,1,2,2,H
1957-10-26,1957,Preston North End,Everton,3-1,3,1,1,1,4,2,H
1957-10-26,1957,Sheffield Wednesday,Sunderland,3-3,3,3,1,1,6,0,D
1957-10-26,1957,Tottenham Hotspur,Leeds United,2-0,2,0,1,1,2,2,H
1957-10-26,1957,West Bromwich Albion,Manchester United,4-3,4,3,1,1,7,1,H
1957-11-02,1957,Arsenal,Manchester City,2-1,2,1,1,1,3,1,H
1957-11-02,1957,Aston Villa,Portsmouth,2-1,2,1,1,1,3,1,H
1957-11-02,1957,Blackpool,Chelsea,2-1,2,1,1,1,3,1,H
1957-11-02,1957,Bolton Wanderers,Sheffield Wednesday,5-4,5,4,1,1,9,1,H
1957-11-02,1957,Everton,West Bromwich Albion,1-1,1,1,1,1,2,0,D
1957-11-02,1957,Leeds United,Preston North End,2-3,2,3,1,1,5,-1,A
1957-11-02,1957,Leicester City,Newcastle United,2-1,2,1,1,1,3,1,H
1957-11-02,1957,Luton Town,Birmingham City,3-0,3,0,1,1,3,3,H
1957-11-02,1957,Manchester United,Burnley,1-0,1,0,1,1,1,1,H
1957-11-02,1957,Sunderland,Tottenham Hotspur,1-1,1,1,1,1,2,0,D
1957-11-02,1957,Wolverhampton Wanderers,Nottingham Forest,2-0,2,0,1,1,2,2,H
1957-11-09,1957,Birmingham City,Sunderland,2-3,2,3,1,1,5,-1,A
1957-11-09,1957,Burnley,Leicester City,7-3,7,3,1,1,10,4,H
1957-11-09,1957,Chelsea,Luton Town,1-3,1,3,1,1,4,-2,A
1957-11-09,1957,Manchester City,Bolton Wanderers,2-1,2,1,1,1,3,1,H
1957-11-09,1957,Newcastle United,Blackpool,1-2,1,2,1,1,3,-1,A
1957-11-09,1957,Nottingham Forest,Arsenal,4-0,4,0,1,1,4,4,H
1957-11-09,1957,Portsmouth,Wolverhampton Wanderers,1-1,1,1,1,1,2,0,D
1957-11-09,1957,Preston North End,Manchester United,1-1,1,1,1,1,2,0,D
1957-11-09,1957,Sheffield Wednesday,Leeds United,3-2,3,2,1,1,5,1,H
1957-11-09,1957,Tottenham Hotspur,Everton,3-1,3,1,1,1,4,2,H
1957-11-09,1957,West Bromwich Albion,Aston Villa,3-2,3,2,1,1,5,1,H
1957-11-16,1957,Arsenal,Portsmouth,3-2,3,2,1,1,5,1,H
1957-11-16,1957,Aston Villa,Tottenham Hotspur,1-1,1,1,1,1,2,0,D
1957-11-16,1957,Blackpool,Burnley,2-4,2,4,1,1,6,-2,A
1957-11-16,1957,Bolton Wanderers,Nottingham Forest,2-0,2,0,1,1,2,2,H
1957-11-16,1957,Everton,Birmingham City,0-2,0,2,1,1,2,-2,A
1957-11-16,1957,Leeds United,Manchester City,2-4,2,4,1,1,6,-2,A
1957-11-16,1957,Leicester City,Preston North End,1-3,1,3,1,1,4,-2,A
1957-11-16,1957,Luton Town,Newcastle United,0-3,0,3,1,1,3,-3,A
1957-11-16,1957,Manchester United,Sheffield Wednesday,2-1,2,1,1,1,3,1,H
1957-11-16,1957,Sunderland,Chelsea,2-2,2,2,1,1,4,0,D
1957-11-16,1957,Wolverhampton Wanderers,West Bromwich Albion,1-1,1,1,1,1,2,0,D
1957-11-20,1957,Everton,Blackpool,0-0,0,0,1,1,0,0,D
1957-11-23,1957,Birmingham City,Blackpool,0-0,0,0,1,1,0,0,D
1957-11-23,1957,Burnley,Leeds United,3-1,3,1,1,1,4,2,H
1957-11-23,1957,Chelsea,Leicester City,4-0,4,0,1,1,4,4,H
1957-11-23,1957,Manchester City,Wolverhampton Wanderers,3-4,3,4,1,1,7,-1,A
1957-11-23,1957,Newcastle United,Manchester United,1-2,1,2,1,1,3,-1,A
1957-11-23,1957,Nottingham Forest,Aston Villa,4-1,4,1,1,1,5,3,H
1957-11-23,1957,Portsmouth,Everton,3-2,3,2,1,1,5,1,H
1957-11-23,1957,Preston North End,Bolton Wanderers,3-0,3,0,1,1,3,3,H
1957-11-23,1957,Sheffield Wednesday,Arsenal,2-0,2,0,1,1,2,2,H
1957-11-23,1957,Tottenham Hotspur,Luton Town,3-1,3,1,1,1,4,2,H
1957-11-23,1957,West Bromwich Albion,Sunderland,3-0,3,0,1,1,3,3,H
1957-11-30,1957,Arsenal,Newcastle United,2-3,2,3,1,1,5,-1,A
1957-11-30,1957,Aston Villa,Preston North End,2-2,2,2,1,1,4,0,D
1957-11-30,1957,Blackpool,Portsmouth,2-1,2,1,1,1,3,1,H
1957-11-30,1957,Bolton Wanderers,Chelsea,3-3,3,3,1,1,6,0,D
1957-11-30,1957,Everton,Sheffield Wednesday,1-1,1,1,1,1,2,0,D
1957-11-30,1957,Leeds United,Birmingham City,1-1,1,1,1,1,2,0,D
1957-11-30,1957,Leicester City,West Bromwich Albion,3-3,3,3,1,1,6,0,D
1957-11-30,1957,Luton Town,Nottingham Forest,3-1,3,1,1,1,4,2,H
1957-11-30,1957,Manchester United,Tottenham Hotspur,3-4,3,4,1,1,7,-1,A
1957-11-30,1957,Sunderland,Manchester City,2-1,2,1,1,1,3,1,H
1957-11-30,1957,Wolverhampton Wanderers,Burnley,2-1,2,1,1,1,3,1,H
1957-12-07,1957,Birmingham City,Manchester United,3-3,3,3,1,1,6,0,D
1957-12-07,1957,Burnley,Arsenal,2-1,2,1,1,1,3,1,H
1957-12-07,1957,Chelsea,Leeds United,2-1,2,1,1,1,3,1,H
1957-12-07,1957,Manchester City,Everton,6-2,6,2,1,1,8,4,H
1957-12-07,1957,Newcastle United,Bolton Wanderers,1-2,1,2,1,1,3,-1,A
1957-12-07,1957,Nottingham Forest,Sunderland,2-0,2,0,1,1,2,2,H
1957-12-07,1957,Portsmouth,Luton Town,5-0,5,0,1,1,5,5,H
1957-12-07,1957,Preston North End,Wolverhampton Wanderers,1-2,1,2,1,1,3,-1,A
1957-12-07,1957,Sheffield Wednesday,Aston Villa,2-5,2,5,1,1,7,-3,A
1957-12-07,1957,Tottenham Hotspur,Leicester City,1-4,1,4,1,1,5,-3,A
1957-12-07,1957,West Bromwich Albion,Blackpool,1-1,1,1,1,1,2,0,D
1957-12-14,1957,Arsenal,Preston North End,4-2,4,2,1,1,6,2,H
1957-12-14,1957,Aston Villa,Manchester City,1-2,1,2,1,1,3,-1,A
1957-12-14,1957,Blackpool,Tottenham Hotspur,0-2,0,2,1,1,2,-2,A
1957-12-14,1957,Bolton Wanderers,Burnley,2-1,2,1,1,1,3,1,H
1957-12-14,1957,Everton,Nottingham Forest,1-1,1,1,1,1,2,0,D
1957-12-14,1957,Leeds United,Newcastle United,3-0,3,0,1,1,3,3,H
1957-12-14,1957,Leicester City,Birmingham City,2-2,2,2,1,1,4,0,D
1957-12-14,1957,Luton Town,West Bromwich Albion,5-1,5,1,1,1,6,4,H
1957-12-14,1957,Manchester United,Chelsea,0-1,0,1,1,1,1,-1,A
1957-12-14,1957,Sunderland,Portsmouth,1-1,1,1,1,1,2,0,D
1957-12-14,1957,Wolverhampton Wanderers,Sheffield Wednesday,4-3,4,3,1,1,7,1,H
1957-12-21,1957,Arsenal,Sunderland,3-0,3,0,1,1,3,3,H
1957-12-21,1957,Aston Villa,Birmingham City,0-2,0,2,1,1,2,-2,A
1957-12-21,1957,Bolton Wanderers,Luton Town,1-2,1,2,1,1,3,-1,A
1957-12-21,1957,Burnley,Portsmouth,3-1,3,1,1,1,4,2,H
1957-12-21,1957,Chelsea,Tottenham Hotspur,2-4,2,4,1,1,6,-2,A
1957-12-21,1957,Leeds United,Blackpool,2-1,2,1,1,1,3,1,H
1957-12-21,1957,Manchester United,Leicester City,4-0,4,0,1,1,4,4,H
1957-12-21,1957,Newcastle United,West Bromwich Albion,3-0,3,0,1,1,3,3,H
1957-12-21,1957,Preston North End,Nottingham Forest,2-0,2,0,1,1,2,2,H
1957-12-21,1957,Sheffield Wednesday,Manchester City,4-5,4,5,1,1,9,-1,A
1957-12-21,1957,Wolverhampton Wanderers,Everton,2-0,2,0,1,1,2,2,H
1957-12-25,1957,Blackpool,Leicester City,5-1,5,1,1,1,6,4,H
1957-12-25,1957,Burnley,Manchester City,2-1,2,1,1,1,3,1,H
1957-12-25,1957,Chelsea,Portsmouth,7-4,7,4,1,1,11,3,H
1957-12-25,1957,Everton,Bolton Wanderers,1-1,1,1,1,1,2,0,D
1957-12-25,1957,Manchester United,Luton Town,3-0,3,0,1,1,3,3,H
1957-12-25,1957,Newcastle United,Nottingham Forest,1-4,1,4,1,1,5,-3,A
1957-12-25,1957,Sheffield Wednesday,Preston North End,4-4,4,4,1,1,8,0,D
1957-12-26,1957,Aston Villa,Arsenal,3-0,3,0,1,1,3,3,H
1957-12-26,1957,Birmingham City,West Bromwich Albion,3-5,3,5,1,1,8,-2,A
1957-12-26,1957,Bolton Wanderers,Everton,1-5,1,5,1,1,6,-4,A
1957-12-26,1957,Leicester City,Blackpool,2-1,2,1,1,1,3,1,H
1957-12-26,1957,Luton Town,Manchester United,2-2,2,2,1,1,4,0,D
1957-12-26,1957,Manchester City,Burnley,4-1,4,1,1,1,5,3,H
1957-12-26,1957,Nottingham Forest,Newcastle United,2-3,2,3,1,1,5,-1,A
1957-12-26,1957,Portsmouth,Chelsea,3-0,3,0,1,1,3,3,H
1957-12-26,1957,Preston North End,Sheffield Wednesday,3-0,3,0,1,1,3,3,H
1957-12-26,1957,Sunderland,Leeds United,2-1,2,1,1,1,3,1,H
1957-12-26,1957,Tottenham Hotspur,Wolverhampton Wanderers,1-0,1,0,1,1,1,1,H
1957-12-28,1957,Birmingham City,Chelsea,3-3,3,3,1,1,6,0,D
1957-12-28,1957,Blackpool,Bolton Wanderers,2-3,2,3,1,1,5,-1,A
1957-12-28,1957,Everton,Aston Villa,1-2,1,2,1,1,3,-1,A
1957-12-28,1957,Leicester City,Leeds United,3-0,3,0,1,1,3,3,H
1957-12-28,1957,Luton Town,Arsenal,4-0,4,0,1,1,4,4,H
1957-12-28,1957,Manchester City,Manchester United,2-2,2,2,1,1,4,0,D
1957-12-28,1957,Nottingham Forest,Sheffield Wednesday,5-2,5,2,1,1,7,3,H
1957-12-28,1957,Portsmouth,Preston North End,0-2,0,2,1,1,2,-2,A
1957-12-28,1957,Sunderland,Wolverhampton Wanderers,0-2,0,2,1,1,2,-2,A
1957-12-28,1957,Tottenham Hotspur,Newcastle United,3-3,3,3,1,1,6,0,D
1957-12-28,1957,West Bromwich Albion,Burnley,5-1,5,1,1,1,6,4,H
1958-01-11,1957,Arsenal,Blackpool,2-3,2,3,1,1,5,-1,A
1958-01-11,1957,Aston Villa,Sunderland,5-2,5,2,1,1,7,3,H
1958-01-11,1957,Bolton Wanderers,Leicester City,2-3,2,3,1,1,5,-1,A
1958-01-11,1957,Burnley,Tottenham Hotspur,2-0,2,0,1,1,2,2,H
1958-01-11,1957,Chelsea,Everton,3-1,3,1,1,1,4,2,H
1958-01-11,1957,Leeds United,Manchester United,1-1,1,1,1,1,2,0,D
1958-01-11,1957,Manchester City,Nottingham Forest,1-1,1,1,1,1,2,0,D
1958-01-11,1957,Newcastle United,Birmingham City,1-2,1,2,1,1,3,-1,A
1958-01-11,1957,Preston North End,West Bromwich Albion,3-1,3,1,1,1,4,2,H
1958-01-11,1957,Sheffield Wednesday,Portsmouth,4-2,4,2,1,1,6,2,H
1958-01-11,1957,Wolverhampton Wanderers,Luton Town,1-1,1,1,1,1,2,0,D
1958-01-18,1957,Birmingham City,Burnley,2-3,2,3,1,1,5,-1,A
1958-01-18,1957,Blackpool,Wolverhampton Wanderers,3-2,3,2,1,1,5,1,H
1958-01-18,1957,Chelsea,Newcastle United,2-1,2,1,1,1,3,1,H
1958-01-18,1957,Leicester City,Arsenal,0-1,0,1,1,1,1,-1,A
1958-01-18,1957,Luton Town,Aston Villa,3-0,3,0,1,1,3,3,H
1958-01-18,1957,Manchester United,Bolton Wanderers,7-2,7,2,1,1,9,5,H
1958-01-18,1957,Nottingham Forest,Leeds United,1-1,1,1,1,1,2,0,D
1958-01-18,1957,Portsmouth,Manchester City,2-1,2,1,1,1,3,1,H
1958-01-18,1957,Sunderland,Everton,1-1,1,1,1,1,2,0,D
1958-01-18,1957,Tottenham Hotspur,Preston North End,3-3,3,3,1,1,6,0,D
1958-01-18,1957,West Bromwich Albion,Sheffield Wednesday,3-1,3,1,1,1,4,2,H
1958-02-01,1957,Arsenal,Manchester United,4-5,4,5,1,1,9,-1,A
1958-02-01,1957,Aston Villa,Blackpool,1-1,1,1,1,1,2,0,D
1958-02-01,1957,Bolton Wanderers,Leeds United,0-2,0,2,1,1,2,-2,A
1958-02-01,1957,Burnley,Chelsea,2-1,2,1,1,1,3,1,H
1958-02-01,1957,Everton,Luton Town,0-2,0,2,1,1,2,-2,A
1958-02-01,1957,Manchester City,West Bromwich Albion,4-1,4,1,1,1,5,3,H
1958-02-01,1957,Newcastle United,Sunderland,2-2,2,2,1,1,4,0,D
1958-02-01,1957,Nottingham Forest,Portsmouth,2-0,2,0,1,1,2,2,H
1958-02-01,1957,Preston North End,Birmingham City,8-0,8,0,1,1,8,8,H
1958-02-01,1957,Sheffield Wednesday,Tottenham Hotspur,2-0,2,0,1,1,2,2,H
1958-02-01,1957,Wolverhampton Wanderers,Leicester City,5-1,5,1,1,1,6,4,H
1958-02-08,1957,Chelsea,Preston North End,0-2,0,2,1,1,2,-2,A
1958-02-08,1957,Leicester City,Aston Villa,6-1,6,1,1,1,7,5,H
1958-02-08,1957,Luton Town,Sunderland,7-1,7,1,1,1,8,6,H
1958-02-08,1957,Portsmouth,Bolton Wanderers,2-2,2,2,1,1,4,0,D
1958-02-08,1957,Tottenham Hotspur,Manchester City,5-1,5,1,1,1,6,4,H
1958-02-08,1957,West Bromwich Albion,Nottingham Forest,3-2,3,2,1,1,5,1,H
1958-02-15,1957,Burnley,Luton Town,1-2,1,2,1,1,3,-1,A
1958-02-15,1957,Everton,Leicester City,2-2,2,2,1,1,4,0,D
1958-02-15,1957,Nottingham Forest,Tottenham Hotspur,1-2,1,2,1,1,3,-1,A
1958-02-15,1957,Sheffield Wednesday,Chelsea,2-3,2,3,1,1,5,-1,A
1958-02-15,1957,Sunderland,Blackpool,1-4,1,4,1,1,5,-3,A
1958-02-18,1957,Arsenal,Bolton Wanderers,1-2,1,2,1,1,3,-1,A
1958-02-19,1957,Wolverhampton Wanderers,Leeds United,3-2,3,2,1,1,5,1,H
1958-02-22,1957,Arsenal,Tottenham Hotspur,4-4,4,4,1,1,8,0,D
1958-02-22,1957,Aston Villa,Chelsea,1-3,1,3,1,1,4,-2,A
1958-02-22,1957,Blackpool,Sheffield Wednesday,2-2,2,2,1,1,4,0,D
1958-02-22,1957,Bolton Wanderers,West Bromwich Albion,2-2,2,2,1,1,4,0,D
1958-02-22,1957,Everton,Newcastle United,1-2,1,2,1,1,3,-1,A
1958-02-22,1957,Leeds United,Portsmouth,2-0,2,0,1,1,2,2,H
1958-02-22,1957,Leicester City,Manchester City,8-4,8,4,1,1,12,4,H
1958-02-22,1957,Luton Town,Preston North End,1-3,1,3,1,1,4,-2,A
1958-02-22,1957,Manchester United,Nottingham Forest,1-1,1,1,1,1,2,0,D
1958-02-22,1957,Sunderland,Burnley,2-3,2,3,1,1,5,-1,A
1958-02-22,1957,Wolverhampton Wanderers,Birmingham City,5-1,5,1,1,1,6,4,H
1958-03-01,1957,Birmingham City,Arsenal,4-1,4,1,1,1,5,3,H
1958-03-01,1957,Burnley,Everton,0-2,0,2,1,1,2,-2,A
1958-03-01,1957,Manchester City,Blackpool,4-3,4,3,1,1,7,1,H
1958-03-01,1957,Newcastle United,Aston Villa,2-4,2,4,1,1,6,-2,A
1958-03-01,1957,Nottingham Forest,Leicester City,3-1,3,1,1,1,4,2,H
1958-03-01,1957,Preston North End,Sunderland,3-0,3,0,1,1,3,3,H
1958-03-01,1957,Sheffield Wednesday,Luton Town,2-1,2,1,1,1,3,1,H
1958-03-05,1957,Manchester City,Birmingham City,1-1,1,1,1,1,2,0,D
1958-03-08,1957,Arsenal,Chelsea,5-4,5,4,1,1,9,1,H
1958-03-08,1957,Aston Villa,Burnley,3-0,3,0,1,1,3,3,H
1958-03-08,1957,Blackpool,Nottingham Forest,3-0,3,0,1,1,3,3,H
1958-03-08,1957,Bolton Wanderers,Birmingham City,1-0,1,0,1,1,1,1,H
1958-03-08,1957,Everton,Preston North End,4-2,4,2,1,1,6,2,H
1958-03-08,1957,Leeds United,Tottenham Hotspur,1-2,1,2,1,1,3,-1,A
1958-03-08,1957,Leicester City,Portsmouth,2-2,2,2,1,1,4,0,D
1958-03-08,1957,Luton Town,Manchester City,1-2,1,2,1,1,3,-1,A
1958-03-08,1957,Manchester United,West Bromwich Albion,0-4,0,4,1,1,4,-4,A
1958-03-08,1957,Sunderland,Sheffield Wednesday,3-3,3,3,1,1,6,0,D
1958-03-08,1957,Wolverhampton Wanderers,Newcastle United,3-1,3,1,1,1,4,2,H
1958-03-11,1957,Chelsea,Wolverhampton Wanderers,1-2,1,2,1,1,3,-1,A
1958-03-12,1957,Birmingham City,Sheffield Wednesday,1-0,1,0,1,1,1,1,H
1958-03-12,1957,Tottenham Hotspur,Bolton Wanderers,4-1,4,1,1,1,5,3,H
1958-03-12,1957,West Bromwich Albion,Leeds United,1-0,1,0,1,1,1,1,H
1958-03-15,1957,Birmingham City,Luton Town,1-1,1,1,1,1,2,0,D
1958-03-15,1957,Burnley,Manchester United,3-0,3,0,1,1,3,3,H
1958-03-15,1957,Chelsea,Blackpool,1-4,1,4,1,1,5,-3,A
1958-03-15,1957,Manchester City,Arsenal,2-4,2,4,1,1,6,-2,A
1958-03-15,1957,Newcastle United,Leicester City,5-3,5,3,1,1,8,2,H
1958-03-15,1957,Nottingham Forest,Wolverhampton Wanderers,1-4,1,4,1,1,5,-3,A
1958-03-15,1957,Portsmouth,Aston Villa,1-0,1,0,1,1,1,1,H
1958-03-15,1957,Preston North End,Leeds United,3-0,3,0,1,1,3,3,H
1958-03-15,1957,Sheffield Wednesday,Bolton Wanderers,1-0,1,0,1,1,1,1,H
1958-03-15,1957,Tottenham Hotspur,Sunderland,0-1,0,1,1,1,1,-1,A
1958-03-15,1957,West Bromwich Albion,Everton,4-0,4,0,1,1,4,4,H
1958-03-19,1957,Leeds United,Arsenal,2-0,2,0,1,1,2,2,H
1958-03-19,1957,Portsmouth,West Bromwich Albion,2-2,2,2,1,1,4,0,D
1958-03-19,1957,Preston North End,Newcastle United,2-1,2,1,1,1,3,1,H
1958-03-22,1957,Arsenal,Sheffield Wednesday,1-0,1,0,1,1,1,1,H
1958-03-22,1957,Blackpool,Birmingham City,4-2,4,2,1,1,6,2,H
1958-03-22,1957,Everton,Portsmouth,4-2,4,2,1,1,6,2,H
1958-03-22,1957,Leeds United,Burnley,1-0,1,0,1,1,1,1,H
1958-03-22,1957,Leicester City,Chelsea,3-2,3,2,1,1,5,1,H
1958-03-22,1957,Luton Town,Tottenham Hotspur,0-0,0,0,1,1,0,0,D
1958-03-22,1957,Sunderland,West Bromwich Albion,2-0,2,0,1,1,2,2,H
1958-03-22,1957,Wolverhampton Wanderers,Manchester City,3-3,3,3,1,1,6,0,D
1958-03-29,1957,Birmingham City,Everton,2-1,2,1,1,1,3,1,H
1958-03-29,1957,Burnley,Blackpool,2-1,2,1,1,1,3,1,H
1958-03-29,1957,Chelsea,Sunderland,0-0,0,0,1,1,0,0,D
1958-03-29,1957,Manchester City,Leeds United,1-0,1,0,1,1,1,1,H
1958-03-29,1957,Newcastle United,Luton Town,3-2,3,2,1,1,5,1,H
1958-03-29,1957,Nottingham Forest,Bolton Wanderers,0-0,0,0,1,1,0,0,D
1958-03-29,1957,Portsmouth,Arsenal,5-4,5,4,1,1,9,1,H
1958-03-29,1957,Preston North End,Leicester City,4-1,4,1,1,1,5,3,H
1958-03-29,1957,Sheffield Wednesday,Manchester United,1-0,1,0,1,1,1,1,H
1958-03-29,1957,Tottenham Hotspur,Aston Villa,6-2,6,2,1,1,8,4,H
1958-03-29,1957,West Bromwich Albion,Wolverhampton Wanderers,0-3,0,3,1,1,3,-3,A
1958-03-31,1957,Aston Villa,Manchester United,3-2,3,2,1,1,5,1,H
1958-04-04,1957,Blackpool,Preston North End,1-2,1,2,1,1,3,-1,A
1958-04-04,1957,Bolton Wanderers,Aston Villa,4-0,4,0,1,1,4,4,H
1958-04-04,1957,Burnley,Sheffield Wednesday,2-0,2,0,1,1,2,2,H
1958-04-04,1957,Chelsea,Nottingham Forest,0-0,0,0,1,1,0,0,D
1958-04-04,1957,Everton,Leeds United,0-1,0,1,1,1,1,-1,A
1958-04-04,1957,Manchester United,Sunderland,2-2,2,2,1,1,4,0,D
1958-04-04,1957,Portsmouth,Birmingham City,3-2,3,2,1,1,5,1,H
1958-04-04,1957,Tottenham Hotspur,West Bromwich Albion,0-0,0,0,1,1,0,0,D
1958-04-05,1957,Aston Villa,West Bromwich Albion,2-1,2,1,1,1,3,1,H
1958-04-05,1957,Blackpool,Newcastle United,3-2,3,2,1,1,5,1,H
1958-04-05,1957,Bolton Wanderers,Manchester City,0-2,0,2,1,1,2,-2,A
1958-04-05,1957,Everton,Tottenham Hotspur,3-4,3,4,1,1,7,-1,A
1958-04-05,1957,Leeds United,Sheffield Wednesday,2-2,2,2,1,1,4,0,D
1958-04-05,1957,Leicester City,Burnley,5-3,5,3,1,1,8,2,H
1958-04-05,1957,Luton Town,Chelsea,0-2,0,2,1,1,2,-2,A
1958-04-05,1957,Manchester United,Preston North End,0-0,0,0,1,1,0,0,D
1958-04-05,1957,Sunderland,Birmingham City,1-6,1,6,1,1,7,-5,A
1958-04-05,1957,Wolverhampton Wanderers,Portsmouth,1-0,1,0,1,1,1,1,H
1958-04-07,1957,Arsenal,Wolverhampton Wanderers,0-2,0,2,1,1,2,-2,A
1958-04-07,1957,Birmingham City,Portsmouth,4-1,4,1,1,1,5,3,H
1958-04-07,1957,Leeds United,Everton,1-0,1,0,1,1,1,1,H
1958-04-07,1957,Luton Town,Leicester City,2-1,2,1,1,1,3,1,H
1958-04-07,1957,Manchester City,Newcastle United,2-1,2,1,1,1,3,1,H
1958-04-07,1957,Nottingham Forest,Chelsea,1-1,1,1,1,1,2,0,D
1958-04-07,1957,Preston North End,Blackpool,2-1,2,1,1,1,3,1,H
1958-04-07,1957,Sheffield Wednesday,Burnley,1-2,1,2,1,1,3,-1,A
1958-04-07,1957,Sunderland,Manchester United,1-2,1,2,1,1,3,-1,A
1958-04-07,1957,West Bromwich Albion,Tottenham Hotspur,0-2,0,2,1,1,2,-2,A
1958-04-08,1957,Aston Villa,Bolton Wanderers,4-0,4,0,1,1,4,4,H
1958-04-08,1957,Leicester City,Luton Town,4-1,4,1,1,1,5,3,H
1958-04-08,1957,Wolverhampton Wanderers,Arsenal,1-2,1,2,1,1,3,-1,A
1958-04-12,1957,Birmingham City,Leeds United,1-1,1,1,1,1,2,0,D
1958-04-12,1957,Burnley,Wolverhampton Wanderers,1-1,1,1,1,1,2,0,D
1958-04-12,1957,Chelsea,Bolton Wanderers,2-2,2,2,1,1,4,0,D
1958-04-12,1957,Manchester City,Sunderland,3-1,3,1,1,1,4,2,H
1958-04-12,1957,Newcastle United,Arsenal,3-3,3,3,1,1,6,0,D
1958-04-12,1957,Nottingham Forest,Luton Town,1-0,1,0,1,1,1,1,H
1958-04-12,1957,Portsmouth,Blackpool,1-2,1,2,1,1,3,-1,A
1958-04-12,1957,Preston North End,Aston Villa,1-1,1,1,1,1,2,0,D
1958-04-12,1957,Sheffield Wednesday,Everton,2-1,2,1,1,1,3,1,H
1958-04-12,1957,Tottenham Hotspur,Manchester United,1-0,1,0,1,1,1,1,H
1958-04-12,1957,West Bromwich Albion,Leicester City,6-2,6,2,1,1,8,4,H
1958-04-14,1957,Newcastle United,Manchester City,4-1,4,1,1,1,5,3,H
1958-04-16,1957,Portsmouth,Manchester United,3-3,3,3,1,1,6,0,D
1958-04-19,1957,Arsenal,Burnley,0-0,0,0,1,1,0,0,D
1958-04-19,1957,Aston Villa,Sheffield Wednesday,2-0,2,0,1,1,2,2,H
1958-04-19,1957,Blackpool,West Bromwich Albion,2-0,2,0,1,1,2,2,H
1958-04-19,1957,Bolton Wanderers,Newcastle United,1-1,1,1,1,1,2,0,D
1958-04-19,1957,Everton,Manchester City,2-5,2,5,1,1,7,-3,A
1958-04-19,1957,Leeds United,Chelsea,0-0,0,0,1,1,0,0,D
1958-04-19,1957,Leicester City,Tottenham Hotspur,1-3,1,3,1,1,4,-2,A
1958-04-19,1957,Luton Town,Portsmouth,2-1,2,1,1,1,3,1,H
1958-04-19,1957,Manchester United,Birmingham City,0-2,0,2,1,1,2,-2,A
1958-04-19,1957,Sunderland,Nottingham Forest,3-0,3,0,1,1,3,3,H
1958-04-19,1957,Wolverhampton Wanderers,Preston North End,2-0,2,0,1,1,2,2,H
1958-04-21,1957,Arsenal,Nottingham Forest,1-1,1,1,1,1,2,0,D
1958-04-21,1957,Bolton Wanderers,Preston North End,0-4,0,4,1,1,4,-4,A
1958-04-21,1957,Manchester United,Wolverhampton Wanderers,0-4,0,4,1,1,4,-4,A
1958-04-23,1957,Blackpool,Everton,0-1,0,1,1,1,1,-1,A
1958-04-23,1957,Manchester United,Newcastle United,1-1,1,1,1,1,2,0,D
1958-04-26,1957,Birmingham City,Leicester City,0-1,0,1,1,1,1,-1,A
1958-04-26,1957,Burnley,Bolton Wanderers,3-1,3,1,1,1,4,2,H
1958-04-26,1957,Chelsea,Manchester United,2-1,2,1,1,1,3,1,H
1958-04-26,1957,Manchester City,Aston Villa,1-2,1,2,1,1,3,-1,A
1958-04-26,1957,Newcastle United,Leeds United,1-2,1,2,1,1,3,-1,A
1958-04-26,1957,Nottingham Forest,Everton,0-3,0,3,1,1,3,-3,A
1958-04-26,1957,Portsmouth,Sunderland,0-2,0,2,1,1,2,-2,A
1958-04-26,1957,Preston North End,Arsenal,3-0,3,0,1,1,3,3,H
1958-04-26,1957,Sheffield Wednesday,Wolverhampton Wanderers,2-1,2,1,1,1,3,1,H
1958-04-26,1957,Tottenham Hotspur,Blackpool,2-1,2,1,1,1,3,1,H
1958-04-26,1957,West Bromwich Albion,Luton Town,4-2,4,2,1,1,6,2,H
1958-04-28,1957,Newcastle United,Burnley,1-3,1,3,1,1,4,-2,A
1958-04-30,1957,Aston Villa,Nottingham Forest,1-1,1,1,1,1,2,0,D
1958-08-23,1958,Aston Villa,Birmingham City,1-1,1,1,1,1,2,0,D
1958-08-23,1958,Bolton Wanderers,Leeds United,4-0,4,0,1,1,4,4,H
1958-08-23,1958,Burnley,Manchester City,3-4,3,4,1,1,7,-1,A
1958-08-23,1958,Leicester City,Everton,2-0,2,0,1,1,2,2,H
1958-08-23,1958,Luton Town,West Bromwich Albion,1-1,1,1,1,1,2,0,D
1958-08-23,1958,Manchester United,Chelsea,5-2,5,2,1,1,7,3,H
1958-08-23,1958,Newcastle United,Blackburn Rovers,1-5,1,5,1,1,6,-4,A
1958-08-23,1958,Portsmouth,West Ham United,1-2,1,2,1,1,3,-1,A
1958-08-23,1958,Preston North End,Arsenal,2-1,2,1,1,1,3,1,H
1958-08-23,1958,Tottenham Hotspur,Blackpool,2-3,2,3,1,1,5,-1,A
1958-08-23,1958,Wolverhampton Wanderers,Nottingham Forest,5-1,5,1,1,1,6,4,H
1958-08-25,1958,Aston Villa,Portsmouth,3-2,3,2,1,1,5,1,H
1958-08-25,1958,Blackburn Rovers,Leicester City,5-0,5,0,1,1,5,5,H
1958-08-25,1958,Blackpool,Newcastle United,3-0,3,0,1,1,3,3,H
1958-08-25,1958,West Ham United,Wolverhampton Wanderers,2-0,2,0,1,1,2,2,H
1958-08-26,1958,Arsenal,Burnley,3-0,3,0,1,1,3,3,H
1958-08-26,1958,Leeds United,Luton Town,1-1,1,1,1,1,2,0,D
1958-08-27,1958,Chelsea,Tottenham Hotspur,4-2,4,2,1,1,6,2,H
1958-08-27,1958,Everton,Preston North End,1-4,1,4,1,1,5,-3,A
1958-08-27,1958,Manchester City,Bolton Wanderers,3-3,3,3,1,1,6,0,D
1958-08-27,1958,Nottingham Forest,Manchester United,0-3,0,3,1,1,3,-3,A
1958-08-27,1958,West Bromwich Albion,Birmingham City,2-2,2,2,1,1,4,0,D
1958-08-30,1958,Arsenal,Leicester City,5-1,5,1,1,1,6,4,H
1958-08-30,1958,Birmingham City,Luton Town,0-1,0,1,1,1,1,-1,A
1958-08-30,1958,Blackburn Rovers,Tottenham Hotspur,5-0,5,0,1,1,5,5,H
1958-08-30,1958,Blackpool,Manchester United,2-1,2,1,1,1,3,1,H
1958-08-30,1958,Chelsea,Wolverhampton Wanderers,6-2,6,2,1,1,8,4,H
1958-08-30,1958,Everton,Newcastle United,0-2,0,2,1,1,2,-2,A
1958-08-30,1958,Leeds United,Burnley,1-1,1,1,1,1,2,0,D
1958-08-30,1958,Manchester City,Preston North End,1-1,1,1,1,1,2,0,D
1958-08-30,1958,Nottingham Forest,Portsmouth,5-0,5,0,1,1,5,5,H
1958-08-30,1958,West Bromwich Albion,Bolton Wanderers,1-1,1,1,1,1,2,0,D
1958-08-30,1958,West Ham United,Aston Villa,7-2,7,2,1,1,9,5,H
1958-09-01,1958,Preston North End,Everton,3-1,3,1,1,1,4,2,H
1958-09-02,1958,Burnley,Arsenal,3-1,3,1,1,1,4,2,H
1958-09-03,1958,Birmingham City,West Bromwich Albion,0-6,0,6,1,1,6,-6,A
1958-09-03,1958,Bolton Wanderers,Manchester City,4-1,4,1,1,1,5,3,H
1958-09-03,1958,Leicester City,Blackburn Rovers,1-1,1,1,1,1,2,0,D
1958-09-03,1958,Luton Town,Leeds United,1-1,1,1,1,1,2,0,D
1958-09-03,1958,Manchester United,Nottingham Forest,1-1,1,1,1,1,2,0,D
1958-09-03,1958,Newcastle United,Blackpool,1-0,1,0,1,1,1,1,H
1958-09-03,1958,Portsmouth,Aston Villa,5-2,5,2,1,1,7,3,H
1958-09-03,1958,Tottenham Hotspur,Chelsea,4-0,4,0,1,1,4,4,H
1958-09-03,1958,Wolverhampton Wanderers,West Ham United,1-1,1,1,1,1,2,0,D
1958-09-06,1958,Aston Villa,Nottingham Forest,2-3,2,3,1,1,5,-1,A
1958-09-06,1958,Bolton Wanderers,Birmingham City,2-0,2,0,1,1,2,2,H
1958-09-06,1958,Burnley,West Bromwich Albion,1-3,1,3,1,1,4,-2,A
1958-09-06,1958,Everton,Arsenal,1-6,1,6,1,1,7,-5,A
1958-09-06,1958,Leicester City,Manchester City,3-1,3,1,1,1,4,2,H
1958-09-06,1958,Luton Town,West Ham United,4-1,4,1,1,1,5,3,H
1958-09-06,1958,Manchester United,Blackburn Rovers,6-1,6,1,1,1,7,5,H
1958-09-06,1958,Portsmouth,Chelsea,2-2,2,2,1,1,4,0,D
1958-09-06,1958,Preston North End,Leeds United,1-2,1,2,1,1,3,-1,A
1958-09-06,1958,Tottenham Hotspur,Newcastle United,1-3,1,3,1,1,4,-2,A
1958-09-06,1958,Wolverhampton Wanderers,Blackpool,2-0,2,0,1,1,2,2,H
1958-09-08,1958,Aston Villa,Wolverhampton Wanderers,1-3,1,3,1,1,4,-2,A
1958-09-08,1958,Blackpool,Blackburn Rovers,1-1,1,1,1,1,2,0,D
1958-09-08,1958,West Ham United,Manchester United,3-2,3,2,1,1,5,1,H
1958-09-09,1958,Arsenal,Bolton Wanderers,6-1,6,1,1,1,7,5,H
1958-09-09,1958,Burnley,Everton,3-1,3,1,1,1,4,2,H
1958-09-10,1958,Chelsea,Newcastle United,6-5,6,5,1,1,11,1,H
1958-09-10,1958,Leeds United,Birmingham City,0-0,0,0,1,1,0,0,D
1958-09-10,1958,Manchester City,Luton Town,1-1,1,1,1,1,2,0,D
1958-09-10,1958,Nottingham Forest,Tottenham Hotspur,1-1,1,1,1,1,2,0,D
1958-09-10,1958,West Bromwich Albion,Portsmouth,1-2,1,2,1,1,3,-1,A
1958-09-13,1958,Arsenal,Tottenham Hotspur,3-1,3,1,1,1,4,2,H
1958-09-13,1958,Birmingham City,Burnley,2-1,2,1,1,1,3,1,H
1958-09-13,1958,Blackburn Rovers,Wolverhampton Wanderers,1-2,1,2,1,1,3,-1,A
1958-09-13,1958,Blackpool,Portsmouth,1-1,1,1,1,1,2,0,D
1958-09-13,1958,Chelsea,Aston Villa,2-1,2,1,1,1,3,1,H
1958-09-13,1958,Leeds United,Leicester City,1-1,1,1,1,1,2,0,D
1958-09-13,1958,Luton Town,Bolton Wanderers,0-0,0,0,1,1,0,0,D
1958-09-13,1958,Manchester City,Everton,1-3,1,3,1,1,4,-2,A
1958-09-13,1958,Newcastle United,Manchester United,1-1,1,1,1,1,2,0,D
1958-09-13,1958,Nottingham Forest,West Ham United,4-0,4,0,1,1,4,4,H
1958-09-13,1958,West Bromwich Albion,Preston North End,1-1,1,1,1,1,2,0,D
1958-09-15,1958,Blackburn Rovers,Blackpool,0-0,0,0,1,1,0,0,D
1958-09-17,1958,Birmingham City,Leeds United,4-1,4,1,1,1,5,3,H
1958-09-17,1958,Bolton Wanderers,Arsenal,2-1,2,1,1,1,3,1,H
1958-09-17,1958,Everton,Burnley,1-2,1,2,1,1,3,-1,A
1958-09-17,1958,Leicester City,Preston North End,2-2,2,2,1,1,4,0,D
1958-09-17,1958,Luton Town,Manchester City,5-1,5,1,1,1,6,4,H
1958-09-17,1958,Manchester United,West Ham United,4-1,4,1,1,1,5,3,H
1958-09-17,1958,Newcastle United,Chelsea,1-2,1,2,1,1,3,-1,A
1958-09-17,1958,Portsmouth,West Bromwich Albion,2-6,2,6,1,1,8,-4,A
1958-09-17,1958,Tottenham Hotspur,Nottingham Forest,1-0,1,0,1,1,1,1,H
1958-09-17,1958,Wolverhampton Wanderers,Aston Villa,4-0,4,0,1,1,4,4,H
1958-09-20,1958,Arsenal,Manchester City,4-1,4,1,1,1,5,3,H
1958-09-20,1958,Aston Villa,Blackpool,1-1,1,1,1,1,2,0,D
1958-09-20,1958,Bolton Wanderers,Nottingham Forest,3-2,3,2,1,1,5,1,H
1958-09-20,1958,Burnley,Luton Town,2-2,2,2,1,1,4,0,D
1958-09-20,1958,Everton,Leeds United,3-2,3,2,1,1,5,1,H
1958-09-20,1958,Leicester City,West Bromwich Albion,2-2,2,2,1,1,4,0,D
1958-09-20,1958,Manchester United,Tottenham Hotspur,2-2,2,2,1,1,4,0,D
1958-09-20,1958,Portsmouth,Blackburn Rovers,2-1,2,1,1,1,3,1,H
1958-09-20,1958,Preston North End,Birmingham City,3-0,3,0,1,1,3,3,H
1958-09-20,1958,West Ham United,Chelsea,4-2,4,2,1,1,6,2,H
1958-09-20,1958,Wolverhampton Wanderers,Newcastle United,1-3,1,3,1,1,4,-2,A
1958-09-22,1958,Preston North End,Leicester City,3-1,3,1,1,1,4,2,H
1958-09-27,1958,Birmingham City,Leicester City,4-2,4,2,1,1,6,2,H
1958-09-27,1958,Blackburn Rovers,Aston Villa,2-3,2,3,1,1,5,-1,A
1958-09-27,1958,Blackpool,West Ham United,2-0,2,0,1,1,2,2,H
1958-09-27,1958,Bolton Wanderers,Burnley,1-2,1,2,1,1,3,-1,A
1958-09-27,1958,Chelsea,Nottingham Forest,4-1,4,1,1,1,5,3,H
1958-09-27,1958,Leeds United,Arsenal,2-1,2,1,1,1,3,1,H
1958-09-27,1958,Luton Town,Preston North End,4-1,4,1,1,1,5,3,H
1958-09-27,1958,Manchester City,Manchester United,1-1,1,1,1,1,2,0,D
1958-09-27,1958,Newcastle United,Portsmouth,2-0,2,0,1,1,2,2,H
1958-09-27,1958,Tottenham Hotspur,Wolverhampton Wanderers,2-1,2,1,1,1,3,1,H
1958-09-27,1958,West Bromwich Albion,Everton,2-3,2,3,1,1,5,-1,A
1958-10-04,1958,Arsenal,West Bromwich Albion,4-3,4,3,1,1,7,1,H
1958-10-04,1958,Aston Villa,Newcastle United,2-1,2,1,1,1,3,1,H
1958-10-04,1958,Burnley,Chelsea,4-0,4,0,1,1,4,4,H
1958-10-04,1958,Everton,Birmingham City,3-1,3,1,1,1,4,2,H
1958-10-04,1958,Leicester City,Luton Town,3-1,3,1,1,1,4,2,H
1958-10-04,1958,Manchester City,Leeds United,2-1,2,1,1,1,3,1,H
1958-10-04,1958,Nottingham Forest,Blackpool,2-0,2,0,1,1,2,2,H
1958-10-04,1958,Portsmouth,Tottenham Hotspur,1-1,1,1,1,1,2,0,D
1958-10-04,1958,Preston North End,Bolton Wanderers,0-0,0,0,1,1,0,0,D
1958-10-04,1958,West Ham United,Blackburn Rovers,6-3,6,3,1,1,9,3,H
1958-10-04,1958,Wolverhampton Wanderers,Manchester United,4-0,4,0,1,1,4,4,H
1958-10-08,1958,Manchester United,Preston North End,0-2,0,2,1,1,2,-2,A
1958-10-11,1958,Aston Villa,West Bromwich Albion,1-4,1,4,1,1,5,-3,A
1958-10-11,1958,Blackburn Rovers,Preston North End,4-1,4,1,1,1,5,3,H
1958-10-11,1958,Blackpool,Burnley,1-1,1,1,1,1,2,0,D
1958-10-11,1958,Chelsea,Bolton Wanderers,0-1,0,1,1,1,1,-1,A
1958-10-11,1958,Manchester United,Arsenal,1-1,1,1,1,1,2,0,D
1958-10-11,1958,Newcastle United,Leicester City,3-1,3,1,1,1,4,2,H
1958-10-11,1958,Nottingham Forest,Luton Town,3-1,3,1,1,1,4,2,H
1958-10-11,1958,Portsmouth,Leeds United,2-0,2,0,1,1,2,2,H
1958-10-11,1958,Tottenham Hotspur,Everton,10-4,10,4,1,1,14,6,H
1958-10-11,1958,West Ham United,Birmingham City,1-2,1,2,1,1,3,-1,A
1958-10-11,1958,Wolverhampton Wanderers,Manchester City,2-0,2,0,1,1,2,2,H
1958-10-18,1958,Arsenal,Wolverhampton Wanderers,1-1,1,1,1,1,2,0,D
1958-10-18,1958,Birmingham City,Nottingham Forest,0-3,0,3,1,1,3,-3,A
1958-10-18,1958,Bolton Wanderers,Blackpool,4-0,4,0,1,1,4,4,H
1958-10-18,1958,Burnley,Blackburn Rovers,0-0,0,0,1,1,0,0,D
1958-10-18,1958,Everton,Manchester United,3-2,3,2,1,1,5,1,H
1958-10-18,1958,Leeds United,Aston Villa,0-0,0,0,1,1,0,0,D
1958-10-18,1958,Leicester City,Tottenham Hotspur,3-4,3,4,1,1,7,-1,A
1958-10-18,1958,Luton Town,Chelsea,2-1,2,1,1,1,3,1,H
1958-10-18,1958,Manchester City,Portsmouth,3-2,3,2,1,1,5,1,H
1958-10-18,1958,Preston North End,Newcastle United,3-4,3,4,1,1,7,-1,A
1958-10-18,1958,West Bromwich Albion,West Ham United,2-1,2,1,1,1,3,1,H
1958-10-22,1958,Aston Villa,Arsenal,1-2,1,2,1,1,3,-1,A
1958-10-25,1958,Aston Villa,Bolton Wanderers,2-1,2,1,1,1,3,1,H
1958-10-25,1958,Blackburn Rovers,Arsenal,4-2,4,2,1,1,6,2,H
1958-10-25,1958,Blackpool,Everton,1-1,1,1,1,1,2,0,D
1958-10-25,1958,Chelsea,Leicester City,5-2,5,2,1,1,7,3,H
1958-10-25,1958,Manchester United,West Bromwich Albion,1-2,1,2,1,1,3,-1,A
1958-10-25,1958,Newcastle United,Manchester City,4-1,4,1,1,1,5,3,H
1958-10-25,1958,Nottingham Forest,Preston North End,0-1,0,1,1,1,1,-1,A
1958-10-25,1958,Portsmouth,Luton Town,2-2,2,2,1,1,4,0,D
1958-10-25,1958,Tottenham Hotspur,Leeds United,2-3,2,3,1,1,5,-1,A
1958-10-25,1958,West Ham United,Burnley,1-0,1,0,1,1,1,1,H
1958-10-25,1958,Wolverhampton Wanderers,Birmingham City,3-1,3,1,1,1,4,2,H
1958-11-01,1958,Arsenal,Newcastle United,3-2,3,2,1,1,5,1,H
1958-11-01,1958,Birmingham City,Portsmouth,2-2,2,2,1,1,4,0,D
1958-11-01,1958,Bolton Wanderers,West Ham United,0-2,0,2,1,1,2,-2,A
1958-11-01,1958,Burnley,Nottingham Forest,0-2,0,2,1,1,2,-2,A
1958-11-01,1958,Everton,Blackburn Rovers,2-2,2,2,1,1,4,0,D
1958-11-01,1958,Leeds United,Manchester United,1-2,1,2,1,1,3,-1,A
1958-11-01,1958,Leicester City,Blackpool,0-3,0,3,1,1,3,-3,A
1958-11-01,1958,Luton Town,Aston Villa,2-1,2,1,1,1,3,1,H
1958-11-01,1958,Manchester City,Tottenham Hotspur,5-1,5,1,1,1,6,4,H
1958-11-01,1958,Preston North End,Chelsea,2-0,2,0,1,1,2,2,H
1958-11-01,1958,West Bromwich Albion,Wolverhampton Wanderers,2-1,2,1,1,1,3,1,H
1958-11-08,1958,Aston Villa,Everton,2-4,2,4,1,1,6,-2,A
1958-11-08,1958,Blackburn Rovers,Birmingham City,3-2,3,2,1,1,5,1,H
1958-11-08,1958,Blackpool,West Bromwich Albion,1-1,1,1,1,1,2,0,D
1958-11-08,1958,Chelsea,Leeds United,2-0,2,0,1,1,2,2,H
1958-11-08,1958,Manchester United,Burnley,1-3,1,3,1,1,4,-2,A
1958-11-08,1958,Newcastle United,Luton Town,1-0,1,0,1,1,1,1,H
1958-11-08,1958,Nottingham Forest,Manchester City,4-0,4,0,1,1,4,4,H
1958-11-08,1958,Portsmouth,Leicester City,4-1,4,1,1,1,5,3,H
1958-11-08,1958,Tottenham Hotspur,Bolton Wanderers,1-1,1,1,1,1,2,0,D
1958-11-08,1958,West Ham United,Arsenal,0-0,0,0,1,1,0,0,D
1958-11-08,1958,Wolverhampton Wanderers,Preston North End,2-0,2,0,1,1,2,2,H
1958-11-15,1958,Arsenal,Nottingham Forest,3-1,3,1,1,1,4,2,H
1958-11-15,1958,Birmingham City,Newcastle United,1-0,1,0,1,1,1,1,H
1958-11-15,1958,Bolton Wanderers,Manchester United,6-3,6,3,1,1,9,3,H
1958-11-15,1958,Burnley,Wolverhampton Wanderers,0-2,0,2,1,1,2,-2,A
1958-11-15,1958,Everton,West Ham United,2-2,2,2,1,1,4,0,D
1958-11-15,1958,Leeds United,Blackpool,1-1,1,1,1,1,2,0,D
1958-11-15,1958,Leicester City,Aston Villa,6-3,6,3,1,1,9,3,H
1958-11-15,1958,Luton Town,Tottenham Hotspur,1-2,1,2,1,1,3,-1,A
1958-11-15,1958,Manchester City,Chelsea,5-1,5,1,1,1,6,4,H
1958-11-15,1958,Preston North End,Portsmouth,3-1,3,1,1,1,4,2,H
1958-11-15,1958,West Bromwich Albion,Blackburn Rovers,2-3,2,3,1,1,5,-1,A
1958-11-22,1958,Aston Villa,Preston North End,2-0,2,0,1,1,2,2,H
1958-11-22,1958,Blackburn Rovers,Leeds United,2-4,2,4,1,1,6,-2,A
1958-11-22,1958,Blackpool,Manchester City,0-0,0,0,1,1,0,0,D
1958-11-22,1958,Chelsea,Arsenal,0-3,0,3,1,1,3,-3,A
1958-11-22,1958,Manchester United,Luton Town,2-1,2,1,1,1,3,1,H
1958-11-22,1958,Newcastle United,West Bromwich Albion,1-2,1,2,1,1,3,-1,A
1958-11-22,1958,Nottingham Forest,Everton,2-1,2,1,1,1,3,1,H
1958-11-22,1958,Portsmouth,Burnley,4-2,4,2,1,1,6,2,H
1958-11-22,1958,Tottenham Hotspur,Birmingham City,0-4,0,4,1,1,4,-4,A
1958-11-22,1958,West Ham United,Leicester City,0-3,0,3,1,1,3,-3,A
1958-11-22,1958,Wolverhampton Wanderers,Bolton Wanderers,1-2,1,2,1,1,3,-1,A
1958-11-29,1958,Arsenal,Blackpool,1-4,1,4,1,1,5,-3,A
1958-11-29,1958,Birmingham City,Manchester United,0-4,0,4,1,1,4,-4,A
1958-11-29,1958,Bolton Wanderers,Portsmouth,2-1,2,1,1,1,3,1,H
1958-11-29,1958,Burnley,Aston Villa,3-1,3,1,1,1,4,2,H
1958-11-29,1958,Everton,Chelsea,3-1,3,1,1,1,4,2,H
1958-11-29,1958,Leeds United,Newcastle United,3-2,3,2,1,1,5,1,H
1958-11-29,1958,Leicester City,Nottingham Forest,0-3,0,3,1,1,3,-3,A
1958-11-29,1958,Luton Town,Wolverhampton Wanderers,0-1,0,1,1,1,1,-1,A
1958-11-29,1958,Manchester City,Blackburn Rovers,0-1,0,1,1,1,1,-1,A
1958-11-29,1958,Preston North End,West Ham United,2-1,2,1,1,1,3,1,H
1958-11-29,1958,West Bromwich Albion,Tottenham Hotspur,4-3,4,3,1,1,7,1,H
1958-12-06,1958,Aston Villa,Manchester City,1-1,1,1,1,1,2,0,D
1958-12-06,1958,Blackburn Rovers,Bolton Wanderers,1-1,1,1,1,1,2,0,D
1958-12-06,1958,Blackpool,Luton Town,3-0,3,0,1,1,3,3,H
1958-12-06,1958,Chelsea,Birmingham City,1-0,1,0,1,1,1,1,H
1958-12-06,1958,Manchester United,Leicester City,4-1,4,1,1,1,5,3,H
1958-12-06,1958,Newcastle United,Burnley,5-2,5,2,1,1,7,3,H
1958-12-06,1958,Nottingham Forest,West Bromwich Albion,1-1,1,1,1,1,2,0,D
1958-12-06,1958,Portsmouth,Arsenal,0-1,0,1,1,1,1,-1,A
1958-12-06,1958,Tottenham Hotspur,Preston North End,1-2,1,2,1,1,3,-1,A
1958-12-06,1958,West Ham United,Leeds United,2-3,2,3,1,1,5,-1,A
1958-12-06,1958,Wolverhampton Wanderers,Everton,1-0,1,0,1,1,1,1,H
1958-12-13,1958,Arsenal,Aston Villa,1-2,1,2,1,1,3,-1,A
1958-12-13,1958,Birmingham City,Blackpool,4-2,4,2,1,1,6,2,H
1958-12-13,1958,Bolton Wanderers,Newcastle United,1-1,1,1,1,1,2,0,D
1958-12-13,1958,Burnley,Tottenham Hotspur,3-1,3,1,1,1,4,2,H
1958-12-13,1958,Everton,Portsmouth,2-1,2,1,1,1,3,1,H
1958-12-13,1958,Leeds United,Nottingham Forest,1-0,1,0,1,1,1,1,H
1958-12-13,1958,Leicester City,Wolverhampton Wanderers,1-0,1,0,1,1,1,1,H
1958-12-13,1958,Luton Town,Blackburn Rovers,1-1,1,1,1,1,2,0,D
1958-12-13,1958,Manchester City,West Ham United,3-1,3,1,1,1,4,2,H
1958-12-13,1958,Preston North End,Manchester United,3-4,3,4,1,1,7,-1,A
1958-12-13,1958,West Bromwich Albion,Chelsea,4-0,4,0,1,1,4,4,H
1958-12-20,1958,Arsenal,Preston North End,1-2,1,2,1,1,3,-1,A
1958-12-20,1958,Birmingham City,Aston Villa,4-1,4,1,1,1,5,3,H
1958-12-20,1958,Blackburn Rovers,Newcastle United,3-0,3,0,1,1,3,3,H
1958-12-20,1958,Blackpool,Tottenham Hotspur,0-0,0,0,1,1,0,0,D
1958-12-20,1958,Chelsea,Manchester United,2-3,2,3,1,1,5,-1,A
1958-12-20,1958,Everton,Leicester City,0-1,0,1,1,1,1,-1,A
1958-12-20,1958,Leeds United,Bolton Wanderers,3-4,3,4,1,1,7,-1,A
1958-12-20,1958,Manchester City,Burnley,1-4,1,4,1,1,5,-3,A
1958-12-20,1958,Nottingham Forest,Wolverhampton Wanderers,1-3,1,3,1,1,4,-2,A
1958-12-20,1958,West Ham United,Portsmouth,6-0,6,0,1,1,6,6,H
1958-12-25,1958,Blackburn Rovers,Chelsea,0-3,0,3,1,1,3,-3,A
1958-12-25,1958,Blackpool,Preston North End,4-2,4,2,1,1,6,2,H
1958-12-25,1958,West Ham United,Tottenham Hotspur,2-1,2,1,1,1,3,1,H
1958-12-26,1958,Birmingham City,Manchester City,6-1,6,1,1,1,7,5,H
1958-12-26,1958,Everton,Bolton Wanderers,1-0,1,0,1,1,1,1,H
1958-12-26,1958,Leicester City,Burnley,1-1,1,1,1,1,2,0,D
1958-12-26,1958,Luton Town,Arsenal,6-3,6,3,1,1,9,3,H
1958-12-26,1958,Manchester United,Aston Villa,2-1,2,1,1,1,3,1,H
1958-12-26,1958,Newcastle United,Nottingham Forest,1-3,1,3,1,1,4,-2,A
1958-12-26,1958,Portsmouth,Wolverhampton Wanderers,3-5,3,5,1,1,8,-2,A
1958-12-26,1958,Preston North End,Blackpool,0-3,0,3,1,1,3,-3,A
1958-12-26,1958,Tottenham Hotspur,West Ham United,1-4,1,4,1,1,5,-3,A
1958-12-26,1958,West Bromwich Albion,Leeds United,1-2,1,2,1,1,3,-1,A
1958-12-27,1958,Arsenal,Luton Town,1-0,1,0,1,1,1,1,H
1958-12-27,1958,Aston Villa,Manchester United,0-2,0,2,1,1,2,-2,A
1958-12-27,1958,Bolton Wanderers,Everton,0-3,0,3,1,1,3,-3,A
1958-12-27,1958,Burnley,Leicester City,3-3,3,3,1,1,6,0,D
1958-12-27,1958,Chelsea,Blackburn Rovers,0-2,0,2,1,1,2,-2,A
1958-12-27,1958,Leeds United,West Bromwich Albion,0-1,0,1,1,1,1,-1,A
1958-12-27,1958,Manchester City,Birmingham City,4-1,4,1,1,1,5,3,H
1958-12-27,1958,Nottingham Forest,Newcastle United,3-0,3,0,1,1,3,3,H
1958-12-27,1958,Wolverhampton Wanderers,Portsmouth,7-0,7,0,1,1,7,7,H
1959-01-03,1958,Aston Villa,West Ham United,1-2,1,2,1,1,3,-1,A
1959-01-03,1958,Bolton Wanderers,West Bromwich Albion,2-1,2,1,1,1,3,1,H
1959-01-03,1958,Burnley,Leeds United,3-1,3,1,1,1,4,2,H
1959-01-03,1958,Leicester City,Arsenal,2-3,2,3,1,1,5,-1,A
1959-01-03,1958,Luton Town,Birmingham City,0-1,0,1,1,1,1,-1,A
1959-01-03,1958,Manchester United,Blackpool,3-1,3,1,1,1,4,2,H
1959-01-03,1958,Newcastle United,Everton,4-0,4,0,1,1,4,4,H
1959-01-03,1958,Portsmouth,Nottingham Forest,0-1,0,1,1,1,1,-1,A
1959-01-03,1958,Preston North End,Manchester City,2-0,2,0,1,1,2,2,H
1959-01-03,1958,Tottenham Hotspur,Blackburn Rovers,3-1,3,1,1,1,4,2,H
1959-01-03,1958,Wolverhampton Wanderers,Chelsea,1-2,1,2,1,1,3,-1,A
1959-01-17,1958,Arsenal,Everton,3-1,3,1,1,1,4,2,H
1959-01-17,1958,Chelsea,Portsmouth,2-2,2,2,1,1,4,0,D
1959-01-17,1958,Leeds United,Preston North End,1-3,1,3,1,1,4,-2,A
1959-01-17,1958,Newcastle United,Tottenham Hotspur,1-2,1,2,1,1,3,-1,A
1959-01-31,1958,Aston Villa,Chelsea,3-1,3,1,1,1,4,2,H
1959-01-31,1958,Bolton Wanderers,Luton Town,4-2,4,2,1,1,6,2,H
1959-01-31,1958,Burnley,Birmingham City,0-1,0,1,1,1,1,-1,A
1959-01-31,1958,Everton,Manchester City,3-1,3,1,1,1,4,2,H
1959-01-31,1958,Leicester City,Leeds United,0-1,0,1,1,1,1,-1,A
1959-01-31,1958,Manchester United,Newcastle United,4-4,4,4,1,1,8,0,D
1959-01-31,1958,Portsmouth,Blackpool,1-2,1,2,1,1,3,-1,A
1959-01-31,1958,Preston North End,West Bromwich Albion,2-4,2,4,1,1,6,-2,A
1959-01-31,1958,Tottenham Hotspur,Arsenal,1-4,1,4,1,1,5,-3,A
1959-01-31,1958,West Ham United,Nottingham Forest,5-3,5,3,1,1,8,2,H
1959-01-31,1958,Wolverhampton Wanderers,Blackburn Rovers,5-0,5,0,1,1,5,5,H
1959-02-07,1958,Birmingham City,Preston North End,5-1,5,1,1,1,6,4,H
1959-02-07,1958,Blackburn Rovers,Portsmouth,2-1,2,1,1,1,3,1,H
1959-02-07,1958,Blackpool,Aston Villa,2-1,2,1,1,1,3,1,H
1959-02-07,1958,Chelsea,West Ham United,3-2,3,2,1,1,5,1,H
1959-02-07,1958,Leeds United,Everton,1-0,1,0,1,1,1,1,H
1959-02-07,1958,Luton Town,Burnley,6-2,6,2,1,1,8,4,H
1959-02-07,1958,Manchester City,Arsenal,0-0,0,0,1,1,0,0,D
1959-02-07,1958,Newcastle United,Wolverhampton Wanderers,3-4,3,4,1,1,7,-1,A
1959-02-07,1958,Nottingham Forest,Bolton Wanderers,3-0,3,0,1,1,3,3,H
1959-02-07,1958,Tottenham Hotspur,Manchester United,1-3,1,3,1,1,4,-2,A
1959-02-07,1958,West Bromwich Albion,Leicester City,2-2,2,2,1,1,4,0,D
1959-02-14,1958,Manchester United,Manchester City,4-1,4,1,1,1,5,3,H
1959-02-14,1958,Wolverhampton Wanderers,Leeds United,6-2,6,2,1,1,8,4,H
1959-02-16,1958,West Ham United,Blackpool,1-0,1,0,1,1,1,1,H
1959-02-18,1958,Aston Villa,Blackburn Rovers,1-0,1,0,1,1,1,1,H
1959-02-18,1958,Everton,West Bromwich Albion,3-3,3,3,1,1,6,0,D
1959-02-21,1958,Birmingham City,Everton,2-1,2,1,1,1,3,1,H
1959-02-21,1958,Blackburn Rovers,West Ham United,1-2,1,2,1,1,3,-1,A
1959-02-21,1958,Blackpool,Nottingham Forest,1-0,1,0,1,1,1,1,H
1959-02-21,1958,Bolton Wanderers,Preston North End,2-1,2,1,1,1,3,1,H
1959-02-21,1958,Chelsea,Burnley,1-3,1,3,1,1,4,-2,A
1959-02-21,1958,Leeds United,Manchester City,0-4,0,4,1,1,4,-4,A
1959-02-21,1958,Luton Town,Leicester City,4-3,4,3,1,1,7,1,H
1959-02-21,1958,Manchester United,Wolverhampton Wanderers,2-1,2,1,1,1,3,1,H
1959-02-21,1958,Newcastle United,Aston Villa,1-0,1,0,1,1,1,1,H
1959-02-21,1958,Tottenham Hotspur,Portsmouth,4-4,4,4,1,1,8,0,D
1959-02-21,1958,West Bromwich Albion,Arsenal,1-1,1,1,1,1,2,0,D
1959-02-24,1958,Arsenal,Leeds United,1-0,1,0,1,1,1,1,H
1959-02-28,1958,Arsenal,Manchester United,3-2,3,2,1,1,5,1,H
1959-02-28,1958,Birmingham City,West Ham United,3-0,3,0,1,1,3,3,H
1959-02-28,1958,Everton,Tottenham Hotspur,2-1,2,1,1,1,3,1,H
1959-02-28,1958,Leeds United,Portsmouth,1-1,1,1,1,1,2,0,D
1959-02-28,1958,Leicester City,Newcastle United,0-1,0,1,1,1,1,-1,A
1959-02-28,1958,Manchester City,Wolverhampton Wanderers,1-4,1,4,1,1,5,-3,A
1959-02-28,1958,Preston North End,Blackburn Rovers,1-2,1,2,1,1,3,-1,A
1959-03-02,1958,Blackburn Rovers,Manchester United,1-3,1,3,1,1,4,-2,A
1959-03-02,1958,Wolverhampton Wanderers,Tottenham Hotspur,1-1,1,1,1,1,2,0,D
1959-03-04,1958,Bolton Wanderers,Chelsea,6-0,6,0,1,1,6,6,H
1959-03-07,1958,Aston Villa,Leeds United,2-1,2,1,1,1,3,1,H
1959-03-07,1958,Blackburn Rovers,Burnley,4-1,4,1,1,1,5,3,H
1959-03-07,1958,Blackpool,Bolton Wanderers,4-0,4,0,1,1,4,4,H
1959-03-07,1958,Chelsea,Luton Town,3-3,3,3,1,1,6,0,D
1959-03-07,1958,Manchester United,Everton,2-1,2,1,1,1,3,1,H
1959-03-07,1958,Newcastle United,Preston North End,1-2,1,2,1,1,3,-1,A
1959-03-07,1958,Nottingham Forest,Birmingham City,1-7,1,7,1,1,8,-6,A
1959-03-07,1958,Portsmouth,Manchester City,3-4,3,4,1,1,7,-1,A
1959-03-07,1958,Tottenham Hotspur,Leicester City,6-0,6,0,1,1,6,6,H
1959-03-07,1958,West Ham United,West Bromwich Albion,3-1,3,1,1,1,4,2,H
1959-03-07,1958,Wolverhampton Wanderers,Arsenal,6-1,6,1,1,1,7,5,H
1959-03-11,1958,Portsmouth,Newcastle United,1-5,1,5,1,1,6,-4,A
1959-03-11,1958,West Bromwich Albion,Burnley,2-4,2,4,1,1,6,-2,A
1959-03-14,1958,Arsenal,Blackburn Rovers,1-1,1,1,1,1,2,0,D
1959-03-14,1958,Birmingham City,Wolverhampton Wanderers,0-3,0,3,1,1,3,-3,A
1959-03-14,1958,Burnley,West Ham United,1-0,1,0,1,1,1,1,H
1959-03-14,1958,Everton,Blackpool,3-1,3,1,1,1,4,2,H
1959-03-14,1958,Leeds United,Tottenham Hotspur,3-1,3,1,1,1,4,2,H
1959-03-14,1958,Leicester City,Chelsea,0-3,0,3,1,1,3,-3,A
1959-03-14,1958,Manchester City,Newcastle United,5-1,5,1,1,1,6,4,H
1959-03-14,1958,West Bromwich Albion,Manchester United,1-3,1,3,1,1,4,-2,A
1959-03-16,1958,Preston North End,Nottingham Forest,3-5,3,5,1,1,8,-2,A
1959-03-17,1958,Burnley,Blackpool,3-1,3,1,1,1,4,2,H
1959-03-18,1958,Bolton Wanderers,Aston Villa,1-3,1,3,1,1,4,-2,A
1959-03-18,1958,Leicester City,Birmingham City,2-4,2,4,1,1,6,-2,A
1959-03-21,1958,Aston Villa,Luton Town,3-1,3,1,1,1,4,2,H
1959-03-21,1958,Blackburn Rovers,Everton,2-1,2,1,1,1,3,1,H
1959-03-21,1958,Blackpool,Leicester City,2-1,2,1,1,1,3,1,H
1959-03-21,1958,Chelsea,Preston North End,3-1,3,1,1,1,4,2,H
1959-03-21,1958,Manchester United,Leeds United,4-0,4,0,1,1,4,4,H
1959-03-21,1958,Newcastle United,Arsenal,1-0,1,0,1,1,1,1,H
1959-03-21,1958,Nottingham Forest,Burnley,1-2,1,2,1,1,3,-1,A
1959-03-21,1958,Portsmouth,Birmingham City,1-1,1,1,1,1,2,0,D
1959-03-21,1958,Tottenham Hotspur,Manchester City,3-1,3,1,1,1,4,2,H
1959-03-21,1958,West Ham United,Bolton Wanderers,4-3,4,3,1,1,7,1,H
1959-03-21,1958,Wolverhampton Wanderers,West Bromwich Albion,5-2,5,2,1,1,7,3,H
1959-03-27,1958,Blackburn Rovers,Nottingham Forest,3-0,3,0,1,1,3,3,H
1959-03-27,1958,Blackpool,Chelsea,5-0,5,0,1,1,5,5,H
1959-03-27,1958,Bolton Wanderers,Leicester City,3-3,3,3,1,1,6,0,D
1959-03-27,1958,Burnley,Preston North End,1-0,1,0,1,1,1,1,H
1959-03-27,1958,Luton Town,Everton,0-1,0,1,1,1,1,-1,A
1959-03-27,1958,Manchester United,Portsmouth,6-1,6,1,1,1,7,5,H
1959-03-27,1958,Tottenham Hotspur,Aston Villa,3-2,3,2,1,1,5,1,H
1959-03-27,1958,West Ham United,Newcastle United,3-0,3,0,1,1,3,3,H
1959-03-28,1958,Arsenal,West Ham United,1-2,1,2,1,1,3,-1,A
1959-03-28,1958,Bolton Wanderers,Tottenham Hotspur,4-1,4,1,1,1,5,3,H
1959-03-28,1958,Burnley,Manchester United,4-2,4,2,1,1,6,2,H
1959-03-28,1958,Everton,Aston Villa,2-1,2,1,1,1,3,1,H
1959-03-28,1958,Leeds United,Chelsea,4-0,4,0,1,1,4,4,H
1959-03-28,1958,Leicester City,Portsmouth,3-1,3,1,1,1,4,2,H
1959-03-28,1958,Luton Town,Newcastle United,4-2,4,2,1,1,6,2,H
1959-03-28,1958,Manchester City,Nottingham Forest,1-1,1,1,1,1,2,0,D
1959-03-28,1958,Preston North End,Wolverhampton Wanderers,1-2,1,2,1,1,3,-1,A
1959-03-28,1958,West Bromwich Albion,Blackpool,3-1,3,1,1,1,4,2,H
1959-03-30,1958,Aston Villa,Tottenham Hotspur,1-1,1,1,1,1,2,0,D
1959-03-30,1958,Chelsea,Blackpool,3-1,3,1,1,1,4,2,H
1959-03-30,1958,Everton,Luton Town,3-1,3,1,1,1,4,2,H
1959-03-30,1958,Leicester City,Bolton Wanderers,0-0,0,0,1,1,0,0,D
1959-03-30,1958,Manchester City,West Bromwich Albion,0-2,0,2,1,1,2,-2,A
1959-03-30,1958,Newcastle United,West Ham United,3-1,3,1,1,1,4,2,H
1959-03-30,1958,Portsmouth,Manchester United,1-3,1,3,1,1,4,-2,A
1959-03-30,1958,Preston North End,Burnley,0-4,0,4,1,1,4,-4,A
1959-03-31,1958,Leeds United,Wolverhampton Wanderers,1-3,1,3,1,1,4,-2,A
1959-03-31,1958,Nottingham Forest,Blackburn Rovers,1-1,1,1,1,1,2,0,D
1959-03-31,1958,West Bromwich Albion,Manchester City,3-0,3,0,1,1,3,3,H
1959-04-04,1958,Aston Villa,Leicester City,1-2,1,2,1,1,3,-1,A
1959-04-04,1958,Blackburn Rovers,West Bromwich Albion,0-0,0,0,1,1,0,0,D
1959-04-04,1958,Blackpool,Leeds United,3-0,3,0,1,1,3,3,H
1959-04-04,1958,Chelsea,Manchester City,2-0,2,0,1,1,2,2,H
1959-04-04,1958,Manchester United,Bolton Wanderers,3-0,3,0,1,1,3,3,H
1959-04-04,1958,Nottingham Forest,Arsenal,1-1,1,1,1,1,2,0,D
1959-04-04,1958,Portsmouth,Preston North End,1-2,1,2,1,1,3,-1,A
1959-04-04,1958,Tottenham Hotspur,Luton Town,3-0,3,0,1,1,3,3,H
1959-04-04,1958,West Ham United,Everton,3-2,3,2,1,1,5,1,H
1959-04-04,1958,Wolverhampton Wanderers,Burnley,3-3,3,3,1,1,6,0,D
1959-04-06,1958,Preston North End,Luton Town,0-0,0,0,1,1,0,0,D
1959-04-08,1958,Birmingham City,Bolton Wanderers,1-3,1,3,1,1,4,-2,A
1959-04-08,1958,Tottenham Hotspur,Burnley,2-2,2,2,1,1,4,0,D
1959-04-09,1958,Luton Town,Nottingham Forest,5-1,5,1,1,1,6,4,H
1959-04-11,1958,Arsenal,Chelsea,1-1,1,1,1,1,2,0,D
1959-04-11,1958,Birmingham City,Tottenham Hotspur,5-1,5,1,1,1,6,4,H
1959-04-11,1958,Bolton Wanderers,Wolverhampton Wanderers,2-2,2,2,1,1,4,0,D
1959-04-11,1958,Burnley,Portsmouth,2-1,2,1,1,1,3,1,H
1959-04-11,1958,Everton,Nottingham Forest,1-3,1,3,1,1,4,-2,A
1959-04-11,1958,Leeds United,Blackburn Rovers,2-1,2,1,1,1,3,1,H
1959-04-11,1958,Leicester City,West Ham United,1-1,1,1,1,1,2,0,D
1959-04-11,1958,Luton Town,Manchester United,0-0,0,0,1,1,0,0,D
1959-04-11,1958,Manchester City,Blackpool,0-2,0,2,1,1,2,-2,A
1959-04-11,1958,Preston North End,Aston Villa,4-2,4,2,1,1,6,2,H
1959-04-11,1958,West Bromwich Albion,Newcastle United,2-2,2,2,1,1,4,0,D
1959-04-13,1958,Blackpool,Wolverhampton Wanderers,0-1,0,1,1,1,1,-1,A
1959-04-13,1958,West Ham United,Luton Town,0-0,0,0,1,1,0,0,D
1959-04-14,1958,Birmingham City,Arsenal,4-1,4,1,1,1,5,3,H
1959-04-14,1958,Burnley,Bolton Wanderers,0-1,0,1,1,1,1,-1,A
1959-04-15,1958,Nottingham Forest,Chelsea,1-3,1,3,1,1,4,-2,A
1959-04-15,1958,Portsmouth,Everton,2-3,2,3,1,1,5,-1,A
1959-04-15,1958,West Bromwich Albion,Luton Town,2-0,2,0,1,1,2,2,H
1959-04-18,1958,Aston Villa,Burnley,0-0,0,0,1,1,0,0,D
1959-04-18,1958,Blackburn Rovers,Manchester City,2-1,2,1,1,1,3,1,H
1959-04-18,1958,Blackpool,Arsenal,1-2,1,2,1,1,3,-1,A
1959-04-18,1958,Chelsea,Everton,3-1,3,1,1,1,4,2,H
1959-04-18,1958,Manchester United,Birmingham City,1-0,1,0,1,1,1,1,H
1959-04-18,1958,Newcastle United,Leeds United,2-2,2,2,1,1,4,0,D
1959-04-18,1958,Nottingham Forest,Leicester City,1-4,1,4,1,1,5,-3,A
1959-04-18,1958,Portsmouth,Bolton Wanderers,0-1,0,1,1,1,1,-1,A
1959-04-18,1958,Tottenham Hotspur,West Bromwich Albion,5-0,5,0,1,1,5,5,H
1959-04-18,1958,West Ham United,Preston North End,1-1,1,1,1,1,2,0,D
1959-04-18,1958,Wolverhampton Wanderers,Luton Town,5-0,5,0,1,1,5,5,H
1959-04-20,1958,Blackburn Rovers,Luton Town,3-1,3,1,1,1,4,2,H
1959-04-20,1958,Blackpool,Birmingham City,2-0,2,0,1,1,2,2,H
1959-04-20,1958,Nottingham Forest,Aston Villa,2-0,2,0,1,1,2,2,H
1959-04-20,1958,West Ham United,Manchester City,5-1,5,1,1,1,6,4,H
1959-04-22,1958,Birmingham City,Blackburn Rovers,3-0,3,0,1,1,3,3,H
1959-04-22,1958,Chelsea,West Bromwich Albion,0-2,0,2,1,1,2,-2,A
1959-04-22,1958,Luton Town,Portsmouth,3-1,3,1,1,1,4,2,H
1959-04-22,1958,Newcastle United,Bolton Wanderers,2-0,2,0,1,1,2,2,H
1959-04-22,1958,Nottingham Forest,Leeds United,0-3,0,3,1,1,3,-3,A
1959-04-22,1958,Wolverhampton Wanderers,Leicester City,3-0,3,0,1,1,3,3,H
1959-04-25,1958,Arsenal,Portsmouth,5-2,5,2,1,1,7,3,H
1959-04-25,1958,Birmingham City,Chelsea,4-1,4,1,1,1,5,3,H
1959-04-25,1958,Bolton Wanderers,Blackburn Rovers,3-1,3,1,1,1,4,2,H
1959-04-25,1958,Burnley,Newcastle United,2-2,2,2,1,1,4,0,D
1959-04-25,1958,Everton,Wolverhampton Wanderers,0-1,0,1,1,1,1,-1,A
1959-04-25,1958,Leeds United,West Ham United,1-0,1,0,1,1,1,1,H
1959-04-25,1958,Leicester City,Manchester United,2-1,2,1,1,1,3,1,H
1959-04-25,1958,Luton Town,Blackpool,1-1,1,1,1,1,2,0,D
1959-04-25,1958,Manchester City,Aston Villa,0-0,0,0,1,1,0,0,D
1959-04-25,1958,Preston North End,Tottenham Hotspur,2-2,2,2,1,1,4,0,D
1959-04-25,1958,West Bromwich Albion,Nottingham Forest,2-0,2,0,1,1,2,2,H
1959-04-29,1958,Manchester City,Leicester City,3-1,3,1,1,1,4,2,H
1959-04-29,1958,Newcastle United,Birmingham City,1-1,1,1,1,1,2,0,D
1959-04-29,1958,West Bromwich Albion,Aston Villa,1-1,1,1,1,1,2,0,D
1959-05-04,1958,Arsenal,Birmingham City,2-1,2,1,1,1,3,1,H
1959-08-22,1959,Arsenal,Sheffield Wednesday,0-1,0,1,1,1,1,-1,A
1959-08-22,1959,Birmingham City,Wolverhampton Wanderers,0-1,0,1,1,1,1,-1,A
1959-08-22,1959,Blackburn Rovers,Fulham,4-0,4,0,1,1,4,4,H
1959-08-22,1959,Blackpool,Bolton Wanderers,3-2,3,2,1,1,5,1,H
1959-08-22,1959,Chelsea,Preston North End,4-4,4,4,1,1,8,0,D
1959-08-22,1959,Everton,Luton Town,2-2,2,2,1,1,4,0,D
1959-08-22,1959,Leeds United,Burnley,2-3,2,3,1,1,5,-1,A
1959-08-22,1959,Manchester City,Nottingham Forest,2-1,2,1,1,1,3,1,H
1959-08-22,1959,Newcastle United,Tottenham Hotspur,1-5,1,5,1,1,6,-4,A
1959-08-22,1959,West Bromwich Albion,Manchester United,3-2,3,2,1,1,5,1,H
1959-08-22,1959,West Ham United,Leicester City,3-0,3,0,1,1,3,3,H
1959-08-25,1959,Burnley,Everton,5-2,5,2,1,1,7,3,H
1959-08-25,1959,Preston North End,West Ham United,1-1,1,1,1,1,2,0,D
1959-08-26,1959,Birmingham City,Newcastle United,4-3,4,3,1,1,7,1,H
1959-08-26,1959,Bolton Wanderers,Blackburn Rovers,0-3,0,3,1,1,3,-3,A
1959-08-26,1959,Fulham,Manchester City,5-2,5,2,1,1,7,3,H
1959-08-26,1959,Leicester City,Leeds United,3-2,3,2,1,1,5,1,H
1959-08-26,1959,Luton Town,Blackpool,0-1,0,1,1,1,1,-1,A
1959-08-26,1959,Manchester United,Chelsea,0-1,0,1,1,1,1,-1,A
1959-08-26,1959,Nottingham Forest,Arsenal,0-3,0,3,1,1,3,-3,A
1959-08-26,1959,Tottenham Hotspur,West Bromwich Albion,2-2,2,2,1,1,4,0,D
1959-08-26,1959,Wolverhampton Wanderers,Sheffield Wednesday,3-1,3,1,1,1,4,2,H
1959-08-29,1959,Bolton Wanderers,Everton,2-1,2,1,1,1,3,1,H
1959-08-29,1959,Burnley,West Ham United,1-3,1,3,1,1,4,-2,A
1959-08-29,1959,Fulham,Blackpool,1-0,1,0,1,1,1,1,H
1959-08-29,1959,Leicester City,Chelsea,3-1,3,1,1,1,4,2,H
1959-08-29,1959,Luton Town,Leeds United,0-1,0,1,1,1,1,-1,A
1959-08-29,1959,Manchester United,Newcastle United,3-2,3,2,1,1,5,1,H
1959-08-29,1959,Nottingham Forest,Blackburn Rovers,2-2,2,2,1,1,4,0,D
1959-08-29,1959,Preston North End,West Bromwich Albion,1-1,1,1,1,1,2,0,D
1959-08-29,1959,Sheffield Wednesday,Manchester City,1-0,1,0,1,1,1,1,H
1959-08-29,1959,Tottenham Hotspur,Birmingham City,0-0,0,0,1,1,0,0,D
1959-08-29,1959,Wolverhampton Wanderers,Arsenal,3-3,3,3,1,1,6,0,D
1959-08-31,1959,Blackburn Rovers,Bolton Wanderers,1-0,1,0,1,1,1,1,H
1959-08-31,1959,Blackpool,Luton Town,0-0,0,0,1,1,0,0,D
1959-08-31,1959,West Ham United,Preston North End,2-1,2,1,1,1,3,1,H
1959-09-01,1959,Arsenal,Nottingham Forest,1-1,1,1,1,1,2,0,D
1959-09-02,1959,Chelsea,Manchester United,3-6,3,6,1,1,9,-3,A
1959-09-02,1959,Everton,Burnley,1-2,1,2,1,1,3,-1,A
1959-09-02,1959,Leeds United,Leicester City,1-1,1,1,1,1,2,0,D
1959-09-02,1959,Manchester City,Fulham,3-1,3,1,1,1,4,2,H
1959-09-02,1959,Newcastle United,Birmingham City,1-0,1,0,1,1,1,1,H
1959-09-02,1959,Sheffield Wednesday,Wolverhampton Wanderers,2-2,2,2,1,1,4,0,D
1959-09-02,1959,West Bromwich Albion,Tottenham Hotspur,1-2,1,2,1,1,3,-1,A
1959-09-05,1959,Arsenal,Tottenham Hotspur,1-1,1,1,1,1,2,0,D
1959-09-05,1959,Birmingham City,Manchester United,1-1,1,1,1,1,2,0,D
1959-09-05,1959,Blackburn Rovers,Sheffield Wednesday,3-1,3,1,1,1,4,2,H
1959-09-05,1959,Blackpool,Nottingham Forest,0-1,0,1,1,1,1,-1,A
1959-09-05,1959,Chelsea,Burnley,4-1,4,1,1,1,5,3,H
1959-09-05,1959,Everton,Fulham,0-0,0,0,1,1,0,0,D
1959-09-05,1959,Luton Town,Bolton Wanderers,0-0,0,0,1,1,0,0,D
1959-09-05,1959,Manchester City,Wolverhampton Wanderers,4-6,4,6,1,1,10,-2,A
1959-09-05,1959,Newcastle United,Preston North End,1-2,1,2,1,1,3,-1,A
1959-09-05,1959,West Bromwich Albion,Leicester City,5-0,5,0,1,1,5,5,H
1959-09-05,1959,West Ham United,Leeds United,1-2,1,2,1,1,3,-1,A
1959-09-08,1959,Burnley,Preston North End,2-1,2,1,1,1,3,1,H
1959-09-09,1959,Birmingham City,Chelsea,1-1,1,1,1,1,2,0,D
1959-09-09,1959,Bolton Wanderers,Arsenal,0-1,0,1,1,1,1,-1,A
1959-09-09,1959,Fulham,Wolverhampton Wanderers,3-1,3,1,1,1,4,2,H
1959-09-09,1959,Leicester City,Blackpool,1-1,1,1,1,1,2,0,D
1959-09-09,1959,Luton Town,Manchester City,1-2,1,2,1,1,3,-1,A
1959-09-09,1959,Manchester United,Leeds United,6-0,6,0,1,1,6,6,H
1959-09-09,1959,Nottingham Forest,Sheffield Wednesday,2-1,2,1,1,1,3,1,H
1959-09-09,1959,Tottenham Hotspur,West Ham United,2-2,2,2,1,1,4,0,D
1959-09-09,1959,West Bromwich Albion,Newcastle United,2-2,2,2,1,1,4,0,D
1959-09-12,1959,Arsenal,Manchester City,3-1,3,1,1,1,4,2,H
1959-09-12,1959,Bolton Wanderers,West Ham United,5-1,5,1,1,1,6,4,H
1959-09-12,1959,Burnley,West Bromwich Albion,2-1,2,1,1,1,3,1,H
1959-09-12,1959,Fulham,Luton Town,4-2,4,2,1,1,6,2,H
1959-09-12,1959,Leeds United,Chelsea,2-1,2,1,1,1,3,1,H
1959-09-12,1959,Leicester City,Newcastle United,0-2,0,2,1,1,2,-2,A
1959-09-12,1959,Manchester United,Tottenham Hotspur,1-5,1,5,1,1,6,-4,A
1959-09-12,1959,Nottingham Forest,Everton,1-1,1,1,1,1,2,0,D
1959-09-12,1959,Preston North End,Birmingham City,3-2,3,2,1,1,5,1,H
1959-09-12,1959,Sheffield Wednesday,Blackpool,5-0,5,0,1,1,5,5,H
1959-09-12,1959,Wolverhampton Wanderers,Blackburn Rovers,3-1,3,1,1,1,4,2,H
1959-09-14,1959,Blackpool,Leicester City,3-3,3,3,1,1,6,0,D
1959-09-14,1959,West Ham United,Tottenham Hotspur,1-2,1,2,1,1,3,-1,A
1959-09-15,1959,Arsenal,Bolton Wanderers,2-1,2,1,1,1,3,1,H
1959-09-15,1959,Preston North End,Burnley,1-0,1,0,1,1,1,1,H
1959-09-16,1959,Chelsea,Birmingham City,4-2,4,2,1,1,6,2,H
1959-09-16,1959,Everton,Blackburn Rovers,2-0,2,0,1,1,2,2,H
1959-09-16,1959,Leeds United,Manchester United,2-2,2,2,1,1,4,0,D
1959-09-16,1959,Manchester City,Luton Town,1-2,1,2,1,1,3,-1,A
1959-09-16,1959,Newcastle United,West Bromwich Albion,0-0,0,0,1,1,0,0,D
1959-09-16,1959,Sheffield Wednesday,Nottingham Forest,0-1,0,1,1,1,1,-1,A
1959-09-16,1959,Wolverhampton Wanderers,Fulham,9-0,9,0,1,1,9,9,H
1959-09-19,1959,Birmingham City,Leicester City,3-4,3,4,1,1,7,-1,A
1959-09-19,1959,Blackburn Rovers,Arsenal,1-1,1,1,1,1,2,0,D
1959-09-19,1959,Blackpool,Wolverhampton Wanderers,3-1,3,1,1,1,4,2,H
1959-09-19,1959,Bolton Wanderers,Fulham,3-2,3,2,1,1,5,1,H
1959-09-19,1959,Chelsea,West Ham United,2-4,2,4,1,1,6,-2,A
1959-09-19,1959,Everton,Sheffield Wednesday,2-1,2,1,1,1,3,1,H
1959-09-19,1959,Luton Town,Nottingham Forest,1-0,1,0,1,1,1,1,H
1959-09-19,1959,Manchester City,Manchester United,3-0,3,0,1,1,3,3,H
1959-09-19,1959,Newcastle United,Burnley,1-3,1,3,1,1,4,-2,A
1959-09-19,1959,Tottenham Hotspur,Preston North End,5-1,5,1,1,1,6,4,H
1959-09-19,1959,West Bromwich Albion,Leeds United,3-0,3,0,1,1,3,3,H
1959-09-21,1959,Blackburn Rovers,Everton,3-1,3,1,1,1,4,2,H
1959-09-26,1959,Arsenal,Blackpool,2-1,2,1,1,1,3,1,H
1959-09-26,1959,Burnley,Birmingham City,3-1,3,1,1,1,4,2,H
1959-09-26,1959,Fulham,Chelsea,1-3,1,3,1,1,4,-2,A
1959-09-26,1959,Leeds United,Newcastle United,2-3,2,3,1,1,5,-1,A
1959-09-26,1959,Leicester City,Tottenham Hotspur,1-1,1,1,1,1,2,0,D
1959-09-26,1959,Manchester City,Blackburn Rovers,2-1,2,1,1,1,3,1,H
1959-09-26,1959,Nottingham Forest,Bolton Wanderers,2-0,2,0,1,1,2,2,H
1959-09-26,1959,Preston North End,Manchester United,4-0,4,0,1,1,4,4,H
1959-09-26,1959,Sheffield Wednesday,Luton Town,2-0,2,0,1,1,2,2,H
1959-09-26,1959,West Ham United,West Bromwich Albion,4-1,4,1,1,1,5,3,H
1959-09-26,1959,Wolverhampton Wanderers,Everton,2-0,2,0,1,1,2,2,H
1959-10-03,1959,Birmingham City,Leeds United,2-0,2,0,1,1,2,2,H
1959-10-03,1959,Blackburn Rovers,Preston North End,1-4,1,4,1,1,5,-3,A
1959-10-03,1959,Blackpool,Manchester City,1-3,1,3,1,1,4,-2,A
1959-10-03,1959,Bolton Wanderers,Sheffield Wednesday,1-0,1,0,1,1,1,1,H
1959-10-03,1959,Everton,Arsenal,3-1,3,1,1,1,4,2,H
1959-10-03,1959,Fulham,Nottingham Forest,3-1,3,1,1,1,4,2,H
1959-10-03,1959,Luton Town,Wolverhampton Wanderers,1-5,1,5,1,1,6,-4,A
1959-10-03,1959,Manchester United,Leicester City,4-1,4,1,1,1,5,3,H
1959-10-03,1959,Newcastle United,West Ham United,0-0,0,0,1,1,0,0,D
1959-10-03,1959,Tottenham Hotspur,Burnley,1-1,1,1,1,1,2,0,D
1959-10-03,1959,West Bromwich Albion,Chelsea,1-3,1,3,1,1,4,-2,A
1959-10-10,1959,Birmingham City,Sheffield Wednesday,0-0,0,0,1,1,0,0,D
1959-10-10,1959,Burnley,Blackpool,1-4,1,4,1,1,5,-3,A
1959-10-10,1959,Chelsea,Bolton Wanderers,0-2,0,2,1,1,2,-2,A
1959-10-10,1959,Leeds United,Everton,3-3,3,3,1,1,6,0,D
1959-10-10,1959,Leicester City,Blackburn Rovers,2-3,2,3,1,1,5,-1,A
1959-10-10,1959,Manchester United,Arsenal,4-2,4,2,1,1,6,2,H
1959-10-10,1959,Newcastle United,Nottingham Forest,2-1,2,1,1,1,3,1,H
1959-10-10,1959,Preston North End,Manchester City,1-5,1,5,1,1,6,-4,A
1959-10-10,1959,Tottenham Hotspur,Wolverhampton Wanderers,5-1,5,1,1,1,6,4,H
1959-10-10,1959,West Bromwich Albion,Fulham,2-4,2,4,1,1,6,-2,A
1959-10-10,1959,West Ham United,Luton Town,3-1,3,1,1,1,4,2,H
1959-10-17,1959,Arsenal,Preston North End,0-3,0,3,1,1,3,-3,A
1959-10-17,1959,Blackburn Rovers,Burnley,3-2,3,2,1,1,5,1,H
1959-10-17,1959,Blackpool,Leeds United,3-3,3,3,1,1,6,0,D
1959-10-17,1959,Bolton Wanderers,West Bromwich Albion,0-0,0,0,1,1,0,0,D
1959-10-17,1959,Everton,West Ham United,0-1,0,1,1,1,1,-1,A
1959-10-17,1959,Fulham,Newcastle United,4-3,4,3,1,1,7,1,H
1959-10-17,1959,Luton Town,Chelsea,1-2,1,2,1,1,3,-1,A
1959-10-17,1959,Manchester City,Leicester City,3-2,3,2,1,1,5,1,H
1959-10-17,1959,Nottingham Forest,Birmingham City,0-2,0,2,1,1,2,-2,A
1959-10-17,1959,Sheffield Wednesday,Tottenham Hotspur,2-1,2,1,1,1,3,1,H
1959-10-17,1959,Wolverhampton Wanderers,Manchester United,3-2,3,2,1,1,5,1,H
1959-10-24,1959,Birmingham City,Fulham,2-4,2,4,1,1,6,-2,A
1959-10-24,1959,Burnley,Manchester City,4-3,4,3,1,1,7,1,H
1959-10-24,1959,Chelsea,Everton,1-0,1,0,1,1,1,1,H
1959-10-24,1959,Leeds United,Blackburn Rovers,0-1,0,1,1,1,1,-1,A
1959-10-24,1959,Leicester City,Arsenal,2-2,2,2,1,1,4,0,D
1959-10-24,1959,Manchester United,Sheffield Wednesday,3-1,3,1,1,1,4,2,H
1959-10-24,1959,Newcastle United,Bolton Wanderers,0-2,0,2,1,1,2,-2,A
1959-10-24,1959,Preston North End,Wolverhampton Wanderers,4-3,4,3,1,1,7,1,H
1959-10-24,1959,Tottenham Hotspur,Nottingham Forest,2-1,2,1,1,1,3,1,H
1959-10-24,1959,West Bromwich Albion,Luton Town,4-0,4,0,1,1,4,4,H
1959-10-24,1959,West Ham United,Blackpool,1-0,1,0,1,1,1,1,H
1959-10-31,1959,Arsenal,Birmingham City,3-0,3,0,1,1,3,3,H
1959-10-31,1959,Blackburn Rovers,Manchester United,1-1,1,1,1,1,2,0,D
1959-10-31,1959,Blackpool,Preston North End,0-2,0,2,1,1,2,-2,A
1959-10-31,1959,Bolton Wanderers,Leeds United,1-1,1,1,1,1,2,0,D
1959-10-31,1959,Everton,Leicester City,6-1,6,1,1,1,7,5,H
1959-10-31,1959,Fulham,West Ham United,1-0,1,0,1,1,1,1,H
1959-10-31,1959,Luton Town,Burnley,1-1,1,1,1,1,2,0,D
1959-10-31,1959,Manchester City,Tottenham Hotspur,1-2,1,2,1,1,3,-1,A
1959-10-31,1959,Nottingham Forest,Chelsea,3-1,3,1,1,1,4,2,H
1959-10-31,1959,Sheffield Wednesday,West Bromwich Albion,2-0,2,0,1,1,2,2,H
1959-10-31,1959,Wolverhampton Wanderers,Newcastle United,2-0,2,0,1,1,2,2,H
1959-11-07,1959,Birmingham City,Luton Town,1-1,1,1,1,1,2,0,D
1959-11-07,1959,Burnley,Wolverhampton Wanderers,4-1,4,1,1,1,5,3,H
1959-11-07,1959,Chelsea,Blackburn Rovers,3-1,3,1,1,1,4,2,H
1959-11-07,1959,Leeds United,Arsenal,3-2,3,2,1,1,5,1,H
1959-11-07,1959,Leicester City,Sheffield Wednesday,2-0,2,0,1,1,2,2,H
1959-11-07,1959,Manchester United,Fulham,3-3,3,3,1,1,6,0,D
1959-11-07,1959,Newcastle United,Everton,8-2,8,2,1,1,10,6,H
1959-11-07,1959,Preston North End,Nottingham Forest,1-0,1,0,1,1,1,1,H
1959-11-07,1959,Tottenham Hotspur,Bolton Wanderers,0-2,0,2,1,1,2,-2,A
1959-11-07,1959,West Bromwich Albion,Blackpool,2-1,2,1,1,1,3,1,H
1959-11-07,1959,West Ham United,Manchester City,4-1,4,1,1,1,5,3,H
1959-11-14,1959,Arsenal,West Ham United,1-3,1,3,1,1,4,-2,A
1959-11-14,1959,Blackburn Rovers,West Bromwich Albion,3-2,3,2,1,1,5,1,H
1959-11-14,1959,Blackpool,Newcastle United,2-0,2,0,1,1,2,2,H
1959-11-14,1959,Bolton Wanderers,Manchester United,1-1,1,1,1,1,2,0,D
1959-11-14,1959,Everton,Birmingham City,4-0,4,0,1,1,4,4,H
1959-11-14,1959,Fulham,Preston North End,1-2,1,2,1,1,3,-1,A
1959-11-14,1959,Luton Town,Tottenham Hotspur,1-0,1,0,1,1,1,1,H
1959-11-14,1959,Manchester City,Chelsea,1-1,1,1,1,1,2,0,D
1959-11-14,1959,Nottingham Forest,Leicester City,1-0,1,0,1,1,1,1,H
1959-11-14,1959,Sheffield Wednesday,Burnley,1-1,1,1,1,1,2,0,D
1959-11-14,1959,Wolverhampton Wanderers,Leeds United,4-2,4,2,1,1,6,2,H
1959-11-21,1959,Birmingham City,Blackpool,2-1,2,1,1,1,3,1,H
1959-11-21,1959,Burnley,Nottingham Forest,8-0,8,0,1,1,8,8,H
1959-11-21,1959,Chelsea,Arsenal,1-3,1,3,1,1,4,-2,A
1959-11-21,1959,Leeds United,Sheffield Wednesday,1-3,1,3,1,1,4,-2,A
1959-11-21,1959,Leicester City,Fulham,0-1,0,1,1,1,1,-1,A
1959-11-21,1959,Manchester United,Luton Town,4-1,4,1,1,1,5,3,H
1959-11-21,1959,Newcastle United,Blackburn Rovers,3-1,3,1,1,1,4,2,H
1959-11-21,1959,Preston North End,Bolton Wanderers,1-0,1,0,1,1,1,1,H
1959-11-21,1959,Tottenham Hotspur,Everton,3-0,3,0,1,1,3,3,H
1959-11-21,1959,West Bromwich Albion,Manchester City,2-0,2,0,1,1,2,2,H
1959-11-21,1959,West Ham United,Wolverhampton Wanderers,3-2,3,2,1,1,5,1,H
1959-11-28,1959,Arsenal,West Bromwich Albion,2-4,2,4,1,1,6,-2,A
1959-11-28,1959,Blackburn Rovers,Birmingham City,2-1,2,1,1,1,3,1,H
1959-11-28,1959,Blackpool,Tottenham Hotspur,2-2,2,2,1,1,4,0,D
1959-11-28,1959,Bolton Wanderers,Leicester City,3-1,3,1,1,1,4,2,H
1959-11-28,1959,Everton,Manchester United,2-1,2,1,1,1,3,1,H
1959-11-28,1959,Fulham,Burnley,1-0,1,0,1,1,1,1,H
1959-11-28,1959,Luton Town,Preston North End,1-3,1,3,1,1,4,-2,A
1959-11-28,1959,Manchester City,Newcastle United,3-4,3,4,1,1,7,-1,A
1959-11-28,1959,Nottingham Forest,Leeds United,4-1,4,1,1,1,5,3,H
1959-11-28,1959,Sheffield Wednesday,West Ham United,7-0,7,0,1,1,7,7,H
1959-11-28,1959,Wolverhampton Wanderers,Chelsea,3-1,3,1,1,1,4,2,H
1959-12-05,1959,Birmingham City,Manchester City,4-2,4,2,1,1,6,2,H
1959-12-05,1959,Burnley,Bolton Wanderers,4-0,4,0,1,1,4,4,H
1959-12-05,1959,Chelsea,Sheffield Wednesday,0-4,0,4,1,1,4,-4,A
1959-12-05,1959,Leeds United,Fulham,1-4,1,4,1,1,5,-3,A
1959-12-05,1959,Leicester City,Luton Town,3-3,3,3,1,1,6,0,D
1959-12-05,1959,Manchester United,Blackpool,3-1,3,1,1,1,4,2,H
1959-12-05,1959,Newcastle United,Arsenal,4-1,4,1,1,1,5,3,H
1959-12-05,1959,Preston North End,Everton,0-0,0,0,1,1,0,0,D
1959-12-05,1959,Tottenham Hotspur,Blackburn Rovers,2-1,2,1,1,1,3,1,H
1959-12-05,1959,West Bromwich Albion,Wolverhampton Wanderers,0-1,0,1,1,1,1,-1,A
1959-12-05,1959,West Ham United,Nottingham Forest,4-1,4,1,1,1,5,3,H
1959-12-12,1959,Arsenal,Burnley,2-4,2,4,1,1,6,-2,A
1959-12-12,1959,Blackburn Rovers,West Ham United,6-2,6,2,1,1,8,4,H
1959-12-12,1959,Blackpool,Chelsea,3-1,3,1,1,1,4,2,H
1959-12-12,1959,Bolton Wanderers,Birmingham City,4-1,4,1,1,1,5,3,H
1959-12-12,1959,Everton,West Bromwich Albion,2-2,2,2,1,1,4,0,D
1959-12-12,1959,Fulham,Tottenham Hotspur,1-1,1,1,1,1,2,0,D
1959-12-12,1959,Luton Town,Newcastle United,3-4,3,4,1,1,7,-1,A
1959-12-12,1959,Manchester City,Leeds United,3-3,3,3,1,1,6,0,D
1959-12-12,1959,Nottingham Forest,Manchester United,1-5,1,5,1,1,6,-4,A
1959-12-12,1959,Sheffield Wednesday,Preston North End,2-2,2,2,1,1,4,0,D
1959-12-12,1959,Wolverhampton Wanderers,Leicester City,0-3,0,3,1,1,3,-3,A
1959-12-19,1959,Bolton Wanderers,Blackpool,0-3,0,3,1,1,3,-3,A
1959-12-19,1959,Burnley,Leeds United,0-1,0,1,1,1,1,-1,A
1959-12-19,1959,Fulham,Blackburn Rovers,0-1,0,1,1,1,1,-1,A
1959-12-19,1959,Leicester City,West Ham United,2-1,2,1,1,1,3,1,H
1959-12-19,1959,Luton Town,Everton,2-1,2,1,1,1,3,1,H
1959-12-19,1959,Manchester United,West Bromwich Albion,2-3,2,3,1,1,5,-1,A
1959-12-19,1959,Nottingham Forest,Manchester City,1-2,1,2,1,1,3,-1,A
1959-12-19,1959,Preston North End,Chelsea,4-5,4,5,1,1,9,-1,A
1959-12-19,1959,Sheffield Wednesday,Arsenal,5-1,5,1,1,1,6,4,H
1959-12-19,1959,Tottenham Hotspur,Newcastle United,4-0,4,0,1,1,4,4,H
1959-12-19,1959,Wolverhampton Wanderers,Birmingham City,2-0,2,0,1,1,2,2,H
1959-12-25,1959,Blackburn Rovers,Blackpool,1-0,1,0,1,1,1,1,H
1959-12-26,1959,Arsenal,Luton Town,0-3,0,3,1,1,3,-3,A
1959-12-26,1959,Birmingham City,West Ham United,2-0,2,0,1,1,2,2,H
1959-12-26,1959,Blackpool,Blackburn Rovers,1-0,1,0,1,1,1,1,H
1959-12-26,1959,Bolton Wanderers,Wolverhampton Wanderers,2-1,2,1,1,1,3,1,H
1959-12-26,1959,Chelsea,Newcastle United,2-2,2,2,1,1,4,0,D
1959-12-26,1959,Everton,Manchester City,2-1,2,1,1,1,3,1,H
1959-12-26,1959,Leeds United,Tottenham Hotspur,2-4,2,4,1,1,6,-2,A
1959-12-26,1959,Leicester City,Preston North End,2-2,2,2,1,1,4,0,D
1959-12-26,1959,Manchester United,Burnley,1-2,1,2,1,1,3,-1,A
1959-12-26,1959,Sheffield Wednesday,Fulham,1-1,1,1,1,1,2,0,D
1959-12-26,1959,West Bromwich Albion,Nottingham Forest,2-3,2,3,1,1,5,-1,A
1959-12-28,1959,Burnley,Manchester United,1-4,1,4,1,1,5,-3,A
1959-12-28,1959,Fulham,Sheffield Wednesday,1-2,1,2,1,1,3,-1,A
1959-12-28,1959,Luton Town,Arsenal,0-1,0,1,1,1,1,-1,A
1959-12-28,1959,Manchester City,Everton,4-0,4,0,1,1,4,4,H
1959-12-28,1959,Newcastle United,Chelsea,1-1,1,1,1,1,2,0,D
1959-12-28,1959,Nottingham Forest,West Bromwich Albion,1-2,1,2,1,1,3,-1,A
1959-12-28,1959,Preston North End,Leicester City,1-1,1,1,1,1,2,0,D
1959-12-28,1959,Tottenham Hotspur,Leeds United,1-4,1,4,1,1,5,-3,A
1959-12-28,1959,West Ham United,Birmingham City,3-1,3,1,1,1,4,2,H
1959-12-28,1959,Wolverhampton Wanderers,Bolton Wanderers,0-1,0,1,1,1,1,-1,A
1960-01-02,1959,Arsenal,Wolverhampton Wanderers,4-4,4,4,1,1,8,0,D
1960-01-02,1959,Birmingham City,Tottenham Hotspur,0-1,0,1,1,1,1,-1,A
1960-01-02,1959,Blackburn Rovers,Nottingham Forest,1-2,1,2,1,1,3,-1,A
1960-01-02,1959,Blackpool,Fulham,3-1,3,1,1,1,4,2,H
1960-01-02,1959,Chelsea,Leicester City,2-2,2,2,1,1,4,0,D
1960-01-02,1959,Everton,Bolton Wanderers,0-1,0,1,1,1,1,-1,A
1960-01-02,1959,Leeds United,Luton Town,1-1,1,1,1,1,2,0,D
1960-01-02,1959,Manchester City,Sheffield Wednesday,4-1,4,1,1,1,5,3,H
1960-01-02,1959,Newcastle United,Manchester United,7-3,7,3,1,1,10,4,H
1960-01-02,1959,West Bromwich Albion,Preston North End,4-0,4,0,1,1,4,4,H
1960-01-02,1959,West Ham United,Burnley,2-5,2,5,1,1,7,-3,A
1960-01-16,1959,Burnley,Chelsea,2-1,2,1,1,1,3,1,H
1960-01-16,1959,Fulham,Everton,2-0,2,0,1,1,2,2,H
1960-01-16,1959,Leeds United,West Ham United,3-0,3,0,1,1,3,3,H
1960-01-16,1959,Leicester City,West Bromwich Albion,0-1,0,1,1,1,1,-1,A
1960-01-16,1959,Manchester United,Birmingham City,2-1,2,1,1,1,3,1,H
1960-01-16,1959,Nottingham Forest,Blackpool,0-0,0,0,1,1,0,0,D
1960-01-16,1959,Preston North End,Newcastle United,1-2,1,2,1,1,3,-1,A
1960-01-16,1959,Sheffield Wednesday,Blackburn Rovers,3-0,3,0,1,1,3,3,H
1960-01-16,1959,Tottenham Hotspur,Arsenal,3-0,3,0,1,1,3,3,H
1960-01-16,1959,Wolverhampton Wanderers,Manchester City,4-2,4,2,1,1,6,2,H
1960-01-23,1959,Birmingham City,Preston North End,2-1,2,1,1,1,3,1,H
1960-01-23,1959,Blackburn Rovers,Wolverhampton Wanderers,0-1,0,1,1,1,1,-1,A
1960-01-23,1959,Blackpool,Sheffield Wednesday,0-2,0,2,1,1,2,-2,A
1960-01-23,1959,Chelsea,Leeds United,1-3,1,3,1,1,4,-2,A
1960-01-23,1959,Everton,Nottingham Forest,6-1,6,1,1,1,7,5,H
1960-01-23,1959,Luton Town,Fulham,4-1,4,1,1,1,5,3,H
1960-01-23,1959,Manchester City,Arsenal,1-2,1,2,1,1,3,-1,A
1960-01-23,1959,Newcastle United,Leicester City,0-2,0,2,1,1,2,-2,A
1960-01-23,1959,Tottenham Hotspur,Manchester United,2-1,2,1,1,1,3,1,H
1960-01-23,1959,West Bromwich Albion,Burnley,0-0,0,0,1,1,0,0,D
1960-01-23,1959,West Ham United,Bolton Wanderers,1-2,1,2,1,1,3,-1,A
1960-02-06,1959,Arsenal,Blackburn Rovers,5-2,5,2,1,1,7,3,H
1960-02-06,1959,Burnley,Newcastle United,2-1,2,1,1,1,3,1,H
1960-02-06,1959,Fulham,Bolton Wanderers,1-1,1,1,1,1,2,0,D
1960-02-06,1959,Leeds United,West Bromwich Albion,1-4,1,4,1,1,5,-3,A
1960-02-06,1959,Leicester City,Birmingham City,1-3,1,3,1,1,4,-2,A
1960-02-06,1959,Manchester United,Manchester City,0-0,0,0,1,1,0,0,D
1960-02-06,1959,Nottingham Forest,Luton Town,2-0,2,0,1,1,2,2,H
1960-02-06,1959,Preston North End,Tottenham Hotspur,1-1,1,1,1,1,2,0,D
1960-02-06,1959,Sheffield Wednesday,Everton,2-2,2,2,1,1,4,0,D
1960-02-06,1959,West Ham United,Chelsea,4-2,4,2,1,1,6,2,H
1960-02-06,1959,Wolverhampton Wanderers,Blackpool,1-1,1,1,1,1,2,0,D
1960-02-13,1959,Blackburn Rovers,Manchester City,2-1,2,1,1,1,3,1,H
1960-02-13,1959,Blackpool,Arsenal,2-1,2,1,1,1,3,1,H
1960-02-13,1959,Bolton Wanderers,Nottingham Forest,1-1,1,1,1,1,2,0,D
1960-02-13,1959,Chelsea,Fulham,4-2,4,2,1,1,6,2,H
1960-02-13,1959,Everton,Wolverhampton Wanderers,0-2,0,2,1,1,2,-2,A
1960-02-13,1959,Luton Town,Sheffield Wednesday,0-1,0,1,1,1,1,-1,A
1960-02-13,1959,Manchester United,Preston North End,1-1,1,1,1,1,2,0,D
1960-02-13,1959,Newcastle United,Leeds United,2-1,2,1,1,1,3,1,H
1960-02-13,1959,Tottenham Hotspur,Leicester City,1-2,1,2,1,1,3,-1,A
1960-02-20,1959,Arsenal,Everton,2-1,2,1,1,1,3,1,H
1960-02-20,1959,Nottingham Forest,Fulham,2-2,2,2,1,1,4,0,D
1960-02-20,1959,West Ham United,Newcastle United,3-5,3,5,1,1,8,-2,A
1960-02-23,1959,Wolverhampton Wanderers,Luton Town,3-2,3,2,1,1,5,1,H
1960-02-24,1959,Chelsea,West Bromwich Albion,2-2,2,2,1,1,4,0,D
1960-02-24,1959,Leicester City,Manchester United,3-1,3,1,1,1,4,2,H
1960-02-24,1959,Sheffield Wednesday,Bolton Wanderers,1-0,1,0,1,1,1,1,H
1960-02-27,1959,Arsenal,Newcastle United,1-0,1,0,1,1,1,1,H
1960-02-27,1959,Blackburn Rovers,Tottenham Hotspur,1-4,1,4,1,1,5,-3,A
1960-02-27,1959,Blackpool,Manchester United,0-6,0,6,1,1,6,-6,A
1960-02-27,1959,Bolton Wanderers,Burnley,2-1,2,1,1,1,3,1,H
1960-02-27,1959,Everton,Preston North End,4-0,4,0,1,1,4,4,H
1960-02-27,1959,Fulham,Leeds United,5-0,5,0,1,1,5,5,H
1960-02-27,1959,Luton Town,Leicester City,2-0,2,0,1,1,2,2,H
1960-02-27,1959,Manchester City,Birmingham City,3-0,3,0,1,1,3,3,H
1960-02-27,1959,Nottingham Forest,West Ham United,3-1,3,1,1,1,4,2,H
1960-02-27,1959,Sheffield Wednesday,Chelsea,1-1,1,1,1,1,2,0,D
1960-02-27,1959,Wolverhampton Wanderers,West Bromwich Albion,3-1,3,1,1,1,4,2,H
1960-03-01,1959,Burnley,Tottenham Hotspur,2-0,2,0,1,1,2,2,H
1960-03-01,1959,Preston North End,Blackburn Rovers,5-3,5,3,1,1,8,2,H
1960-03-05,1959,Birmingham City,Nottingham Forest,4-1,4,1,1,1,5,3,H
1960-03-05,1959,Burnley,Blackburn Rovers,1-0,1,0,1,1,1,1,H
1960-03-05,1959,Chelsea,Luton Town,3-0,3,0,1,1,3,3,H
1960-03-05,1959,Leeds United,Blackpool,2-4,2,4,1,1,6,-2,A
1960-03-05,1959,Leicester City,Manchester City,5-0,5,0,1,1,5,5,H
1960-03-05,1959,Manchester United,Wolverhampton Wanderers,0-2,0,2,1,1,2,-2,A
1960-03-05,1959,Newcastle United,Fulham,3-1,3,1,1,1,4,2,H
1960-03-05,1959,Preston North End,Arsenal,0-3,0,3,1,1,3,-3,A
1960-03-05,1959,Tottenham Hotspur,Sheffield Wednesday,4-1,4,1,1,1,5,3,H
1960-03-05,1959,West Bromwich Albion,Bolton Wanderers,1-1,1,1,1,1,2,0,D
1960-03-05,1959,West Ham United,Everton,2-2,2,2,1,1,4,0,D
1960-03-09,1959,Bolton Wanderers,Luton Town,2-2,2,2,1,1,4,0,D
1960-03-09,1959,Leeds United,Birmingham City,3-3,3,3,1,1,6,0,D
1960-03-09,1959,Manchester City,Blackpool,2-3,2,3,1,1,5,-1,A
1960-03-09,1959,West Bromwich Albion,West Ham United,3-2,3,2,1,1,5,1,H
1960-03-12,1959,Blackpool,West Ham United,3-2,3,2,1,1,5,1,H
1960-03-12,1959,Bolton Wanderers,Newcastle United,1-4,1,4,1,1,5,-3,A
1960-03-12,1959,Everton,Chelsea,6-1,6,1,1,1,7,5,H
1960-03-12,1959,Fulham,Birmingham City,2-2,2,2,1,1,4,0,D
1960-03-12,1959,Luton Town,West Bromwich Albion,0-0,0,0,1,1,0,0,D
1960-03-12,1959,Nottingham Forest,Tottenham Hotspur,1-3,1,3,1,1,4,-2,A
1960-03-15,1959,Arsenal,Leicester City,1-1,1,1,1,1,2,0,D
1960-03-16,1959,Wolverhampton Wanderers,Preston North End,3-3,3,3,1,1,6,0,D
1960-03-19,1959,Birmingham City,Bolton Wanderers,2-5,2,5,1,1,7,-3,A
1960-03-19,1959,Burnley,Arsenal,3-2,3,2,1,1,5,1,H
1960-03-19,1959,Chelsea,Blackpool,2-3,2,3,1,1,5,-1,A
1960-03-19,1959,Leeds United,Manchester City,4-3,4,3,1,1,7,1,H
1960-03-19,1959,Leicester City,Wolverhampton Wanderers,2-1,2,1,1,1,3,1,H
1960-03-19,1959,Manchester United,Nottingham Forest,3-1,3,1,1,1,4,2,H
1960-03-19,1959,Newcastle United,Luton Town,3-2,3,2,1,1,5,1,H
1960-03-19,1959,Preston North End,Sheffield Wednesday,3-4,3,4,1,1,7,-1,A
1960-03-19,1959,Tottenham Hotspur,Fulham,1-1,1,1,1,1,2,0,D
1960-03-19,1959,West Bromwich Albion,Everton,6-2,6,2,1,1,8,4,H
1960-03-19,1959,West Ham United,Blackburn Rovers,2-1,2,1,1,1,3,1,H
1960-03-25,1959,Everton,Newcastle United,1-2,1,2,1,1,3,-1,A
1960-03-26,1959,Arsenal,Leeds United,1-1,1,1,1,1,2,0,D
1960-03-26,1959,Blackpool,West Bromwich Albion,2-0,2,0,1,1,2,2,H
1960-03-26,1959,Bolton Wanderers,Tottenham Hotspur,2-1,2,1,1,1,3,1,H
1960-03-26,1959,Fulham,Manchester United,0-5,0,5,1,1,5,-5,A
1960-03-26,1959,Luton Town,Birmingham City,1-1,1,1,1,1,2,0,D
1960-03-26,1959,Nottingham Forest,Preston North End,1-1,1,1,1,1,2,0,D
1960-03-30,1959,Blackburn Rovers,Chelsea,1-0,1,0,1,1,1,1,H
1960-03-30,1959,Manchester City,West Ham United,3-1,3,1,1,1,4,2,H
1960-03-30,1959,Sheffield Wednesday,Manchester United,4-2,4,2,1,1,6,2,H
1960-03-30,1959,Wolverhampton Wanderers,Burnley,6-1,6,1,1,1,7,5,H
1960-04-02,1959,Birmingham City,Everton,2-2,2,2,1,1,4,0,D
1960-04-02,1959,Burnley,Sheffield Wednesday,3-3,3,3,1,1,6,0,D
1960-04-02,1959,Chelsea,Manchester City,3-0,3,0,1,1,3,3,H
1960-04-02,1959,Leeds United,Wolverhampton Wanderers,0-3,0,3,1,1,3,-3,A
1960-04-02,1959,Leicester City,Nottingham Forest,0-1,0,1,1,1,1,-1,A
1960-04-02,1959,Manchester United,Bolton Wanderers,2-0,2,0,1,1,2,2,H
1960-04-02,1959,Newcastle United,Blackpool,1-1,1,1,1,1,2,0,D
1960-04-02,1959,Preston North End,Fulham,4-1,4,1,1,1,5,3,H
1960-04-02,1959,Tottenham Hotspur,Luton Town,1-1,1,1,1,1,2,0,D
1960-04-02,1959,West Bromwich Albion,Blackburn Rovers,2-0,2,0,1,1,2,2,H
1960-04-02,1959,West Ham United,Arsenal,0-0,0,0,1,1,0,0,D
1960-04-06,1959,Sheffield Wednesday,Leicester City,2-2,2,2,1,1,4,0,D
1960-04-09,1959,Arsenal,Chelsea,1-4,1,4,1,1,5,-3,A
1960-04-09,1959,Blackburn Rovers,Newcastle United,1-1,1,1,1,1,2,0,D
1960-04-09,1959,Blackpool,Birmingham City,0-1,0,1,1,1,1,-1,A
1960-04-09,1959,Bolton Wanderers,Preston North End,2-1,2,1,1,1,3,1,H
1960-04-09,1959,Everton,Tottenham Hotspur,2-1,2,1,1,1,3,1,H
1960-04-09,1959,Fulham,Leicester City,1-1,1,1,1,1,2,0,D
1960-04-09,1959,Luton Town,Manchester United,2-3,2,3,1,1,5,-1,A
1960-04-09,1959,Manchester City,West Bromwich Albion,0-1,0,1,1,1,1,-1,A
1960-04-09,1959,Nottingham Forest,Burnley,0-1,0,1,1,1,1,-1,A
1960-04-09,1959,Sheffield Wednesday,Leeds United,1-0,1,0,1,1,1,1,H
1960-04-11,1959,Wolverhampton Wanderers,West Ham United,5-0,5,0,1,1,5,5,H
1960-04-15,1959,Arsenal,Fulham,2-0,2,0,1,1,2,2,H
1960-04-15,1959,Blackburn Rovers,Luton Town,0-2,0,2,1,1,2,-2,A
1960-04-15,1959,Burnley,Leicester City,1-0,1,0,1,1,1,1,H
1960-04-15,1959,Chelsea,Tottenham Hotspur,1-3,1,3,1,1,4,-2,A
1960-04-15,1959,Everton,Blackpool,4-0,4,0,1,1,4,4,H
1960-04-15,1959,Manchester City,Bolton Wanderers,1-0,1,0,1,1,1,1,H
1960-04-15,1959,Newcastle United,Sheffield Wednesday,3-3,3,3,1,1,6,0,D
1960-04-15,1959,West Ham United,Manchester United,2-1,2,1,1,1,3,1,H
1960-04-16,1959,Birmingham City,Arsenal,3-0,3,0,1,1,3,3,H
1960-04-16,1959,Burnley,Luton Town,3-0,3,0,1,1,3,3,H
1960-04-16,1959,Chelsea,Nottingham Forest,1-1,1,1,1,1,2,0,D
1960-04-16,1959,Leeds United,Bolton Wanderers,1-0,1,0,1,1,1,1,H
1960-04-16,1959,Leicester City,Everton,3-3,3,3,1,1,6,0,D
1960-04-16,1959,Manchester United,Blackburn Rovers,1-0,1,0,1,1,1,1,H
1960-04-16,1959,Newcastle United,Wolverhampton Wanderers,1-0,1,0,1,1,1,1,H
1960-04-16,1959,Preston North End,Blackpool,4-1,4,1,1,1,5,3,H
1960-04-16,1959,Tottenham Hotspur,Manchester City,0-1,0,1,1,1,1,-1,A
1960-04-16,1959,West Bromwich Albion,Sheffield Wednesday,3-1,3,1,1,1,4,2,H
1960-04-16,1959,West Ham United,Fulham,1-2,1,2,1,1,3,-1,A
1960-04-18,1959,Birmingham City,West Bromwich Albion,1-7,1,7,1,1,8,-6,A
1960-04-18,1959,Blackpool,Everton,0-0,0,0,1,1,0,0,D
1960-04-18,1959,Bolton Wanderers,Manchester City,3-1,3,1,1,1,4,2,H
1960-04-18,1959,Fulham,Arsenal,3-0,3,0,1,1,3,3,H
1960-04-18,1959,Leicester City,Burnley,2-1,2,1,1,1,3,1,H
1960-04-18,1959,Luton Town,Blackburn Rovers,1-1,1,1,1,1,2,0,D
1960-04-18,1959,Manchester United,West Ham United,5-3,5,3,1,1,8,2,H
1960-04-18,1959,Preston North End,Leeds United,1-1,1,1,1,1,2,0,D
1960-04-18,1959,Sheffield Wednesday,Newcastle United,2-0,2,0,1,1,2,2,H
1960-04-18,1959,Tottenham Hotspur,Chelsea,0-1,0,1,1,1,1,-1,A
1960-04-18,1959,Wolverhampton Wanderers,Nottingham Forest,3-1,3,1,1,1,4,2,H
1960-04-19,1959,Leeds United,Preston North End,2-1,2,1,1,1,3,1,H
1960-04-19,1959,Nottingham Forest,Wolverhampton Wanderers,0-0,0,0,1,1,0,0,D
1960-04-19,1959,West Bromwich Albion,Birmingham City,1-1,1,1,1,1,2,0,D
1960-04-23,1959,Arsenal,Manchester United,5-2,5,2,1,1,7,3,H
1960-04-23,1959,Blackburn Rovers,Leicester City,0-1,0,1,1,1,1,-1,A
1960-04-23,1959,Blackpool,Burnley,1-1,1,1,1,1,2,0,D
1960-04-23,1959,Bolton Wanderers,Chelsea,2-0,2,0,1,1,2,2,H
1960-04-23,1959,Everton,Leeds United,1-0,1,0,1,1,1,1,H
1960-04-23,1959,Fulham,West Bromwich Albion,2-1,2,1,1,1,3,1,H
1960-04-23,1959,Luton Town,West Ham United,3-1,3,1,1,1,4,2,H
1960-04-23,1959,Manchester City,Preston North End,2-1,2,1,1,1,3,1,H
1960-04-23,1959,Nottingham Forest,Newcastle United,3-0,3,0,1,1,3,3,H
1960-04-23,1959,Sheffield Wednesday,Birmingham City,2-4,2,4,1,1,6,-2,A
1960-04-23,1959,Wolverhampton Wanderers,Tottenham Hotspur,1-3,1,3,1,1,4,-2,A
1960-04-27,1959,Birmingham City,Burnley,0-1,0,1,1,1,1,-1,A
1960-04-27,1959,Blackburn Rovers,Leeds United,3-2,3,2,1,1,5,1,H
1960-04-30,1959,Birmingham City,Blackburn Rovers,1-0,1,0,1,1,1,1,H
1960-04-30,1959,Burnley,Fulham,0-0,0,0,1,1,0,0,D
1960-04-30,1959,Chelsea,Wolverhampton Wanderers,1-5,1,5,1,1,6,-4,A
1960-04-30,1959,Leeds United,Nottingham Forest,1-0,1,0,1,1,1,1,H
1960-04-30,1959,Leicester City,Bolton Wanderers,1-2,1,2,1,1,3,-1,A
1960-04-30,1959,Manchester United,Everton,5-0,5,0,1,1,5,5,H
1960-04-30,1959,Newcastle United,Manchester City,0-1,0,1,1,1,1,-1,A
1960-04-30,1959,Preston North End,Luton Town,2-0,2,0,1,1,2,2,H
1960-04-30,1959,Tottenham Hotspur,Blackpool,4-1,4,1,1,1,5,3,H
1960-04-30,1959,West Bromwich Albion,Arsenal,1-0,1,0,1,1,1,1,H
1960-04-30,1959,West Ham United,Sheffield Wednesday,1-1,1,1,1,1,2,0,D
1960-05-02,1959,Manchester City,Burnley,1-2,1,2,1,1,3,-1,A
1960-08-20,1960,Aston Villa,Chelsea,3-2,3,2,1,1,5,1,H
1960-08-20,1960,Bolton Wanderers,Birmingham City,2-2,2,2,1,1,4,0,D
1960-08-20,1960,Burnley,Arsenal,3-2,3,2,1,1,5,1,H
1960-08-20,1960,Fulham,Cardiff City,2-2,2,2,1,1,4,0,D
1960-08-20,1960,Leicester City,Blackpool,1-1,1,1,1,1,2,0,D
1960-08-20,1960,Manchester United,Blackburn Rovers,1-3,1,3,1,1,4,-2,A
1960-08-20,1960,Nottingham Forest,Manchester City,2-2,2,2,1,1,4,0,D
1960-08-20,1960,Preston North End,Newcastle United,2-3,2,3,1,1,5,-1,A
1960-08-20,1960,Sheffield Wednesday,West Bromwich Albion,1-0,1,0,1,1,1,1,H
1960-08-20,1960,Tottenham Hotspur,Everton,2-0,2,0,1,1,2,2,H
1960-08-20,1960,Wolverhampton Wanderers,West Ham United,4-2,4,2,1,1,6,2,H
1960-08-22,1960,Blackpool,Tottenham Hotspur,1-3,1,3,1,1,4,-2,A
1960-08-22,1960,West Ham United,Aston Villa,5-2,5,2,1,1,7,3,H
1960-08-23,1960,Arsenal,Preston North End,1-0,1,0,1,1,1,1,H
1960-08-24,1960,Blackburn Rovers,Nottingham Forest,4-1,4,1,1,1,5,3,H
1960-08-24,1960,Bolton Wanderers,Wolverhampton Wanderers,0-2,0,2,1,1,2,-2,A
1960-08-24,1960,Cardiff City,Sheffield Wednesday,0-1,0,1,1,1,1,-1,A
1960-08-24,1960,Chelsea,Leicester City,1-3,1,3,1,1,4,-2,A
1960-08-24,1960,Everton,Manchester United,4-0,4,0,1,1,4,4,H
1960-08-24,1960,Manchester City,Burnley,2-1,2,1,1,1,3,1,H
1960-08-24,1960,Newcastle United,Fulham,7-2,7,2,1,1,9,5,H
1960-08-24,1960,West Bromwich Albion,Birmingham City,1-2,1,2,1,1,3,-1,A
1960-08-27,1960,Arsenal,Nottingham Forest,3-0,3,0,1,1,3,3,H
1960-08-27,1960,Birmingham City,Sheffield Wednesday,1-1,1,1,1,1,2,0,D
1960-08-27,1960,Blackburn Rovers,Tottenham Hotspur,1-4,1,4,1,1,5,-3,A
1960-08-27,1960,Blackpool,Aston Villa,5-3,5,3,1,1,8,2,H
1960-08-27,1960,Cardiff City,Preston North End,2-0,2,0,1,1,2,2,H
1960-08-27,1960,Chelsea,Wolverhampton Wanderers,3-3,3,3,1,1,6,0,D
1960-08-27,1960,Everton,Leicester City,3-1,3,1,1,1,4,2,H
1960-08-27,1960,Newcastle United,Burnley,0-1,0,1,1,1,1,-1,A
1960-08-27,1960,West Bromwich Albion,Fulham,2-4,2,4,1,1,6,-2,A
1960-08-27,1960,West Ham United,Bolton Wanderers,2-1,2,1,1,1,3,1,H
1960-08-29,1960,Aston Villa,West Ham United,2-1,2,1,1,1,3,1,H
1960-08-30,1960,Burnley,Manchester City,1-3,1,3,1,1,4,-2,A
1960-08-30,1960,Preston North End,Arsenal,2-0,2,0,1,1,2,2,H
1960-08-31,1960,Birmingham City,West Bromwich Albion,3-1,3,1,1,1,4,2,H
1960-08-31,1960,Fulham,Newcastle United,4-3,4,3,1,1,7,1,H
1960-08-31,1960,Leicester City,Chelsea,1-3,1,3,1,1,4,-2,A
1960-08-31,1960,Manchester United,Everton,4-0,4,0,1,1,4,4,H
1960-08-31,1960,Nottingham Forest,Blackburn Rovers,1-1,1,1,1,1,2,0,D
1960-08-31,1960,Sheffield Wednesday,Cardiff City,2-0,2,0,1,1,2,2,H
1960-08-31,1960,Tottenham Hotspur,Blackpool,3-1,3,1,1,1,4,2,H
1960-08-31,1960,Wolverhampton Wanderers,Bolton Wanderers,3-1,3,1,1,1,4,2,H
1960-09-03,1960,Aston Villa,Everton,3-2,3,2,1,1,5,1,H
1960-09-03,1960,Bolton Wanderers,Chelsea,4-1,4,1,1,1,5,3,H
1960-09-03,1960,Burnley,Cardiff City,1-2,1,2,1,1,3,-1,A
1960-09-03,1960,Fulham,Birmingham City,2-1,2,1,1,1,3,1,H
1960-09-03,1960,Leicester City,Blackburn Rovers,2-4,2,4,1,1,6,-2,A
1960-09-03,1960,Manchester City,Arsenal,0-0,0,0,1,1,0,0,D
1960-09-03,1960,Nottingham Forest,Newcastle United,0-2,0,2,1,1,2,-2,A
1960-09-03,1960,Preston North End,West Bromwich Albion,2-1,2,1,1,1,3,1,H
1960-09-03,1960,Sheffield Wednesday,West Ham United,1-0,1,0,1,1,1,1,H
1960-09-03,1960,Tottenham Hotspur,Manchester United,4-1,4,1,1,1,5,3,H
1960-09-03,1960,Wolverhampton Wanderers,Blackpool,1-0,1,0,1,1,1,1,H
1960-09-05,1960,Blackpool,Everton,1-4,1,4,1,1,5,-3,A
1960-09-05,1960,West Bromwich Albion,Newcastle United,6-0,6,0,1,1,6,6,H
1960-09-05,1960,West Ham United,Manchester United,2-1,2,1,1,1,3,1,H
1960-09-06,1960,Arsenal,Birmingham City,2-0,2,0,1,1,2,2,H
1960-09-06,1960,Burnley,Preston North End,5-0,5,0,1,1,5,5,H
1960-09-07,1960,Bolton Wanderers,Tottenham Hotspur,1-2,1,2,1,1,3,-1,A
1960-09-07,1960,Cardiff City,Aston Villa,1-1,1,1,1,1,2,0,D
1960-09-07,1960,Chelsea,Blackburn Rovers,5-2,5,2,1,1,7,3,H
1960-09-07,1960,Manchester City,Sheffield Wednesday,1-1,1,1,1,1,2,0,D
1960-09-07,1960,Wolverhampton Wanderers,Leicester City,3-2,3,2,1,1,5,1,H
1960-09-10,1960,Arsenal,Tottenham Hotspur,2-3,2,3,1,1,5,-1,A
1960-09-10,1960,Birmingham City,Preston North End,1-3,1,3,1,1,4,-2,A
1960-09-10,1960,Blackburn Rovers,Aston Villa,4-1,4,1,1,1,5,3,H
1960-09-10,1960,Blackpool,Bolton Wanderers,0-1,0,1,1,1,1,-1,A
1960-09-10,1960,Cardiff City,Nottingham Forest,1-3,1,3,1,1,4,-2,A
1960-09-10,1960,Chelsea,West Ham United,3-2,3,2,1,1,5,1,H
1960-09-10,1960,Everton,Wolverhampton Wanderers,3-1,3,1,1,1,4,2,H
1960-09-10,1960,Manchester United,Leicester City,1-1,1,1,1,1,2,0,D
1960-09-10,1960,Newcastle United,Manchester City,1-3,1,3,1,1,4,-2,A
1960-09-10,1960,Sheffield Wednesday,Fulham,2-0,2,0,1,1,2,2,H
1960-09-10,1960,West Bromwich Albion,Burnley,0-2,0,2,1,1,2,-2,A
1960-09-12,1960,Aston Villa,Cardiff City,2-1,2,1,1,1,3,1,H
1960-09-13,1960,Fulham,Nottingham Forest,1-0,1,0,1,1,1,1,H
1960-09-13,1960,Preston North End,Burnley,2-3,2,3,1,1,5,-1,A
1960-09-14,1960,Birmingham City,Arsenal,2-0,2,0,1,1,2,2,H
1960-09-14,1960,Everton,Blackpool,1-0,1,0,1,1,1,1,H
1960-09-14,1960,Leicester City,Wolverhampton Wanderers,2-0,2,0,1,1,2,2,H
1960-09-14,1960,Manchester United,West Ham United,6-1,6,1,1,1,7,5,H
1960-09-14,1960,Newcastle United,West Bromwich Albion,3-2,3,2,1,1,5,1,H
1960-09-14,1960,Sheffield Wednesday,Manchester City,3-1,3,1,1,1,4,2,H
1960-09-14,1960,Tottenham Hotspur,Bolton Wanderers,3-1,3,1,1,1,4,2,H
1960-09-17,1960,Arsenal,Newcastle United,5-0,5,0,1,1,5,5,H
1960-09-17,1960,Aston Villa,Manchester United,3-1,3,1,1,1,4,2,H
1960-09-17,1960,Bolton Wanderers,Everton,3-4,3,4,1,1,7,-1,A
1960-09-17,1960,Burnley,Birmingham City,2-1,2,1,1,1,3,1,H
1960-09-17,1960,Fulham,Chelsea,3-2,3,2,1,1,5,1,H
1960-09-17,1960,Leicester City,Tottenham Hotspur,1-2,1,2,1,1,3,-1,A
1960-09-17,1960,Manchester City,Cardiff City,4-2,4,2,1,1,6,2,H
1960-09-17,1960,Nottingham Forest,West Bromwich Albion,1-2,1,2,1,1,3,-1,A
1960-09-17,1960,Preston North End,Sheffield Wednesday,2-2,2,2,1,1,4,0,D
1960-09-17,1960,West Ham United,Blackpool,3-3,3,3,1,1,6,0,D
1960-09-17,1960,Wolverhampton Wanderers,Blackburn Rovers,0-0,0,0,1,1,0,0,D
1960-09-19,1960,Blackburn Rovers,Chelsea,3-1,3,1,1,1,4,2,H
1960-09-21,1960,Nottingham Forest,Fulham,4-2,4,2,1,1,6,2,H
1960-09-24,1960,Birmingham City,Nottingham Forest,3-1,3,1,1,1,4,2,H
1960-09-24,1960,Blackburn Rovers,Bolton Wanderers,3-1,3,1,1,1,4,2,H
1960-09-24,1960,Blackpool,Chelsea,1-4,1,4,1,1,5,-3,A
1960-09-24,1960,Cardiff City,Arsenal,1-0,1,0,1,1,1,1,H
1960-09-24,1960,Everton,West Ham United,4-1,4,1,1,1,5,3,H
1960-09-24,1960,Fulham,Preston North End,2-0,2,0,1,1,2,2,H
1960-09-24,1960,Manchester United,Wolverhampton Wanderers,1-3,1,3,1,1,4,-2,A
1960-09-24,1960,Newcastle United,Leicester City,1-3,1,3,1,1,4,-2,A
1960-09-24,1960,Sheffield Wednesday,Burnley,3-1,3,1,1,1,4,2,H
1960-09-24,1960,Tottenham Hotspur,Aston Villa,6-2,6,2,1,1,8,4,H
1960-09-24,1960,West Bromwich Albion,Manchester City,6-3,6,3,1,1,9,3,H
1960-10-01,1960,Arsenal,West Bromwich Albion,1-0,1,0,1,1,1,1,H
1960-10-01,1960,Aston Villa,Leicester City,1-3,1,3,1,1,4,-2,A
1960-10-01,1960,Bolton Wanderers,Manchester United,1-1,1,1,1,1,2,0,D
1960-10-01,1960,Burnley,Fulham,5-0,5,0,1,1,5,5,H
1960-10-01,1960,Chelsea,Everton,3-3,3,3,1,1,6,0,D
1960-10-01,1960,Manchester City,Birmingham City,2-1,2,1,1,1,3,1,H
1960-10-01,1960,Newcastle United,Cardiff City,5-0,5,0,1,1,5,5,H
1960-10-01,1960,Nottingham Forest,Sheffield Wednesday,1-2,1,2,1,1,3,-1,A
1960-10-01,1960,Preston North End,Blackpool,1-0,1,0,1,1,1,1,H
1960-10-01,1960,West Ham United,Blackburn Rovers,3-2,3,2,1,1,5,1,H
1960-10-01,1960,Wolverhampton Wanderers,Tottenham Hotspur,0-4,0,4,1,1,4,-4,A
1960-10-08,1960,Aston Villa,Newcastle United,2-0,2,0,1,1,2,2,H
1960-10-08,1960,Blackburn Rovers,Burnley,1-4,1,4,1,1,5,-3,A
1960-10-08,1960,Blackpool,Fulham,2-5,2,5,1,1,7,-3,A
1960-10-08,1960,Bolton Wanderers,West Bromwich Albion,0-1,0,1,1,1,1,-1,A
1960-10-08,1960,Everton,Preston North End,0-0,0,0,1,1,0,0,D
1960-10-08,1960,Leicester City,Arsenal,2-1,2,1,1,1,3,1,H
1960-10-08,1960,West Ham United,Birmingham City,4-3,4,3,1,1,7,1,H
1960-10-08,1960,Wolverhampton Wanderers,Cardiff City,2-2,2,2,1,1,4,0,D
1960-10-10,1960,Tottenham Hotspur,Manchester City,1-1,1,1,1,1,2,0,D
1960-10-15,1960,Arsenal,Aston Villa,2-1,2,1,1,1,3,1,H
1960-10-15,1960,Birmingham City,Chelsea,1-0,1,0,1,1,1,1,H
1960-10-15,1960,Burnley,Manchester United,5-3,5,3,1,1,8,2,H
1960-10-15,1960,Cardiff City,Bolton Wanderers,0-1,0,1,1,1,1,-1,A
1960-10-15,1960,Fulham,Everton,2-3,2,3,1,1,5,-1,A
1960-10-15,1960,Manchester City,Leicester City,3-1,3,1,1,1,4,2,H
1960-10-15,1960,Newcastle United,Wolverhampton Wanderers,4-4,4,4,1,1,8,0,D
1960-10-15,1960,Nottingham Forest,Tottenham Hotspur,0-4,0,4,1,1,4,-4,A
1960-10-15,1960,Preston North End,Blackburn Rovers,2-0,2,0,1,1,2,2,H
1960-10-15,1960,Sheffield Wednesday,Blackpool,4-0,4,0,1,1,4,4,H
1960-10-15,1960,West Bromwich Albion,West Ham United,1-0,1,0,1,1,1,1,H
1960-10-22,1960,Aston Villa,Birmingham City,6-2,6,2,1,1,8,4,H
1960-10-22,1960,Blackburn Rovers,Arsenal,2-4,2,4,1,1,6,-2,A
1960-10-22,1960,Blackpool,Nottingham Forest,4-0,4,0,1,1,4,4,H
1960-10-22,1960,Bolton Wanderers,Fulham,0-3,0,3,1,1,3,-3,A
1960-10-22,1960,Chelsea,Burnley,2-6,2,6,1,1,8,-4,A
1960-10-22,1960,Leicester City,West Bromwich Albion,2-2,2,2,1,1,4,0,D
1960-10-22,1960,Manchester United,Newcastle United,3-2,3,2,1,1,5,1,H
1960-10-22,1960,West Ham United,Preston North End,5-2,5,2,1,1,7,3,H
1960-10-22,1960,Wolverhampton Wanderers,Sheffield Wednesday,4-1,4,1,1,1,5,3,H
1960-10-24,1960,Everton,Manchester City,4-2,4,2,1,1,6,2,H
1960-10-24,1960,Manchester United,Nottingham Forest,2-1,2,1,1,1,3,1,H
1960-10-28,1960,Cardiff City,Leicester City,2-1,2,1,1,1,3,1,H
1960-10-29,1960,Arsenal,Manchester United,2-1,2,1,1,1,3,1,H
1960-10-29,1960,Birmingham City,Wolverhampton Wanderers,1-2,1,2,1,1,3,-1,A
1960-10-29,1960,Burnley,Blackpool,1-2,1,2,1,1,3,-1,A
1960-10-29,1960,Fulham,West Ham United,1-1,1,1,1,1,2,0,D
1960-10-29,1960,Manchester City,Blackburn Rovers,4-0,4,0,1,1,4,4,H
1960-10-29,1960,Newcastle United,Tottenham Hotspur,3-4,3,4,1,1,7,-1,A
1960-10-29,1960,Nottingham Forest,Everton,1-2,1,2,1,1,3,-1,A
1960-10-29,1960,Preston North End,Chelsea,0-2,0,2,1,1,2,-2,A
1960-10-29,1960,Sheffield Wednesday,Bolton Wanderers,2-0,2,0,1,1,2,2,H
1960-10-29,1960,West Bromwich Albion,Aston Villa,0-2,0,2,1,1,2,-2,A
1960-11-02,1960,Tottenham Hotspur,Cardiff City,3-2,3,2,1,1,5,1,H
1960-11-04,1960,Leicester City,Preston North End,5-2,5,2,1,1,7,3,H
1960-11-05,1960,Aston Villa,Burnley,2-0,2,0,1,1,2,2,H
1960-11-05,1960,Blackburn Rovers,Birmingham City,2-0,2,0,1,1,2,2,H
1960-11-05,1960,Blackpool,Cardiff City,6-1,6,1,1,1,7,5,H
1960-11-05,1960,Bolton Wanderers,Manchester City,3-1,3,1,1,1,4,2,H
1960-11-05,1960,Chelsea,Newcastle United,4-2,4,2,1,1,6,2,H
1960-11-05,1960,Everton,West Bromwich Albion,1-1,1,1,1,1,2,0,D
1960-11-05,1960,Manchester United,Sheffield Wednesday,0-0,0,0,1,1,0,0,D
1960-11-05,1960,Tottenham Hotspur,Fulham,5-1,5,1,1,1,6,4,H
1960-11-05,1960,West Ham United,Arsenal,6-0,6,0,1,1,6,6,H
1960-11-05,1960,Wolverhampton Wanderers,Nottingham Forest,5-3,5,3,1,1,8,2,H
1960-11-12,1960,Arsenal,Chelsea,1-4,1,4,1,1,5,-3,A
1960-11-12,1960,Birmingham City,Manchester United,3-1,3,1,1,1,4,2,H
1960-11-12,1960,Burnley,Wolverhampton Wanderers,5-3,5,3,1,1,8,2,H
1960-11-12,1960,Cardiff City,Everton,1-1,1,1,1,1,2,0,D
1960-11-12,1960,Fulham,Leicester City,4-2,4,2,1,1,6,2,H
1960-11-12,1960,Manchester City,West Ham United,1-2,1,2,1,1,3,-1,A
1960-11-12,1960,Newcastle United,Blackpool,4-3,4,3,1,1,7,1,H
1960-11-12,1960,Nottingham Forest,Bolton Wanderers,2-2,2,2,1,1,4,0,D
1960-11-12,1960,Preston North End,Aston Villa,1-1,1,1,1,1,2,0,D
1960-11-12,1960,Sheffield Wednesday,Tottenham Hotspur,2-1,2,1,1,1,3,1,H
1960-11-12,1960,West Bromwich Albion,Blackburn Rovers,1-2,1,2,1,1,3,-1,A
1960-11-19,1960,Aston Villa,Fulham,2-1,2,1,1,1,3,1,H
1960-11-19,1960,Blackburn Rovers,Cardiff City,2-2,2,2,1,1,4,0,D
1960-11-19,1960,Blackpool,Arsenal,1-1,1,1,1,1,2,0,D
1960-11-19,1960,Bolton Wanderers,Burnley,3-5,3,5,1,1,8,-2,A
1960-11-19,1960,Chelsea,Manchester City,6-3,6,3,1,1,9,3,H
1960-11-19,1960,Everton,Newcastle United,5-0,5,0,1,1,5,5,H
1960-11-19,1960,Leicester City,Sheffield Wednesday,2-1,2,1,1,1,3,1,H
1960-11-19,1960,Manchester United,West Bromwich Albion,3-0,3,0,1,1,3,3,H
1960-11-19,1960,Tottenham Hotspur,Birmingham City,6-0,6,0,1,1,6,6,H
1960-11-19,1960,West Ham United,Nottingham Forest,2-4,2,4,1,1,6,-2,A
1960-11-19,1960,Wolverhampton Wanderers,Preston North End,3-0,3,0,1,1,3,3,H
1960-11-26,1960,Arsenal,Everton,3-2,3,2,1,1,5,1,H
1960-11-26,1960,Birmingham City,Leicester City,0-2,0,2,1,1,2,-2,A
1960-11-26,1960,Cardiff City,Manchester United,3-0,3,0,1,1,3,3,H
1960-11-26,1960,Fulham,Wolverhampton Wanderers,1-3,1,3,1,1,4,-2,A
1960-11-26,1960,Newcastle United,Blackburn Rovers,3-1,3,1,1,1,4,2,H
1960-11-26,1960,Nottingham Forest,Chelsea,2-1,2,1,1,1,3,1,H
1960-11-26,1960,Sheffield Wednesday,Aston Villa,1-2,1,2,1,1,3,-1,A
1960-11-26,1960,West Bromwich Albion,Tottenham Hotspur,1-3,1,3,1,1,4,-2,A
1960-12-03,1960,Aston Villa,Manchester City,5-1,5,1,1,1,6,4,H
1960-12-03,1960,Blackburn Rovers,Fulham,5-1,5,1,1,1,6,4,H
1960-12-03,1960,Blackpool,Birmingham City,1-2,1,2,1,1,3,-1,A
1960-12-03,1960,Bolton Wanderers,Newcastle United,2-1,2,1,1,1,3,1,H
1960-12-03,1960,Chelsea,West Bromwich Albion,7-1,7,1,1,1,8,6,H
1960-12-03,1960,Everton,Sheffield Wednesday,4-2,4,2,1,1,6,2,H
1960-12-03,1960,Leicester City,Nottingham Forest,1-1,1,1,1,1,2,0,D
1960-12-03,1960,Manchester United,Preston North End,1-0,1,0,1,1,1,1,H
1960-12-03,1960,Tottenham Hotspur,Burnley,4-4,4,4,1,1,8,0,D
1960-12-03,1960,West Ham United,Cardiff City,2-0,2,0,1,1,2,2,H
1960-12-03,1960,Wolverhampton Wanderers,Arsenal,5-3,5,3,1,1,8,2,H
1960-12-10,1960,Arsenal,Bolton Wanderers,5-1,5,1,1,1,6,4,H
1960-12-10,1960,Birmingham City,Everton,2-4,2,4,1,1,6,-2,A
1960-12-10,1960,Burnley,Leicester City,3-2,3,2,1,1,5,1,H
1960-12-10,1960,Cardiff City,Chelsea,2-1,2,1,1,1,3,1,H
1960-12-10,1960,Fulham,Manchester United,4-4,4,4,1,1,8,0,D
1960-12-10,1960,Manchester City,Wolverhampton Wanderers,2-4,2,4,1,1,6,-2,A
1960-12-10,1960,Newcastle United,West Ham United,5-5,5,5,1,1,10,0,D
1960-12-10,1960,Nottingham Forest,Aston Villa,2-0,2,0,1,1,2,2,H
1960-12-10,1960,Preston North End,Tottenham Hotspur,0-1,0,1,1,1,1,-1,A
1960-12-10,1960,Sheffield Wednesday,Blackburn Rovers,5-4,5,4,1,1,9,1,H
1960-12-10,1960,West Bromwich Albion,Blackpool,3-1,3,1,1,1,4,2,H
1960-12-17,1960,Arsenal,Burnley,2-5,2,5,1,1,7,-3,A
1960-12-17,1960,Birmingham City,Bolton Wanderers,2-2,2,2,1,1,4,0,D
1960-12-17,1960,Blackburn Rovers,Manchester United,1-2,1,2,1,1,3,-1,A
1960-12-17,1960,Blackpool,Leicester City,5-1,5,1,1,1,6,4,H
1960-12-17,1960,Cardiff City,Fulham,2-0,2,0,1,1,2,2,H
1960-12-17,1960,Chelsea,Aston Villa,2-4,2,4,1,1,6,-2,A
1960-12-17,1960,Everton,Tottenham Hotspur,1-3,1,3,1,1,4,-2,A
1960-12-17,1960,Manchester City,Nottingham Forest,1-2,1,2,1,1,3,-1,A
1960-12-17,1960,Newcastle United,Preston North End,0-0,0,0,1,1,0,0,D
1960-12-17,1960,West Bromwich Albion,Sheffield Wednesday,2-2,2,2,1,1,4,0,D
1960-12-17,1960,West Ham United,Wolverhampton Wanderers,5-0,5,0,1,1,5,5,H
1960-12-23,1960,Sheffield Wednesday,Arsenal,1-1,1,1,1,1,2,0,D
1960-12-24,1960,Aston Villa,Wolverhampton Wanderers,0-2,0,2,1,1,2,-2,A
1960-12-24,1960,Blackpool,Blackburn Rovers,2-0,2,0,1,1,2,2,H
1960-12-24,1960,Bolton Wanderers,Leicester City,2-0,2,0,1,1,2,2,H
1960-12-24,1960,Chelsea,Manchester United,1-2,1,2,1,1,3,-1,A
1960-12-24,1960,Manchester City,Fulham,3-2,3,2,1,1,5,1,H
1960-12-24,1960,Newcastle United,Birmingham City,2-2,2,2,1,1,4,0,D
1960-12-24,1960,Nottingham Forest,Preston North End,2-0,2,0,1,1,2,2,H
1960-12-24,1960,Tottenham Hotspur,West Ham United,2-0,2,0,1,1,2,2,H
1960-12-26,1960,Arsenal,Sheffield Wednesday,1-1,1,1,1,1,2,0,D
1960-12-26,1960,Birmingham City,Newcastle United,2-1,2,1,1,1,3,1,H
1960-12-26,1960,Burnley,Everton,1-3,1,3,1,1,4,-2,A
1960-12-26,1960,Cardiff City,West Bromwich Albion,3-1,3,1,1,1,4,2,H
1960-12-26,1960,Fulham,Manchester City,1-0,1,0,1,1,1,1,H
1960-12-26,1960,Leicester City,Bolton Wanderers,2-0,2,0,1,1,2,2,H
1960-12-26,1960,Manchester United,Chelsea,6-0,6,0,1,1,6,6,H
1960-12-26,1960,Preston North End,Nottingham Forest,0-1,0,1,1,1,1,-1,A
1960-12-26,1960,West Ham United,Tottenham Hotspur,0-3,0,3,1,1,3,-3,A
1960-12-26,1960,Wolverhampton Wanderers,Aston Villa,3-2,3,2,1,1,5,1,H
1960-12-27,1960,Blackburn Rovers,Blackpool,2-0,2,0,1,1,2,2,H
1960-12-27,1960,Everton,Burnley,0-3,0,3,1,1,3,-3,A
1960-12-27,1960,West Bromwich Albion,Cardiff City,1-1,1,1,1,1,2,0,D
1960-12-31,1960,Aston Villa,Blackpool,2-2,2,2,1,1,4,0,D
1960-12-31,1960,Bolton Wanderers,West Ham United,3-1,3,1,1,1,4,2,H
1960-12-31,1960,Burnley,Newcastle United,5-3,5,3,1,1,8,2,H
1960-12-31,1960,Fulham,West Bromwich Albion,1-2,1,2,1,1,3,-1,A
1960-12-31,1960,Leicester City,Everton,4-1,4,1,1,1,5,3,H
1960-12-31,1960,Manchester United,Manchester City,5-1,5,1,1,1,6,4,H
1960-12-31,1960,Nottingham Forest,Arsenal,3-5,3,5,1,1,8,-2,A
1960-12-31,1960,Preston North End,Cardiff City,1-1,1,1,1,1,2,0,D
1960-12-31,1960,Sheffield Wednesday,Birmingham City,2-0,2,0,1,1,2,2,H
1960-12-31,1960,Tottenham Hotspur,Blackburn Rovers,5-2,5,2,1,1,7,3,H
1960-12-31,1960,Wolverhampton Wanderers,Chelsea,6-1,6,1,1,1,7,5,H
1961-01-14,1960,Arsenal,Manchester City,5-4,5,4,1,1,9,1,H
1961-01-14,1960,Birmingham City,Fulham,1-0,1,0,1,1,1,1,H
1961-01-14,1960,Blackburn Rovers,Leicester City,1-1,1,1,1,1,2,0,D
1961-01-14,1960,Cardiff City,Burnley,2-1,2,1,1,1,3,1,H
1961-01-14,1960,Chelsea,Bolton Wanderers,1-1,1,1,1,1,2,0,D
1961-01-14,1960,Newcastle United,Nottingham Forest,2-2,2,2,1,1,4,0,D
1961-01-14,1960,West Bromwich Albion,Preston North End,3-1,3,1,1,1,4,2,H
1961-01-14,1960,West Ham United,Sheffield Wednesday,1-1,1,1,1,1,2,0,D
1961-01-16,1960,Manchester United,Tottenham Hotspur,2-0,2,0,1,1,2,2,H
1961-01-21,1960,Aston Villa,Blackburn Rovers,2-2,2,2,1,1,4,0,D
1961-01-21,1960,Bolton Wanderers,Blackpool,3-1,3,1,1,1,4,2,H
1961-01-21,1960,Burnley,West Bromwich Albion,0-1,0,1,1,1,1,-1,A
1961-01-21,1960,Fulham,Sheffield Wednesday,1-6,1,6,1,1,7,-5,A
1961-01-21,1960,Leicester City,Manchester United,6-0,6,0,1,1,6,6,H
1961-01-21,1960,Manchester City,Newcastle United,3-3,3,3,1,1,6,0,D
1961-01-21,1960,Nottingham Forest,Cardiff City,2-1,2,1,1,1,3,1,H
1961-01-21,1960,Preston North End,Birmingham City,2-3,2,3,1,1,5,-1,A
1961-01-21,1960,Tottenham Hotspur,Arsenal,4-2,4,2,1,1,6,2,H
1961-01-21,1960,West Ham United,Chelsea,3-1,3,1,1,1,4,2,H
1961-01-21,1960,Wolverhampton Wanderers,Everton,4-1,4,1,1,1,5,3,H
1961-01-28,1960,Wolverhampton Wanderers,West Bromwich Albion,4-2,4,2,1,1,6,2,H
1961-02-04,1960,Blackburn Rovers,Wolverhampton Wanderers,2-1,2,1,1,1,3,1,H
1961-02-04,1960,Blackpool,West Ham United,3-0,3,0,1,1,3,3,H
1961-02-04,1960,Cardiff City,Manchester City,3-3,3,3,1,1,6,0,D
1961-02-04,1960,Chelsea,Fulham,2-1,2,1,1,1,3,1,H
1961-02-04,1960,Everton,Bolton Wanderers,1-2,1,2,1,1,3,-1,A
1961-02-04,1960,Manchester United,Aston Villa,1-1,1,1,1,1,2,0,D
1961-02-04,1960,Newcastle United,Arsenal,3-3,3,3,1,1,6,0,D
1961-02-04,1960,Sheffield Wednesday,Preston North End,5-1,5,1,1,1,6,4,H
1961-02-04,1960,Tottenham Hotspur,Leicester City,2-3,2,3,1,1,5,-1,A
1961-02-04,1960,West Bromwich Albion,Nottingham Forest,1-2,1,2,1,1,3,-1,A
1961-02-11,1960,Arsenal,Cardiff City,2-3,2,3,1,1,5,-1,A
1961-02-11,1960,Aston Villa,Tottenham Hotspur,1-2,1,2,1,1,3,-1,A
1961-02-11,1960,Bolton Wanderers,Blackburn Rovers,0-0,0,0,1,1,0,0,D
1961-02-11,1960,Burnley,Sheffield Wednesday,3-4,3,4,1,1,7,-1,A
1961-02-11,1960,Chelsea,Blackpool,2-2,2,2,1,1,4,0,D
1961-02-11,1960,Leicester City,Newcastle United,5-3,5,3,1,1,8,2,H
1961-02-11,1960,Manchester City,West Bromwich Albion,3-0,3,0,1,1,3,3,H
1961-02-11,1960,Nottingham Forest,Birmingham City,1-0,1,0,1,1,1,1,H
1961-02-11,1960,Preston North End,Fulham,2-0,2,0,1,1,2,2,H
1961-02-11,1960,West Ham United,Everton,4-0,4,0,1,1,4,4,H
1961-02-11,1960,Wolverhampton Wanderers,Manchester United,2-1,2,1,1,1,3,1,H
1961-02-18,1960,Blackpool,Preston North End,0-1,0,1,1,1,1,-1,A
1961-02-18,1960,Everton,Chelsea,1-1,1,1,1,1,2,0,D
1961-02-18,1960,Manchester United,Bolton Wanderers,3-1,3,1,1,1,4,2,H
1961-02-18,1960,West Bromwich Albion,Arsenal,2-3,2,3,1,1,5,-1,A
1961-02-21,1960,Sheffield Wednesday,Nottingham Forest,1-0,1,0,1,1,1,1,H
1961-02-22,1960,Cardiff City,Newcastle United,3-2,3,2,1,1,5,1,H
1961-02-22,1960,Fulham,Burnley,0-1,0,1,1,1,1,-1,A
1961-02-22,1960,Tottenham Hotspur,Wolverhampton Wanderers,1-1,1,1,1,1,2,0,D
1961-02-25,1960,Arsenal,Leicester City,1-3,1,3,1,1,4,-2,A
1961-02-25,1960,Birmingham City,West Ham United,4-2,4,2,1,1,6,2,H
1961-02-25,1960,Burnley,Blackburn Rovers,1-1,1,1,1,1,2,0,D
1961-02-25,1960,Cardiff City,Wolverhampton Wanderers,3-2,3,2,1,1,5,1,H
1961-02-25,1960,Fulham,Blackpool,4-3,4,3,1,1,7,1,H
1961-02-25,1960,Manchester City,Tottenham Hotspur,0-1,0,1,1,1,1,-1,A
1961-02-25,1960,Newcastle United,Aston Villa,2-1,2,1,1,1,3,1,H
1961-02-25,1960,Nottingham Forest,Manchester United,3-2,3,2,1,1,5,1,H
1961-02-25,1960,Preston North End,Everton,1-0,1,0,1,1,1,1,H
1961-02-25,1960,Sheffield Wednesday,Chelsea,1-0,1,0,1,1,1,1,H
1961-02-25,1960,West Bromwich Albion,Bolton Wanderers,3-2,3,2,1,1,5,1,H
1961-03-04,1960,Aston Villa,Arsenal,2-2,2,2,1,1,4,0,D
1961-03-04,1960,Blackburn Rovers,Preston North End,1-0,1,0,1,1,1,1,H
1961-03-04,1960,Blackpool,Wolverhampton Wanderers,5-2,5,2,1,1,7,3,H
1961-03-04,1960,Bolton Wanderers,Cardiff City,3-0,3,0,1,1,3,3,H
1961-03-04,1960,Chelsea,Birmingham City,3-2,3,2,1,1,5,1,H
1961-03-04,1960,Everton,Fulham,1-0,1,0,1,1,1,1,H
1961-03-04,1960,Manchester City,Manchester United,1-3,1,3,1,1,4,-2,A
1961-03-04,1960,West Ham United,West Bromwich Albion,1-2,1,2,1,1,3,-1,A
1961-03-08,1960,Wolverhampton Wanderers,Newcastle United,2-1,2,1,1,1,3,1,H
1961-03-11,1960,Arsenal,Blackburn Rovers,0-0,0,0,1,1,0,0,D
1961-03-11,1960,Birmingham City,Aston Villa,1-1,1,1,1,1,2,0,D
1961-03-11,1960,Burnley,Chelsea,4-4,4,4,1,1,8,0,D
1961-03-11,1960,Cardiff City,Tottenham Hotspur,3-2,3,2,1,1,5,1,H
1961-03-11,1960,Fulham,Bolton Wanderers,2-2,2,2,1,1,4,0,D
1961-03-11,1960,Manchester City,Everton,2-1,2,1,1,1,3,1,H
1961-03-11,1960,Newcastle United,Manchester United,1-1,1,1,1,1,2,0,D
1961-03-11,1960,Nottingham Forest,Blackpool,0-0,0,0,1,1,0,0,D
1961-03-11,1960,Preston North End,West Ham United,4-0,4,0,1,1,4,4,H
1961-03-11,1960,Sheffield Wednesday,Wolverhampton Wanderers,0-0,0,0,1,1,0,0,D
1961-03-11,1960,West Bromwich Albion,Leicester City,1-0,1,0,1,1,1,1,H
1961-03-15,1960,Blackpool,Sheffield Wednesday,0-1,0,1,1,1,1,-1,A
1961-03-18,1960,Blackburn Rovers,Manchester City,4-1,4,1,1,1,5,3,H
1961-03-18,1960,Bolton Wanderers,Sheffield Wednesday,0-1,0,1,1,1,1,-1,A
1961-03-18,1960,Chelsea,Preston North End,1-1,1,1,1,1,2,0,D
1961-03-18,1960,Everton,Nottingham Forest,1-0,1,0,1,1,1,1,H
1961-03-18,1960,Manchester United,Arsenal,1-1,1,1,1,1,2,0,D
1961-03-18,1960,West Ham United,Fulham,1-2,1,2,1,1,3,-1,A
1961-03-18,1960,Wolverhampton Wanderers,Birmingham City,5-1,5,1,1,1,6,4,H
1961-03-20,1960,Blackburn Rovers,West Ham United,4-1,4,1,1,1,5,3,H
1961-03-21,1960,Blackpool,Burnley,0-0,0,0,1,1,0,0,D
1961-03-22,1960,Birmingham City,Manchester City,3-2,3,2,1,1,5,1,H
1961-03-22,1960,Everton,Aston Villa,1-2,1,2,1,1,3,-1,A
1961-03-22,1960,Tottenham Hotspur,Newcastle United,1-2,1,2,1,1,3,-1,A
1961-03-24,1960,Cardiff City,Blackpool,0-2,0,2,1,1,2,-2,A
1961-03-25,1960,Arsenal,West Ham United,0-0,0,0,1,1,0,0,D
1961-03-25,1960,Birmingham City,Blackburn Rovers,1-1,1,1,1,1,2,0,D
1961-03-25,1960,Burnley,Aston Villa,1-1,1,1,1,1,2,0,D
1961-03-25,1960,Fulham,Tottenham Hotspur,0-0,0,0,1,1,0,0,D
1961-03-25,1960,Manchester City,Bolton Wanderers,0-0,0,0,1,1,0,0,D
1961-03-25,1960,Newcastle United,Chelsea,1-6,1,6,1,1,7,-5,A
1961-03-25,1960,Nottingham Forest,Wolverhampton Wanderers,1-1,1,1,1,1,2,0,D
1961-03-25,1960,Preston North End,Leicester City,0-0,0,0,1,1,0,0,D
1961-03-25,1960,Sheffield Wednesday,Manchester United,5-1,5,1,1,1,6,4,H
1961-03-25,1960,West Bromwich Albion,Everton,3-0,3,0,1,1,3,3,H
1961-03-28,1960,Aston Villa,West Bromwich Albion,0-1,0,1,1,1,1,-1,A
1961-03-31,1960,Blackburn Rovers,Everton,1-3,1,3,1,1,4,-2,A
1961-03-31,1960,Blackpool,Manchester United,2-0,2,0,1,1,2,2,H
1961-03-31,1960,Burnley,Nottingham Forest,4-1,4,1,1,1,5,3,H
1961-03-31,1960,Cardiff City,Birmingham City,0-2,0,2,1,1,2,-2,A
1961-03-31,1960,Fulham,Arsenal,2-2,2,2,1,1,4,0,D
1961-03-31,1960,Manchester City,Preston North End,2-3,2,3,1,1,5,-1,A
1961-03-31,1960,Newcastle United,Sheffield Wednesday,0-1,0,1,1,1,1,-1,A
1961-03-31,1960,Tottenham Hotspur,Chelsea,4-2,4,2,1,1,6,2,H
1961-03-31,1960,West Ham United,Leicester City,1-0,1,0,1,1,1,1,H
1961-04-01,1960,Aston Villa,Nottingham Forest,1-2,1,2,1,1,3,-1,A
1961-04-01,1960,Blackburn Rovers,Sheffield Wednesday,1-1,1,1,1,1,2,0,D
1961-04-01,1960,Blackpool,West Bromwich Albion,0-1,0,1,1,1,1,-1,A
1961-04-01,1960,Bolton Wanderers,Arsenal,1-1,1,1,1,1,2,0,D
1961-04-01,1960,Chelsea,Cardiff City,6-1,6,1,1,1,7,5,H
1961-04-01,1960,Everton,Birmingham City,1-0,1,0,1,1,1,1,H
1961-04-01,1960,Leicester City,Burnley,2-2,2,2,1,1,4,0,D
1961-04-01,1960,Manchester United,Fulham,3-1,3,1,1,1,4,2,H
1961-04-01,1960,Tottenham Hotspur,Preston North End,5-0,5,0,1,1,5,5,H
1961-04-01,1960,West Ham United,Newcastle United,1-1,1,1,1,1,2,0,D
1961-04-01,1960,Wolverhampton Wanderers,Manchester City,1-0,1,0,1,1,1,1,H
1961-04-03,1960,Arsenal,Fulham,4-2,4,2,1,1,6,2,H
1961-04-03,1960,Birmingham City,Cardiff City,2-1,2,1,1,1,3,1,H
1961-04-03,1960,Bolton Wanderers,Aston Villa,3-0,3,0,1,1,3,3,H
1961-04-03,1960,Chelsea,Tottenham Hotspur,2-3,2,3,1,1,5,-1,A
1961-04-03,1960,Everton,Blackburn Rovers,2-2,2,2,1,1,4,0,D
1961-04-03,1960,Leicester City,West Ham United,5-1,5,1,1,1,6,4,H
1961-04-03,1960,Manchester United,Blackpool,2-0,2,0,1,1,2,2,H
1961-04-03,1960,Nottingham Forest,Burnley,3-1,3,1,1,1,4,2,H
1961-04-03,1960,Preston North End,Manchester City,1-1,1,1,1,1,2,0,D
1961-04-03,1960,Sheffield Wednesday,Newcastle United,1-1,1,1,1,1,2,0,D
1961-04-03,1960,West Bromwich Albion,Wolverhampton Wanderers,2-1,2,1,1,1,3,1,H
1961-04-04,1960,Aston Villa,Bolton Wanderers,4-0,4,0,1,1,4,4,H
1961-04-08,1960,Arsenal,Blackpool,1-0,1,0,1,1,1,1,H
1961-04-08,1960,Birmingham City,Tottenham Hotspur,2-3,2,3,1,1,5,-1,A
1961-04-08,1960,Burnley,Bolton Wanderers,2-0,2,0,1,1,2,2,H
1961-04-08,1960,Cardiff City,Blackburn Rovers,1-1,1,1,1,1,2,0,D
1961-04-08,1960,Fulham,Aston Villa,1-1,1,1,1,1,2,0,D
1961-04-08,1960,Manchester City,Chelsea,2-1,2,1,1,1,3,1,H
1961-04-08,1960,Newcastle United,Everton,0-4,0,4,1,1,4,-4,A
1961-04-08,1960,Nottingham Forest,West Ham United,1-1,1,1,1,1,2,0,D
1961-04-08,1960,Preston North End,Wolverhampton Wanderers,1-2,1,2,1,1,3,-1,A
1961-04-08,1960,Sheffield Wednesday,Leicester City,2-2,2,2,1,1,4,0,D
1961-04-08,1960,West Bromwich Albion,Manchester United,1-1,1,1,1,1,2,0,D
1961-04-10,1960,Leicester City,Cardiff City,3-0,3,0,1,1,3,3,H
1961-04-12,1960,Manchester United,Burnley,6-0,6,0,1,1,6,6,H
1961-04-15,1960,Aston Villa,Preston North End,1-0,1,0,1,1,1,1,H
1961-04-15,1960,Blackburn Rovers,West Bromwich Albion,2-1,2,1,1,1,3,1,H
1961-04-15,1960,Blackpool,Newcastle United,2-1,2,1,1,1,3,1,H
1961-04-15,1960,Bolton Wanderers,Nottingham Forest,3-1,3,1,1,1,4,2,H
1961-04-15,1960,Chelsea,Arsenal,3-1,3,1,1,1,4,2,H
1961-04-15,1960,Everton,Cardiff City,5-1,5,1,1,1,6,4,H
1961-04-15,1960,Leicester City,Fulham,1-2,1,2,1,1,3,-1,A
1961-04-15,1960,Manchester United,Birmingham City,4-1,4,1,1,1,5,3,H
1961-04-15,1960,West Ham United,Manchester City,1-1,1,1,1,1,2,0,D
1961-04-15,1960,Wolverhampton Wanderers,Burnley,2-1,2,1,1,1,3,1,H
1961-04-17,1960,Tottenham Hotspur,Sheffield Wednesday,2-1,2,1,1,1,3,1,H
1961-04-18,1960,Burnley,West Ham United,2-2,2,2,1,1,4,0,D
1961-04-18,1960,Preston North End,Bolton Wanderers,0-0,0,0,1,1,0,0,D
1961-04-19,1960,Leicester City,Aston Villa,3-1,3,1,1,1,4,2,H
1961-04-19,1960,Manchester City,Blackpool,1-1,1,1,1,1,2,0,D
1961-04-22,1960,Arsenal,Wolverhampton Wanderers,1-5,1,5,1,1,6,-4,A
1961-04-22,1960,Birmingham City,Blackpool,0-2,0,2,1,1,2,-2,A
1961-04-22,1960,Burnley,Tottenham Hotspur,4-2,4,2,1,1,6,2,H
1961-04-22,1960,Cardiff City,West Ham United,1-1,1,1,1,1,2,0,D
1961-04-22,1960,Fulham,Blackburn Rovers,1-1,1,1,1,1,2,0,D
1961-04-22,1960,Manchester City,Aston Villa,4-1,4,1,1,1,5,3,H
1961-04-22,1960,Newcastle United,Bolton Wanderers,4-1,4,1,1,1,5,3,H
1961-04-22,1960,Nottingham Forest,Leicester City,2-2,2,2,1,1,4,0,D
1961-04-22,1960,Preston North End,Manchester United,2-4,2,4,1,1,6,-2,A
1961-04-22,1960,Sheffield Wednesday,Everton,1-2,1,2,1,1,3,-1,A
1961-04-22,1960,West Bromwich Albion,Chelsea,3-0,3,0,1,1,3,3,H
1961-04-26,1960,Chelsea,Sheffield Wednesday,0-2,0,2,1,1,2,-2,A
1961-04-26,1960,Leicester City,Manchester City,1-2,1,2,1,1,3,-1,A
1961-04-26,1960,Tottenham Hotspur,Nottingham Forest,1-0,1,0,1,1,1,1,H
1961-04-27,1960,Birmingham City,Burnley,0-1,0,1,1,1,1,-1,A
1961-04-29,1960,Aston Villa,Sheffield Wednesday,4-1,4,1,1,1,5,3,H
1961-04-29,1960,Blackburn Rovers,Newcastle United,2-4,2,4,1,1,6,-2,A
1961-04-29,1960,Blackpool,Manchester City,3-3,3,3,1,1,6,0,D
1961-04-29,1960,Bolton Wanderers,Preston North End,1-1,1,1,1,1,2,0,D
1961-04-29,1960,Chelsea,Nottingham Forest,4-3,4,3,1,1,7,1,H
1961-04-29,1960,Everton,Arsenal,4-1,4,1,1,1,5,3,H
1961-04-29,1960,Leicester City,Birmingham City,3-2,3,2,1,1,5,1,H
1961-04-29,1960,Manchester United,Cardiff City,3-3,3,3,1,1,6,0,D
1961-04-29,1960,Tottenham Hotspur,West Bromwich Albion,1-2,1,2,1,1,3,-1,A
1961-04-29,1960,West Ham United,Burnley,1-2,1,2,1,1,3,-1,A
1961-04-29,1960,Wolverhampton Wanderers,Fulham,2-4,2,4,1,1,6,-2,A
1961-08-19,1961,Arsenal,Burnley,2-2,2,2,1,1,4,0,D
1961-08-19,1961,Birmingham City,Fulham,2-1,2,1,1,1,3,1,H
1961-08-19,1961,Blackburn Rovers,Cardiff City,0-0,0,0,1,1,0,0,D
1961-08-19,1961,Blackpool,Tottenham Hotspur,1-2,1,2,1,1,3,-1,A
1961-08-19,1961,Bolton Wanderers,Ipswich Town,0-0,0,0,1,1,0,0,D
1961-08-19,1961,Chelsea,Nottingham Forest,2-2,2,2,1,1,4,0,D
1961-08-19,1961,Everton,Aston Villa,2-0,2,0,1,1,2,2,H
1961-08-19,1961,Manchester City,Leicester City,3-1,3,1,1,1,4,2,H
1961-08-19,1961,Sheffield United,Wolverhampton Wanderers,2-1,2,1,1,1,3,1,H
1961-08-19,1961,West Bromwich Albion,Sheffield Wednesday,0-2,0,2,1,1,2,-2,A
1961-08-19,1961,West Ham United,Manchester United,1-1,1,1,1,1,2,0,D
1961-08-21,1961,Blackpool,Blackburn Rovers,2-1,2,1,1,1,3,1,H
1961-08-22,1961,Burnley,Ipswich Town,4-3,4,3,1,1,7,1,H
1961-08-22,1961,Nottingham Forest,Birmingham City,2-1,2,1,1,1,3,1,H
1961-08-23,1961,Cardiff City,Sheffield United,1-1,1,1,1,1,2,0,D
1961-08-23,1961,Fulham,Manchester City,3-4,3,4,1,1,7,-1,A
1961-08-23,1961,Leicester City,Arsenal,0-1,0,1,1,1,1,-1,A
1961-08-23,1961,Manchester United,Chelsea,3-2,3,2,1,1,5,1,H
1961-08-23,1961,Sheffield Wednesday,Bolton Wanderers,4-2,4,2,1,1,6,2,H
1961-08-23,1961,Tottenham Hotspur,West Ham United,2-2,2,2,1,1,4,0,D
1961-08-23,1961,West Bromwich Albion,Everton,2-0,2,0,1,1,2,2,H
1961-08-26,1961,Aston Villa,Chelsea,3-1,3,1,1,1,4,2,H
1961-08-26,1961,Burnley,Bolton Wanderers,3-1,3,1,1,1,4,2,H
1961-08-26,1961,Cardiff City,Blackpool,3-2,3,2,1,1,5,1,H
1961-08-26,1961,Fulham,Everton,2-1,2,1,1,1,3,1,H
1961-08-26,1961,Ipswich Town,Manchester City,2-4,2,4,1,1,6,-2,A
1961-08-26,1961,Leicester City,West Bromwich Albion,1-0,1,0,1,1,1,1,H
1961-08-26,1961,Manchester United,Blackburn Rovers,6-1,6,1,1,1,7,5,H
1961-08-26,1961,Nottingham Forest,Sheffield United,2-0,2,0,1,1,2,2,H
1961-08-26,1961,Sheffield Wednesday,Birmingham City,5-1,5,1,1,1,6,4,H
1961-08-26,1961,Tottenham Hotspur,Arsenal,4-3,4,3,1,1,7,1,H
1961-08-26,1961,Wolverhampton Wanderers,West Ham United,3-2,3,2,1,1,5,1,H
1961-08-28,1961,Blackburn Rovers,Blackpool,1-1,1,1,1,1,2,0,D
1961-08-28,1961,Sheffield United,Cardiff City,1-0,1,0,1,1,1,1,H
1961-08-28,1961,West Ham United,Tottenham Hotspur,2-1,2,1,1,1,3,1,H
1961-08-28,1961,Wolverhampton Wanderers,Aston Villa,2-2,2,2,1,1,4,0,D
1961-08-29,1961,Arsenal,Leicester City,4-4,4,4,1,1,8,0,D
1961-08-29,1961,Ipswich Town,Burnley,6-2,6,2,1,1,8,4,H
1961-08-30,1961,Birmingham City,Nottingham Forest,1-1,1,1,1,1,2,0,D
1961-08-30,1961,Bolton Wanderers,Sheffield Wednesday,4-3,4,3,1,1,7,1,H
1961-08-30,1961,Chelsea,Manchester United,2-0,2,0,1,1,2,2,H
1961-08-30,1961,Everton,West Bromwich Albion,3-1,3,1,1,1,4,2,H
1961-08-30,1961,Manchester City,Fulham,2-1,2,1,1,1,3,1,H
1961-09-02,1961,Birmingham City,Leicester City,1-5,1,5,1,1,6,-4,A
1961-09-02,1961,Blackburn Rovers,Wolverhampton Wanderers,2-1,2,1,1,1,3,1,H
1961-09-02,1961,Blackpool,Manchester United,2-3,2,3,1,1,5,-1,A
1961-09-02,1961,Bolton Wanderers,Arsenal,2-1,2,1,1,1,3,1,H
1961-09-02,1961,Chelsea,Fulham,0-0,0,0,1,1,0,0,D
1961-09-02,1961,Everton,Sheffield Wednesday,0-4,0,4,1,1,4,-4,A
1961-09-02,1961,Manchester City,Burnley,1-3,1,3,1,1,4,-2,A
1961-09-02,1961,Sheffield United,Aston Villa,0-2,0,2,1,1,2,-2,A
1961-09-02,1961,Tottenham Hotspur,Cardiff City,3-2,3,2,1,1,5,1,H
1961-09-02,1961,West Bromwich Albion,Ipswich Town,1-3,1,3,1,1,4,-2,A
1961-09-02,1961,West Ham United,Nottingham Forest,3-2,3,2,1,1,5,1,H
1961-09-04,1961,Blackpool,West Ham United,2-0,2,0,1,1,2,2,H
1961-09-04,1961,Sheffield United,Tottenham Hotspur,1-1,1,1,1,1,2,0,D
1961-09-05,1961,Burnley,Leicester City,2-0,2,0,1,1,2,2,H
1961-09-05,1961,Ipswich Town,Blackburn Rovers,2-1,2,1,1,1,3,1,H
1961-09-06,1961,Cardiff City,Chelsea,5-2,5,2,1,1,7,3,H
1961-09-06,1961,Everton,Manchester City,0-2,0,2,1,1,2,-2,A
1961-09-06,1961,Fulham,Bolton Wanderers,2-2,2,2,1,1,4,0,D
1961-09-06,1961,West Bromwich Albion,Birmingham City,0-0,0,0,1,1,0,0,D
1961-09-09,1961,Arsenal,Manchester City,3-0,3,0,1,1,3,3,H
1961-09-09,1961,Aston Villa,West Ham United,2-4,2,4,1,1,6,-2,A
1961-09-09,1961,Burnley,West Bromwich Albion,3-1,3,1,1,1,4,2,H
1961-09-09,1961,Cardiff City,Bolton Wanderers,1-2,1,2,1,1,3,-1,A
1961-09-09,1961,Chelsea,Sheffield United,6-1,6,1,1,1,7,5,H
1961-09-09,1961,Ipswich Town,Birmingham City,4-1,4,1,1,1,5,3,H
1961-09-09,1961,Leicester City,Everton,2-0,2,0,1,1,2,2,H
1961-09-09,1961,Manchester United,Tottenham Hotspur,1-0,1,0,1,1,1,1,H
1961-09-09,1961,Nottingham Forest,Blackburn Rovers,1-2,1,2,1,1,3,-1,A
1961-09-09,1961,Sheffield Wednesday,Fulham,1-1,1,1,1,1,2,0,D
1961-09-09,1961,Wolverhampton Wanderers,Blackpool,2-2,2,2,1,1,4,0,D
1961-09-16,1961,Birmingham City,Burnley,2-6,2,6,1,1,8,-4,A
1961-09-16,1961,Blackburn Rovers,Aston Villa,4-2,4,2,1,1,6,2,H
1961-09-16,1961,Blackpool,Nottingham Forest,1-3,1,3,1,1,4,-2,A
1961-09-16,1961,Cardiff City,Manchester United,1-2,1,2,1,1,3,-1,A
1961-09-16,1961,Everton,Ipswich Town,5-2,5,2,1,1,7,3,H
1961-09-16,1961,Fulham,Leicester City,2-1,2,1,1,1,3,1,H
1961-09-16,1961,Manchester City,Bolton Wanderers,2-1,2,1,1,1,3,1,H
1961-09-16,1961,Sheffield United,Sheffield Wednesday,1-0,1,0,1,1,1,1,H
1961-09-16,1961,Tottenham Hotspur,Wolverhampton Wanderers,1-0,1,0,1,1,1,1,H
1961-09-16,1961,West Bromwich Albion,Arsenal,4-0,4,0,1,1,4,4,H
1961-09-16,1961,West Ham United,Chelsea,2-1,2,1,1,1,3,1,H
1961-09-18,1961,Aston Villa,Manchester United,1-1,1,1,1,1,2,0,D
1961-09-18,1961,Blackburn Rovers,Ipswich Town,2-2,2,2,1,1,4,0,D
1961-09-18,1961,West Ham United,Blackpool,2-2,2,2,1,1,4,0,D
1961-09-19,1961,Nottingham Forest,Wolverhampton Wanderers,3-1,3,1,1,1,4,2,H
1961-09-20,1961,Birmingham City,West Bromwich Albion,1-2,1,2,1,1,3,-1,A
1961-09-20,1961,Bolton Wanderers,Fulham,2-3,2,3,1,1,5,-1,A
1961-09-20,1961,Chelsea,Cardiff City,2-3,2,3,1,1,5,-1,A
1961-09-20,1961,Leicester City,Burnley,2-6,2,6,1,1,8,-4,A
1961-09-20,1961,Manchester City,Everton,1-3,1,3,1,1,4,-2,A
1961-09-20,1961,Sheffield Wednesday,Arsenal,1-1,1,1,1,1,2,0,D
1961-09-23,1961,Arsenal,Birmingham City,1-1,1,1,1,1,2,0,D
1961-09-23,1961,Aston Villa,Blackpool,5-0,5,0,1,1,5,5,H
1961-09-23,1961,Bolton Wanderers,West Bromwich Albion,3-2,3,2,1,1,5,1,H
1961-09-23,1961,Burnley,Everton,2-1,2,1,1,1,3,1,H
1961-09-23,1961,Chelsea,Blackburn Rovers,1-1,1,1,1,1,2,0,D
1961-09-23,1961,Ipswich Town,Fulham,2-4,2,4,1,1,6,-2,A
1961-09-23,1961,Leicester City,Sheffield Wednesday,1-0,1,0,1,1,1,1,H
1961-09-23,1961,Manchester United,Manchester City,3-2,3,2,1,1,5,1,H
1961-09-23,1961,Nottingham Forest,Tottenham Hotspur,2-0,2,0,1,1,2,2,H
1961-09-23,1961,Sheffield United,West Ham United,1-4,1,4,1,1,5,-3,A
1961-09-23,1961,Wolverhampton Wanderers,Cardiff City,1-1,1,1,1,1,2,0,D
1961-09-27,1961,Wolverhampton Wanderers,Nottingham Forest,2-1,2,1,1,1,3,1,H
1961-09-30,1961,Birmingham City,Bolton Wanderers,2-1,2,1,1,1,3,1,H
1961-09-30,1961,Blackburn Rovers,Sheffield United,1-2,1,2,1,1,3,-1,A
1961-09-30,1961,Blackpool,Chelsea,4-0,4,0,1,1,4,4,H
1961-09-30,1961,Cardiff City,Nottingham Forest,2-2,2,2,1,1,4,0,D
1961-09-30,1961,Everton,Arsenal,4-1,4,1,1,1,5,3,H
1961-09-30,1961,Fulham,Burnley,3-5,3,5,1,1,8,-2,A
1961-09-30,1961,Manchester United,Wolverhampton Wanderers,0-2,0,2,1,1,2,-2,A
1961-09-30,1961,Sheffield Wednesday,Ipswich Town,1-4,1,4,1,1,5,-3,A
1961-09-30,1961,Tottenham Hotspur,Aston Villa,1-0,1,0,1,1,1,1,H
1961-09-30,1961,West Bromwich Albion,Manchester City,2-2,2,2,1,1,4,0,D
1961-09-30,1961,West Ham United,Leicester City,4-1,4,1,1,1,5,3,H
1961-10-02,1961,Aston Villa,Wolverhampton Wanderers,1-0,1,0,1,1,1,1,H
1961-10-07,1961,Arsenal,Blackpool,3-0,3,0,1,1,3,3,H
1961-10-07,1961,Birmingham City,Wolverhampton Wanderers,3-6,3,6,1,1,9,-3,A
1961-10-07,1961,Everton,Nottingham Forest,6-0,6,0,1,1,6,6,H
1961-10-07,1961,Fulham,Aston Villa,3-1,3,1,1,1,4,2,H
1961-10-07,1961,Ipswich Town,West Ham United,4-2,4,2,1,1,6,2,H
1961-10-07,1961,Leicester City,Sheffield United,4-1,4,1,1,1,5,3,H
1961-10-07,1961,Manchester City,Cardiff City,1-2,1,2,1,1,3,-1,A
1961-10-07,1961,Sheffield Wednesday,Chelsea,5-3,5,3,1,1,8,2,H
1961-10-07,1961,West Bromwich Albion,Manchester United,1-1,1,1,1,1,2,0,D
1961-10-09,1961,Bolton Wanderers,Tottenham Hotspur,1-2,1,2,1,1,3,-1,A
1961-10-14,1961,Blackburn Rovers,Arsenal,0-0,0,0,1,1,0,0,D
1961-10-14,1961,Blackpool,Bolton Wanderers,2-1,2,1,1,1,3,1,H
1961-10-14,1961,Chelsea,Leicester City,1-3,1,3,1,1,4,-2,A
1961-10-14,1961,Manchester United,Birmingham City,0-2,0,2,1,1,2,-2,A
1961-10-14,1961,Nottingham Forest,Fulham,1-1,1,1,1,1,2,0,D
1961-10-14,1961,Sheffield United,Ipswich Town,2-1,2,1,1,1,3,1,H
1961-10-14,1961,Tottenham Hotspur,Manchester City,2-0,2,0,1,1,2,2,H
1961-10-14,1961,West Ham United,Burnley,2-1,2,1,1,1,3,1,H
1961-10-14,1961,Wolverhampton Wanderers,Everton,0-3,0,3,1,1,3,-3,A
1961-10-16,1961,Aston Villa,Sheffield Wednesday,1-0,1,0,1,1,1,1,H
1961-10-18,1961,Cardiff City,West Bromwich Albion,2-2,2,2,1,1,4,0,D
1961-10-21,1961,Arsenal,Manchester United,5-1,5,1,1,1,6,4,H
1961-10-21,1961,Birmingham City,Chelsea,3-2,3,2,1,1,5,1,H
1961-10-21,1961,Bolton Wanderers,Wolverhampton Wanderers,1-0,1,0,1,1,1,1,H
1961-10-21,1961,Burnley,Cardiff City,2-1,2,1,1,1,3,1,H
1961-10-21,1961,Everton,Sheffield United,1-0,1,0,1,1,1,1,H
1961-10-21,1961,Fulham,West Ham United,2-0,2,0,1,1,2,2,H
1961-10-21,1961,Ipswich Town,Tottenham Hotspur,3-2,3,2,1,1,5,1,H
1961-10-21,1961,Leicester City,Blackpool,0-2,0,2,1,1,2,-2,A
1961-10-21,1961,Manchester City,Nottingham Forest,3-0,3,0,1,1,3,3,H
1961-10-21,1961,Sheffield Wednesday,Blackburn Rovers,1-0,1,0,1,1,1,1,H
1961-10-21,1961,West Bromwich Albion,Aston Villa,1-1,1,1,1,1,2,0,D
1961-10-28,1961,Aston Villa,Birmingham City,1-3,1,3,1,1,4,-2,A
1961-10-28,1961,Blackburn Rovers,Leicester City,2-1,2,1,1,1,3,1,H
1961-10-28,1961,Blackpool,Ipswich Town,1-1,1,1,1,1,2,0,D
1961-10-28,1961,Cardiff City,Arsenal,1-1,1,1,1,1,2,0,D
1961-10-28,1961,Chelsea,Everton,1-1,1,1,1,1,2,0,D
1961-10-28,1961,Manchester United,Bolton Wanderers,0-3,0,3,1,1,3,-3,A
1961-10-28,1961,Nottingham Forest,West Bromwich Albion,4-4,4,4,1,1,8,0,D
1961-10-28,1961,Sheffield United,Fulham,2-2,2,2,1,1,4,0,D
1961-10-28,1961,Tottenham Hotspur,Burnley,4-2,4,2,1,1,6,2,H
1961-10-28,1961,West Ham United,Sheffield Wednesday,2-3,2,3,1,1,5,-1,A
1961-10-28,1961,Wolverhampton Wanderers,Manchester City,4-1,4,1,1,1,5,3,H
1961-11-04,1961,Arsenal,Chelsea,0-3,0,3,1,1,3,-3,A
1961-11-04,1961,Birmingham City,Blackpool,1-1,1,1,1,1,2,0,D
1961-11-04,1961,Bolton Wanderers,Sheffield United,2-0,2,0,1,1,2,2,H
1961-11-04,1961,Burnley,Aston Villa,3-0,3,0,1,1,3,3,H
1961-11-04,1961,Everton,Tottenham Hotspur,3-0,3,0,1,1,3,3,H
1961-11-04,1961,Fulham,Cardiff City,0-1,0,1,1,1,1,-1,A
1961-11-04,1961,Ipswich Town,Nottingham Forest,1-0,1,0,1,1,1,1,H
1961-11-04,1961,Leicester City,Wolverhampton Wanderers,3-0,3,0,1,1,3,3,H
1961-11-04,1961,Manchester City,West Ham United,3-5,3,5,1,1,8,-2,A
1961-11-04,1961,Sheffield Wednesday,Manchester United,3-1,3,1,1,1,4,2,H
1961-11-04,1961,West Bromwich Albion,Blackburn Rovers,4-0,4,0,1,1,4,4,H
1961-11-11,1961,Aston Villa,Arsenal,3-1,3,1,1,1,4,2,H
1961-11-11,1961,Blackburn Rovers,Birmingham City,2-0,2,0,1,1,2,2,H
1961-11-11,1961,Blackpool,Everton,1-1,1,1,1,1,2,0,D
1961-11-11,1961,Cardiff City,Sheffield Wednesday,2-1,2,1,1,1,3,1,H
1961-11-11,1961,Chelsea,Bolton Wanderers,1-0,1,0,1,1,1,1,H
1961-11-11,1961,Manchester United,Leicester City,2-2,2,2,1,1,4,0,D
1961-11-11,1961,Nottingham Forest,Burnley,3-2,3,2,1,1,5,1,H
1961-11-11,1961,Sheffield United,Manchester City,3-1,3,1,1,1,4,2,H
1961-11-11,1961,Tottenham Hotspur,Fulham,4-2,4,2,1,1,6,2,H
1961-11-11,1961,West Ham United,West Bromwich Albion,3-3,3,3,1,1,6,0,D
1961-11-11,1961,Wolverhampton Wanderers,Ipswich Town,2-0,2,0,1,1,2,2,H
1961-11-14,1961,Arsenal,Sheffield Wednesday,1-0,1,0,1,1,1,1,H
1961-11-18,1961,Arsenal,Nottingham Forest,2-1,2,1,1,1,3,1,H
1961-11-18,1961,Birmingham City,West Ham United,4-0,4,0,1,1,4,4,H
1961-11-18,1961,Bolton Wanderers,Aston Villa,1-1,1,1,1,1,2,0,D
1961-11-18,1961,Burnley,Wolverhampton Wanderers,3-3,3,3,1,1,6,0,D
1961-11-18,1961,Everton,Blackburn Rovers,1-0,1,0,1,1,1,1,H
1961-11-18,1961,Fulham,Blackpool,0-1,0,1,1,1,1,-1,A
1961-11-18,1961,Ipswich Town,Manchester United,4-1,4,1,1,1,5,3,H
1961-11-18,1961,Leicester City,Cardiff City,3-0,3,0,1,1,3,3,H
1961-11-18,1961,Manchester City,Chelsea,2-2,2,2,1,1,4,0,D
1961-11-18,1961,Sheffield Wednesday,Tottenham Hotspur,0-0,0,0,1,1,0,0,D
1961-11-18,1961,West Bromwich Albion,Sheffield United,3-1,3,1,1,1,4,2,H
1961-11-25,1961,Aston Villa,Manchester City,2-1,2,1,1,1,3,1,H
1961-11-25,1961,Blackburn Rovers,Fulham,0-2,0,2,1,1,2,-2,A
1961-11-25,1961,Blackpool,Sheffield Wednesday,1-3,1,3,1,1,4,-2,A
1961-11-25,1961,Cardiff City,Ipswich Town,0-3,0,3,1,1,3,-3,A
1961-11-25,1961,Chelsea,West Bromwich Albion,4-1,4,1,1,1,5,3,H
1961-11-25,1961,Manchester United,Burnley,1-4,1,4,1,1,5,-3,A
1961-11-25,1961,Nottingham Forest,Bolton Wanderers,0-1,0,1,1,1,1,-1,A
1961-11-25,1961,Sheffield United,Birmingham City,3-1,3,1,1,1,4,2,H
1961-11-25,1961,Tottenham Hotspur,Leicester City,1-2,1,2,1,1,3,-1,A
1961-11-25,1961,West Ham United,Everton,3-1,3,1,1,1,4,2,H
1961-11-25,1961,Wolverhampton Wanderers,Arsenal,2-3,2,3,1,1,5,-1,A
1961-12-02,1961,Arsenal,West Ham United,2-2,2,2,1,1,4,0,D
1961-12-02,1961,Birmingham City,Cardiff City,3-0,3,0,1,1,3,3,H
1961-12-02,1961,Bolton Wanderers,Blackburn Rovers,1-1,1,1,1,1,2,0,D
1961-12-02,1961,Burnley,Sheffield United,4-2,4,2,1,1,6,2,H
1961-12-02,1961,Everton,Manchester United,5-1,5,1,1,1,6,4,H
1961-12-02,1961,Fulham,Wolverhampton Wanderers,0-1,0,1,1,1,1,-1,A
1961-12-02,1961,Ipswich Town,Chelsea,5-2,5,2,1,1,7,3,H
1961-12-02,1961,Leicester City,Aston Villa,0-2,0,2,1,1,2,-2,A
1961-12-02,1961,Manchester City,Blackpool,2-4,2,4,1,1,6,-2,A
1961-12-02,1961,Sheffield Wednesday,Nottingham Forest,3-0,3,0,1,1,3,3,H
1961-12-02,1961,West Bromwich Albion,Tottenham Hotspur,2-4,2,4,1,1,6,-2,A
1961-12-09,1961,Aston Villa,Ipswich Town,3-0,3,0,1,1,3,3,H
1961-12-09,1961,Blackburn Rovers,Manchester City,4-1,4,1,1,1,5,3,H
1961-12-09,1961,Blackpool,West Bromwich Albion,2-2,2,2,1,1,4,0,D
1961-12-09,1961,Cardiff City,Everton,0-0,0,0,1,1,0,0,D
1961-12-09,1961,Chelsea,Burnley,1-2,1,2,1,1,3,-1,A
1961-12-09,1961,Manchester United,Fulham,3-0,3,0,1,1,3,3,H
1961-12-09,1961,Nottingham Forest,Leicester City,0-0,0,0,1,1,0,0,D
1961-12-09,1961,Sheffield United,Arsenal,2-1,2,1,1,1,3,1,H
1961-12-09,1961,Tottenham Hotspur,Birmingham City,3-1,3,1,1,1,4,2,H
1961-12-09,1961,West Ham United,Bolton Wanderers,1-0,1,0,1,1,1,1,H
1961-12-09,1961,Wolverhampton Wanderers,Sheffield Wednesday,3-0,3,0,1,1,3,3,H
1961-12-16,1961,Aston Villa,Everton,1-1,1,1,1,1,2,0,D
1961-12-16,1961,Burnley,Arsenal,0-2,0,2,1,1,2,-2,A
1961-12-16,1961,Cardiff City,Blackburn Rovers,1-1,1,1,1,1,2,0,D
1961-12-16,1961,Fulham,Birmingham City,0-1,0,1,1,1,1,-1,A
1961-12-16,1961,Ipswich Town,Bolton Wanderers,2-1,2,1,1,1,3,1,H
1961-12-16,1961,Leicester City,Manchester City,2-0,2,0,1,1,2,2,H
1961-12-16,1961,Manchester United,West Ham United,1-2,1,2,1,1,3,-1,A
1961-12-16,1961,Nottingham Forest,Chelsea,3-0,3,0,1,1,3,3,H
1961-12-16,1961,Sheffield Wednesday,West Bromwich Albion,2-1,2,1,1,1,3,1,H
1961-12-16,1961,Tottenham Hotspur,Blackpool,5-2,5,2,1,1,7,3,H
1961-12-16,1961,Wolverhampton Wanderers,Sheffield United,0-1,0,1,1,1,1,-1,A
1961-12-18,1961,West Ham United,Wolverhampton Wanderers,4-2,4,2,1,1,6,2,H
1961-12-22,1961,Sheffield United,Nottingham Forest,2-0,2,0,1,1,2,2,H
1961-12-23,1961,Arsenal,Tottenham Hotspur,2-1,2,1,1,1,3,1,H
1961-12-23,1961,Birmingham City,Sheffield Wednesday,1-1,1,1,1,1,2,0,D
1961-12-23,1961,Blackpool,Cardiff City,3-0,3,0,1,1,3,3,H
1961-12-23,1961,Chelsea,Aston Villa,1-0,1,0,1,1,1,1,H
1961-12-23,1961,Everton,Fulham,3-0,3,0,1,1,3,3,H
1961-12-23,1961,Manchester City,Ipswich Town,3-0,3,0,1,1,3,3,H
1961-12-23,1961,West Bromwich Albion,Leicester City,2-0,2,0,1,1,2,2,H
1961-12-26,1961,Arsenal,Fulham,1-0,1,0,1,1,1,1,H
1961-12-26,1961,Birmingham City,Manchester City,1-1,1,1,1,1,2,0,D
1961-12-26,1961,Burnley,Sheffield Wednesday,4-0,4,0,1,1,4,4,H
1961-12-26,1961,Cardiff City,Aston Villa,1-0,1,0,1,1,1,1,H
1961-12-26,1961,Chelsea,Tottenham Hotspur,0-2,0,2,1,1,2,-2,A
1961-12-26,1961,Everton,Bolton Wanderers,1-0,1,0,1,1,1,1,H
1961-12-26,1961,Ipswich Town,Leicester City,1-0,1,0,1,1,1,1,H
1961-12-26,1961,Manchester United,Nottingham Forest,6-3,6,3,1,1,9,3,H
1961-12-26,1961,Sheffield United,Blackpool,2-1,2,1,1,1,3,1,H
1961-12-26,1961,West Bromwich Albion,Wolverhampton Wanderers,1-1,1,1,1,1,2,0,D
1961-12-26,1961,West Ham United,Blackburn Rovers,2-3,2,3,1,1,5,-1,A
1961-12-30,1961,Tottenham Hotspur,Chelsea,5-2,5,2,1,1,7,3,H
1962-01-13,1961,Arsenal,Bolton Wanderers,1-2,1,2,1,1,3,-1,A
1962-01-13,1961,Aston Villa,Sheffield United,0-0,0,0,1,1,0,0,D
1962-01-13,1961,Burnley,Manchester City,6-3,6,3,1,1,9,3,H
1962-01-13,1961,Cardiff City,Tottenham Hotspur,1-1,1,1,1,1,2,0,D
1962-01-13,1961,Fulham,Chelsea,3-4,3,4,1,1,7,-1,A
1962-01-13,1961,Ipswich Town,West Bromwich Albion,3-0,3,0,1,1,3,3,H
1962-01-13,1961,Leicester City,Birmingham City,1-2,1,2,1,1,3,-1,A
1962-01-13,1961,Manchester United,Blackpool,0-1,0,1,1,1,1,-1,A
1962-01-13,1961,Nottingham Forest,West Ham United,3-0,3,0,1,1,3,3,H
1962-01-13,1961,Sheffield Wednesday,Everton,3-1,3,1,1,1,4,2,H
1962-01-13,1961,Wolverhampton Wanderers,Blackburn Rovers,0-2,0,2,1,1,2,-2,A
1962-01-15,1961,Manchester United,Aston Villa,2-0,2,0,1,1,2,2,H
1962-01-20,1961,Birmingham City,Ipswich Town,3-1,3,1,1,1,4,2,H
1962-01-20,1961,Blackburn Rovers,Nottingham Forest,2-1,2,1,1,1,3,1,H
1962-01-20,1961,Blackpool,Wolverhampton Wanderers,7-2,7,2,1,1,9,5,H
1962-01-20,1961,Bolton Wanderers,Cardiff City,1-1,1,1,1,1,2,0,D
1962-01-20,1961,Everton,Leicester City,3-2,3,2,1,1,5,1,H
1962-01-20,1961,Fulham,Sheffield Wednesday,0-2,0,2,1,1,2,-2,A
1962-01-20,1961,Manchester City,Arsenal,3-2,3,2,1,1,5,1,H
1962-01-20,1961,Sheffield United,Chelsea,3-1,3,1,1,1,4,2,H
1962-01-20,1961,Tottenham Hotspur,Manchester United,2-2,2,2,1,1,4,0,D
1962-01-20,1961,West Bromwich Albion,Burnley,1-1,1,1,1,1,2,0,D
1962-01-20,1961,West Ham United,Aston Villa,2-0,2,0,1,1,2,2,H
1962-02-03,1961,Arsenal,West Bromwich Albion,0-1,0,1,1,1,1,-1,A
1962-02-03,1961,Aston Villa,Blackburn Rovers,1-0,1,0,1,1,1,1,H
1962-02-03,1961,Bolton Wanderers,Manchester City,0-2,0,2,1,1,2,-2,A
1962-02-03,1961,Burnley,Birmingham City,7-1,7,1,1,1,8,6,H
1962-02-03,1961,Chelsea,West Ham United,0-1,0,1,1,1,1,-1,A
1962-02-03,1961,Ipswich Town,Everton,4-2,4,2,1,1,6,2,H
1962-02-03,1961,Leicester City,Fulham,4-1,4,1,1,1,5,3,H
1962-02-03,1961,Manchester United,Cardiff City,3-0,3,0,1,1,3,3,H
1962-02-03,1961,Nottingham Forest,Blackpool,3-4,3,4,1,1,7,-1,A
1962-02-03,1961,Sheffield Wednesday,Sheffield United,1-2,1,2,1,1,3,-1,A
1962-02-03,1961,Wolverhampton Wanderers,Tottenham Hotspur,3-1,3,1,1,1,4,2,H
1962-02-09,1961,Cardiff City,Wolverhampton Wanderers,2-3,2,3,1,1,5,-1,A
1962-02-10,1961,Birmingham City,Arsenal,1-0,1,0,1,1,1,1,H
1962-02-10,1961,Blackburn Rovers,Chelsea,3-0,3,0,1,1,3,3,H
1962-02-10,1961,Blackpool,Aston Villa,1-2,1,2,1,1,3,-1,A
1962-02-10,1961,Everton,Burnley,2-2,2,2,1,1,4,0,D
1962-02-10,1961,Fulham,Ipswich Town,1-2,1,2,1,1,3,-1,A
1962-02-10,1961,Manchester City,Manchester United,0-2,0,2,1,1,2,-2,A
1962-02-10,1961,Sheffield Wednesday,Leicester City,1-2,1,2,1,1,3,-1,A
1962-02-10,1961,Tottenham Hotspur,Nottingham Forest,4-2,4,2,1,1,6,2,H
1962-02-10,1961,West Bromwich Albion,Bolton Wanderers,6-2,6,2,1,1,8,4,H
1962-02-10,1961,West Ham United,Sheffield United,1-2,1,2,1,1,3,-1,A
1962-02-16,1961,Chelsea,Blackpool,1-0,1,0,1,1,1,1,H
1962-02-17,1961,Bolton Wanderers,Birmingham City,3-2,3,2,1,1,5,1,H
1962-02-17,1961,Leicester City,West Ham United,2-2,2,2,1,1,4,0,D
1962-02-17,1961,Nottingham Forest,Cardiff City,2-1,2,1,1,1,3,1,H
1962-02-20,1961,Burnley,Fulham,2-1,2,1,1,1,3,1,H
1962-02-20,1961,Sheffield United,Blackburn Rovers,0-0,0,0,1,1,0,0,D
1962-02-21,1961,Aston Villa,Tottenham Hotspur,0-0,0,0,1,1,0,0,D
1962-02-21,1961,Manchester City,West Bromwich Albion,3-1,3,1,1,1,4,2,H
1962-02-24,1961,Aston Villa,Fulham,2-0,2,0,1,1,2,2,H
1962-02-24,1961,Blackburn Rovers,Burnley,2-1,2,1,1,1,3,1,H
1962-02-24,1961,Blackpool,Arsenal,0-1,0,1,1,1,1,-1,A
1962-02-24,1961,Cardiff City,Manchester City,0-0,0,0,1,1,0,0,D
1962-02-24,1961,Chelsea,Sheffield Wednesday,1-0,1,0,1,1,1,1,H
1962-02-24,1961,Manchester United,West Bromwich Albion,4-1,4,1,1,1,5,3,H
1962-02-24,1961,Nottingham Forest,Everton,2-1,2,1,1,1,3,1,H
1962-02-24,1961,Sheffield United,Leicester City,3-1,3,1,1,1,4,2,H
1962-02-24,1961,Tottenham Hotspur,Bolton Wanderers,2-2,2,2,1,1,4,0,D
1962-02-24,1961,West Ham United,Ipswich Town,2-2,2,2,1,1,4,0,D
1962-02-24,1961,Wolverhampton Wanderers,Birmingham City,2-1,2,1,1,1,3,1,H
1962-02-28,1961,Wolverhampton Wanderers,Manchester United,2-2,2,2,1,1,4,0,D
1962-03-03,1961,Arsenal,Blackburn Rovers,0-0,0,0,1,1,0,0,D
1962-03-03,1961,Birmingham City,Manchester United,1-1,1,1,1,1,2,0,D
1962-03-03,1961,Bolton Wanderers,Blackpool,0-0,0,0,1,1,0,0,D
1962-03-03,1961,Burnley,West Ham United,6-0,6,0,1,1,6,6,H
1962-03-03,1961,Everton,Wolverhampton Wanderers,4-0,4,0,1,1,4,4,H
1962-03-03,1961,Fulham,Nottingham Forest,1-1,1,1,1,1,2,0,D
1962-03-03,1961,Ipswich Town,Sheffield United,4-0,4,0,1,1,4,4,H
1962-03-03,1961,Manchester City,Tottenham Hotspur,6-2,6,2,1,1,8,4,H
1962-03-03,1961,Sheffield Wednesday,Aston Villa,3-0,3,0,1,1,3,3,H
1962-03-03,1961,West Bromwich Albion,Cardiff City,5-1,5,1,1,1,6,4,H
1962-03-09,1961,Chelsea,Birmingham City,1-1,1,1,1,1,2,0,D
1962-03-09,1961,Ipswich Town,Sheffield Wednesday,2-1,2,1,1,1,3,1,H
1962-03-10,1961,Blackpool,Leicester City,2-1,2,1,1,1,3,1,H
1962-03-10,1961,Nottingham Forest,Manchester City,1-2,1,2,1,1,3,-1,A
1962-03-10,1961,Wolverhampton Wanderers,Bolton Wanderers,5-1,5,1,1,1,6,4,H
1962-03-14,1961,Aston Villa,West Bromwich Albion,1-0,1,0,1,1,1,1,H
1962-03-14,1961,Cardiff City,Burnley,1-1,1,1,1,1,2,0,D
1962-03-14,1961,Sheffield United,Everton,1-1,1,1,1,1,2,0,D
1962-03-14,1961,Tottenham Hotspur,Ipswich Town,1-3,1,3,1,1,4,-2,A
1962-03-17,1961,Arsenal,Cardiff City,1-1,1,1,1,1,2,0,D
1962-03-17,1961,Birmingham City,Aston Villa,0-2,0,2,1,1,2,-2,A
1962-03-17,1961,Bolton Wanderers,Manchester United,1-0,1,0,1,1,1,1,H
1962-03-17,1961,Burnley,Tottenham Hotspur,2-2,2,2,1,1,4,0,D
1962-03-17,1961,Everton,Chelsea,4-0,4,0,1,1,4,4,H
1962-03-17,1961,Fulham,Sheffield United,5-2,5,2,1,1,7,3,H
1962-03-17,1961,Ipswich Town,Blackpool,1-1,1,1,1,1,2,0,D
1962-03-17,1961,Leicester City,Blackburn Rovers,2-0,2,0,1,1,2,2,H
1962-03-17,1961,Manchester City,Wolverhampton Wanderers,2-2,2,2,1,1,4,0,D
1962-03-17,1961,Sheffield Wednesday,West Ham United,0-0,0,0,1,1,0,0,D
1962-03-17,1961,West Bromwich Albion,Nottingham Forest,2-2,2,2,1,1,4,0,D
1962-03-20,1961,Nottingham Forest,Manchester United,1-0,1,0,1,1,1,1,H
1962-03-23,1961,Cardiff City,Fulham,0-3,0,3,1,1,3,-3,A
1962-03-24,1961,Aston Villa,Burnley,0-2,0,2,1,1,2,-2,A
1962-03-24,1961,Blackburn Rovers,West Bromwich Albion,1-1,1,1,1,1,2,0,D
1962-03-24,1961,Blackpool,Birmingham City,1-0,1,0,1,1,1,1,H
1962-03-24,1961,Chelsea,Arsenal,2-3,2,3,1,1,5,-1,A
1962-03-24,1961,Manchester United,Sheffield Wednesday,1-1,1,1,1,1,2,0,D
1962-03-24,1961,Nottingham Forest,Ipswich Town,1-1,1,1,1,1,2,0,D
1962-03-24,1961,Sheffield United,Bolton Wanderers,3-1,3,1,1,1,4,2,H
1962-03-24,1961,Tottenham Hotspur,Everton,3-1,3,1,1,1,4,2,H
1962-03-24,1961,West Ham United,Manchester City,0-4,0,4,1,1,4,-4,A
1962-03-24,1961,Wolverhampton Wanderers,Leicester City,1-1,1,1,1,1,2,0,D
1962-03-28,1961,Blackburn Rovers,West Ham United,1-0,1,0,1,1,1,1,H
1962-03-28,1961,Leicester City,Ipswich Town,0-2,0,2,1,1,2,-2,A
1962-03-28,1961,Wolverhampton Wanderers,West Bromwich Albion,1-5,1,5,1,1,6,-4,A
1962-03-30,1961,Birmingham City,Blackburn Rovers,2-1,2,1,1,1,3,1,H
1962-03-30,1961,Everton,Blackpool,2-2,2,2,1,1,4,0,D
1962-03-31,1961,Arsenal,Aston Villa,4-5,4,5,1,1,9,-1,A
1962-03-31,1961,Bolton Wanderers,Chelsea,4-2,4,2,1,1,6,2,H
1962-03-31,1961,Ipswich Town,Wolverhampton Wanderers,3-2,3,2,1,1,5,1,H
1962-03-31,1961,Manchester City,Sheffield United,1-1,1,1,1,1,2,0,D
1962-03-31,1961,West Bromwich Albion,West Ham United,0-1,0,1,1,1,1,-1,A
1962-04-03,1961,Blackpool,Sheffield United,2-4,2,4,1,1,6,-2,A
1962-04-03,1961,Burnley,Nottingham Forest,0-0,0,0,1,1,0,0,D
1962-04-03,1961,Sheffield Wednesday,Cardiff City,2-0,2,0,1,1,2,2,H
1962-04-04,1961,Bolton Wanderers,Everton,1-1,1,1,1,1,2,0,D
1962-04-04,1961,Leicester City,Manchester United,4-3,4,3,1,1,7,1,H
1962-04-06,1961,West Ham United,Birmingham City,2-2,2,2,1,1,4,0,D
1962-04-07,1961,Aston Villa,Bolton Wanderers,3-0,3,0,1,1,3,3,H
1962-04-07,1961,Blackburn Rovers,Everton,1-1,1,1,1,1,2,0,D
1962-04-07,1961,Blackpool,Fulham,2-1,2,1,1,1,3,1,H
1962-04-07,1961,Cardiff City,Leicester City,0-4,0,4,1,1,4,-4,A
1962-04-07,1961,Chelsea,Manchester City,1-1,1,1,1,1,2,0,D
1962-04-07,1961,Manchester United,Ipswich Town,5-0,5,0,1,1,5,5,H
1962-04-07,1961,Nottingham Forest,Arsenal,0-1,0,1,1,1,1,-1,A
1962-04-07,1961,Sheffield United,West Bromwich Albion,1-1,1,1,1,1,2,0,D
1962-04-07,1961,Tottenham Hotspur,Sheffield Wednesday,4-0,4,0,1,1,4,4,H
1962-04-07,1961,Wolverhampton Wanderers,Burnley,1-1,1,1,1,1,2,0,D
1962-04-09,1961,Tottenham Hotspur,Sheffield United,3-3,3,3,1,1,6,0,D
1962-04-10,1961,Blackburn Rovers,Manchester United,3-0,3,0,1,1,3,3,H
1962-04-11,1961,Bolton Wanderers,Burnley,0-0,0,0,1,1,0,0,D
1962-04-11,1961,Fulham,Arsenal,5-2,5,2,1,1,7,3,H
1962-04-11,1961,Leicester City,Chelsea,2-0,2,0,1,1,2,2,H
1962-04-11,1961,Manchester City,Birmingham City,1-4,1,4,1,1,5,-3,A
1962-04-14,1961,Arsenal,Wolverhampton Wanderers,3-1,3,1,1,1,4,2,H
1962-04-14,1961,Birmingham City,Sheffield United,3-0,3,0,1,1,3,3,H
1962-04-14,1961,Bolton Wanderers,Nottingham Forest,6-1,6,1,1,1,7,5,H
1962-04-14,1961,Burnley,Manchester United,1-3,1,3,1,1,4,-2,A
1962-04-14,1961,Everton,West Ham United,3-0,3,0,1,1,3,3,H
1962-04-14,1961,Fulham,Blackburn Rovers,2-0,2,0,1,1,2,2,H
1962-04-14,1961,Ipswich Town,Cardiff City,1-0,1,0,1,1,1,1,H
1962-04-14,1961,Manchester City,Aston Villa,1-0,1,0,1,1,1,1,H
1962-04-14,1961,Sheffield Wednesday,Blackpool,3-2,3,2,1,1,5,1,H
1962-04-14,1961,West Bromwich Albion,Chelsea,4-0,4,0,1,1,4,4,H
1962-04-16,1961,Manchester United,Arsenal,2-3,2,3,1,1,5,-1,A
1962-04-17,1961,Burnley,Blackburn Rovers,0-1,0,1,1,1,1,-1,A
1962-04-17,1961,Fulham,Tottenham Hotspur,1-1,1,1,1,1,2,0,D
1962-04-20,1961,Burnley,Blackpool,2-0,2,0,1,1,2,2,H
1962-04-20,1961,Chelsea,Wolverhampton Wanderers,4-5,4,5,1,1,9,-1,A
1962-04-20,1961,Everton,Birmingham City,4-1,4,1,1,1,5,3,H
1962-04-20,1961,Ipswich Town,Arsenal,2-2,2,2,1,1,4,0,D
1962-04-20,1961,Manchester City,Sheffield Wednesday,3-1,3,1,1,1,4,2,H
1962-04-20,1961,Tottenham Hotspur,Blackburn Rovers,4-1,4,1,1,1,5,3,H
1962-04-20,1961,West Ham United,Cardiff City,4-1,4,1,1,1,5,3,H
1962-04-21,1961,Aston Villa,Leicester City,8-3,8,3,1,1,11,5,H
1962-04-21,1961,Blackburn Rovers,Bolton Wanderers,2-3,2,3,1,1,5,-1,A
1962-04-21,1961,Blackpool,Manchester City,3-1,3,1,1,1,4,2,H
1962-04-21,1961,Cardiff City,Birmingham City,3-2,3,2,1,1,5,1,H
1962-04-21,1961,Chelsea,Ipswich Town,2-2,2,2,1,1,4,0,D
1962-04-21,1961,Manchester United,Everton,1-1,1,1,1,1,2,0,D
1962-04-21,1961,Nottingham Forest,Sheffield Wednesday,3-1,3,1,1,1,4,2,H
1962-04-21,1961,Sheffield United,Burnley,2-0,2,0,1,1,2,2,H
1962-04-21,1961,Tottenham Hotspur,West Bromwich Albion,1-2,1,2,1,1,3,-1,A
1962-04-21,1961,West Ham United,Arsenal,3-3,3,3,1,1,6,0,D
1962-04-21,1961,Wolverhampton Wanderers,Fulham,1-3,1,3,1,1,4,-2,A
1962-04-23,1961,Arsenal,Ipswich Town,0-3,0,3,1,1,3,-3,A
1962-04-23,1961,Aston Villa,Nottingham Forest,5-1,5,1,1,1,6,4,H
1962-04-23,1961,Blackburn Rovers,Tottenham Hotspur,0-1,0,1,1,1,1,-1,A
1962-04-23,1961,Blackpool,Burnley,1-1,1,1,1,1,2,0,D
1962-04-23,1961,Bolton Wanderers,Leicester City,1-0,1,0,1,1,1,1,H
1962-04-23,1961,Cardiff City,West Ham United,3-0,3,0,1,1,3,3,H
1962-04-23,1961,Fulham,West Bromwich Albion,1-2,1,2,1,1,3,-1,A
1962-04-23,1961,Manchester United,Sheffield United,0-1,0,1,1,1,1,-1,A
1962-04-23,1961,Sheffield Wednesday,Manchester City,1-0,1,0,1,1,1,1,H
1962-04-23,1961,Wolverhampton Wanderers,Chelsea,1-1,1,1,1,1,2,0,D
1962-04-24,1961,Birmingham City,Everton,0-0,0,0,1,1,0,0,D
1962-04-24,1961,Leicester City,Bolton Wanderers,1-1,1,1,1,1,2,0,D
1962-04-24,1961,Nottingham Forest,Aston Villa,2-0,2,0,1,1,2,2,H
1962-04-24,1961,Sheffield United,Manchester United,2-3,2,3,1,1,5,-1,A
1962-04-24,1961,West Bromwich Albion,Fulham,2-0,2,0,1,1,2,2,H
1962-04-26,1961,Blackburn Rovers,Sheffield Wednesday,0-2,0,2,1,1,2,-2,A
1962-04-28,1961,Arsenal,Sheffield United,2-0,2,0,1,1,2,2,H
1962-04-28,1961,Birmingham City,Tottenham Hotspur,2-3,2,3,1,1,5,-1,A
1962-04-28,1961,Bolton Wanderers,West Ham United,1-0,1,0,1,1,1,1,H
1962-04-28,1961,Burnley,Chelsea,1-1,1,1,1,1,2,0,D
1962-04-28,1961,Everton,Cardiff City,8-3,8,3,1,1,11,5,H
1962-04-28,1961,Fulham,Manchester United,2-0,2,0,1,1,2,2,H
1962-04-28,1961,Ipswich Town,Aston Villa,2-0,2,0,1,1,2,2,H
1962-04-28,1961,Leicester City,Nottingham Forest,2-1,2,1,1,1,3,1,H
1962-04-28,1961,Manchester City,Blackburn Rovers,3-1,3,1,1,1,4,2,H
1962-04-28,1961,Sheffield Wednesday,Wolverhampton Wanderers,3-2,3,2,1,1,5,1,H
1962-04-28,1961,West Bromwich Albion,Blackpool,7-1,7,1,1,1,8,6,H
1962-04-30,1961,Leicester City,Tottenham Hotspur,2-3,2,3,1,1,5,-1,A
1962-04-30,1961,Sheffield Wednesday,Burnley,4-0,4,0,1,1,4,4,H
1962-04-30,1961,West Ham United,Fulham,4-2,4,2,1,1,6,2,H
1962-05-01,1961,Arsenal,Everton,2-3,2,3,1,1,5,-1,A
1962-05-01,1961,Aston Villa,Cardiff City,2-2,2,2,1,1,4,0,D
1962-08-18,1962,Aston Villa,West Ham United,3-1,3,1,1,1,4,2,H
1962-08-18,1962,Burnley,Everton,1-3,1,3,1,1,4,-2,A
1962-08-18,1962,Fulham,Leicester City,2-1,2,1,1,1,3,1,H
1962-08-18,1962,Ipswich Town,Blackburn Rovers,3-3,3,3,1,1,6,0,D
1962-08-18,1962,Leyton Orient,Arsenal,1-2,1,2,1,1,3,-1,A
1962-08-18,1962,Liverpool,Blackpool,1-2,1,2,1,1,3,-1,A
1962-08-18,1962,Manchester United,West Bromwich Albion,2-2,2,2,1,1,4,0,D
1962-08-18,1962,Nottingham Forest,Sheffield United,2-1,2,1,1,1,3,1,H
1962-08-18,1962,Sheffield Wednesday,Bolton Wanderers,1-1,1,1,1,1,2,0,D
1962-08-18,1962,Tottenham Hotspur,Birmingham City,3-0,3,0,1,1,3,3,H
1962-08-18,1962,Wolverhampton Wanderers,Manchester City,8-1,8,1,1,1,9,7,H
1962-08-20,1962,Aston Villa,Tottenham Hotspur,2-1,2,1,1,1,3,1,H
1962-08-20,1962,Blackburn Rovers,Nottingham Forest,2-5,2,5,1,1,7,-3,A
1962-08-20,1962,Blackpool,Ipswich Town,1-0,1,0,1,1,1,1,H
1962-08-20,1962,West Ham United,Wolverhampton Wanderers,1-4,1,4,1,1,5,-3,A
1962-08-21,1962,Arsenal,Birmingham City,2-0,2,0,1,1,2,2,H
1962-08-22,1962,Bolton Wanderers,Burnley,2-2,2,2,1,1,4,0,D
1962-08-22,1962,Everton,Manchester United,3-1,3,1,1,1,4,2,H
1962-08-22,1962,Leicester City,Sheffield Wednesday,3-3,3,3,1,1,6,0,D
1962-08-22,1962,Manchester City,Liverpool,2-2,2,2,1,1,4,0,D
1962-08-22,1962,Sheffield United,Fulham,2-0,2,0,1,1,2,2,H
1962-08-22,1962,West Bromwich Albion,Leyton Orient,2-1,2,1,1,1,3,1,H
1962-08-25,1962,Arsenal,Manchester United,1-3,1,3,1,1,4,-2,A
1962-08-25,1962,Birmingham City,Leyton Orient,2-2,2,2,1,1,4,0,D
1962-08-25,1962,Blackburn Rovers,Liverpool,1-0,1,0,1,1,1,1,H
1962-08-25,1962,Blackpool,Wolverhampton Wanderers,0-2,0,2,1,1,2,-2,A
1962-08-25,1962,Bolton Wanderers,Fulham,1-0,1,0,1,1,1,1,H
1962-08-25,1962,Everton,Sheffield Wednesday,4-1,4,1,1,1,5,3,H
1962-08-25,1962,Leicester City,Nottingham Forest,2-1,2,1,1,1,3,1,H
1962-08-25,1962,Manchester City,Aston Villa,0-2,0,2,1,1,2,-2,A
1962-08-25,1962,Sheffield United,Ipswich Town,2-1,2,1,1,1,3,1,H
1962-08-25,1962,West Bromwich Albion,Burnley,1-2,1,2,1,1,3,-1,A
1962-08-25,1962,West Ham United,Tottenham Hotspur,1-6,1,6,1,1,7,-5,A
1962-08-28,1962,Burnley,Bolton Wanderers,2-1,2,1,1,1,3,1,H
1962-08-28,1962,Ipswich Town,Blackpool,5-2,5,2,1,1,7,3,H
1962-08-28,1962,Nottingham Forest,Blackburn Rovers,2-0,2,0,1,1,2,2,H
1962-08-29,1962,Birmingham City,Arsenal,2-2,2,2,1,1,4,0,D
1962-08-29,1962,Fulham,Sheffield United,2-2,2,2,1,1,4,0,D
1962-08-29,1962,Leyton Orient,West Bromwich Albion,2-3,2,3,1,1,5,-1,A
1962-08-29,1962,Liverpool,Manchester City,4-1,4,1,1,1,5,3,H
1962-08-29,1962,Manchester United,Everton,0-1,0,1,1,1,1,-1,A
1962-08-29,1962,Sheffield Wednesday,Leicester City,0-3,0,3,1,1,3,-3,A
1962-08-29,1962,Tottenham Hotspur,Aston Villa,4-2,4,2,1,1,6,2,H
1962-08-29,1962,Wolverhampton Wanderers,West Ham United,0-0,0,0,1,1,0,0,D
1962-09-01,1962,Aston Villa,Blackpool,1-1,1,1,1,1,2,0,D
1962-09-01,1962,Burnley,Arsenal,2-1,2,1,1,1,3,1,H
1962-09-01,1962,Fulham,Everton,1-0,1,0,1,1,1,1,H
1962-09-01,1962,Ipswich Town,Nottingham Forest,1-1,1,1,1,1,2,0,D
1962-09-01,1962,Leicester City,Bolton Wanderers,4-1,4,1,1,1,5,3,H
1962-09-01,1962,Leyton Orient,West Ham United,2-0,2,0,1,1,2,2,H
1962-09-01,1962,Liverpool,Sheffield United,2-0,2,0,1,1,2,2,H
1962-09-01,1962,Manchester United,Birmingham City,2-0,2,0,1,1,2,2,H
1962-09-01,1962,Sheffield Wednesday,West Bromwich Albion,3-1,3,1,1,1,4,2,H
1962-09-01,1962,Tottenham Hotspur,Manchester City,4-2,4,2,1,1,6,2,H
1962-09-01,1962,Wolverhampton Wanderers,Blackburn Rovers,4-2,4,2,1,1,6,2,H
1962-09-03,1962,Blackpool,Nottingham Forest,2-1,2,1,1,1,3,1,H
1962-09-03,1962,West Ham United,Liverpool,1-0,1,0,1,1,1,1,H
1962-09-04,1962,Arsenal,Aston Villa,1-2,1,2,1,1,3,-1,A
1962-09-04,1962,Burnley,Leicester City,1-1,1,1,1,1,2,0,D
1962-09-05,1962,Bolton Wanderers,Manchester United,3-0,3,0,1,1,3,3,H
1962-09-05,1962,Everton,Leyton Orient,3-0,3,0,1,1,3,3,H
1962-09-05,1962,Manchester City,Ipswich Town,2-1,2,1,1,1,3,1,H
1962-09-05,1962,Sheffield United,Blackburn Rovers,1-1,1,1,1,1,2,0,D
1962-09-08,1962,Arsenal,Sheffield Wednesday,1-2,1,2,1,1,3,-1,A
1962-09-08,1962,Birmingham City,Burnley,5-1,5,1,1,1,6,4,H
1962-09-08,1962,Blackburn Rovers,Aston Villa,4-1,4,1,1,1,5,3,H
1962-09-08,1962,Blackpool,Tottenham Hotspur,1-2,1,2,1,1,3,-1,A
1962-09-08,1962,Bolton Wanderers,Ipswich Town,1-3,1,3,1,1,4,-2,A
1962-09-08,1962,Everton,Leicester City,3-2,3,2,1,1,5,1,H
1962-09-08,1962,Leyton Orient,Manchester United,1-0,1,0,1,1,1,1,H
1962-09-08,1962,Manchester City,West Ham United,1-6,1,6,1,1,7,-5,A
1962-09-08,1962,Nottingham Forest,Liverpool,3-1,3,1,1,1,4,2,H
1962-09-08,1962,Sheffield United,Wolverhampton Wanderers,1-2,1,2,1,1,3,-1,A
1962-09-08,1962,West Bromwich Albion,Fulham,6-1,6,1,1,1,7,5,H
1962-09-10,1962,Aston Villa,Arsenal,3-1,3,1,1,1,4,2,H
1962-09-11,1962,Ipswich Town,Manchester City,0-0,0,0,1,1,0,0,D
1962-09-11,1962,Nottingham Forest,Blackpool,2-0,2,0,1,1,2,2,H
1962-09-12,1962,Leyton Orient,Everton,3-0,3,0,1,1,3,3,H
1962-09-12,1962,Liverpool,West Ham United,2-1,2,1,1,1,3,1,H
1962-09-12,1962,Manchester United,Bolton Wanderers,3-0,3,0,1,1,3,3,H
1962-09-12,1962,Sheffield Wednesday,Fulham,1-0,1,0,1,1,1,1,H
1962-09-12,1962,Tottenham Hotspur,Wolverhampton Wanderers,1-2,1,2,1,1,3,-1,A
1962-09-12,1962,West Bromwich Albion,Birmingham City,1-0,1,0,1,1,1,1,H
1962-09-14,1962,West Ham United,Blackpool,2-2,2,2,1,1,4,0,D
1962-09-15,1962,Aston Villa,Sheffield United,1-2,1,2,1,1,3,-1,A
1962-09-15,1962,Bolton Wanderers,Everton,0-2,0,2,1,1,2,-2,A
1962-09-15,1962,Burnley,Leyton Orient,2-0,2,0,1,1,2,2,H
1962-09-15,1962,Fulham,Arsenal,1-3,1,3,1,1,4,-2,A
1962-09-15,1962,Leicester City,West Bromwich Albion,1-0,1,0,1,1,1,1,H
1962-09-15,1962,Liverpool,Ipswich Town,1-1,1,1,1,1,2,0,D
1962-09-15,1962,Manchester United,Manchester City,2-3,2,3,1,1,5,-1,A
1962-09-15,1962,Sheffield Wednesday,Birmingham City,5-0,5,0,1,1,5,5,H
1962-09-15,1962,Tottenham Hotspur,Blackburn Rovers,4-1,4,1,1,1,5,3,H
1962-09-15,1962,Wolverhampton Wanderers,Nottingham Forest,1-1,1,1,1,1,2,0,D
1962-09-17,1962,Blackburn Rovers,Sheffield United,1-2,1,2,1,1,3,-1,A
1962-09-19,1962,Birmingham City,West Bromwich Albion,0-0,0,0,1,1,0,0,D
1962-09-19,1962,Fulham,Sheffield Wednesday,4-1,4,1,1,1,5,3,H
1962-09-19,1962,Leicester City,Burnley,3-3,3,3,1,1,6,0,D
1962-09-19,1962,Wolverhampton Wanderers,Tottenham Hotspur,2-2,2,2,1,1,4,0,D
1962-09-22,1962,Arsenal,Leicester City,1-1,1,1,1,1,2,0,D
1962-09-22,1962,Birmingham City,Fulham,4-1,4,1,1,1,5,3,H
1962-09-22,1962,Blackburn Rovers,West Ham United,0-4,0,4,1,1,4,-4,A
1962-09-22,1962,Blackpool,Manchester City,2-2,2,2,1,1,4,0,D
1962-09-22,1962,Everton,Liverpool,2-2,2,2,1,1,4,0,D
1962-09-22,1962,Ipswich Town,Wolverhampton Wanderers,2-3,2,3,1,1,5,-1,A
1962-09-22,1962,Leyton Orient,Sheffield Wednesday,2-4,2,4,1,1,6,-2,A
1962-09-22,1962,Manchester United,Burnley,2-5,2,5,1,1,7,-3,A
1962-09-22,1962,Nottingham Forest,Aston Villa,3-1,3,1,1,1,4,2,H
1962-09-22,1962,Sheffield United,Tottenham Hotspur,3-1,3,1,1,1,4,2,H
1962-09-22,1962,West Bromwich Albion,Bolton Wanderers,5-4,5,4,1,1,9,1,H
1962-09-29,1962,Aston Villa,Ipswich Town,4-2,4,2,1,1,6,2,H
1962-09-29,1962,Bolton Wanderers,Arsenal,3-0,3,0,1,1,3,3,H
1962-09-29,1962,Burnley,Blackpool,2-0,2,0,1,1,2,2,H
1962-09-29,1962,Everton,West Bromwich Albion,4-2,4,2,1,1,6,2,H
1962-09-29,1962,Fulham,Leyton Orient,0-2,0,2,1,1,2,-2,A
1962-09-29,1962,Leicester City,Birmingham City,3-0,3,0,1,1,3,3,H
1962-09-29,1962,Manchester City,Blackburn Rovers,0-1,0,1,1,1,1,-1,A
1962-09-29,1962,Sheffield Wednesday,Manchester United,1-0,1,0,1,1,1,1,H
1962-09-29,1962,Tottenham Hotspur,Nottingham Forest,9-2,9,2,1,1,11,7,H
1962-09-29,1962,West Ham United,Sheffield United,1-1,1,1,1,1,2,0,D
1962-09-29,1962,Wolverhampton Wanderers,Liverpool,3-2,3,2,1,1,5,1,H
1962-10-06,1962,Aston Villa,West Bromwich Albion,2-0,2,0,1,1,2,2,H
1962-10-06,1962,Blackburn Rovers,Burnley,2-3,2,3,1,1,5,-1,A
1962-10-06,1962,Blackpool,Manchester United,2-2,2,2,1,1,4,0,D
1962-10-06,1962,Ipswich Town,Leicester City,0-1,0,1,1,1,1,-1,A
1962-10-06,1962,Liverpool,Bolton Wanderers,1-0,1,0,1,1,1,1,H
1962-10-06,1962,Manchester City,Leyton Orient,2-0,2,0,1,1,2,2,H
1962-10-06,1962,Nottingham Forest,Fulham,3-1,3,1,1,1,4,2,H
1962-10-06,1962,Sheffield United,Sheffield Wednesday,2-2,2,2,1,1,4,0,D
1962-10-06,1962,Tottenham Hotspur,Arsenal,4-4,4,4,1,1,8,0,D
1962-10-06,1962,West Ham United,Birmingham City,5-0,5,0,1,1,5,5,H
1962-10-06,1962,Wolverhampton Wanderers,Everton,0-2,0,2,1,1,2,-2,A
1962-10-13,1962,Arsenal,West Ham United,1-1,1,1,1,1,2,0,D
1962-10-13,1962,Birmingham City,Manchester City,2-2,2,2,1,1,4,0,D
1962-10-13,1962,Bolton Wanderers,Wolverhampton Wanderers,3-0,3,0,1,1,3,3,H
1962-10-13,1962,Burnley,Sheffield United,5-1,5,1,1,1,6,4,H
1962-10-13,1962,Everton,Aston Villa,1-1,1,1,1,1,2,0,D
1962-10-13,1962,Fulham,Ipswich Town,1-1,1,1,1,1,2,0,D
1962-10-13,1962,Leicester City,Liverpool,3-0,3,0,1,1,3,3,H
1962-10-13,1962,Leyton Orient,Blackpool,0-2,0,2,1,1,2,-2,A
1962-10-13,1962,Manchester United,Blackburn Rovers,0-3,0,3,1,1,3,-3,A
1962-10-13,1962,Sheffield Wednesday,Nottingham Forest,2-2,2,2,1,1,4,0,D
1962-10-13,1962,West Bromwich Albion,Tottenham Hotspur,1-2,1,2,1,1,3,-1,A
1962-10-20,1962,Aston Villa,Leyton Orient,1-0,1,0,1,1,1,1,H
1962-10-20,1962,Blackburn Rovers,Leicester City,2-0,2,0,1,1,2,2,H
1962-10-20,1962,Blackpool,Fulham,0-0,0,0,1,1,0,0,D
1962-10-20,1962,Ipswich Town,West Bromwich Albion,1-1,1,1,1,1,2,0,D
1962-10-20,1962,Manchester City,Sheffield Wednesday,3-2,3,2,1,1,5,1,H
1962-10-20,1962,Sheffield United,Bolton Wanderers,4-1,4,1,1,1,5,3,H
1962-10-22,1962,West Ham United,Burnley,1-1,1,1,1,1,2,0,D
1962-10-24,1962,Tottenham Hotspur,Manchester United,6-2,6,2,1,1,8,4,H
1962-10-24,1962,Wolverhampton Wanderers,Birmingham City,0-2,0,2,1,1,2,-2,A
1962-10-27,1962,Arsenal,Wolverhampton Wanderers,5-4,5,4,1,1,9,1,H
1962-10-27,1962,Birmingham City,Aston Villa,3-2,3,2,1,1,5,1,H
1962-10-27,1962,Bolton Wanderers,Nottingham Forest,1-0,1,0,1,1,1,1,H
1962-10-27,1962,Burnley,Manchester City,0-0,0,0,1,1,0,0,D
1962-10-27,1962,Everton,Ipswich Town,3-1,3,1,1,1,4,2,H
1962-10-27,1962,Fulham,Blackburn Rovers,0-0,0,0,1,1,0,0,D
1962-10-27,1962,Leicester City,Sheffield United,3-1,3,1,1,1,4,2,H
1962-10-27,1962,Leyton Orient,Tottenham Hotspur,1-5,1,5,1,1,6,-4,A
1962-10-27,1962,Manchester United,West Ham United,3-1,3,1,1,1,4,2,H
1962-10-27,1962,Sheffield Wednesday,Blackpool,0-0,0,0,1,1,0,0,D
1962-10-27,1962,West Bromwich Albion,Liverpool,1-0,1,0,1,1,1,1,H
1962-11-03,1962,Aston Villa,Fulham,1-2,1,2,1,1,3,-1,A
1962-11-03,1962,Blackburn Rovers,Arsenal,5-5,5,5,1,1,10,0,D
1962-11-03,1962,Blackpool,West Bromwich Albion,0-2,0,2,1,1,2,-2,A
1962-11-03,1962,Ipswich Town,Manchester United,3-5,3,5,1,1,8,-2,A
1962-11-03,1962,Liverpool,Burnley,1-2,1,2,1,1,3,-1,A
1962-11-03,1962,Manchester City,Everton,1-1,1,1,1,1,2,0,D
1962-11-03,1962,Nottingham Forest,Leyton Orient,1-1,1,1,1,1,2,0,D
1962-11-03,1962,Sheffield United,Birmingham City,0-2,0,2,1,1,2,-2,A
1962-11-03,1962,Tottenham Hotspur,Leicester City,4-0,4,0,1,1,4,4,H
1962-11-03,1962,West Ham United,Bolton Wanderers,1-2,1,2,1,1,3,-1,A
1962-11-03,1962,Wolverhampton Wanderers,Sheffield Wednesday,2-2,2,2,1,1,4,0,D
1962-11-10,1962,Arsenal,Sheffield United,1-0,1,0,1,1,1,1,H
1962-11-10,1962,Birmingham City,Nottingham Forest,2-2,2,2,1,1,4,0,D
1962-11-10,1962,Bolton Wanderers,Manchester City,3-1,3,1,1,1,4,2,H
1962-11-10,1962,Burnley,Wolverhampton Wanderers,2-0,2,0,1,1,2,2,H
1962-11-10,1962,Everton,Blackpool,5-0,5,0,1,1,5,5,H
1962-11-10,1962,Fulham,Tottenham Hotspur,0-2,0,2,1,1,2,-2,A
1962-11-10,1962,Leicester City,West Ham United,2-0,2,0,1,1,2,2,H
1962-11-10,1962,Leyton Orient,Ipswich Town,1-2,1,2,1,1,3,-1,A
1962-11-10,1962,Manchester United,Liverpool,3-3,3,3,1,1,6,0,D
1962-11-10,1962,Sheffield Wednesday,Aston Villa,0-0,0,0,1,1,0,0,D
1962-11-10,1962,West Bromwich Albion,Blackburn Rovers,2-5,2,5,1,1,7,-3,A
1962-11-13,1962,Nottingham Forest,Everton,3-4,3,4,1,1,7,-1,A
1962-11-14,1962,Liverpool,Arsenal,2-1,2,1,1,1,3,1,H
1962-11-17,1962,Aston Villa,Burnley,2-1,2,1,1,1,3,1,H
1962-11-17,1962,Blackburn Rovers,Everton,3-2,3,2,1,1,5,1,H
1962-11-17,1962,Blackpool,Bolton Wanderers,3-1,3,1,1,1,4,2,H
1962-11-17,1962,Ipswich Town,Birmingham City,1-5,1,5,1,1,6,-4,A
1962-11-17,1962,Liverpool,Leyton Orient,5-0,5,0,1,1,5,5,H
1962-11-17,1962,Manchester City,Leicester City,1-1,1,1,1,1,2,0,D
1962-11-17,1962,Nottingham Forest,Arsenal,3-0,3,0,1,1,3,3,H
1962-11-17,1962,Sheffield United,West Bromwich Albion,1-0,1,0,1,1,1,1,H
1962-11-17,1962,Tottenham Hotspur,Sheffield Wednesday,1-1,1,1,1,1,2,0,D
1962-11-17,1962,West Ham United,Fulham,2-2,2,2,1,1,4,0,D
1962-11-17,1962,Wolverhampton Wanderers,Manchester United,2-3,2,3,1,1,5,-1,A
1962-11-24,1962,Arsenal,Ipswich Town,3-1,3,1,1,1,4,2,H
1962-11-24,1962,Birmingham City,Liverpool,0-2,0,2,1,1,2,-2,A
1962-11-24,1962,Bolton Wanderers,Blackburn Rovers,0-0,0,0,1,1,0,0,D
1962-11-24,1962,Burnley,Tottenham Hotspur,2-1,2,1,1,1,3,1,H
1962-11-24,1962,Everton,Sheffield United,3-0,3,0,1,1,3,3,H
1962-11-24,1962,Fulham,Manchester City,2-4,2,4,1,1,6,-2,A
1962-11-24,1962,Leicester City,Blackpool,0-0,0,0,1,1,0,0,D
1962-11-24,1962,Leyton Orient,Wolverhampton Wanderers,0-4,0,4,1,1,4,-4,A
1962-11-24,1962,Manchester United,Aston Villa,2-2,2,2,1,1,4,0,D
1962-11-24,1962,Sheffield Wednesday,West Ham United,1-3,1,3,1,1,4,-2,A
1962-11-24,1962,West Bromwich Albion,Nottingham Forest,1-4,1,4,1,1,5,-3,A
1962-12-01,1962,Aston Villa,Bolton Wanderers,5-0,5,0,1,1,5,5,H
1962-12-01,1962,Blackburn Rovers,Leyton Orient,1-1,1,1,1,1,2,0,D
1962-12-01,1962,Blackpool,Birmingham City,1-1,1,1,1,1,2,0,D
1962-12-01,1962,Ipswich Town,Sheffield Wednesday,2-0,2,0,1,1,2,2,H
1962-12-01,1962,Liverpool,Fulham,2-1,2,1,1,1,3,1,H
1962-12-01,1962,Manchester City,Arsenal,2-4,2,4,1,1,6,-2,A
1962-12-01,1962,Nottingham Forest,Burnley,2-1,2,1,1,1,3,1,H
1962-12-01,1962,Sheffield United,Manchester United,1-1,1,1,1,1,2,0,D
1962-12-01,1962,Tottenham Hotspur,Everton,0-0,0,0,1,1,0,0,D
1962-12-01,1962,West Ham United,West Bromwich Albion,2-2,2,2,1,1,4,0,D
1962-12-01,1962,Wolverhampton Wanderers,Leicester City,1-3,1,3,1,1,4,-2,A
1962-12-08,1962,Arsenal,Blackpool,2-0,2,0,1,1,2,2,H
1962-12-08,1962,Birmingham City,Blackburn Rovers,3-3,3,3,1,1,6,0,D
1962-12-08,1962,Bolton Wanderers,Tottenham Hotspur,1-0,1,0,1,1,1,1,H
1962-12-08,1962,Burnley,Ipswich Town,3-1,3,1,1,1,4,2,H
1962-12-08,1962,Everton,West Ham United,1-1,1,1,1,1,2,0,D
1962-12-08,1962,Fulham,Wolverhampton Wanderers,0-5,0,5,1,1,5,-5,A
1962-12-08,1962,Leicester City,Aston Villa,3-3,3,3,1,1,6,0,D
1962-12-08,1962,Leyton Orient,Sheffield United,2-2,2,2,1,1,4,0,D
1962-12-08,1962,Manchester United,Nottingham Forest,5-1,5,1,1,1,6,4,H
1962-12-08,1962,Sheffield Wednesday,Liverpool,0-2,0,2,1,1,2,-2,A
1962-12-08,1962,West Bromwich Albion,Manchester City,2-1,2,1,1,1,3,1,H
1962-12-15,1962,Arsenal,Leyton Orient,2-0,2,0,1,1,2,2,H
1962-12-15,1962,Birmingham City,Tottenham Hotspur,0-2,0,2,1,1,2,-2,A
1962-12-15,1962,Blackburn Rovers,Ipswich Town,0-1,0,1,1,1,1,-1,A
1962-12-15,1962,Blackpool,Liverpool,1-2,1,2,1,1,3,-1,A
1962-12-15,1962,Everton,Burnley,3-1,3,1,1,1,4,2,H
1962-12-15,1962,Leicester City,Fulham,2-3,2,3,1,1,5,-1,A
1962-12-15,1962,Manchester City,Wolverhampton Wanderers,3-3,3,3,1,1,6,0,D
1962-12-15,1962,Sheffield United,Nottingham Forest,3-1,3,1,1,1,4,2,H
1962-12-15,1962,West Bromwich Albion,Manchester United,3-0,3,0,1,1,3,3,H
1962-12-15,1962,West Ham United,Aston Villa,1-1,1,1,1,1,2,0,D
1962-12-21,1962,Ipswich Town,Sheffield United,1-0,1,0,1,1,1,1,H
1962-12-22,1962,Leyton Orient,Birmingham City,2-2,2,2,1,1,4,0,D
1962-12-22,1962,Liverpool,Blackburn Rovers,3-1,3,1,1,1,4,2,H
1962-12-22,1962,Sheffield Wednesday,Everton,2-2,2,2,1,1,4,0,D
1962-12-22,1962,Tottenham Hotspur,West Ham United,4-4,4,4,1,1,8,0,D
1962-12-26,1962,Fulham,Manchester United,0-1,0,1,1,1,1,-1,A
1962-12-26,1962,Leicester City,Leyton Orient,5-1,5,1,1,1,6,4,H
1962-12-26,1962,Tottenham Hotspur,Ipswich Town,5-0,5,0,1,1,5,5,H
1962-12-29,1962,Burnley,Sheffield Wednesday,4-0,4,0,1,1,4,4,H
1962-12-29,1962,Nottingham Forest,West Ham United,3-4,3,4,1,1,7,-1,A
1963-01-12,1962,West Bromwich Albion,Sheffield Wednesday,0-3,0,3,1,1,3,-3,A
1963-01-19,1962,Aston Villa,Blackburn Rovers,0-0,0,0,1,1,0,0,D
1963-01-19,1962,Tottenham Hotspur,Blackpool,2-0,2,0,1,1,2,2,H
1963-01-19,1962,Wolverhampton Wanderers,Sheffield United,0-0,0,0,1,1,0,0,D
1963-02-09,1962,Leicester City,Arsenal,2-0,2,0,1,1,2,2,H
1963-02-12,1962,Leicester City,Everton,3-1,3,1,1,1,4,2,H
1963-02-13,1962,Liverpool,Aston Villa,4-0,4,0,1,1,4,4,H
1963-02-16,1962,Arsenal,Bolton Wanderers,3-2,3,2,1,1,5,1,H
1963-02-16,1962,Leyton Orient,Fulham,1-1,1,1,1,1,2,0,D
1963-02-16,1962,Liverpool,Wolverhampton Wanderers,4-1,4,1,1,1,5,3,H
1963-02-16,1962,Sheffield United,West Ham United,0-2,0,2,1,1,2,-2,A
1963-02-19,1962,Nottingham Forest,Leicester City,0-2,0,2,1,1,2,-2,A
1963-02-23,1962,Arsenal,Tottenham Hotspur,2-3,2,3,1,1,5,-1,A
1963-02-23,1962,Everton,Wolverhampton Wanderers,0-0,0,0,1,1,0,0,D
1963-02-23,1962,Fulham,Nottingham Forest,3-1,3,1,1,1,4,2,H
1963-02-23,1962,Leicester City,Ipswich Town,3-0,3,0,1,1,3,3,H
1963-02-23,1962,Leyton Orient,Manchester City,1-1,1,1,1,1,2,0,D
1963-02-23,1962,Manchester United,Blackpool,1-1,1,1,1,1,2,0,D
1963-03-02,1962,Blackburn Rovers,Manchester United,2-2,2,2,1,1,4,0,D
1963-03-02,1962,Blackpool,Leyton Orient,3-2,3,2,1,1,5,1,H
1963-03-02,1962,Ipswich Town,Fulham,0-1,0,1,1,1,1,-1,A
1963-03-02,1962,Liverpool,Leicester City,0-2,0,2,1,1,2,-2,A
1963-03-02,1962,Manchester City,Birmingham City,2-1,2,1,1,1,3,1,H
1963-03-02,1962,Nottingham Forest,Sheffield Wednesday,0-3,0,3,1,1,3,-3,A
1963-03-02,1962,Sheffield United,Burnley,1-0,1,0,1,1,1,1,H
1963-03-02,1962,Tottenham Hotspur,West Bromwich Albion,2-1,2,1,1,1,3,1,H
1963-03-02,1962,West Ham United,Arsenal,0-4,0,4,1,1,4,-4,A
1963-03-05,1962,Ipswich Town,Liverpool,2-2,2,2,1,1,4,0,D
1963-03-09,1962,Arsenal,Liverpool,2-2,2,2,1,1,4,0,D
1963-03-09,1962,Birmingham City,Wolverhampton Wanderers,3-4,3,4,1,1,7,-1,A
1963-03-09,1962,Bolton Wanderers,Sheffield United,3-2,3,2,1,1,5,1,H
1963-03-09,1962,Burnley,West Ham United,1-1,1,1,1,1,2,0,D
1963-03-09,1962,Everton,Nottingham Forest,2-0,2,0,1,1,2,2,H
1963-03-09,1962,Fulham,Blackpool,2-0,2,0,1,1,2,2,H
1963-03-09,1962,Leicester City,Blackburn Rovers,2-0,2,0,1,1,2,2,H
1963-03-09,1962,Leyton Orient,Aston Villa,0-2,0,2,1,1,2,-2,A
1963-03-09,1962,Manchester United,Tottenham Hotspur,0-2,0,2,1,1,2,-2,A
1963-03-09,1962,Sheffield Wednesday,Manchester City,4-1,4,1,1,1,5,3,H
1963-03-09,1962,West Bromwich Albion,Ipswich Town,6-1,6,1,1,1,7,5,H
1963-03-16,1962,Aston Villa,Birmingham City,4-0,4,0,1,1,4,4,H
1963-03-16,1962,Blackburn Rovers,Fulham,0-1,0,1,1,1,1,-1,A
1963-03-16,1962,Blackpool,Sheffield Wednesday,2-3,2,3,1,1,5,-1,A
1963-03-16,1962,Ipswich Town,Tottenham Hotspur,2-4,2,4,1,1,6,-2,A
1963-03-16,1962,Nottingham Forest,Bolton Wanderers,1-0,1,0,1,1,1,1,H
1963-03-16,1962,Wolverhampton Wanderers,West Bromwich Albion,7-0,7,0,1,1,7,7,H
1963-03-18,1962,West Ham United,Manchester United,3-1,3,1,1,1,4,2,H
1963-03-19,1962,Ipswich Town,Everton,0-3,0,3,1,1,3,-3,A
1963-03-20,1962,Blackpool,Burnley,0-0,0,0,1,1,0,0,D
1963-03-20,1962,Liverpool,West Bromwich Albion,2-2,2,2,1,1,4,0,D
1963-03-20,1962,Wolverhampton Wanderers,Bolton Wanderers,4-0,4,0,1,1,4,4,H
1963-03-23,1962,Arsenal,Blackburn Rovers,3-1,3,1,1,1,4,2,H
1963-03-23,1962,Birmingham City,Sheffield United,0-1,0,1,1,1,1,-1,A
1963-03-23,1962,Bolton Wanderers,West Ham United,3-0,3,0,1,1,3,3,H
1963-03-23,1962,Burnley,Liverpool,1-3,1,3,1,1,4,-2,A
1963-03-23,1962,Everton,Manchester City,2-1,2,1,1,1,3,1,H
1963-03-23,1962,Fulham,Aston Villa,1-0,1,0,1,1,1,1,H
1963-03-23,1962,Leicester City,Tottenham Hotspur,2-2,2,2,1,1,4,0,D
1963-03-23,1962,Leyton Orient,Nottingham Forest,0-1,0,1,1,1,1,-1,A
1963-03-23,1962,Manchester United,Ipswich Town,0-1,0,1,1,1,1,-1,A
1963-03-23,1962,Sheffield Wednesday,Wolverhampton Wanderers,3-1,3,1,1,1,4,2,H
1963-03-23,1962,West Bromwich Albion,Blackpool,1-2,1,2,1,1,3,-1,A
1963-03-25,1962,Blackburn Rovers,Blackpool,3-3,3,3,1,1,6,0,D
1963-03-25,1962,Bolton Wanderers,West Bromwich Albion,1-2,1,2,1,1,3,-1,A
1963-03-26,1962,Arsenal,Everton,4-3,4,3,1,1,7,1,H
1963-03-26,1962,Manchester City,Burnley,2-5,2,5,1,1,7,-3,A
1963-03-26,1962,Sheffield United,Leicester City,0-0,0,0,1,1,0,0,D
1963-03-27,1962,Tottenham Hotspur,Leyton Orient,2-0,2,0,1,1,2,2,H
1963-03-29,1962,Blackburn Rovers,Bolton Wanderers,5-0,5,0,1,1,5,5,H
1963-03-29,1962,Blackpool,Aston Villa,4-0,4,0,1,1,4,4,H
1963-03-29,1962,Manchester City,Fulham,2-3,2,3,1,1,5,-1,A
1963-03-30,1962,Birmingham City,Sheffield Wednesday,1-1,1,1,1,1,2,0,D
1963-03-30,1962,Ipswich Town,Arsenal,1-1,1,1,1,1,2,0,D
1963-03-30,1962,Sheffield United,Everton,2-1,2,1,1,1,3,1,H
1963-03-30,1962,Tottenham Hotspur,Burnley,1-1,1,1,1,1,2,0,D
1963-03-30,1962,Wolverhampton Wanderers,Leyton Orient,2-1,2,1,1,1,3,1,H
1963-04-01,1962,Aston Villa,Everton,0-2,0,2,1,1,2,-2,A
1963-04-01,1962,Manchester United,Fulham,0-2,0,2,1,1,2,-2,A
1963-04-02,1962,Burnley,Blackburn Rovers,1-0,1,0,1,1,1,1,H
1963-04-02,1962,West Ham United,Sheffield Wednesday,2-0,2,0,1,1,2,2,H
1963-04-03,1962,Birmingham City,Bolton Wanderers,2-2,2,2,1,1,4,0,D
1963-04-03,1962,Leyton Orient,Leicester City,0-2,0,2,1,1,2,-2,A
1963-04-03,1962,Sheffield United,Manchester City,3-1,3,1,1,1,4,2,H
1963-04-03,1962,West Bromwich Albion,Wolverhampton Wanderers,2-2,2,2,1,1,4,0,D
1963-04-06,1962,Arsenal,Nottingham Forest,0-0,0,0,1,1,0,0,D
1963-04-06,1962,Birmingham City,Ipswich Town,0-1,0,1,1,1,1,-1,A
1963-04-06,1962,Bolton Wanderers,Blackpool,3-0,3,0,1,1,3,3,H
1963-04-06,1962,Burnley,Aston Villa,3-1,3,1,1,1,4,2,H
1963-04-06,1962,Everton,Blackburn Rovers,0-0,0,0,1,1,0,0,D
1963-04-06,1962,Fulham,West Ham United,2-0,2,0,1,1,2,2,H
1963-04-06,1962,Leicester City,Manchester City,2-0,2,0,1,1,2,2,H
1963-04-06,1962,West Bromwich Albion,Sheffield United,1-2,1,2,1,1,3,-1,A
1963-04-08,1962,Blackpool,Leicester City,1-1,1,1,1,1,2,0,D
1963-04-08,1962,Liverpool,Everton,0-0,0,0,1,1,0,0,D
1963-04-08,1962,Sheffield Wednesday,Tottenham Hotspur,3-1,3,1,1,1,4,2,H
1963-04-08,1962,Wolverhampton Wanderers,Arsenal,1-0,1,0,1,1,1,1,H
1963-04-09,1962,Aston Villa,Manchester United,1-2,1,2,1,1,3,-1,A
1963-04-12,1962,Arsenal,West Bromwich Albion,3-2,3,2,1,1,5,1,H
1963-04-12,1962,Blackburn Rovers,Sheffield Wednesday,3-0,3,0,1,1,3,3,H
1963-04-12,1962,Burnley,Fulham,4-0,4,0,1,1,4,4,H
1963-04-12,1962,Leyton Orient,Bolton Wanderers,0-1,0,1,1,1,1,-1,A
1963-04-12,1962,Liverpool,Tottenham Hotspur,5-2,5,2,1,1,7,3,H
1963-04-12,1962,Manchester City,Nottingham Forest,1-0,1,0,1,1,1,1,H
1963-04-12,1962,West Ham United,Ipswich Town,1-3,1,3,1,1,4,-2,A
1963-04-13,1962,Aston Villa,Sheffield Wednesday,0-2,0,2,1,1,2,-2,A
1963-04-13,1962,Blackburn Rovers,West Bromwich Albion,3-1,3,1,1,1,4,2,H
1963-04-13,1962,Blackpool,Everton,1-2,1,2,1,1,3,-1,A
1963-04-13,1962,Ipswich Town,Leyton Orient,1-1,1,1,1,1,2,0,D
1963-04-13,1962,Liverpool,Manchester United,1-0,1,0,1,1,1,1,H
1963-04-13,1962,Manchester City,Bolton Wanderers,2-1,2,1,1,1,3,1,H
1963-04-13,1962,Nottingham Forest,Birmingham City,0-2,0,2,1,1,2,-2,A
1963-04-13,1962,Sheffield United,Arsenal,3-3,3,3,1,1,6,0,D
1963-04-13,1962,Tottenham Hotspur,Fulham,1-1,1,1,1,1,2,0,D
1963-04-13,1962,West Ham United,Leicester City,2-0,2,0,1,1,2,2,H
1963-04-13,1962,Wolverhampton Wanderers,Burnley,7-2,7,2,1,1,9,5,H
1963-04-15,1962,Blackpool,Sheffield United,3-1,3,1,1,1,4,2,H
1963-04-15,1962,Bolton Wanderers,Leyton Orient,0-1,0,1,1,1,1,-1,A
1963-04-15,1962,Everton,Birmingham City,2-2,2,2,1,1,4,0,D
1963-04-15,1962,Fulham,Burnley,1-1,1,1,1,1,2,0,D
1963-04-15,1962,Ipswich Town,West Ham United,2-3,2,3,1,1,5,-1,A
1963-04-15,1962,Manchester United,Leicester City,2-2,2,2,1,1,4,0,D
1963-04-15,1962,Nottingham Forest,Manchester City,1-1,1,1,1,1,2,0,D
1963-04-15,1962,Sheffield Wednesday,Blackburn Rovers,4-0,4,0,1,1,4,4,H
1963-04-15,1962,Tottenham Hotspur,Liverpool,7-2,7,2,1,1,9,5,H
1963-04-15,1962,West Bromwich Albion,Arsenal,1-2,1,2,1,1,3,-1,A
1963-04-15,1962,Wolverhampton Wanderers,Aston Villa,3-1,3,1,1,1,4,2,H
1963-04-16,1962,Aston Villa,Wolverhampton Wanderers,0-2,0,2,1,1,2,-2,A
1963-04-16,1962,Birmingham City,Everton,0-1,0,1,1,1,1,-1,A
1963-04-16,1962,Leicester City,Manchester United,4-3,4,3,1,1,7,1,H
1963-04-16,1962,Sheffield United,Blackpool,0-0,0,0,1,1,0,0,D
1963-04-18,1962,Liverpool,Nottingham Forest,0-2,0,2,1,1,2,-2,A
1963-04-20,1962,Arsenal,Manchester City,2-3,2,3,1,1,5,-1,A
1963-04-20,1962,Birmingham City,Blackpool,3-6,3,6,1,1,9,-3,A
1963-04-20,1962,Bolton Wanderers,Aston Villa,4-1,4,1,1,1,5,3,H
1963-04-20,1962,Burnley,Nottingham Forest,0-0,0,0,1,1,0,0,D
1963-04-20,1962,Everton,Tottenham Hotspur,1-0,1,0,1,1,1,1,H
1963-04-20,1962,Fulham,Liverpool,0-0,0,0,1,1,0,0,D
1963-04-20,1962,Leicester City,Wolverhampton Wanderers,1-1,1,1,1,1,2,0,D
1963-04-20,1962,Leyton Orient,Blackburn Rovers,1-1,1,1,1,1,2,0,D
1963-04-20,1962,Manchester United,Sheffield United,1-1,1,1,1,1,2,0,D
1963-04-20,1962,Sheffield Wednesday,Ipswich Town,0-3,0,3,1,1,3,-3,A
1963-04-20,1962,West Bromwich Albion,West Ham United,1-0,1,0,1,1,1,1,H
1963-04-22,1962,Manchester United,Wolverhampton Wanderers,2-1,2,1,1,1,3,1,H
1963-04-22,1962,West Ham United,Nottingham Forest,4-1,4,1,1,1,5,3,H
1963-04-23,1962,Blackpool,Blackburn Rovers,4-1,4,1,1,1,5,3,H
1963-04-23,1962,Sheffield Wednesday,Burnley,0-1,0,1,1,1,1,-1,A
1963-04-24,1962,Bolton Wanderers,Birmingham City,0-0,0,0,1,1,0,0,D
1963-04-24,1962,Everton,Arsenal,1-1,1,1,1,1,2,0,D
1963-04-24,1962,Manchester City,Sheffield United,1-3,1,3,1,1,4,-2,A
1963-04-26,1962,Sheffield United,Leyton Orient,2-0,2,0,1,1,2,2,H
1963-04-27,1962,Blackburn Rovers,Birmingham City,6-1,6,1,1,1,7,5,H
1963-04-27,1962,Blackpool,Arsenal,3-2,3,2,1,1,5,1,H
1963-04-27,1962,Ipswich Town,Burnley,2-1,2,1,1,1,3,1,H
1963-04-27,1962,Manchester City,West Bromwich Albion,1-5,1,5,1,1,6,-4,A
1963-04-27,1962,Tottenham Hotspur,Bolton Wanderers,4-1,4,1,1,1,5,3,H
1963-04-27,1962,West Ham United,Everton,1-2,1,2,1,1,3,-1,A
1963-04-27,1962,Wolverhampton Wanderers,Fulham,2-1,2,1,1,1,3,1,H
1963-04-29,1962,Liverpool,Sheffield Wednesday,0-2,0,2,1,1,2,-2,A
1963-04-30,1962,Burnley,West Bromwich Albion,2-1,2,1,1,1,3,1,H
1963-04-30,1962,Nottingham Forest,Wolverhampton Wanderers,2-0,2,0,1,1,2,2,H
1963-05-01,1962,Birmingham City,West Ham United,3-2,3,2,1,1,5,1,H
1963-05-01,1962,Blackburn Rovers,Manchester City,4-1,4,1,1,1,5,3,H
1963-05-01,1962,Fulham,Bolton Wanderers,2-1,2,1,1,1,3,1,H
1963-05-01,1962,Manchester United,Sheffield Wednesday,1-3,1,3,1,1,4,-2,A
1963-05-01,1962,Sheffield United,Aston Villa,2-1,2,1,1,1,3,1,H
1963-05-02,1962,Leyton Orient,Liverpool,2-1,2,1,1,1,3,1,H
1963-05-04,1962,Aston Villa,Nottingham Forest,0-2,0,2,1,1,2,-2,A
1963-05-04,1962,Burnley,Manchester United,0-1,0,1,1,1,1,-1,A
1963-05-04,1962,Everton,Bolton Wanderers,1-0,1,0,1,1,1,1,H
1963-05-04,1962,Fulham,Birmingham City,3-3,3,3,1,1,6,0,D
1963-05-04,1962,Manchester City,Blackpool,0-3,0,3,1,1,3,-3,A
1963-05-04,1962,Sheffield Wednesday,Leyton Orient,3-1,3,1,1,1,4,2,H
1963-05-04,1962,Tottenham Hotspur,Sheffield United,4-2,4,2,1,1,6,2,H
1963-05-04,1962,West Bromwich Albion,Leicester City,2-1,2,1,1,1,3,1,H
1963-05-04,1962,West Ham United,Blackburn Rovers,0-1,0,1,1,1,1,-1,A
1963-05-04,1962,Wolverhampton Wanderers,Ipswich Town,0-0,0,0,1,1,0,0,D
1963-05-06,1962,Bolton Wanderers,Sheffield Wednesday,0-4,0,4,1,1,4,-4,A
1963-05-06,1962,Manchester United,Arsenal,2-3,2,3,1,1,5,-1,A
1963-05-07,1962,Leyton Orient,Burnley,0-1,0,1,1,1,1,-1,A
1963-05-07,1962,West Bromwich Albion,Everton,0-4,0,4,1,1,4,-4,A
1963-05-08,1962,Aston Villa,Manchester City,3-1,3,1,1,1,4,2,H
1963-05-08,1962,Liverpool,Birmingham City,5-1,5,1,1,1,6,4,H
1963-05-09,1962,Wolverhampton Wanderers,Blackpool,2-0,2,0,1,1,2,2,H
1963-05-10,1962,Birmingham City,Manchester United,2-1,2,1,1,1,3,1,H
1963-05-10,1962,Nottingham Forest,Ipswich Town,2-1,2,1,1,1,3,1,H
1963-05-11,1962,Arsenal,Burnley,2-3,2,3,1,1,5,-1,A
1963-05-11,1962,Bolton Wanderers,Leicester City,2-0,2,0,1,1,2,2,H
1963-05-11,1962,Everton,Fulham,4-1,4,1,1,1,5,3,H
1963-05-11,1962,Manchester City,Tottenham Hotspur,1-0,1,0,1,1,1,1,H
1963-05-11,1962,Sheffield United,Liverpool,0-0,0,0,1,1,0,0,D
1963-05-11,1962,West Bromwich Albion,Aston Villa,1-0,1,0,1,1,1,1,H
1963-05-11,1962,West Ham United,Leyton Orient,2-0,2,0,1,1,2,2,H
1963-05-13,1962,Blackburn Rovers,Wolverhampton Wanderers,5-1,5,1,1,1,6,4,H
1963-05-13,1962,Blackpool,West Ham United,0-0,0,0,1,1,0,0,D
1963-05-13,1962,Bolton Wanderers,Liverpool,1-0,1,0,1,1,1,1,H
1963-05-14,1962,Arsenal,Fulham,3-0,3,0,1,1,3,3,H
1963-05-14,1962,Burnley,Birmingham City,3-1,3,1,1,1,4,2,H
1963-05-14,1962,Nottingham Forest,West Bromwich Albion,2-2,2,2,1,1,4,0,D
1963-05-15,1962,Aston Villa,Leicester City,3-1,3,1,1,1,4,2,H
1963-05-15,1962,Manchester City,Manchester United,1-1,1,1,1,1,2,0,D
1963-05-15,1962,Sheffield Wednesday,Sheffield United,3-1,3,1,1,1,4,2,H
1963-05-17,1962,Ipswich Town,Bolton Wanderers,4-1,4,1,1,1,5,3,H
1963-05-18,1962,Aston Villa,Liverpool,2-0,2,0,1,1,2,2,H
1963-05-18,1962,Birmingham City,Leicester City,3-2,3,2,1,1,5,1,H
1963-05-18,1962,Fulham,West Bromwich Albion,1-2,1,2,1,1,3,-1,A
1963-05-18,1962,Manchester United,Leyton Orient,3-1,3,1,1,1,4,2,H
1963-05-18,1962,Nottingham Forest,Tottenham Hotspur,1-1,1,1,1,1,2,0,D
1963-05-18,1962,Sheffield Wednesday,Arsenal,2-3,2,3,1,1,5,-1,A
1963-05-18,1962,West Ham United,Manchester City,6-1,6,1,1,1,7,5,H
1963-05-20,1962,Blackburn Rovers,Tottenham Hotspur,3-0,3,0,1,1,3,3,H
1963-05-20,1962,Nottingham Forest,Manchester United,3-2,3,2,1,1,5,1,H
1963-05-21,1962,Ipswich Town,Aston Villa,1-1,1,1,1,1,2,0,D
1963-08-24,1963,Arsenal,Wolverhampton Wanderers,1-3,1,3,1,1,4,-2,A
1963-08-24,1963,Birmingham City,Bolton Wanderers,2-1,2,1,1,1,3,1,H
1963-08-24,1963,Blackburn Rovers,Liverpool,1-2,1,2,1,1,3,-1,A
1963-08-24,1963,Blackpool,Sheffield United,2-2,2,2,1,1,4,0,D
1963-08-24,1963,Chelsea,West Ham United,0-0,0,0,1,1,0,0,D
1963-08-24,1963,Everton,Fulham,3-0,3,0,1,1,3,3,H
1963-08-24,1963,Ipswich Town,Burnley,3-1,3,1,1,1,4,2,H
1963-08-24,1963,Nottingham Forest,Aston Villa,0-1,0,1,1,1,1,-1,A
1963-08-24,1963,Sheffield Wednesday,Manchester United,3-3,3,3,1,1,6,0,D
1963-08-24,1963,Stoke City,Tottenham Hotspur,2-1,2,1,1,1,3,1,H
1963-08-24,1963,West Bromwich Albion,Leicester City,1-1,1,1,1,1,2,0,D
1963-08-26,1963,Aston Villa,Stoke City,1-3,1,3,1,1,4,-2,A
1963-08-26,1963,West Ham United,Blackpool,3-1,3,1,1,1,4,2,H
1963-08-27,1963,Arsenal,West Bromwich Albion,3-2,3,2,1,1,5,1,H
1963-08-27,1963,Burnley,Chelsea,0-0,0,0,1,1,0,0,D
1963-08-28,1963,Fulham,Sheffield Wednesday,2-0,2,0,1,1,2,2,H
1963-08-28,1963,Leicester City,Birmingham City,3-0,3,0,1,1,3,3,H
1963-08-28,1963,Liverpool,Nottingham Forest,1-2,1,2,1,1,3,-1,A
1963-08-28,1963,Manchester United,Ipswich Town,2-0,2,0,1,1,2,2,H
1963-08-28,1963,Sheffield United,Blackburn Rovers,0-1,0,1,1,1,1,-1,A
1963-08-28,1963,Wolverhampton Wanderers,Tottenham Hotspur,1-4,1,4,1,1,5,-3,A
1963-08-30,1963,West Ham United,Ipswich Town,2-2,2,2,1,1,4,0,D
1963-08-31,1963,Aston Villa,Blackburn Rovers,1-2,1,2,1,1,3,-1,A
1963-08-31,1963,Bolton Wanderers,West Bromwich Albion,1-2,1,2,1,1,3,-1,A
1963-08-31,1963,Burnley,Sheffield Wednesday,3-1,3,1,1,1,4,2,H
1963-08-31,1963,Fulham,Birmingham City,2-1,2,1,1,1,3,1,H
1963-08-31,1963,Leicester City,Arsenal,7-2,7,2,1,1,9,5,H
1963-08-31,1963,Liverpool,Blackpool,1-2,1,2,1,1,3,-1,A
1963-08-31,1963,Manchester United,Everton,5-1,5,1,1,1,6,4,H
1963-08-31,1963,Sheffield United,Chelsea,1-1,1,1,1,1,2,0,D
1963-08-31,1963,Tottenham Hotspur,Nottingham Forest,4-1,4,1,1,1,5,3,H
1963-08-31,1963,Wolverhampton Wanderers,Stoke City,2-1,2,1,1,1,3,1,H
1963-09-02,1963,Blackpool,West Ham United,0-1,0,1,1,1,1,-1,A
1963-09-03,1963,Ipswich Town,Manchester United,2-7,2,7,1,1,9,-5,A
1963-09-03,1963,Nottingham Forest,Liverpool,0-0,0,0,1,1,0,0,D
1963-09-04,1963,Birmingham City,Leicester City,2-0,2,0,1,1,2,2,H
1963-09-04,1963,Blackburn Rovers,Sheffield United,2-2,2,2,1,1,4,0,D
1963-09-04,1963,Bolton Wanderers,Everton,1-3,1,3,1,1,4,-2,A
1963-09-04,1963,Chelsea,Burnley,2-0,2,0,1,1,2,2,H
1963-09-04,1963,Sheffield Wednesday,Fulham,3-0,3,0,1,1,3,3,H
1963-09-04,1963,Stoke City,Aston Villa,2-2,2,2,1,1,4,0,D
1963-09-04,1963,Tottenham Hotspur,Wolverhampton Wanderers,4-3,4,3,1,1,7,1,H
1963-09-04,1963,West Bromwich Albion,Arsenal,4-0,4,0,1,1,4,4,H
1963-09-07,1963,Arsenal,Bolton Wanderers,4-3,4,3,1,1,7,1,H
1963-09-07,1963,Birmingham City,Manchester United,1-1,1,1,1,1,2,0,D
1963-09-07,1963,Blackburn Rovers,Tottenham Hotspur,7-2,7,2,1,1,9,5,H
1963-09-07,1963,Blackpool,Aston Villa,0-4,0,4,1,1,4,-4,A
1963-09-07,1963,Chelsea,Liverpool,1-3,1,3,1,1,4,-2,A
1963-09-07,1963,Everton,Burnley,3-4,3,4,1,1,7,-1,A
1963-09-07,1963,Nottingham Forest,Wolverhampton Wanderers,3-0,3,0,1,1,3,3,H
1963-09-07,1963,Sheffield Wednesday,Ipswich Town,3-1,3,1,1,1,4,2,H
1963-09-07,1963,Stoke City,Leicester City,3-3,3,3,1,1,6,0,D
1963-09-07,1963,West Bromwich Albion,Fulham,3-0,3,0,1,1,3,3,H
1963-09-07,1963,West Ham United,Sheffield United,2-3,2,3,1,1,5,-1,A
1963-09-09,1963,West Ham United,Nottingham Forest,0-2,0,2,1,1,2,-2,A
1963-09-09,1963,Wolverhampton Wanderers,Liverpool,1-3,1,3,1,1,4,-2,A
1963-09-10,1963,Arsenal,Aston Villa,3-0,3,0,1,1,3,3,H
1963-09-10,1963,Burnley,Fulham,4-1,4,1,1,1,5,3,H
1963-09-11,1963,Birmingham City,West Bromwich Albion,0-1,0,1,1,1,1,-1,A
1963-09-11,1963,Chelsea,Blackburn Rovers,1-0,1,0,1,1,1,1,H
1963-09-11,1963,Everton,Bolton Wanderers,2-0,2,0,1,1,2,2,H
1963-09-11,1963,Leicester City,Sheffield Wednesday,2-0,2,0,1,1,2,2,H
1963-09-11,1963,Manchester United,Blackpool,3-0,3,0,1,1,3,3,H
1963-09-11,1963,Sheffield United,Stoke City,4-1,4,1,1,1,5,3,H
1963-09-14,1963,Aston Villa,Chelsea,2-0,2,0,1,1,2,2,H
1963-09-14,1963,Bolton Wanderers,Leicester City,0-0,0,0,1,1,0,0,D
1963-09-14,1963,Burnley,Birmingham City,2-1,2,1,1,1,3,1,H
1963-09-14,1963,Fulham,Arsenal,1-4,1,4,1,1,5,-3,A
1963-09-14,1963,Ipswich Town,Everton,0-0,0,0,1,1,0,0,D
1963-09-14,1963,Liverpool,West Ham United,1-2,1,2,1,1,3,-1,A
1963-09-14,1963,Manchester United,West Bromwich Albion,1-0,1,0,1,1,1,1,H
1963-09-14,1963,Sheffield United,Sheffield Wednesday,1-1,1,1,1,1,2,0,D
1963-09-14,1963,Stoke City,Nottingham Forest,0-1,0,1,1,1,1,-1,A
1963-09-14,1963,Tottenham Hotspur,Blackpool,6-1,6,1,1,1,7,5,H
1963-09-14,1963,Wolverhampton Wanderers,Blackburn Rovers,1-5,1,5,1,1,6,-4,A
1963-09-16,1963,Aston Villa,Tottenham Hotspur,2-4,2,4,1,1,6,-2,A
1963-09-16,1963,Blackburn Rovers,Chelsea,2-2,2,2,1,1,4,0,D
1963-09-16,1963,Blackpool,Manchester United,1-0,1,0,1,1,1,1,H
1963-09-16,1963,Liverpool,Wolverhampton Wanderers,6-0,6,0,1,1,6,6,H
1963-09-17,1963,Nottingham Forest,West Ham United,3-1,3,1,1,1,4,2,H
1963-09-18,1963,Bolton Wanderers,Ipswich Town,6-0,6,0,1,1,6,6,H
1963-09-18,1963,Fulham,Burnley,2-1,2,1,1,1,3,1,H
1963-09-18,1963,Stoke City,Sheffield United,0-2,0,2,1,1,2,-2,A
1963-09-18,1963,West Bromwich Albion,Birmingham City,3-1,3,1,1,1,4,2,H
1963-09-21,1963,Arsenal,Manchester United,2-1,2,1,1,1,3,1,H
1963-09-21,1963,Birmingham City,Ipswich Town,1-0,1,0,1,1,1,1,H
1963-09-21,1963,Blackburn Rovers,Stoke City,1-0,1,0,1,1,1,1,H
1963-09-21,1963,Blackpool,Wolverhampton Wanderers,1-2,1,2,1,1,3,-1,A
1963-09-21,1963,Chelsea,Tottenham Hotspur,0-3,0,3,1,1,3,-3,A
1963-09-21,1963,Everton,Sheffield Wednesday,3-2,3,2,1,1,5,1,H
1963-09-21,1963,Leicester City,Fulham,0-1,0,1,1,1,1,-1,A
1963-09-21,1963,Nottingham Forest,Bolton Wanderers,3-1,3,1,1,1,4,2,H
1963-09-21,1963,Sheffield United,Liverpool,3-0,3,0,1,1,3,3,H
1963-09-21,1963,West Bromwich Albion,Burnley,0-0,0,0,1,1,0,0,D
1963-09-21,1963,West Ham United,Aston Villa,0-1,0,1,1,1,1,-1,A
1963-09-28,1963,Aston Villa,Sheffield United,0-1,0,1,1,1,1,-1,A
1963-09-28,1963,Burnley,Arsenal,0-3,0,3,1,1,3,-3,A
1963-09-28,1963,Fulham,Bolton Wanderers,3-1,3,1,1,1,4,2,H
1963-09-28,1963,Ipswich Town,West Bromwich Albion,1-2,1,2,1,1,3,-1,A
1963-09-28,1963,Liverpool,Everton,2-1,2,1,1,1,3,1,H
1963-09-28,1963,Manchester United,Leicester City,3-1,3,1,1,1,4,2,H
1963-09-28,1963,Nottingham Forest,Blackburn Rovers,1-1,1,1,1,1,2,0,D
1963-09-28,1963,Sheffield Wednesday,Birmingham City,2-1,2,1,1,1,3,1,H
1963-09-28,1963,Stoke City,Blackpool,1-2,1,2,1,1,3,-1,A
1963-09-28,1963,Tottenham Hotspur,West Ham United,3-0,3,0,1,1,3,3,H
1963-09-28,1963,Wolverhampton Wanderers,Chelsea,4-1,4,1,1,1,5,3,H
1963-09-30,1963,Blackpool,Fulham,1-0,1,0,1,1,1,1,H
1963-10-01,1963,Burnley,Blackburn Rovers,3-0,3,0,1,1,3,3,H
1963-10-01,1963,Ipswich Town,Bolton Wanderers,1-3,1,3,1,1,4,-2,A
1963-10-02,1963,Chelsea,Manchester United,1-1,1,1,1,1,2,0,D
1963-10-02,1963,Everton,Arsenal,2-1,2,1,1,1,3,1,H
1963-10-02,1963,Sheffield Wednesday,Leicester City,1-2,1,2,1,1,3,-1,A
1963-10-02,1963,Tottenham Hotspur,Birmingham City,6-1,6,1,1,1,7,5,H
1963-10-02,1963,Wolverhampton Wanderers,West Bromwich Albion,0-0,0,0,1,1,0,0,D
1963-10-05,1963,Arsenal,Ipswich Town,6-0,6,0,1,1,6,6,H
1963-10-05,1963,Birmingham City,Everton,0-2,0,2,1,1,2,-2,A
1963-10-05,1963,Blackburn Rovers,Fulham,2-0,2,0,1,1,2,2,H
1963-10-05,1963,Blackpool,Nottingham Forest,1-0,1,0,1,1,1,1,H
1963-10-05,1963,Bolton Wanderers,Manchester United,0-1,0,1,1,1,1,-1,A
1963-10-05,1963,Chelsea,Stoke City,3-3,3,3,1,1,6,0,D
1963-10-05,1963,Leicester City,Burnley,0-0,0,0,1,1,0,0,D
1963-10-05,1963,Liverpool,Aston Villa,5-2,5,2,1,1,7,3,H
1963-10-05,1963,Sheffield United,Tottenham Hotspur,3-3,3,3,1,1,6,0,D
1963-10-05,1963,West Bromwich Albion,Sheffield Wednesday,1-3,1,3,1,1,4,-2,A
1963-10-05,1963,West Ham United,Wolverhampton Wanderers,1-1,1,1,1,1,2,0,D
1963-10-07,1963,Aston Villa,Everton,0-1,0,1,1,1,1,-1,A
1963-10-07,1963,West Ham United,Burnley,1-1,1,1,1,1,2,0,D
1963-10-08,1963,Nottingham Forest,Leicester City,2-0,2,0,1,1,2,2,H
1963-10-09,1963,Blackburn Rovers,Bolton Wanderers,3-0,3,0,1,1,3,3,H
1963-10-09,1963,Liverpool,Sheffield Wednesday,3-1,3,1,1,1,4,2,H
1963-10-09,1963,Sheffield United,Ipswich Town,3-1,3,1,1,1,4,2,H
1963-10-09,1963,Stoke City,Arsenal,1-2,1,2,1,1,3,-1,A
1963-10-12,1963,Bolton Wanderers,Stoke City,3-4,3,4,1,1,7,-1,A
1963-10-12,1963,Burnley,Blackpool,1-0,1,0,1,1,1,1,H
1963-10-12,1963,Fulham,Nottingham Forest,0-0,0,0,1,1,0,0,D
1963-10-12,1963,Ipswich Town,Chelsea,1-3,1,3,1,1,4,-2,A
1963-10-12,1963,Sheffield Wednesday,West Ham United,3-0,3,0,1,1,3,3,H
1963-10-12,1963,West Bromwich Albion,Aston Villa,4-3,4,3,1,1,7,1,H
1963-10-14,1963,Leicester City,Wolverhampton Wanderers,0-1,0,1,1,1,1,-1,A
1963-10-15,1963,Arsenal,Tottenham Hotspur,4-4,4,4,1,1,8,0,D
1963-10-15,1963,Everton,Sheffield United,4-1,4,1,1,1,5,3,H
1963-10-19,1963,Aston Villa,Arsenal,2-1,2,1,1,1,3,1,H
1963-10-19,1963,Blackburn Rovers,Burnley,1-2,1,2,1,1,3,-1,A
1963-10-19,1963,Blackpool,Ipswich Town,2-2,2,2,1,1,4,0,D
1963-10-19,1963,Chelsea,Sheffield Wednesday,1-2,1,2,1,1,3,-1,A
1963-10-19,1963,Liverpool,West Bromwich Albion,1-0,1,0,1,1,1,1,H
1963-10-19,1963,Nottingham Forest,Manchester United,1-2,1,2,1,1,3,-1,A
1963-10-19,1963,Sheffield United,Birmingham City,3-0,3,0,1,1,3,3,H
1963-10-19,1963,Stoke City,Fulham,1-1,1,1,1,1,2,0,D
1963-10-19,1963,Tottenham Hotspur,Leicester City,1-1,1,1,1,1,2,0,D
1963-10-19,1963,West Ham United,Everton,4-2,4,2,1,1,6,2,H
1963-10-19,1963,Wolverhampton Wanderers,Bolton Wanderers,2-2,2,2,1,1,4,0,D
1963-10-26,1963,Arsenal,Nottingham Forest,4-2,4,2,1,1,6,2,H
1963-10-26,1963,Birmingham City,Wolverhampton Wanderers,2-2,2,2,1,1,4,0,D
1963-10-26,1963,Bolton Wanderers,Blackpool,1-1,1,1,1,1,2,0,D
1963-10-26,1963,Burnley,Sheffield United,1-2,1,2,1,1,3,-1,A
1963-10-26,1963,Everton,Tottenham Hotspur,1-0,1,0,1,1,1,1,H
1963-10-26,1963,Fulham,Chelsea,0-1,0,1,1,1,1,-1,A
1963-10-26,1963,Ipswich Town,Liverpool,1-2,1,2,1,1,3,-1,A
1963-10-26,1963,Leicester City,Blackburn Rovers,4-3,4,3,1,1,7,1,H
1963-10-26,1963,Manchester United,West Ham United,0-1,0,1,1,1,1,-1,A
1963-10-26,1963,Sheffield Wednesday,Aston Villa,1-0,1,0,1,1,1,1,H
1963-10-26,1963,West Bromwich Albion,Stoke City,2-3,2,3,1,1,5,-1,A
1963-10-28,1963,Manchester United,Blackburn Rovers,2-2,2,2,1,1,4,0,D
1963-11-02,1963,Aston Villa,Bolton Wanderers,3-0,3,0,1,1,3,3,H
1963-11-02,1963,Blackburn Rovers,Sheffield Wednesday,1-1,1,1,1,1,2,0,D
1963-11-02,1963,Blackpool,Everton,1-1,1,1,1,1,2,0,D
1963-11-02,1963,Chelsea,Birmingham City,2-3,2,3,1,1,5,-1,A
1963-11-02,1963,Liverpool,Leicester City,0-1,0,1,1,1,1,-1,A
1963-11-02,1963,Nottingham Forest,Ipswich Town,3-1,3,1,1,1,4,2,H
1963-11-02,1963,Sheffield United,Arsenal,2-2,2,2,1,1,4,0,D
1963-11-02,1963,Stoke City,Burnley,4-4,4,4,1,1,8,0,D
1963-11-02,1963,Tottenham Hotspur,Fulham,1-0,1,0,1,1,1,1,H
1963-11-02,1963,West Ham United,West Bromwich Albion,4-2,4,2,1,1,6,2,H
1963-11-02,1963,Wolverhampton Wanderers,Manchester United,2-0,2,0,1,1,2,2,H
1963-11-05,1963,Arsenal,Birmingham City,4-1,4,1,1,1,5,3,H
1963-11-09,1963,Arsenal,West Ham United,3-3,3,3,1,1,6,0,D
1963-11-09,1963,Birmingham City,Blackpool,3-2,3,2,1,1,5,1,H
1963-11-09,1963,Bolton Wanderers,Liverpool,1-2,1,2,1,1,3,-1,A
1963-11-09,1963,Burnley,Wolverhampton Wanderers,1-0,1,0,1,1,1,1,H
1963-11-09,1963,Everton,Blackburn Rovers,2-4,2,4,1,1,6,-2,A
1963-11-09,1963,Fulham,Aston Villa,2-0,2,0,1,1,2,2,H
1963-11-09,1963,Ipswich Town,Stoke City,0-2,0,2,1,1,2,-2,A
1963-11-09,1963,Leicester City,Sheffield United,0-1,0,1,1,1,1,-1,A
1963-11-09,1963,Manchester United,Tottenham Hotspur,4-1,4,1,1,1,5,3,H
1963-11-09,1963,Sheffield Wednesday,Nottingham Forest,3-1,3,1,1,1,4,2,H
1963-11-09,1963,West Bromwich Albion,Chelsea,1-1,1,1,1,1,2,0,D
1963-11-16,1963,Aston Villa,Manchester United,4-0,4,0,1,1,4,4,H
1963-11-16,1963,Blackburn Rovers,Birmingham City,3-0,3,0,1,1,3,3,H
1963-11-16,1963,Blackpool,West Bromwich Albion,1-0,1,0,1,1,1,1,H
1963-11-16,1963,Chelsea,Arsenal,3-1,3,1,1,1,4,2,H
1963-11-16,1963,Liverpool,Fulham,2-0,2,0,1,1,2,2,H
1963-11-16,1963,Nottingham Forest,Everton,2-2,2,2,1,1,4,0,D
1963-11-16,1963,Sheffield United,Bolton Wanderers,0-1,0,1,1,1,1,-1,A
1963-11-16,1963,Stoke City,Sheffield Wednesday,4-4,4,4,1,1,8,0,D
1963-11-16,1963,Tottenham Hotspur,Burnley,3-2,3,2,1,1,5,1,H
1963-11-16,1963,West Ham United,Leicester City,2-2,2,2,1,1,4,0,D
1963-11-16,1963,Wolverhampton Wanderers,Ipswich Town,2-1,2,1,1,1,3,1,H
1963-11-23,1963,Arsenal,Blackpool,5-3,5,3,1,1,8,2,H
1963-11-23,1963,Birmingham City,Nottingham Forest,3-3,3,3,1,1,6,0,D
1963-11-23,1963,Bolton Wanderers,West Ham United,1-1,1,1,1,1,2,0,D
1963-11-23,1963,Burnley,Aston Villa,2-0,2,0,1,1,2,2,H
1963-11-23,1963,Everton,Stoke City,2-0,2,0,1,1,2,2,H
1963-11-23,1963,Fulham,Sheffield United,3-1,3,1,1,1,4,2,H
1963-11-23,1963,Ipswich Town,Tottenham Hotspur,2-3,2,3,1,1,5,-1,A
1963-11-23,1963,Leicester City,Chelsea,2-4,2,4,1,1,6,-2,A
1963-11-23,1963,Manchester United,Liverpool,0-1,0,1,1,1,1,-1,A
1963-11-23,1963,Sheffield Wednesday,Wolverhampton Wanderers,5-0,5,0,1,1,5,5,H
1963-11-23,1963,West Bromwich Albion,Blackburn Rovers,1-3,1,3,1,1,4,-2,A
1963-11-30,1963,Aston Villa,Ipswich Town,0-0,0,0,1,1,0,0,D
1963-11-30,1963,Blackburn Rovers,Arsenal,4-1,4,1,1,1,5,3,H
1963-11-30,1963,Blackpool,Leicester City,3-3,3,3,1,1,6,0,D
1963-11-30,1963,Chelsea,Bolton Wanderers,4-0,4,0,1,1,4,4,H
1963-11-30,1963,Liverpool,Burnley,2-0,2,0,1,1,2,2,H
1963-11-30,1963,Nottingham Forest,West Bromwich Albion,0-3,0,3,1,1,3,-3,A
1963-11-30,1963,Sheffield United,Manchester United,1-2,1,2,1,1,3,-1,A
1963-11-30,1963,Stoke City,Birmingham City,4-1,4,1,1,1,5,3,H
1963-11-30,1963,Tottenham Hotspur,Sheffield Wednesday,1-1,1,1,1,1,2,0,D
1963-11-30,1963,West Ham United,Fulham,1-1,1,1,1,1,2,0,D
1963-11-30,1963,Wolverhampton Wanderers,Everton,0-0,0,0,1,1,0,0,D
1963-12-07,1963,Arsenal,Liverpool,1-1,1,1,1,1,2,0,D
1963-12-07,1963,Birmingham City,West Ham United,2-1,2,1,1,1,3,1,H
1963-12-07,1963,Bolton Wanderers,Tottenham Hotspur,1-3,1,3,1,1,4,-2,A
1963-12-07,1963,Burnley,Nottingham Forest,1-1,1,1,1,1,2,0,D
1963-12-07,1963,Everton,Chelsea,1-1,1,1,1,1,2,0,D
1963-12-07,1963,Fulham,Wolverhampton Wanderers,4-1,4,1,1,1,5,3,H
1963-12-07,1963,Ipswich Town,Blackburn Rovers,0-0,0,0,1,1,0,0,D
1963-12-07,1963,Leicester City,Aston Villa,0-0,0,0,1,1,0,0,D
1963-12-07,1963,Manchester United,Stoke City,5-2,5,2,1,1,7,3,H
1963-12-07,1963,Sheffield Wednesday,Blackpool,1-0,1,0,1,1,1,1,H
1963-12-07,1963,West Bromwich Albion,Sheffield United,2-0,2,0,1,1,2,2,H
1963-12-10,1963,Arsenal,Everton,6-0,6,0,1,1,6,6,H
1963-12-14,1963,Aston Villa,Nottingham Forest,3-0,3,0,1,1,3,3,H
1963-12-14,1963,Bolton Wanderers,Birmingham City,0-2,0,2,1,1,2,-2,A
1963-12-14,1963,Burnley,Ipswich Town,3-1,3,1,1,1,4,2,H
1963-12-14,1963,Fulham,Everton,2-2,2,2,1,1,4,0,D
1963-12-14,1963,Leicester City,West Bromwich Albion,0-2,0,2,1,1,2,-2,A
1963-12-14,1963,Liverpool,Blackburn Rovers,1-2,1,2,1,1,3,-1,A
1963-12-14,1963,Manchester United,Sheffield Wednesday,3-1,3,1,1,1,4,2,H
1963-12-14,1963,Sheffield United,Blackpool,1-0,1,0,1,1,1,1,H
1963-12-14,1963,Tottenham Hotspur,Stoke City,2-1,2,1,1,1,3,1,H
1963-12-14,1963,West Ham United,Chelsea,2-2,2,2,1,1,4,0,D
1963-12-14,1963,Wolverhampton Wanderers,Arsenal,2-2,2,2,1,1,4,0,D
1963-12-20,1963,Ipswich Town,West Ham United,3-2,3,2,1,1,5,1,H
1963-12-21,1963,Arsenal,Leicester City,0-1,0,1,1,1,1,-1,A
1963-12-21,1963,Birmingham City,Fulham,0-0,0,0,1,1,0,0,D
1963-12-21,1963,Blackburn Rovers,Aston Villa,2-0,2,0,1,1,2,2,H
1963-12-21,1963,Blackpool,Liverpool,0-1,0,1,1,1,1,-1,A
1963-12-21,1963,Chelsea,Sheffield United,3-2,3,2,1,1,5,1,H
1963-12-21,1963,Everton,Manchester United,4-0,4,0,1,1,4,4,H
1963-12-21,1963,Nottingham Forest,Tottenham Hotspur,1-2,1,2,1,1,3,-1,A
1963-12-21,1963,Sheffield Wednesday,Burnley,3-1,3,1,1,1,4,2,H
1963-12-21,1963,Stoke City,Wolverhampton Wanderers,0-2,0,2,1,1,2,-2,A
1963-12-21,1963,West Bromwich Albion,Bolton Wanderers,1-1,1,1,1,1,2,0,D
1963-12-26,1963,Blackpool,Chelsea,1-5,1,5,1,1,6,-4,A
1963-12-26,1963,Burnley,Manchester United,6-1,6,1,1,1,7,5,H
1963-12-26,1963,Fulham,Ipswich Town,10-1,10,1,1,1,11,9,H
1963-12-26,1963,Leicester City,Everton,2-0,2,0,1,1,2,2,H
1963-12-26,1963,Liverpool,Stoke City,6-1,6,1,1,1,7,5,H
1963-12-26,1963,Nottingham Forest,Sheffield United,3-3,3,3,1,1,6,0,D
1963-12-26,1963,Sheffield Wednesday,Bolton Wanderers,3-0,3,0,1,1,3,3,H
1963-12-26,1963,West Bromwich Albion,Tottenham Hotspur,4-4,4,4,1,1,8,0,D
1963-12-26,1963,West Ham United,Blackburn Rovers,2-8,2,8,1,1,10,-6,A
1963-12-26,1963,Wolverhampton Wanderers,Aston Villa,3-3,3,3,1,1,6,0,D
1963-12-28,1963,Aston Villa,Wolverhampton Wanderers,2-2,2,2,1,1,4,0,D
1963-12-28,1963,Birmingham City,Arsenal,1-4,1,4,1,1,5,-3,A
1963-12-28,1963,Blackburn Rovers,West Ham United,1-3,1,3,1,1,4,-2,A
1963-12-28,1963,Bolton Wanderers,Sheffield Wednesday,3-0,3,0,1,1,3,3,H
1963-12-28,1963,Chelsea,Blackpool,1-0,1,0,1,1,1,1,H
1963-12-28,1963,Everton,Leicester City,0-3,0,3,1,1,3,-3,A
1963-12-28,1963,Ipswich Town,Fulham,4-2,4,2,1,1,6,2,H
1963-12-28,1963,Manchester United,Burnley,5-1,5,1,1,1,6,4,H
1963-12-28,1963,Sheffield United,Nottingham Forest,1-2,1,2,1,1,3,-1,A
1963-12-28,1963,Tottenham Hotspur,West Bromwich Albion,0-2,0,2,1,1,2,-2,A
1964-01-11,1963,Aston Villa,Blackpool,3-1,3,1,1,1,4,2,H
1964-01-11,1963,Bolton Wanderers,Arsenal,1-1,1,1,1,1,2,0,D
1964-01-11,1963,Burnley,Everton,2-3,2,3,1,1,5,-1,A
1964-01-11,1963,Fulham,West Bromwich Albion,1-1,1,1,1,1,2,0,D
1964-01-11,1963,Ipswich Town,Sheffield Wednesday,1-4,1,4,1,1,5,-3,A
1964-01-11,1963,Leicester City,Stoke City,2-1,2,1,1,1,3,1,H
1964-01-11,1963,Liverpool,Chelsea,2-1,2,1,1,1,3,1,H
1964-01-11,1963,Manchester United,Birmingham City,1-2,1,2,1,1,3,-1,A
1964-01-11,1963,Sheffield United,West Ham United,2-1,2,1,1,1,3,1,H
1964-01-11,1963,Tottenham Hotspur,Blackburn Rovers,4-1,4,1,1,1,5,3,H
1964-01-11,1963,Wolverhampton Wanderers,Nottingham Forest,2-3,2,3,1,1,5,-1,A
1964-01-18,1963,Arsenal,Fulham,2-2,2,2,1,1,4,0,D
1964-01-18,1963,Birmingham City,Burnley,0-0,0,0,1,1,0,0,D
1964-01-18,1963,Blackburn Rovers,Wolverhampton Wanderers,1-1,1,1,1,1,2,0,D
1964-01-18,1963,Blackpool,Tottenham Hotspur,0-2,0,2,1,1,2,-2,A
1964-01-18,1963,Chelsea,Aston Villa,1-0,1,0,1,1,1,1,H
1964-01-18,1963,Everton,Ipswich Town,1-1,1,1,1,1,2,0,D
1964-01-18,1963,Leicester City,Bolton Wanderers,1-0,1,0,1,1,1,1,H
1964-01-18,1963,Nottingham Forest,Stoke City,0-0,0,0,1,1,0,0,D
1964-01-18,1963,Sheffield Wednesday,Sheffield United,3-0,3,0,1,1,3,3,H
1964-01-18,1963,West Bromwich Albion,Manchester United,1-4,1,4,1,1,5,-3,A
1964-01-18,1963,West Ham United,Liverpool,1-0,1,0,1,1,1,1,H
1964-01-25,1963,Tottenham Hotspur,Aston Villa,3-1,3,1,1,1,4,2,H
1964-02-01,1963,Aston Villa,West Ham United,2-2,2,2,1,1,4,0,D
1964-02-01,1963,Bolton Wanderers,Nottingham Forest,2-3,2,3,1,1,5,-1,A
1964-02-01,1963,Burnley,West Bromwich Albion,3-2,3,2,1,1,5,1,H
1964-02-01,1963,Fulham,Leicester City,2-1,2,1,1,1,3,1,H
1964-02-01,1963,Ipswich Town,Birmingham City,3-2,3,2,1,1,5,1,H
1964-02-01,1963,Liverpool,Sheffield United,6-1,6,1,1,1,7,5,H
1964-02-01,1963,Manchester United,Arsenal,3-1,3,1,1,1,4,2,H
1964-02-01,1963,Sheffield Wednesday,Everton,0-3,0,3,1,1,3,-3,A
1964-02-01,1963,Stoke City,Blackburn Rovers,3-1,3,1,1,1,4,2,H
1964-02-01,1963,Tottenham Hotspur,Chelsea,1-2,1,2,1,1,3,-1,A
1964-02-01,1963,Wolverhampton Wanderers,Blackpool,1-1,1,1,1,1,2,0,D
1964-02-08,1963,Arsenal,Burnley,3-2,3,2,1,1,5,1,H
1964-02-08,1963,Birmingham City,Sheffield Wednesday,1-2,1,2,1,1,3,-1,A
1964-02-08,1963,Blackburn Rovers,Nottingham Forest,2-0,2,0,1,1,2,2,H
1964-02-08,1963,Blackpool,Stoke City,1-0,1,0,1,1,1,1,H
1964-02-08,1963,Bolton Wanderers,Fulham,2-1,2,1,1,1,3,1,H
1964-02-08,1963,Chelsea,Wolverhampton Wanderers,2-3,2,3,1,1,5,-1,A
1964-02-08,1963,Everton,Liverpool,3-1,3,1,1,1,4,2,H
1964-02-08,1963,Leicester City,Manchester United,3-2,3,2,1,1,5,1,H
1964-02-08,1963,Sheffield United,Aston Villa,1-1,1,1,1,1,2,0,D
1964-02-08,1963,West Bromwich Albion,Ipswich Town,2-1,2,1,1,1,3,1,H
1964-02-08,1963,West Ham United,Tottenham Hotspur,4-0,4,0,1,1,4,4,H
1964-02-15,1963,Nottingham Forest,Blackpool,0-1,0,1,1,1,1,-1,A
1964-02-15,1963,Sheffield Wednesday,West Bromwich Albion,2-2,2,2,1,1,4,0,D
1964-02-15,1963,Tottenham Hotspur,Sheffield United,0-0,0,0,1,1,0,0,D
1964-02-17,1963,Wolverhampton Wanderers,West Ham United,0-2,0,2,1,1,2,-2,A
1964-02-18,1963,Everton,Birmingham City,3-0,3,0,1,1,3,3,H
1964-02-18,1963,Ipswich Town,Arsenal,1-2,1,2,1,1,3,-1,A
1964-02-19,1963,Aston Villa,Liverpool,2-2,2,2,1,1,4,0,D
1964-02-19,1963,Fulham,Blackburn Rovers,1-1,1,1,1,1,2,0,D
1964-02-19,1963,Manchester United,Bolton Wanderers,5-0,5,0,1,1,5,5,H
1964-02-22,1963,Aston Villa,West Bromwich Albion,1-0,1,0,1,1,1,1,H
1964-02-22,1963,Blackburn Rovers,Manchester United,1-3,1,3,1,1,4,-2,A
1964-02-22,1963,Blackpool,Burnley,1-1,1,1,1,1,2,0,D
1964-02-22,1963,Chelsea,Ipswich Town,4-0,4,0,1,1,4,4,H
1964-02-22,1963,Liverpool,Birmingham City,2-1,2,1,1,1,3,1,H
1964-02-22,1963,Nottingham Forest,Fulham,2-0,2,0,1,1,2,2,H
1964-02-22,1963,Sheffield United,Everton,0-0,0,0,1,1,0,0,D
1964-02-22,1963,Stoke City,Bolton Wanderers,0-1,0,1,1,1,1,-1,A
1964-02-22,1963,Tottenham Hotspur,Arsenal,3-1,3,1,1,1,4,2,H
1964-02-22,1963,West Ham United,Sheffield Wednesday,4-3,4,3,1,1,7,1,H
1964-02-22,1963,Wolverhampton Wanderers,Leicester City,1-2,1,2,1,1,3,-1,A
1964-02-28,1963,Everton,Aston Villa,4-2,4,2,1,1,6,2,H
1964-02-29,1963,Arsenal,Stoke City,1-1,1,1,1,1,2,0,D
1964-02-29,1963,Birmingham City,Tottenham Hotspur,1-2,1,2,1,1,3,-1,A
1964-02-29,1963,Bolton Wanderers,Blackburn Rovers,0-5,0,5,1,1,5,-5,A
1964-02-29,1963,Fulham,Blackpool,1-1,1,1,1,1,2,0,D
1964-02-29,1963,Ipswich Town,Sheffield United,1-0,1,0,1,1,1,1,H
1964-02-29,1963,Leicester City,Nottingham Forest,1-1,1,1,1,1,2,0,D
1964-02-29,1963,Sheffield Wednesday,Chelsea,3-2,3,2,1,1,5,1,H
1964-02-29,1963,West Bromwich Albion,Wolverhampton Wanderers,3-1,3,1,1,1,4,2,H
1964-03-03,1963,Burnley,West Ham United,3-1,3,1,1,1,4,2,H
1964-03-04,1963,Sheffield Wednesday,Liverpool,2-2,2,2,1,1,4,0,D
1964-03-04,1963,Stoke City,Chelsea,2-0,2,0,1,1,2,2,H
1964-03-07,1963,Aston Villa,Sheffield Wednesday,2-2,2,2,1,1,4,0,D
1964-03-07,1963,Blackburn Rovers,Leicester City,5-2,5,2,1,1,7,3,H
1964-03-07,1963,Blackpool,Bolton Wanderers,2-0,2,0,1,1,2,2,H
1964-03-07,1963,Chelsea,Fulham,1-2,1,2,1,1,3,-1,A
1964-03-07,1963,Liverpool,Ipswich Town,6-0,6,0,1,1,6,6,H
1964-03-07,1963,Nottingham Forest,Arsenal,2-0,2,0,1,1,2,2,H
1964-03-07,1963,Sheffield United,Burnley,2-0,2,0,1,1,2,2,H
1964-03-07,1963,Stoke City,West Bromwich Albion,1-1,1,1,1,1,2,0,D
1964-03-07,1963,Tottenham Hotspur,Everton,2-4,2,4,1,1,6,-2,A
1964-03-07,1963,West Ham United,Manchester United,0-2,0,2,1,1,2,-2,A
1964-03-07,1963,Wolverhampton Wanderers,Birmingham City,5-1,5,1,1,1,6,4,H
1964-03-10,1963,Burnley,Leicester City,2-0,2,0,1,1,2,2,H
1964-03-13,1963,Birmingham City,Blackburn Rovers,2-2,2,2,1,1,4,0,D
1964-03-13,1963,West Bromwich Albion,Blackpool,2-1,2,1,1,1,3,1,H
1964-03-14,1963,Arsenal,Chelsea,2-4,2,4,1,1,6,-2,A
1964-03-14,1963,Everton,Nottingham Forest,6-1,6,1,1,1,7,5,H
1964-03-14,1963,Fulham,Liverpool,1-0,1,0,1,1,1,1,H
1964-03-18,1963,Leicester City,West Ham United,2-2,2,2,1,1,4,0,D
1964-03-20,1963,Blackpool,Birmingham City,3-0,3,0,1,1,3,3,H
1964-03-20,1963,Liverpool,Bolton Wanderers,2-0,2,0,1,1,2,2,H
1964-03-21,1963,Aston Villa,Fulham,2-2,2,2,1,1,4,0,D
1964-03-21,1963,Blackburn Rovers,Everton,1-2,1,2,1,1,3,-1,A
1964-03-21,1963,Chelsea,West Bromwich Albion,3-1,3,1,1,1,4,2,H
1964-03-21,1963,Nottingham Forest,Sheffield Wednesday,3-2,3,2,1,1,5,1,H
1964-03-21,1963,Sheffield United,Leicester City,0-1,0,1,1,1,1,-1,A
1964-03-21,1963,Stoke City,Ipswich Town,9-1,9,1,1,1,10,8,H
1964-03-21,1963,Tottenham Hotspur,Manchester United,2-3,2,3,1,1,5,-1,A
1964-03-21,1963,West Ham United,Arsenal,1-1,1,1,1,1,2,0,D
1964-03-21,1963,Wolverhampton Wanderers,Burnley,1-1,1,1,1,1,2,0,D
1964-03-23,1963,Manchester United,Chelsea,1-1,1,1,1,1,2,0,D
1964-03-24,1963,Arsenal,Sheffield Wednesday,1-1,1,1,1,1,2,0,D
1964-03-27,1963,Blackburn Rovers,Blackpool,1-2,1,2,1,1,3,-1,A
1964-03-27,1963,Everton,West Bromwich Albion,1-1,1,1,1,1,2,0,D
1964-03-27,1963,Fulham,Manchester United,2-2,2,2,1,1,4,0,D
1964-03-27,1963,Tottenham Hotspur,Liverpool,1-3,1,3,1,1,4,-2,A
1964-03-27,1963,West Ham United,Stoke City,4-1,4,1,1,1,5,3,H
1964-03-28,1963,Arsenal,Sheffield United,1-3,1,3,1,1,4,-2,A
1964-03-28,1963,Birmingham City,Chelsea,3-4,3,4,1,1,7,-1,A
1964-03-28,1963,Bolton Wanderers,Aston Villa,1-1,1,1,1,1,2,0,D
1964-03-28,1963,Burnley,Stoke City,1-0,1,0,1,1,1,1,H
1964-03-28,1963,Everton,Blackpool,3-1,3,1,1,1,4,2,H
1964-03-28,1963,Fulham,Tottenham Hotspur,1-1,1,1,1,1,2,0,D
1964-03-28,1963,Ipswich Town,Nottingham Forest,4-3,4,3,1,1,7,1,H
1964-03-28,1963,Leicester City,Liverpool,0-2,0,2,1,1,2,-2,A
1964-03-28,1963,Manchester United,Wolverhampton Wanderers,2-2,2,2,1,1,4,0,D
1964-03-28,1963,Sheffield Wednesday,Blackburn Rovers,5-2,5,2,1,1,7,3,H
1964-03-28,1963,West Bromwich Albion,West Ham United,0-1,0,1,1,1,1,-1,A
1964-03-30,1963,Aston Villa,Birmingham City,0-3,0,3,1,1,3,-3,A
1964-03-30,1963,Blackpool,Blackburn Rovers,3-2,3,2,1,1,5,1,H
1964-03-30,1963,Bolton Wanderers,Burnley,2-1,2,1,1,1,3,1,H
1964-03-30,1963,Chelsea,Nottingham Forest,1-0,1,0,1,1,1,1,H
1964-03-30,1963,Ipswich Town,Leicester City,1-1,1,1,1,1,2,0,D
1964-03-30,1963,Liverpool,Tottenham Hotspur,3-1,3,1,1,1,4,2,H
1964-03-30,1963,Manchester United,Fulham,3-0,3,0,1,1,3,3,H
1964-03-30,1963,Sheffield Wednesday,Arsenal,0-4,0,4,1,1,4,-4,A
1964-03-30,1963,Wolverhampton Wanderers,Sheffield United,1-1,1,1,1,1,2,0,D
1964-03-31,1963,Birmingham City,Aston Villa,3-3,3,3,1,1,6,0,D
1964-03-31,1963,Burnley,Bolton Wanderers,1-1,1,1,1,1,2,0,D
1964-03-31,1963,Leicester City,Ipswich Town,2-1,2,1,1,1,3,1,H
1964-03-31,1963,Nottingham Forest,Chelsea,0-1,0,1,1,1,1,-1,A
1964-03-31,1963,Sheffield United,Wolverhampton Wanderers,4-3,4,3,1,1,7,1,H
1964-03-31,1963,Stoke City,West Ham United,3-0,3,0,1,1,3,3,H
1964-03-31,1963,West Bromwich Albion,Everton,4-2,4,2,1,1,6,2,H
1964-04-04,1963,Aston Villa,Burnley,2-0,2,0,1,1,2,2,H
1964-04-04,1963,Blackburn Rovers,West Bromwich Albion,0-2,0,2,1,1,2,-2,A
1964-04-04,1963,Blackpool,Arsenal,0-1,0,1,1,1,1,-1,A
1964-04-04,1963,Liverpool,Manchester United,3-0,3,0,1,1,3,3,H
1964-04-04,1963,Nottingham Forest,Birmingham City,4-0,4,0,1,1,4,4,H
1964-04-04,1963,Sheffield United,Fulham,1-0,1,0,1,1,1,1,H
1964-04-04,1963,Stoke City,Everton,3-2,3,2,1,1,5,1,H
1964-04-04,1963,Tottenham Hotspur,Ipswich Town,6-3,6,3,1,1,9,3,H
1964-04-04,1963,West Ham United,Bolton Wanderers,2-3,2,3,1,1,5,-1,A
1964-04-04,1963,Wolverhampton Wanderers,Sheffield Wednesday,1-1,1,1,1,1,2,0,D
1964-04-06,1963,Chelsea,Leicester City,1-0,1,0,1,1,1,1,H
1964-04-06,1963,Manchester United,Aston Villa,1-0,1,0,1,1,1,1,H
1964-04-08,1963,Bolton Wanderers,Sheffield United,3-0,3,0,1,1,3,3,H
1964-04-08,1963,Sheffield Wednesday,Stoke City,2-0,2,0,1,1,2,2,H
1964-04-11,1963,Arsenal,Blackburn Rovers,0-0,0,0,1,1,0,0,D
1964-04-11,1963,Birmingham City,Stoke City,0-1,0,1,1,1,1,-1,A
1964-04-11,1963,Bolton Wanderers,Chelsea,1-0,1,0,1,1,1,1,H
1964-04-11,1963,Everton,Wolverhampton Wanderers,3-3,3,3,1,1,6,0,D
1964-04-11,1963,Fulham,West Ham United,2-0,2,0,1,1,2,2,H
1964-04-11,1963,Ipswich Town,Aston Villa,4-3,4,3,1,1,7,1,H
1964-04-11,1963,Leicester City,Blackpool,2-3,2,3,1,1,5,-1,A
1964-04-11,1963,West Bromwich Albion,Nottingham Forest,2-3,2,3,1,1,5,-1,A
1964-04-13,1963,Manchester United,Sheffield United,2-1,2,1,1,1,3,1,H
1964-04-13,1963,Sheffield Wednesday,Tottenham Hotspur,2-0,2,0,1,1,2,2,H
1964-04-14,1963,Burnley,Liverpool,0-3,0,3,1,1,3,-3,A
1964-04-14,1963,Ipswich Town,Wolverhampton Wanderers,1-0,1,0,1,1,1,1,H
1964-04-17,1963,West Ham United,Birmingham City,5-0,5,0,1,1,5,5,H
1964-04-18,1963,Aston Villa,Leicester City,1-3,1,3,1,1,4,-2,A
1964-04-18,1963,Blackburn Rovers,Ipswich Town,3-1,3,1,1,1,4,2,H
1964-04-18,1963,Blackpool,Sheffield Wednesday,2-2,2,2,1,1,4,0,D
1964-04-18,1963,Chelsea,Everton,1-0,1,0,1,1,1,1,H
1964-04-18,1963,Liverpool,Arsenal,5-0,5,0,1,1,5,5,H
1964-04-18,1963,Nottingham Forest,Burnley,1-3,1,3,1,1,4,-2,A
1964-04-18,1963,Sheffield United,West Bromwich Albion,2-1,2,1,1,1,3,1,H
1964-04-18,1963,Stoke City,Manchester United,3-1,3,1,1,1,4,2,H
1964-04-18,1963,Tottenham Hotspur,Bolton Wanderers,1-0,1,0,1,1,1,1,H
1964-04-18,1963,Wolverhampton Wanderers,Fulham,4-0,4,0,1,1,4,4,H
1964-04-21,1963,Burnley,Tottenham Hotspur,7-2,7,2,1,1,9,5,H
1964-04-22,1963,Birmingham City,Liverpool,3-1,3,1,1,1,4,2,H
1964-04-24,1963,Bolton Wanderers,Wolverhampton Wanderers,0-4,0,4,1,1,4,-4,A
1964-04-25,1963,Birmingham City,Sheffield United,3-0,3,0,1,1,3,3,H
1964-04-25,1963,Everton,West Ham United,2-0,2,0,1,1,2,2,H
1964-04-25,1963,Fulham,Stoke City,3-3,3,3,1,1,6,0,D
1964-04-25,1963,Ipswich Town,Blackpool,4-3,4,3,1,1,7,1,H
1964-04-25,1963,Leicester City,Tottenham Hotspur,0-1,0,1,1,1,1,-1,A
1964-04-25,1963,Manchester United,Nottingham Forest,3-1,3,1,1,1,4,2,H
1964-04-25,1963,West Bromwich Albion,Liverpool,2-2,2,2,1,1,4,0,D
1964-04-29,1963,Stoke City,Liverpool,3-1,3,1,1,1,4,2,H
1964-08-22,1964,Aston Villa,Leeds United,1-2,1,2,1,1,3,-1,A
1964-08-22,1964,Burnley,Blackpool,2-2,2,2,1,1,4,0,D
1964-08-22,1964,Fulham,West Ham United,1-2,1,2,1,1,3,-1,A
1964-08-22,1964,Liverpool,Arsenal,3-2,3,2,1,1,5,1,H
1964-08-22,1964,Manchester United,West Bromwich Albion,2-2,2,2,1,1,4,0,D
1964-08-22,1964,Nottingham Forest,Birmingham City,4-3,4,3,1,1,7,1,H
1964-08-22,1964,Sheffield Wednesday,Blackburn Rovers,1-0,1,0,1,1,1,1,H
1964-08-22,1964,Stoke City,Everton,0-2,0,2,1,1,2,-2,A
1964-08-22,1964,Sunderland,Leicester City,3-3,3,3,1,1,6,0,D
1964-08-22,1964,Tottenham Hotspur,Sheffield United,2-0,2,0,1,1,2,2,H
1964-08-22,1964,Wolverhampton Wanderers,Chelsea,0-3,0,3,1,1,3,-3,A
1964-08-24,1964,Blackpool,Blackburn Rovers,4-2,4,2,1,1,6,2,H
1964-08-24,1964,West Ham United,Manchester United,3-1,3,1,1,1,4,2,H
1964-08-25,1964,Arsenal,Sheffield Wednesday,1-1,1,1,1,1,2,0,D
1964-08-25,1964,Burnley,Tottenham Hotspur,2-2,2,2,1,1,4,0,D
1964-08-25,1964,Everton,Nottingham Forest,1-0,1,0,1,1,1,1,H
1964-08-26,1964,Birmingham City,Fulham,2-2,2,2,1,1,4,0,D
1964-08-26,1964,Chelsea,Aston Villa,2-1,2,1,1,1,3,1,H
1964-08-26,1964,Leeds United,Liverpool,4-2,4,2,1,1,6,2,H
1964-08-26,1964,Leicester City,Wolverhampton Wanderers,3-2,3,2,1,1,5,1,H
1964-08-26,1964,Sheffield United,Stoke City,0-1,0,1,1,1,1,-1,A
1964-08-26,1964,West Bromwich Albion,Sunderland,4-1,4,1,1,1,5,3,H
1964-08-28,1964,West Ham United,Nottingham Forest,2-3,2,3,1,1,5,-1,A
1964-08-29,1964,Arsenal,Aston Villa,3-1,3,1,1,1,4,2,H
1964-08-29,1964,Birmingham City,Stoke City,1-2,1,2,1,1,3,-1,A
1964-08-29,1964,Blackburn Rovers,Liverpool,3-2,3,2,1,1,5,1,H
1964-08-29,1964,Blackpool,Sheffield Wednesday,1-0,1,0,1,1,1,1,H
1964-08-29,1964,Chelsea,Sunderland,3-1,3,1,1,1,4,2,H
1964-08-29,1964,Everton,Tottenham Hotspur,4-1,4,1,1,1,5,3,H
1964-08-29,1964,Leeds United,Wolverhampton Wanderers,3-2,3,2,1,1,5,1,H
1964-08-29,1964,Leicester City,Manchester United,2-2,2,2,1,1,4,0,D
1964-08-29,1964,Sheffield United,Burnley,2-0,2,0,1,1,2,2,H
1964-08-29,1964,West Bromwich Albion,Fulham,2-2,2,2,1,1,4,0,D
1964-08-31,1964,Aston Villa,Chelsea,2-2,2,2,1,1,4,0,D
1964-09-01,1964,Nottingham Forest,Everton,3-1,3,1,1,1,4,2,H
1964-09-02,1964,Blackburn Rovers,Blackpool,4-1,4,1,1,1,5,3,H
1964-09-02,1964,Fulham,Birmingham City,3-1,3,1,1,1,4,2,H
1964-09-02,1964,Liverpool,Leeds United,2-1,2,1,1,1,3,1,H
1964-09-02,1964,Manchester United,West Ham United,3-1,3,1,1,1,4,2,H
1964-09-02,1964,Sheffield Wednesday,Arsenal,2-1,2,1,1,1,3,1,H
1964-09-02,1964,Stoke City,Sheffield United,0-1,0,1,1,1,1,-1,A
1964-09-02,1964,Sunderland,West Bromwich Albion,2-2,2,2,1,1,4,0,D
1964-09-02,1964,Tottenham Hotspur,Burnley,4-1,4,1,1,1,5,3,H
1964-09-02,1964,Wolverhampton Wanderers,Leicester City,1-1,1,1,1,1,2,0,D
1964-09-05,1964,Aston Villa,Blackburn Rovers,0-4,0,4,1,1,4,-4,A
1964-09-05,1964,Burnley,Everton,1-1,1,1,1,1,2,0,D
1964-09-05,1964,Fulham,Manchester United,2-1,2,1,1,1,3,1,H
1964-09-05,1964,Leicester City,Chelsea,1-1,1,1,1,1,2,0,D
1964-09-05,1964,Liverpool,Blackpool,2-2,2,2,1,1,4,0,D
1964-09-05,1964,Nottingham Forest,West Bromwich Albion,0-0,0,0,1,1,0,0,D
1964-09-05,1964,Sheffield Wednesday,Sheffield United,0-2,0,2,1,1,2,-2,A
1964-09-05,1964,Stoke City,West Ham United,3-1,3,1,1,1,4,2,H
1964-09-05,1964,Sunderland,Leeds United,3-3,3,3,1,1,6,0,D
1964-09-05,1964,Tottenham Hotspur,Birmingham City,4-1,4,1,1,1,5,3,H
1964-09-05,1964,Wolverhampton Wanderers,Arsenal,0-1,0,1,1,1,1,-1,A
1964-09-07,1964,Blackpool,Leeds United,4-0,4,0,1,1,4,4,H
1964-09-07,1964,West Ham United,Wolverhampton Wanderers,5-0,5,0,1,1,5,5,H
1964-09-08,1964,Arsenal,Blackburn Rovers,1-1,1,1,1,1,2,0,D
1964-09-08,1964,Burnley,Nottingham Forest,2-2,2,2,1,1,4,0,D
1964-09-08,1964,Everton,Manchester United,3-3,3,3,1,1,6,0,D
1964-09-09,1964,Birmingham City,West Bromwich Albion,1-1,1,1,1,1,2,0,D
1964-09-09,1964,Chelsea,Sheffield Wednesday,1-1,1,1,1,1,2,0,D
1964-09-09,1964,Leicester City,Liverpool,2-0,2,0,1,1,2,2,H
1964-09-09,1964,Sheffield United,Fulham,1-1,1,1,1,1,2,0,D
1964-09-09,1964,Stoke City,Tottenham Hotspur,2-0,2,0,1,1,2,2,H
1964-09-09,1964,Sunderland,Aston Villa,2-2,2,2,1,1,4,0,D
1964-09-12,1964,Arsenal,Sunderland,3-1,3,1,1,1,4,2,H
1964-09-12,1964,Birmingham City,Burnley,2-1,2,1,1,1,3,1,H
1964-09-12,1964,Blackburn Rovers,Wolverhampton Wanderers,4-1,4,1,1,1,5,3,H
1964-09-12,1964,Blackpool,Aston Villa,3-1,3,1,1,1,4,2,H
1964-09-12,1964,Chelsea,Fulham,1-0,1,0,1,1,1,1,H
1964-09-12,1964,Everton,Sheffield United,1-1,1,1,1,1,2,0,D
1964-09-12,1964,Leeds United,Leicester City,3-2,3,2,1,1,5,1,H
1964-09-12,1964,Manchester United,Nottingham Forest,3-0,3,0,1,1,3,3,H
1964-09-12,1964,Sheffield Wednesday,Liverpool,1-0,1,0,1,1,1,1,H
1964-09-12,1964,West Bromwich Albion,Stoke City,5-3,5,3,1,1,8,2,H
1964-09-12,1964,West Ham United,Tottenham Hotspur,3-2,3,2,1,1,5,1,H
1964-09-14,1964,Aston Villa,Sunderland,2-1,2,1,1,1,3,1,H
1964-09-14,1964,Wolverhampton Wanderers,West Ham United,4-3,4,3,1,1,7,1,H
1964-09-15,1964,Nottingham Forest,Burnley,3-1,3,1,1,1,4,2,H
1964-09-16,1964,Blackburn Rovers,Arsenal,1-2,1,2,1,1,3,-1,A
1964-09-16,1964,Fulham,Sheffield United,1-2,1,2,1,1,3,-1,A
1964-09-16,1964,Leeds United,Blackpool,3-0,3,0,1,1,3,3,H
1964-09-16,1964,Manchester United,Everton,2-1,2,1,1,1,3,1,H
1964-09-16,1964,Sheffield Wednesday,Chelsea,2-3,2,3,1,1,5,-1,A
1964-09-16,1964,Tottenham Hotspur,Stoke City,2-1,2,1,1,1,3,1,H
1964-09-16,1964,West Bromwich Albion,Birmingham City,0-2,0,2,1,1,2,-2,A
1964-09-19,1964,Aston Villa,Sheffield Wednesday,2-0,2,0,1,1,2,2,H
1964-09-19,1964,Burnley,West Ham United,3-2,3,2,1,1,5,1,H
1964-09-19,1964,Chelsea,Leeds United,2-0,2,0,1,1,2,2,H
1964-09-19,1964,Leicester City,Arsenal,2-3,2,3,1,1,5,-1,A
1964-09-19,1964,Liverpool,Everton,0-4,0,4,1,1,4,-4,A
1964-09-19,1964,Nottingham Forest,Fulham,2-3,2,3,1,1,5,-1,A
1964-09-19,1964,Sheffield United,Birmingham City,3-1,3,1,1,1,4,2,H
1964-09-19,1964,Stoke City,Manchester United,1-2,1,2,1,1,3,-1,A
1964-09-19,1964,Sunderland,Blackburn Rovers,1-0,1,0,1,1,1,1,H
1964-09-19,1964,Tottenham Hotspur,West Bromwich Albion,1-0,1,0,1,1,1,1,H
1964-09-19,1964,Wolverhampton Wanderers,Blackpool,1-2,1,2,1,1,3,-1,A
1964-09-23,1964,Sheffield Wednesday,Burnley,5-1,5,1,1,1,6,4,H
1964-09-26,1964,Arsenal,Chelsea,1-3,1,3,1,1,4,-2,A
1964-09-26,1964,Birmingham City,Everton,3-5,3,5,1,1,8,-2,A
1964-09-26,1964,Blackburn Rovers,Leicester City,3-1,3,1,1,1,4,2,H
1964-09-26,1964,Blackpool,Sunderland,3-1,3,1,1,1,4,2,H
1964-09-26,1964,Fulham,Stoke City,1-4,1,4,1,1,5,-3,A
1964-09-26,1964,Leeds United,Nottingham Forest,1-2,1,2,1,1,3,-1,A
1964-09-26,1964,Liverpool,Aston Villa,5-1,5,1,1,1,6,4,H
1964-09-26,1964,Manchester United,Tottenham Hotspur,4-1,4,1,1,1,5,3,H
1964-09-26,1964,Sheffield Wednesday,Wolverhampton Wanderers,2-0,2,0,1,1,2,2,H
1964-09-26,1964,West Bromwich Albion,Burnley,1-2,1,2,1,1,3,-1,A
1964-09-26,1964,West Ham United,Sheffield United,3-1,3,1,1,1,4,2,H
1964-09-28,1964,Blackpool,Tottenham Hotspur,1-1,1,1,1,1,2,0,D
1964-09-30,1964,Chelsea,Manchester United,0-2,0,2,1,1,2,-2,A
1964-09-30,1964,Leeds United,Fulham,2-2,2,2,1,1,4,0,D
1964-09-30,1964,Leicester City,West Bromwich Albion,4-2,4,2,1,1,6,2,H
1964-09-30,1964,Wolverhampton Wanderers,Birmingham City,0-2,0,2,1,1,2,-2,A
1964-10-03,1964,Chelsea,Blackburn Rovers,5-1,5,1,1,1,6,4,H
1964-10-03,1964,Everton,West Ham United,1-1,1,1,1,1,2,0,D
1964-10-03,1964,Sheffield United,West Bromwich Albion,1-1,1,1,1,1,2,0,D
1964-10-03,1964,Stoke City,Nottingham Forest,1-1,1,1,1,1,2,0,D
1964-10-05,1964,Aston Villa,Everton,1-2,1,2,1,1,3,-1,A
1964-10-05,1964,Leicester City,Blackpool,3-2,3,2,1,1,5,1,H
1964-10-05,1964,Tottenham Hotspur,Fulham,3-0,3,0,1,1,3,3,H
1964-10-06,1964,Arsenal,Nottingham Forest,0-3,0,3,1,1,3,-3,A
1964-10-06,1964,Burnley,Manchester United,0-0,0,0,1,1,0,0,D
1964-10-07,1964,Blackburn Rovers,Stoke City,1-1,1,1,1,1,2,0,D
1964-10-07,1964,Liverpool,Sheffield United,3-1,3,1,1,1,4,2,H
1964-10-10,1964,Birmingham City,Liverpool,0-0,0,0,1,1,0,0,D
1964-10-10,1964,Burnley,Blackburn Rovers,1-1,1,1,1,1,2,0,D
1964-10-10,1964,Everton,Sheffield Wednesday,1-1,1,1,1,1,2,0,D
1964-10-10,1964,Fulham,Leicester City,5-2,5,2,1,1,7,3,H
1964-10-10,1964,Manchester United,Sunderland,1-0,1,0,1,1,1,1,H
1964-10-10,1964,Nottingham Forest,Chelsea,2-2,2,2,1,1,4,0,D
1964-10-10,1964,Sheffield United,Blackpool,1-3,1,3,1,1,4,-2,A
1964-10-10,1964,Stoke City,Leeds United,2-3,2,3,1,1,5,-1,A
1964-10-10,1964,Tottenham Hotspur,Arsenal,3-1,3,1,1,1,4,2,H
1964-10-10,1964,West Bromwich Albion,Wolverhampton Wanderers,5-1,5,1,1,1,6,4,H
1964-10-10,1964,West Ham United,Aston Villa,3-0,3,0,1,1,3,3,H
1964-10-13,1964,Liverpool,Leicester City,0-1,0,1,1,1,1,-1,A
1964-10-17,1964,Arsenal,Burnley,3-2,3,2,1,1,5,1,H
1964-10-17,1964,Aston Villa,West Bromwich Albion,0-1,0,1,1,1,1,-1,A
1964-10-17,1964,Blackburn Rovers,Sheffield United,4-0,4,0,1,1,4,4,H
1964-10-17,1964,Blackpool,Everton,1-1,1,1,1,1,2,0,D
1964-10-17,1964,Chelsea,Stoke City,4-0,4,0,1,1,4,4,H
1964-10-17,1964,Leeds United,Tottenham Hotspur,3-1,3,1,1,1,4,2,H
1964-10-17,1964,Leicester City,Nottingham Forest,3-2,3,2,1,1,5,1,H
1964-10-17,1964,Liverpool,West Ham United,2-2,2,2,1,1,4,0,D
1964-10-17,1964,Sheffield Wednesday,Birmingham City,5-2,5,2,1,1,7,3,H
1964-10-17,1964,Sunderland,Fulham,0-0,0,0,1,1,0,0,D
1964-10-17,1964,Wolverhampton Wanderers,Manchester United,2-4,2,4,1,1,6,-2,A
1964-10-24,1964,Birmingham City,Blackpool,3-0,3,0,1,1,3,3,H
1964-10-24,1964,Burnley,Leeds United,0-1,0,1,1,1,1,-1,A
1964-10-24,1964,Everton,Blackburn Rovers,2-3,2,3,1,1,5,-1,A
1964-10-24,1964,Fulham,Wolverhampton Wanderers,2-0,2,0,1,1,2,2,H
1964-10-24,1964,Manchester United,Aston Villa,7-0,7,0,1,1,7,7,H
1964-10-24,1964,Nottingham Forest,Sunderland,5-2,5,2,1,1,7,3,H
1964-10-24,1964,Sheffield United,Arsenal,4-0,4,0,1,1,4,4,H
1964-10-24,1964,Stoke City,Leicester City,3-3,3,3,1,1,6,0,D
1964-10-24,1964,Tottenham Hotspur,Chelsea,1-1,1,1,1,1,2,0,D
1964-10-24,1964,West Bromwich Albion,Liverpool,3-0,3,0,1,1,3,3,H
1964-10-24,1964,West Ham United,Sheffield Wednesday,1-2,1,2,1,1,3,-1,A
1964-10-31,1964,Arsenal,Everton,3-1,3,1,1,1,4,2,H
1964-10-31,1964,Aston Villa,Fulham,2-0,2,0,1,1,2,2,H
1964-10-31,1964,Blackburn Rovers,Birmingham City,3-1,3,1,1,1,4,2,H
1964-10-31,1964,Blackpool,West Ham United,1-2,1,2,1,1,3,-1,A
1964-10-31,1964,Chelsea,Burnley,0-1,0,1,1,1,1,-1,A
1964-10-31,1964,Leeds United,Sheffield United,4-1,4,1,1,1,5,3,H
1964-10-31,1964,Leicester City,Tottenham Hotspur,4-2,4,2,1,1,6,2,H
1964-10-31,1964,Liverpool,Manchester United,0-2,0,2,1,1,2,-2,A
1964-10-31,1964,Sheffield Wednesday,West Bromwich Albion,1-1,1,1,1,1,2,0,D
1964-10-31,1964,Sunderland,Stoke City,2-2,2,2,1,1,4,0,D
1964-10-31,1964,Wolverhampton Wanderers,Nottingham Forest,1-2,1,2,1,1,3,-1,A
1964-11-07,1964,Birmingham City,Arsenal,2-3,2,3,1,1,5,-1,A
1964-11-07,1964,Burnley,Leicester City,2-1,2,1,1,1,3,1,H
1964-11-07,1964,Everton,Leeds United,0-1,0,1,1,1,1,-1,A
1964-11-07,1964,Fulham,Liverpool,1-1,1,1,1,1,2,0,D
1964-11-07,1964,Manchester United,Sheffield Wednesday,1-0,1,0,1,1,1,1,H
1964-11-07,1964,Nottingham Forest,Aston Villa,4-2,4,2,1,1,6,2,H
1964-11-07,1964,Sheffield United,Chelsea,0-2,0,2,1,1,2,-2,A
1964-11-07,1964,Stoke City,Wolverhampton Wanderers,0-2,0,2,1,1,2,-2,A
1964-11-07,1964,Tottenham Hotspur,Sunderland,3-0,3,0,1,1,3,3,H
1964-11-07,1964,West Bromwich Albion,Blackpool,1-3,1,3,1,1,4,-2,A
1964-11-07,1964,West Ham United,Blackburn Rovers,1-1,1,1,1,1,2,0,D
1964-11-11,1964,Leeds United,Arsenal,3-1,3,1,1,1,4,2,H
1964-11-14,1964,Arsenal,West Ham United,0-3,0,3,1,1,3,-3,A
1964-11-14,1964,Aston Villa,Stoke City,3-0,3,0,1,1,3,3,H
1964-11-14,1964,Blackburn Rovers,West Bromwich Albion,4-2,4,2,1,1,6,2,H
1964-11-14,1964,Blackpool,Manchester United,1-2,1,2,1,1,3,-1,A
1964-11-14,1964,Chelsea,Everton,5-1,5,1,1,1,6,4,H
1964-11-14,1964,Leeds United,Birmingham City,4-1,4,1,1,1,5,3,H
1964-11-14,1964,Leicester City,Sheffield United,0-2,0,2,1,1,2,-2,A
1964-11-14,1964,Liverpool,Nottingham Forest,2-0,2,0,1,1,2,2,H
1964-11-14,1964,Sheffield Wednesday,Fulham,1-1,1,1,1,1,2,0,D
1964-11-14,1964,Sunderland,Burnley,3-2,3,2,1,1,5,1,H
1964-11-14,1964,Wolverhampton Wanderers,Tottenham Hotspur,3-1,3,1,1,1,4,2,H
1964-11-21,1964,Birmingham City,Chelsea,1-6,1,6,1,1,7,-5,A
1964-11-21,1964,Burnley,Wolverhampton Wanderers,1-1,1,1,1,1,2,0,D
1964-11-21,1964,Everton,Leicester City,2-2,2,2,1,1,4,0,D
1964-11-21,1964,Fulham,Blackpool,3-3,3,3,1,1,6,0,D
1964-11-21,1964,Manchester United,Blackburn Rovers,3-0,3,0,1,1,3,3,H
1964-11-21,1964,Nottingham Forest,Sheffield Wednesday,2-2,2,2,1,1,4,0,D
1964-11-21,1964,Sheffield United,Sunderland,3-0,3,0,1,1,3,3,H
1964-11-21,1964,Stoke City,Liverpool,1-1,1,1,1,1,2,0,D
1964-11-21,1964,Tottenham Hotspur,Aston Villa,4-0,4,0,1,1,4,4,H
1964-11-21,1964,West Bromwich Albion,Arsenal,0-0,0,0,1,1,0,0,D
1964-11-21,1964,West Ham United,Leeds United,3-1,3,1,1,1,4,2,H
1964-11-28,1964,Arsenal,Manchester United,2-3,2,3,1,1,5,-1,A
1964-11-28,1964,Aston Villa,Burnley,1-0,1,0,1,1,1,1,H
1964-11-28,1964,Blackburn Rovers,Fulham,2-0,2,0,1,1,2,2,H
1964-11-28,1964,Blackpool,Nottingham Forest,0-2,0,2,1,1,2,-2,A
1964-11-28,1964,Chelsea,West Ham United,0-3,0,3,1,1,3,-3,A
1964-11-28,1964,Leeds United,West Bromwich Albion,1-0,1,0,1,1,1,1,H
1964-11-28,1964,Leicester City,Birmingham City,4-4,4,4,1,1,8,0,D
1964-11-28,1964,Liverpool,Tottenham Hotspur,1-1,1,1,1,1,2,0,D
1964-11-28,1964,Sheffield Wednesday,Stoke City,1-1,1,1,1,1,2,0,D
1964-11-28,1964,Sunderland,Everton,4-0,4,0,1,1,4,4,H
1964-11-28,1964,Wolverhampton Wanderers,Sheffield United,1-0,1,0,1,1,1,1,H
1964-12-05,1964,Birmingham City,Sunderland,4-3,4,3,1,1,7,1,H
1964-12-05,1964,Burnley,Liverpool,1-5,1,5,1,1,6,-4,A
1964-12-05,1964,Everton,Wolverhampton Wanderers,5-0,5,0,1,1,5,5,H
1964-12-05,1964,Fulham,Arsenal,3-4,3,4,1,1,7,-1,A
1964-12-05,1964,Manchester United,Leeds United,0-1,0,1,1,1,1,-1,A
1964-12-05,1964,Nottingham Forest,Blackburn Rovers,2-5,2,5,1,1,7,-3,A
1964-12-05,1964,Sheffield United,Aston Villa,4-2,4,2,1,1,6,2,H
1964-12-05,1964,Stoke City,Blackpool,4-2,4,2,1,1,6,2,H
1964-12-05,1964,Tottenham Hotspur,Sheffield Wednesday,3-2,3,2,1,1,5,1,H
1964-12-05,1964,West Bromwich Albion,Chelsea,0-2,0,2,1,1,2,-2,A
1964-12-05,1964,West Ham United,Leicester City,0-0,0,0,1,1,0,0,D
1964-12-12,1964,Arsenal,Liverpool,0-0,0,0,1,1,0,0,D
1964-12-12,1964,Birmingham City,Nottingham Forest,1-1,1,1,1,1,2,0,D
1964-12-12,1964,Blackpool,Burnley,2-4,2,4,1,1,6,-2,A
1964-12-12,1964,Chelsea,Wolverhampton Wanderers,2-1,2,1,1,1,3,1,H
1964-12-12,1964,Everton,Stoke City,1-1,1,1,1,1,2,0,D
1964-12-12,1964,Leeds United,Aston Villa,1-0,1,0,1,1,1,1,H
1964-12-12,1964,Leicester City,Sunderland,0-1,0,1,1,1,1,-1,A
1964-12-12,1964,Sheffield United,Tottenham Hotspur,3-3,3,3,1,1,6,0,D
1964-12-12,1964,West Bromwich Albion,Manchester United,1-1,1,1,1,1,2,0,D
1964-12-12,1964,West Ham United,Fulham,2-0,2,0,1,1,2,2,H
1964-12-16,1964,Manchester United,Birmingham City,1-1,1,1,1,1,2,0,D
1964-12-19,1964,Aston Villa,Arsenal,3-1,3,1,1,1,4,2,H
1964-12-19,1964,Burnley,Sheffield United,3-1,3,1,1,1,4,2,H
1964-12-19,1964,Fulham,West Bromwich Albion,3-1,3,1,1,1,4,2,H
1964-12-19,1964,Liverpool,Blackburn Rovers,3-2,3,2,1,1,5,1,H
1964-12-19,1964,Nottingham Forest,West Ham United,3-2,3,2,1,1,5,1,H
1964-12-19,1964,Sheffield Wednesday,Blackpool,4-1,4,1,1,1,5,3,H
1964-12-19,1964,Sunderland,Chelsea,3-0,3,0,1,1,3,3,H
1964-12-19,1964,Tottenham Hotspur,Everton,2-2,2,2,1,1,4,0,D
1964-12-19,1964,Wolverhampton Wanderers,Leeds United,0-1,0,1,1,1,1,-1,A
1964-12-26,1964,Arsenal,Stoke City,3-2,3,2,1,1,5,1,H
1964-12-26,1964,Birmingham City,West Ham United,2-1,2,1,1,1,3,1,H
1964-12-26,1964,Burnley,Fulham,4-0,4,0,1,1,4,4,H
1964-12-26,1964,Chelsea,Blackpool,2-0,2,0,1,1,2,2,H
1964-12-26,1964,Everton,West Bromwich Albion,3-2,3,2,1,1,5,1,H
1964-12-26,1964,Leeds United,Blackburn Rovers,1-1,1,1,1,1,2,0,D
1964-12-26,1964,Leicester City,Sheffield Wednesday,2-2,2,2,1,1,4,0,D
1964-12-26,1964,Nottingham Forest,Tottenham Hotspur,1-2,1,2,1,1,3,-1,A
1964-12-26,1964,Sheffield United,Manchester United,0-1,0,1,1,1,1,-1,A
1964-12-26,1964,Sunderland,Liverpool,2-3,2,3,1,1,5,-1,A
1964-12-26,1964,Wolverhampton Wanderers,Aston Villa,0-1,0,1,1,1,1,-1,A
1964-12-28,1964,Blackburn Rovers,Leeds United,0-2,0,2,1,1,2,-2,A
1964-12-28,1964,Fulham,Burnley,0-1,0,1,1,1,1,-1,A
1964-12-28,1964,Liverpool,Sunderland,0-0,0,0,1,1,0,0,D
1964-12-28,1964,Manchester United,Sheffield United,1-1,1,1,1,1,2,0,D
1964-12-28,1964,Sheffield Wednesday,Leicester City,0-0,0,0,1,1,0,0,D
1964-12-28,1964,Stoke City,Arsenal,4-1,4,1,1,1,5,3,H
1964-12-28,1964,Tottenham Hotspur,Nottingham Forest,4-0,4,0,1,1,4,4,H
1964-12-28,1964,West Ham United,Birmingham City,2-1,2,1,1,1,3,1,H
1965-01-02,1964,Arsenal,Wolverhampton Wanderers,4-1,4,1,1,1,5,3,H
1965-01-02,1964,Birmingham City,Tottenham Hotspur,1-0,1,0,1,1,1,1,H
1965-01-02,1964,Blackburn Rovers,Aston Villa,5-1,5,1,1,1,6,4,H
1965-01-02,1964,Blackpool,Liverpool,2-3,2,3,1,1,5,-1,A
1965-01-02,1964,Chelsea,Leicester City,4-1,4,1,1,1,5,3,H
1965-01-02,1964,Everton,Burnley,2-1,2,1,1,1,3,1,H
1965-01-02,1964,Leeds United,Sunderland,2-1,2,1,1,1,3,1,H
1965-01-02,1964,Sheffield United,Sheffield Wednesday,2-3,2,3,1,1,5,-1,A
1965-01-02,1964,West Bromwich Albion,Nottingham Forest,2-2,2,2,1,1,4,0,D
1965-01-02,1964,West Ham United,Stoke City,0-1,0,1,1,1,1,-1,A
1965-01-16,1964,Aston Villa,Blackpool,3-2,3,2,1,1,5,1,H
1965-01-16,1964,Burnley,Birmingham City,2-0,2,0,1,1,2,2,H
1965-01-16,1964,Fulham,Chelsea,1-2,1,2,1,1,3,-1,A
1965-01-16,1964,Leicester City,Leeds United,2-2,2,2,1,1,4,0,D
1965-01-16,1964,Liverpool,Sheffield Wednesday,4-2,4,2,1,1,6,2,H
1965-01-16,1964,Nottingham Forest,Manchester United,2-2,2,2,1,1,4,0,D
1965-01-16,1964,Sheffield United,Everton,0-0,0,0,1,1,0,0,D
1965-01-16,1964,Stoke City,West Bromwich Albion,2-0,2,0,1,1,2,2,H
1965-01-16,1964,Sunderland,Arsenal,0-2,0,2,1,1,2,-2,A
1965-01-16,1964,Tottenham Hotspur,West Ham United,3-2,3,2,1,1,5,1,H
1965-01-16,1964,Wolverhampton Wanderers,Blackburn Rovers,4-2,4,2,1,1,6,2,H
1965-01-23,1964,Arsenal,Leicester City,4-3,4,3,1,1,7,1,H
1965-01-23,1964,Birmingham City,Sheffield United,1-1,1,1,1,1,2,0,D
1965-01-23,1964,Blackpool,Wolverhampton Wanderers,1-1,1,1,1,1,2,0,D
1965-01-23,1964,Fulham,Nottingham Forest,4-1,4,1,1,1,5,3,H
1965-01-23,1964,Leeds United,Chelsea,2-2,2,2,1,1,4,0,D
1965-01-23,1964,Manchester United,Stoke City,1-1,1,1,1,1,2,0,D
1965-01-23,1964,West Bromwich Albion,Tottenham Hotspur,2-0,2,0,1,1,2,2,H
1965-01-23,1964,West Ham United,Burnley,3-2,3,2,1,1,5,1,H
1965-01-29,1964,Blackburn Rovers,Sheffield Wednesday,0-1,0,1,1,1,1,-1,A
1965-02-06,1964,Aston Villa,Liverpool,0-1,0,1,1,1,1,-1,A
1965-02-06,1964,Burnley,West Bromwich Albion,0-1,0,1,1,1,1,-1,A
1965-02-06,1964,Chelsea,Arsenal,2-1,2,1,1,1,3,1,H
1965-02-06,1964,Everton,Birmingham City,1-1,1,1,1,1,2,0,D
1965-02-06,1964,Leicester City,Blackburn Rovers,2-3,2,3,1,1,5,-1,A
1965-02-06,1964,Nottingham Forest,Leeds United,0-0,0,0,1,1,0,0,D
1965-02-06,1964,Sheffield United,West Ham United,2-1,2,1,1,1,3,1,H
1965-02-06,1964,Stoke City,Fulham,3-1,3,1,1,1,4,2,H
1965-02-06,1964,Sunderland,Blackpool,1-0,1,0,1,1,1,1,H
1965-02-06,1964,Tottenham Hotspur,Manchester United,1-0,1,0,1,1,1,1,H
1965-02-06,1964,Wolverhampton Wanderers,Sheffield Wednesday,3-1,3,1,1,1,4,2,H
1965-02-13,1964,Arsenal,Leeds United,1-2,1,2,1,1,3,-1,A
1965-02-13,1964,Birmingham City,Aston Villa,0-1,0,1,1,1,1,-1,A
1965-02-13,1964,Blackburn Rovers,Chelsea,0-3,0,3,1,1,3,-3,A
1965-02-13,1964,Blackpool,Leicester City,1-1,1,1,1,1,2,0,D
1965-02-13,1964,Fulham,Tottenham Hotspur,4-1,4,1,1,1,5,3,H
1965-02-13,1964,Liverpool,Wolverhampton Wanderers,2-1,2,1,1,1,3,1,H
1965-02-13,1964,Manchester United,Burnley,3-2,3,2,1,1,5,1,H
1965-02-13,1964,Nottingham Forest,Stoke City,3-1,3,1,1,1,4,2,H
1965-02-13,1964,Sheffield Wednesday,Sunderland,2-0,2,0,1,1,2,2,H
1965-02-13,1964,West Bromwich Albion,Sheffield United,0-1,0,1,1,1,1,-1,A
1965-02-13,1964,West Ham United,Everton,0-1,0,1,1,1,1,-1,A
1965-02-20,1964,Arsenal,Fulham,2-0,2,0,1,1,2,2,H
1965-02-20,1964,Blackpool,Sheffield United,2-2,2,2,1,1,4,0,D
1965-02-20,1964,Sheffield Wednesday,Everton,0-1,0,1,1,1,1,-1,A
1965-02-20,1964,Sunderland,West Ham United,3-2,3,2,1,1,5,1,H
1965-02-22,1964,Chelsea,Nottingham Forest,0-1,0,1,1,1,1,-1,A
1965-02-23,1964,Arsenal,Tottenham Hotspur,3-1,3,1,1,1,4,2,H
1965-02-24,1964,Blackburn Rovers,Burnley,1-4,1,4,1,1,5,-3,A
1965-02-24,1964,Leicester City,Fulham,5-1,5,1,1,1,6,4,H
1965-02-24,1964,Liverpool,Birmingham City,4-3,4,3,1,1,7,1,H
1965-02-24,1964,Sunderland,Manchester United,1-0,1,0,1,1,1,1,H
1965-02-27,1964,Birmingham City,Sheffield Wednesday,0-0,0,0,1,1,0,0,D
1965-02-27,1964,Burnley,Arsenal,2-1,2,1,1,1,3,1,H
1965-02-27,1964,Everton,Blackpool,0-0,0,0,1,1,0,0,D
1965-02-27,1964,Fulham,Sunderland,1-0,1,0,1,1,1,1,H
1965-02-27,1964,Manchester United,Wolverhampton Wanderers,3-0,3,0,1,1,3,3,H
1965-02-27,1964,Nottingham Forest,Leicester City,2-1,2,1,1,1,3,1,H
1965-02-27,1964,Sheffield United,Blackburn Rovers,1-1,1,1,1,1,2,0,D
1965-02-27,1964,Stoke City,Chelsea,0-2,0,2,1,1,2,-2,A
1965-02-27,1964,Tottenham Hotspur,Leeds United,0-0,0,0,1,1,0,0,D
1965-02-27,1964,West Bromwich Albion,Aston Villa,3-1,3,1,1,1,4,2,H
1965-02-27,1964,West Ham United,Liverpool,2-1,2,1,1,1,3,1,H
1965-03-06,1964,Arsenal,Sheffield United,1-1,1,1,1,1,2,0,D
1965-03-06,1964,Blackburn Rovers,Everton,0-2,0,2,1,1,2,-2,A
1965-03-06,1964,Blackpool,Birmingham City,3-1,3,1,1,1,4,2,H
1965-03-06,1964,Sheffield Wednesday,West Ham United,2-0,2,0,1,1,2,2,H
1965-03-06,1964,Sunderland,Nottingham Forest,4-0,4,0,1,1,4,4,H
1965-03-10,1964,Chelsea,Tottenham Hotspur,3-1,3,1,1,1,4,2,H
1965-03-13,1964,Birmingham City,Wolverhampton Wanderers,0-1,0,1,1,1,1,-1,A
1965-03-13,1964,Burnley,Sheffield Wednesday,4-1,4,1,1,1,5,3,H
1965-03-13,1964,Everton,Aston Villa,3-1,3,1,1,1,4,2,H
1965-03-13,1964,Fulham,Leeds United,2-2,2,2,1,1,4,0,D
1965-03-13,1964,Manchester United,Chelsea,4-0,4,0,1,1,4,4,H
1965-03-13,1964,Nottingham Forest,Arsenal,3-0,3,0,1,1,3,3,H
1965-03-13,1964,Sheffield United,Liverpool,3-0,3,0,1,1,3,3,H
1965-03-13,1964,Stoke City,Blackburn Rovers,1-1,1,1,1,1,2,0,D
1965-03-13,1964,Tottenham Hotspur,Blackpool,4-1,4,1,1,1,5,3,H
1965-03-13,1964,West Bromwich Albion,Leicester City,6-0,6,0,1,1,6,6,H
1965-03-13,1964,West Ham United,Sunderland,2-3,2,3,1,1,5,-1,A
1965-03-15,1964,Leeds United,Burnley,5-1,5,1,1,1,6,4,H
1965-03-15,1964,Manchester United,Fulham,4-1,4,1,1,1,5,3,H
1965-03-15,1964,Sheffield Wednesday,Aston Villa,3-1,3,1,1,1,4,2,H
1965-03-15,1964,Wolverhampton Wanderers,West Bromwich Albion,3-2,3,2,1,1,5,1,H
1965-03-17,1964,Stoke City,Birmingham City,2-1,2,1,1,1,3,1,H
1965-03-20,1964,Aston Villa,Nottingham Forest,2-1,2,1,1,1,3,1,H
1965-03-20,1964,Blackburn Rovers,West Ham United,4-0,4,0,1,1,4,4,H
1965-03-20,1964,Blackpool,West Bromwich Albion,3-0,3,0,1,1,3,3,H
1965-03-20,1964,Leeds United,Everton,4-1,4,1,1,1,5,3,H
1965-03-20,1964,Leicester City,Burnley,0-2,0,2,1,1,2,-2,A
1965-03-20,1964,Liverpool,Fulham,3-2,3,2,1,1,5,1,H
1965-03-20,1964,Sheffield Wednesday,Manchester United,1-0,1,0,1,1,1,1,H
1965-03-20,1964,Sunderland,Tottenham Hotspur,2-1,2,1,1,1,3,1,H
1965-03-20,1964,Wolverhampton Wanderers,Stoke City,3-1,3,1,1,1,4,2,H
1965-03-22,1964,Aston Villa,Wolverhampton Wanderers,3-2,3,2,1,1,5,1,H
1965-03-22,1964,Chelsea,Sheffield United,3-0,3,0,1,1,3,3,H
1965-03-22,1964,Manchester United,Blackpool,2-0,2,0,1,1,2,2,H
1965-03-23,1964,Blackburn Rovers,Sunderland,3-2,3,2,1,1,5,1,H
1965-03-23,1964,West Bromwich Albion,Everton,4-0,4,0,1,1,4,4,H
1965-03-26,1964,Sheffield United,Leicester City,0-2,0,2,1,1,2,-2,A
1965-03-26,1964,West Bromwich Albion,Blackburn Rovers,0-0,0,0,1,1,0,0,D
1965-03-27,1964,Burnley,Sunderland,0-0,0,0,1,1,0,0,D
1965-03-27,1964,Fulham,Sheffield Wednesday,2-0,2,0,1,1,2,2,H
1965-03-27,1964,Stoke City,Aston Villa,2-1,2,1,1,1,3,1,H
1965-03-27,1964,Tottenham Hotspur,Wolverhampton Wanderers,7-4,7,4,1,1,11,3,H
1965-03-27,1964,West Ham United,Arsenal,2-1,2,1,1,1,3,1,H
1965-03-30,1964,Wolverhampton Wanderers,Fulham,0-0,0,0,1,1,0,0,D
1965-03-31,1964,Aston Villa,West Ham United,2-3,2,3,1,1,5,-1,A
1965-03-31,1964,Everton,Chelsea,1-1,1,1,1,1,2,0,D
1965-04-01,1964,Nottingham Forest,Liverpool,2-2,2,2,1,1,4,0,D
1965-04-03,1964,Arsenal,West Bromwich Albion,1-1,1,1,1,1,2,0,D
1965-04-03,1964,Aston Villa,Tottenham Hotspur,1-0,1,0,1,1,1,1,H
1965-04-03,1964,Blackburn Rovers,Manchester United,0-5,0,5,1,1,5,-5,A
1965-04-03,1964,Blackpool,Fulham,3-0,3,0,1,1,3,3,H
1965-04-03,1964,Chelsea,Birmingham City,3-1,3,1,1,1,4,2,H
1965-04-03,1964,Leeds United,West Ham United,2-1,2,1,1,1,3,1,H
1965-04-03,1964,Leicester City,Everton,2-1,2,1,1,1,3,1,H
1965-04-03,1964,Liverpool,Stoke City,3-2,3,2,1,1,5,1,H
1965-04-03,1964,Sheffield Wednesday,Nottingham Forest,0-0,0,0,1,1,0,0,D
1965-04-03,1964,Sunderland,Sheffield United,3-1,3,1,1,1,4,2,H
1965-04-03,1964,Wolverhampton Wanderers,Burnley,1-2,1,2,1,1,3,-1,A
1965-04-05,1964,Leeds United,Stoke City,3-1,3,1,1,1,4,2,H
1965-04-06,1964,Arsenal,Birmingham City,3-0,3,0,1,1,3,3,H
1965-04-06,1964,Liverpool,West Bromwich Albion,0-3,0,3,1,1,3,-3,A
1965-04-09,1964,Fulham,Blackburn Rovers,3-2,3,2,1,1,5,1,H
1965-04-09,1964,Tottenham Hotspur,Liverpool,3-0,3,0,1,1,3,3,H
1965-04-10,1964,Birmingham City,Leicester City,2-0,2,0,1,1,2,2,H
1965-04-10,1964,Burnley,Aston Villa,2-2,2,2,1,1,4,0,D
1965-04-10,1964,Everton,Sunderland,1-1,1,1,1,1,2,0,D
1965-04-10,1964,Nottingham Forest,Blackpool,2-0,2,0,1,1,2,2,H
1965-04-10,1964,Sheffield United,Wolverhampton Wanderers,0-2,0,2,1,1,2,-2,A
1965-04-10,1964,Stoke City,Sheffield Wednesday,4-1,4,1,1,1,5,3,H
1965-04-12,1964,Aston Villa,Birmingham City,3-0,3,0,1,1,3,3,H
1965-04-12,1964,Everton,Liverpool,2-1,2,1,1,1,3,1,H
1965-04-12,1964,Manchester United,Leicester City,1-0,1,0,1,1,1,1,H
1965-04-12,1964,West Bromwich Albion,Leeds United,1-2,1,2,1,1,3,-1,A
1965-04-12,1964,West Ham United,Chelsea,3-2,3,2,1,1,5,1,H
1965-04-16,1964,Blackpool,Arsenal,1-1,1,1,1,1,2,0,D
1965-04-16,1964,Chelsea,Liverpool,4-0,4,0,1,1,4,4,H
1965-04-16,1964,Everton,Fulham,2-0,2,0,1,1,2,2,H
1965-04-16,1964,Sunderland,Wolverhampton Wanderers,1-2,1,2,1,1,3,-1,A
1965-04-16,1964,Tottenham Hotspur,Blackburn Rovers,5-2,5,2,1,1,7,3,H
1965-04-16,1964,West Ham United,West Bromwich Albion,6-1,6,1,1,1,7,5,H
1965-04-17,1964,Aston Villa,Sheffield United,2-1,2,1,1,1,3,1,H
1965-04-17,1964,Blackpool,Stoke City,1-1,1,1,1,1,2,0,D
1965-04-17,1964,Chelsea,West Bromwich Albion,2-2,2,2,1,1,4,0,D
1965-04-17,1964,Leeds United,Manchester United,0-1,0,1,1,1,1,-1,A
1965-04-17,1964,Leicester City,West Ham United,1-0,1,0,1,1,1,1,H
1965-04-17,1964,Liverpool,Burnley,1-1,1,1,1,1,2,0,D
1965-04-17,1964,Sheffield Wednesday,Tottenham Hotspur,1-0,1,0,1,1,1,1,H
1965-04-17,1964,Sunderland,Birmingham City,2-1,2,1,1,1,3,1,H
1965-04-17,1964,Wolverhampton Wanderers,Everton,2-4,2,4,1,1,6,-2,A
1965-04-19,1964,Arsenal,Blackpool,3-1,3,1,1,1,4,2,H
1965-04-19,1964,Birmingham City,Manchester United,2-4,2,4,1,1,6,-2,A
1965-04-19,1964,Blackburn Rovers,Tottenham Hotspur,3-1,3,1,1,1,4,2,H
1965-04-19,1964,Fulham,Everton,1-1,1,1,1,1,2,0,D
1965-04-19,1964,Leicester City,Aston Villa,1-1,1,1,1,1,2,0,D
1965-04-19,1964,Liverpool,Chelsea,2-0,2,0,1,1,2,2,H
1965-04-19,1964,Nottingham Forest,Sheffield United,0-0,0,0,1,1,0,0,D
1965-04-19,1964,Sheffield Wednesday,Leeds United,3-0,3,0,1,1,3,3,H
1965-04-19,1964,Stoke City,Burnley,2-0,2,0,1,1,2,2,H
1965-04-19,1964,West Bromwich Albion,West Ham United,4-2,4,2,1,1,6,2,H
1965-04-20,1964,Aston Villa,Leicester City,1-0,1,0,1,1,1,1,H
1965-04-20,1964,Burnley,Stoke City,1-0,1,0,1,1,1,1,H
1965-04-20,1964,Leeds United,Sheffield Wednesday,2-0,2,0,1,1,2,2,H
1965-04-20,1964,Sheffield United,Nottingham Forest,0-2,0,2,1,1,2,-2,A
1965-04-20,1964,Wolverhampton Wanderers,Sunderland,3-0,3,0,1,1,3,3,H
1965-04-23,1964,West Ham United,Blackpool,2-1,2,1,1,1,3,1,H
1965-04-24,1964,Birmingham City,Blackburn Rovers,5-5,5,5,1,1,10,0,D
1965-04-24,1964,Burnley,Chelsea,6-2,6,2,1,1,8,4,H
1965-04-24,1964,Everton,Arsenal,1-0,1,0,1,1,1,1,H
1965-04-24,1964,Fulham,Aston Villa,1-1,1,1,1,1,2,0,D
1965-04-24,1964,Manchester United,Liverpool,3-0,3,0,1,1,3,3,H
1965-04-24,1964,Nottingham Forest,Wolverhampton Wanderers,0-2,0,2,1,1,2,-2,A
1965-04-24,1964,Sheffield United,Leeds United,0-3,0,3,1,1,3,-3,A
1965-04-24,1964,Stoke City,Sunderland,3-1,3,1,1,1,4,2,H
1965-04-24,1964,Tottenham Hotspur,Leicester City,6-2,6,2,1,1,8,4,H
1965-04-24,1964,West Bromwich Albion,Sheffield Wednesday,1-0,1,0,1,1,1,1,H
1965-04-26,1964,Birmingham City,Leeds United,3-3,3,3,1,1,6,0,D
1965-04-26,1964,Blackpool,Chelsea,3-2,3,2,1,1,5,1,H
1965-04-26,1964,Leicester City,Stoke City,0-1,0,1,1,1,1,-1,A
1965-04-26,1964,Manchester United,Arsenal,3-1,3,1,1,1,4,2,H
1965-04-26,1964,Wolverhampton Wanderers,Liverpool,1-3,1,3,1,1,4,-2,A
1965-04-27,1964,Blackburn Rovers,Nottingham Forest,1-1,1,1,1,1,2,0,D
1965-04-28,1964,Aston Villa,Manchester United,2-1,2,1,1,1,3,1,H
1965-04-28,1964,Sunderland,Sheffield Wednesday,3-0,3,0,1,1,3,3,H
1965-08-21,1965,Arsenal,Stoke City,2-1,2,1,1,1,3,1,H
1965-08-21,1965,Blackpool,Fulham,2-2,2,2,1,1,4,0,D
1965-08-21,1965,Chelsea,Burnley,1-1,1,1,1,1,2,0,D
1965-08-21,1965,Everton,Northampton Town,5-2,5,2,1,1,7,3,H
1965-08-21,1965,Leeds United,Sunderland,1-0,1,0,1,1,1,1,H
1965-08-21,1965,Leicester City,Liverpool,1-3,1,3,1,1,4,-2,A
1965-08-21,1965,Manchester United,Sheffield Wednesday,1-0,1,0,1,1,1,1,H
1965-08-21,1965,Newcastle United,Nottingham Forest,2-2,2,2,1,1,4,0,D
1965-08-21,1965,Sheffield United,Aston Villa,1-0,1,0,1,1,1,1,H
1965-08-21,1965,West Bromwich Albion,West Ham United,3-0,3,0,1,1,3,3,H
1965-08-23,1965,Aston Villa,Leeds United,0-2,0,2,1,1,2,-2,A
1965-08-23,1965,West Ham United,Sunderland,1-1,1,1,1,1,2,0,D
1965-08-24,1965,Burnley,Blackpool,3-1,3,1,1,1,4,2,H
1965-08-24,1965,Nottingham Forest,Manchester United,4-2,4,2,1,1,6,2,H
1965-08-25,1965,Fulham,Blackburn Rovers,5-2,5,2,1,1,7,3,H
1965-08-25,1965,Liverpool,Sheffield United,0-1,0,1,1,1,1,-1,A
1965-08-25,1965,Newcastle United,West Bromwich Albion,0-1,0,1,1,1,1,-1,A
1965-08-25,1965,Northampton Town,Arsenal,1-1,1,1,1,1,2,0,D
1965-08-25,1965,Sheffield Wednesday,Everton,3-1,3,1,1,1,4,2,H
1965-08-25,1965,Stoke City,Chelsea,2-2,2,2,1,1,4,0,D
1965-08-25,1965,Tottenham Hotspur,Leicester City,4-2,4,2,1,1,6,2,H
1965-08-27,1965,Tottenham Hotspur,Blackpool,4-0,4,0,1,1,4,4,H
1965-08-28,1965,Aston Villa,Leicester City,2-2,2,2,1,1,4,0,D
1965-08-28,1965,Burnley,Arsenal,2-2,2,2,1,1,4,0,D
1965-08-28,1965,Fulham,Chelsea,0-3,0,3,1,1,3,-3,A
1965-08-28,1965,Northampton Town,Manchester United,1-1,1,1,1,1,2,0,D
1965-08-28,1965,Nottingham Forest,West Bromwich Albion,3-2,3,2,1,1,5,1,H
1965-08-28,1965,Sheffield Wednesday,Newcastle United,1-0,1,0,1,1,1,1,H
1965-08-28,1965,Stoke City,Everton,1-1,1,1,1,1,2,0,D
1965-08-28,1965,Sunderland,Sheffield United,4-1,4,1,1,1,5,3,H
1965-08-28,1965,West Ham United,Leeds United,2-1,2,1,1,1,3,1,H
1965-08-30,1965,Blackpool,Burnley,1-3,1,3,1,1,4,-2,A
1965-08-31,1965,Everton,Sheffield Wednesday,5-1,5,1,1,1,6,4,H
1965-09-01,1965,Blackburn Rovers,Fulham,3-2,3,2,1,1,5,1,H
1965-09-01,1965,Chelsea,Stoke City,1-2,1,2,1,1,3,-1,A
1965-09-01,1965,Leeds United,Aston Villa,2-0,2,0,1,1,2,2,H
1965-09-01,1965,Leicester City,Tottenham Hotspur,2-2,2,2,1,1,4,0,D
1965-09-01,1965,Manchester United,Nottingham Forest,0-0,0,0,1,1,0,0,D
1965-09-01,1965,Sheffield United,Liverpool,0-0,0,0,1,1,0,0,D
1965-09-01,1965,Sunderland,West Ham United,2-1,2,1,1,1,3,1,H
1965-09-01,1965,West Bromwich Albion,Newcastle United,1-2,1,2,1,1,3,-1,A
1965-09-04,1965,Arsenal,Chelsea,1-3,1,3,1,1,4,-2,A
1965-09-04,1965,Blackburn Rovers,Aston Villa,0-2,0,2,1,1,2,-2,A
1965-09-04,1965,Blackpool,Liverpool,2-3,2,3,1,1,5,-1,A
1965-09-04,1965,Everton,Burnley,1-0,1,0,1,1,1,1,H
1965-09-04,1965,Fulham,Tottenham Hotspur,0-2,0,2,1,1,2,-2,A
1965-09-04,1965,Leeds United,Nottingham Forest,2-1,2,1,1,1,3,1,H
1965-09-04,1965,Leicester City,Sunderland,4-1,4,1,1,1,5,3,H
1965-09-04,1965,Manchester United,Stoke City,1-1,1,1,1,1,2,0,D
1965-09-04,1965,Newcastle United,Northampton Town,2-0,2,0,1,1,2,2,H
1965-09-04,1965,Sheffield United,West Ham United,5-3,5,3,1,1,8,2,H
1965-09-04,1965,West Bromwich Albion,Sheffield Wednesday,4-2,4,2,1,1,6,2,H
1965-09-06,1965,Aston Villa,Sunderland,3-1,3,1,1,1,4,2,H
1965-09-06,1965,Blackpool,Leicester City,4-0,4,0,1,1,4,4,H
1965-09-06,1965,West Ham United,Liverpool,1-5,1,5,1,1,6,-4,A
1965-09-07,1965,Burnley,Northampton Town,4-1,4,1,1,1,5,3,H
1965-09-07,1965,Everton,West Bromwich Albion,2-3,2,3,1,1,5,-1,A
1965-09-07,1965,Nottingham Forest,Arsenal,0-1,0,1,1,1,1,-1,A
1965-09-08,1965,Fulham,Sheffield United,0-0,0,0,1,1,0,0,D
1965-09-08,1965,Newcastle United,Manchester United,1-2,1,2,1,1,3,-1,A
1965-09-08,1965,Stoke City,Blackburn Rovers,3-2,3,2,1,1,5,1,H
1965-09-08,1965,Tottenham Hotspur,Leeds United,3-2,3,2,1,1,5,1,H
1965-09-10,1965,Northampton Town,West Bromwich Albion,3-4,3,4,1,1,7,-1,A
1965-09-11,1965,Aston Villa,Blackpool,3-0,3,0,1,1,3,3,H
1965-09-11,1965,Burnley,Manchester United,3-0,3,0,1,1,3,3,H
1965-09-11,1965,Chelsea,Everton,3-1,3,1,1,1,4,2,H
1965-09-11,1965,Leeds United,Sheffield United,2-2,2,2,1,1,4,0,D
1965-09-11,1965,Liverpool,Fulham,2-1,2,1,1,1,3,1,H
1965-09-11,1965,Sheffield Wednesday,Nottingham Forest,3-1,3,1,1,1,4,2,H
1965-09-11,1965,Stoke City,Newcastle United,4-0,4,0,1,1,4,4,H
1965-09-11,1965,Sunderland,Blackburn Rovers,1-0,1,0,1,1,1,1,H
1965-09-11,1965,Tottenham Hotspur,Arsenal,2-2,2,2,1,1,4,0,D
1965-09-11,1965,West Ham United,Leicester City,2-5,2,5,1,1,7,-3,A
1965-09-14,1965,Arsenal,Nottingham Forest,1-0,1,0,1,1,1,1,H
1965-09-14,1965,Leicester City,Blackpool,0-3,0,3,1,1,3,-3,A
1965-09-15,1965,Blackburn Rovers,Stoke City,0-1,0,1,1,1,1,-1,A
1965-09-15,1965,Chelsea,Sheffield Wednesday,1-1,1,1,1,1,2,0,D
1965-09-15,1965,Leeds United,Tottenham Hotspur,2-0,2,0,1,1,2,2,H
1965-09-15,1965,Liverpool,West Ham United,1-1,1,1,1,1,2,0,D
1965-09-15,1965,Manchester United,Newcastle United,1-1,1,1,1,1,2,0,D
1965-09-15,1965,Northampton Town,Burnley,1-2,1,2,1,1,3,-1,A
1965-09-15,1965,Sheffield United,Fulham,2-0,2,0,1,1,2,2,H
1965-09-15,1965,Sunderland,Aston Villa,2-0,2,0,1,1,2,2,H
1965-09-15,1965,West Bromwich Albion,Everton,1-1,1,1,1,1,2,0,D
1965-09-18,1965,Blackburn Rovers,West Ham United,1-2,1,2,1,1,3,-1,A
1965-09-18,1965,Blackpool,Sunderland,1-2,1,2,1,1,3,-1,A
1965-09-18,1965,Everton,Arsenal,3-1,3,1,1,1,4,2,H
1965-09-18,1965,Fulham,Aston Villa,3-6,3,6,1,1,9,-3,A
1965-09-18,1965,Leicester City,Leeds United,3-3,3,3,1,1,6,0,D
1965-09-18,1965,Manchester United,Chelsea,4-1,4,1,1,1,5,3,H
1965-09-18,1965,Newcastle United,Burnley,3-2,3,2,1,1,5,1,H
1965-09-18,1965,Nottingham Forest,Northampton Town,1-1,1,1,1,1,2,0,D
1965-09-18,1965,Sheffield United,Sheffield Wednesday,1-0,1,0,1,1,1,1,H
1965-09-18,1965,Tottenham Hotspur,Liverpool,2-1,2,1,1,1,3,1,H
1965-09-18,1965,West Bromwich Albion,Stoke City,6-2,6,2,1,1,8,4,H
1965-09-25,1965,Arsenal,Manchester United,4-2,4,2,1,1,6,2,H
1965-09-25,1965,Aston Villa,Tottenham Hotspur,3-2,3,2,1,1,5,1,H
1965-09-25,1965,Burnley,West Bromwich Albion,2-0,2,0,1,1,2,2,H
1965-09-25,1965,Chelsea,Newcastle United,1-1,1,1,1,1,2,0,D
1965-09-25,1965,Leeds United,Blackburn Rovers,3-0,3,0,1,1,3,3,H
1965-09-25,1965,Liverpool,Everton,5-0,5,0,1,1,5,5,H
1965-09-25,1965,Northampton Town,Sheffield Wednesday,0-0,0,0,1,1,0,0,D
1965-09-25,1965,Sheffield United,Leicester City,2-2,2,2,1,1,4,0,D
1965-09-25,1965,Stoke City,Nottingham Forest,1-0,1,0,1,1,1,1,H
1965-09-25,1965,Sunderland,Fulham,2-2,2,2,1,1,4,0,D
1965-09-25,1965,West Ham United,Blackpool,1-1,1,1,1,1,2,0,D
1965-09-28,1965,Arsenal,Northampton Town,1-1,1,1,1,1,2,0,D
1965-10-02,1965,Blackburn Rovers,Sheffield United,0-0,0,0,1,1,0,0,D
1965-10-02,1965,Fulham,West Ham United,3-0,3,0,1,1,3,3,H
1965-10-02,1965,Leicester City,Northampton Town,1-1,1,1,1,1,2,0,D
1965-10-02,1965,Liverpool,Aston Villa,3-1,3,1,1,1,4,2,H
1965-10-02,1965,Newcastle United,Arsenal,0-1,0,1,1,1,1,-1,A
1965-10-02,1965,West Bromwich Albion,Chelsea,1-2,1,2,1,1,3,-1,A
1965-10-05,1965,Everton,Blackburn Rovers,2-2,2,2,1,1,4,0,D
1965-10-06,1965,Tottenham Hotspur,Sunderland,3-0,3,0,1,1,3,3,H
1965-10-09,1965,Arsenal,Fulham,2-1,2,1,1,1,3,1,H
1965-10-09,1965,Burnley,Blackburn Rovers,1-4,1,4,1,1,5,-3,A
1965-10-09,1965,Chelsea,Blackpool,0-1,0,1,1,1,1,-1,A
1965-10-09,1965,Everton,Tottenham Hotspur,3-1,3,1,1,1,4,2,H
1965-10-09,1965,Manchester United,Liverpool,2-0,2,0,1,1,2,2,H
1965-10-09,1965,Newcastle United,Aston Villa,1-0,1,0,1,1,1,1,H
1965-10-09,1965,Northampton Town,Sheffield United,0-1,0,1,1,1,1,-1,A
1965-10-09,1965,Nottingham Forest,West Ham United,5-0,5,0,1,1,5,5,H
1965-10-09,1965,Sheffield Wednesday,Leeds United,0-0,0,0,1,1,0,0,D
1965-10-09,1965,Stoke City,Leicester City,1-0,1,0,1,1,1,1,H
1965-10-09,1965,West Bromwich Albion,Sunderland,4-1,4,1,1,1,5,3,H
1965-10-16,1965,Aston Villa,West Bromwich Albion,1-1,1,1,1,1,2,0,D
1965-10-16,1965,Blackburn Rovers,Chelsea,0-1,0,1,1,1,1,-1,A
1965-10-16,1965,Blackpool,Arsenal,5-3,5,3,1,1,8,2,H
1965-10-16,1965,Fulham,Everton,3-2,3,2,1,1,5,1,H
1965-10-16,1965,Leeds United,Northampton Town,6-1,6,1,1,1,7,5,H
1965-10-16,1965,Leicester City,Burnley,0-1,0,1,1,1,1,-1,A
1965-10-16,1965,Liverpool,Newcastle United,2-0,2,0,1,1,2,2,H
1965-10-16,1965,Sheffield United,Stoke City,3-2,3,2,1,1,5,1,H
1965-10-16,1965,Sunderland,Nottingham Forest,3-2,3,2,1,1,5,1,H
1965-10-16,1965,Tottenham Hotspur,Manchester United,5-1,5,1,1,1,6,4,H
1965-10-16,1965,West Ham United,Sheffield Wednesday,4-2,4,2,1,1,6,2,H
1965-10-23,1965,Arsenal,Blackburn Rovers,2-2,2,2,1,1,4,0,D
1965-10-23,1965,Burnley,Sheffield United,2-0,2,0,1,1,2,2,H
1965-10-23,1965,Chelsea,Leicester City,0-2,0,2,1,1,2,-2,A
1965-10-23,1965,Everton,Blackpool,0-0,0,0,1,1,0,0,D
1965-10-23,1965,Manchester United,Fulham,4-1,4,1,1,1,5,3,H
1965-10-23,1965,Newcastle United,Tottenham Hotspur,0-0,0,0,1,1,0,0,D
1965-10-23,1965,Northampton Town,West Ham United,2-1,2,1,1,1,3,1,H
1965-10-23,1965,Nottingham Forest,Aston Villa,1-2,1,2,1,1,3,-1,A
1965-10-23,1965,Sheffield Wednesday,Sunderland,3-1,3,1,1,1,4,2,H
1965-10-23,1965,Stoke City,Leeds United,1-2,1,2,1,1,3,-1,A
1965-10-23,1965,West Bromwich Albion,Liverpool,3-0,3,0,1,1,3,3,H
1965-10-30,1965,Aston Villa,Sheffield Wednesday,2-0,2,0,1,1,2,2,H
1965-10-30,1965,Blackburn Rovers,Everton,1-2,1,2,1,1,3,-1,A
1965-10-30,1965,Blackpool,Manchester United,1-2,1,2,1,1,3,-1,A
1965-10-30,1965,Fulham,Newcastle United,2-0,2,0,1,1,2,2,H
1965-10-30,1965,Leeds United,Burnley,1-1,1,1,1,1,2,0,D
1965-10-30,1965,Leicester City,Arsenal,3-1,3,1,1,1,4,2,H
1965-10-30,1965,Liverpool,Nottingham Forest,4-0,4,0,1,1,4,4,H
1965-10-30,1965,Sheffield United,Chelsea,1-2,1,2,1,1,3,-1,A
1965-10-30,1965,Sunderland,Northampton Town,3-0,3,0,1,1,3,3,H
1965-10-30,1965,Tottenham Hotspur,West Bromwich Albion,2-1,2,1,1,1,3,1,H
1965-10-30,1965,West Ham United,Stoke City,0-0,0,0,1,1,0,0,D
1965-11-06,1965,Arsenal,Sheffield United,6-2,6,2,1,1,8,4,H
1965-11-06,1965,Burnley,West Ham United,3-1,3,1,1,1,4,2,H
1965-11-06,1965,Chelsea,Leeds United,1-0,1,0,1,1,1,1,H
1965-11-06,1965,Everton,Leicester City,1-2,1,2,1,1,3,-1,A
1965-11-06,1965,Manchester United,Blackburn Rovers,2-2,2,2,1,1,4,0,D
1965-11-06,1965,Newcastle United,Blackpool,2-0,2,0,1,1,2,2,H
1965-11-06,1965,Northampton Town,Aston Villa,2-1,2,1,1,1,3,1,H
1965-11-06,1965,Nottingham Forest,Tottenham Hotspur,1-0,1,0,1,1,1,1,H
1965-11-06,1965,Sheffield Wednesday,Liverpool,0-2,0,2,1,1,2,-2,A
1965-11-06,1965,Stoke City,Sunderland,1-1,1,1,1,1,2,0,D
1965-11-06,1965,West Bromwich Albion,Fulham,6-2,6,2,1,1,8,4,H
1965-11-13,1965,Aston Villa,Stoke City,0-1,0,1,1,1,1,-1,A
1965-11-13,1965,Blackburn Rovers,Newcastle United,4-2,4,2,1,1,6,2,H
1965-11-13,1965,Blackpool,West Bromwich Albion,1-1,1,1,1,1,2,0,D
1965-11-13,1965,Fulham,Nottingham Forest,1-1,1,1,1,1,2,0,D
1965-11-13,1965,Leeds United,Arsenal,2-0,2,0,1,1,2,2,H
1965-11-13,1965,Leicester City,Manchester United,0-5,0,5,1,1,5,-5,A
1965-11-13,1965,Liverpool,Northampton Town,5-0,5,0,1,1,5,5,H
1965-11-13,1965,Sheffield United,Everton,2-0,2,0,1,1,2,2,H
1965-11-13,1965,Sunderland,Burnley,0-4,0,4,1,1,4,-4,A
1965-11-13,1965,Tottenham Hotspur,Sheffield Wednesday,2-3,2,3,1,1,5,-1,A
1965-11-13,1965,West Ham United,Chelsea,2-1,2,1,1,1,3,1,H
1965-11-17,1965,Liverpool,Blackburn Rovers,5-2,5,2,1,1,7,3,H
1965-11-20,1965,Arsenal,West Ham United,3-2,3,2,1,1,5,1,H
1965-11-20,1965,Burnley,Aston Villa,3-1,3,1,1,1,4,2,H
1965-11-20,1965,Everton,Leeds United,0-0,0,0,1,1,0,0,D
1965-11-20,1965,Manchester United,Sheffield United,3-1,3,1,1,1,4,2,H
1965-11-20,1965,Newcastle United,Leicester City,1-5,1,5,1,1,6,-4,A
1965-11-20,1965,Northampton Town,Tottenham Hotspur,0-2,0,2,1,1,2,-2,A
1965-11-20,1965,Nottingham Forest,Blackpool,2-1,2,1,1,1,3,1,H
1965-11-20,1965,Sheffield Wednesday,Fulham,1-0,1,0,1,1,1,1,H
1965-11-20,1965,Stoke City,Liverpool,0-0,0,0,1,1,0,0,D
1965-11-20,1965,West Bromwich Albion,Blackburn Rovers,2-1,2,1,1,1,3,1,H
1965-11-27,1965,Aston Villa,Chelsea,2-4,2,4,1,1,6,-2,A
1965-11-27,1965,Blackburn Rovers,Nottingham Forest,5-0,5,0,1,1,5,5,H
1965-11-27,1965,Blackpool,Sheffield Wednesday,2-1,2,1,1,1,3,1,H
1965-11-27,1965,Fulham,Northampton Town,1-4,1,4,1,1,5,-3,A
1965-11-27,1965,Leicester City,West Bromwich Albion,2-1,2,1,1,1,3,1,H
1965-11-27,1965,Liverpool,Burnley,2-1,2,1,1,1,3,1,H
1965-11-27,1965,Sheffield United,Newcastle United,3-2,3,2,1,1,5,1,H
1965-11-27,1965,Tottenham Hotspur,Stoke City,2-2,2,2,1,1,4,0,D
1965-11-27,1965,West Ham United,Everton,3-0,3,0,1,1,3,3,H
1965-12-04,1965,Arsenal,Aston Villa,3-3,3,3,1,1,6,0,D
1965-12-04,1965,Burnley,Tottenham Hotspur,1-1,1,1,1,1,2,0,D
1965-12-04,1965,Chelsea,Liverpool,0-1,0,1,1,1,1,-1,A
1965-12-04,1965,Everton,Sunderland,2-0,2,0,1,1,2,2,H
1965-12-04,1965,Manchester United,West Ham United,0-0,0,0,1,1,0,0,D
1965-12-04,1965,Northampton Town,Blackpool,2-1,2,1,1,1,3,1,H
1965-12-04,1965,Nottingham Forest,Leicester City,2-0,2,0,1,1,2,2,H
1965-12-04,1965,Sheffield Wednesday,Blackburn Rovers,2-1,2,1,1,1,3,1,H
1965-12-04,1965,Stoke City,Fulham,3-2,3,2,1,1,5,1,H
1965-12-04,1965,West Bromwich Albion,Sheffield United,1-1,1,1,1,1,2,0,D
1965-12-11,1965,Aston Villa,Everton,3-2,3,2,1,1,5,1,H
1965-12-11,1965,Blackburn Rovers,Northampton Town,6-1,6,1,1,1,7,5,H
1965-12-11,1965,Blackpool,Stoke City,1-1,1,1,1,1,2,0,D
1965-12-11,1965,Fulham,Burnley,2-5,2,5,1,1,7,-3,A
1965-12-11,1965,Leeds United,West Bromwich Albion,4-0,4,0,1,1,4,4,H
1965-12-11,1965,Leicester City,Sheffield Wednesday,4-1,4,1,1,1,5,3,H
1965-12-11,1965,Liverpool,Arsenal,4-2,4,2,1,1,6,2,H
1965-12-11,1965,Sheffield United,Nottingham Forest,1-1,1,1,1,1,2,0,D
1965-12-11,1965,Sunderland,Manchester United,2-3,2,3,1,1,5,-1,A
1965-12-11,1965,Tottenham Hotspur,Chelsea,4-2,4,2,1,1,6,2,H
1965-12-11,1965,West Ham United,Newcastle United,4-3,4,3,1,1,7,1,H
1965-12-15,1965,Manchester United,Everton,3-0,3,0,1,1,3,3,H
1965-12-18,1965,Burnley,Leicester City,4-2,4,2,1,1,6,2,H
1965-12-18,1965,Everton,Fulham,2-0,2,0,1,1,2,2,H
1965-12-18,1965,Manchester United,Tottenham Hotspur,5-1,5,1,1,1,6,4,H
1965-12-18,1965,Newcastle United,Liverpool,0-0,0,0,1,1,0,0,D
1965-12-18,1965,Nottingham Forest,Sunderland,0-0,0,0,1,1,0,0,D
1965-12-18,1965,Sheffield Wednesday,West Ham United,0-0,0,0,1,1,0,0,D
1965-12-25,1965,Blackpool,Blackburn Rovers,4-2,4,2,1,1,6,2,H
1965-12-27,1965,Liverpool,Leeds United,0-1,0,1,1,1,1,-1,A
1965-12-27,1965,Manchester United,West Bromwich Albion,1-1,1,1,1,1,2,0,D
1965-12-27,1965,Northampton Town,Chelsea,2-3,2,3,1,1,5,-1,A
1965-12-27,1965,Nottingham Forest,Everton,1-0,1,0,1,1,1,1,H
1965-12-27,1965,Sheffield Wednesday,Arsenal,4-0,4,0,1,1,4,4,H
1965-12-27,1965,Stoke City,Burnley,3-1,3,1,1,1,4,2,H
1965-12-27,1965,Tottenham Hotspur,Sheffield United,1-0,1,0,1,1,1,1,H
1965-12-28,1965,Arsenal,Sheffield Wednesday,5-2,5,2,1,1,7,3,H
1965-12-28,1965,Burnley,Stoke City,4-1,4,1,1,1,5,3,H
1965-12-28,1965,Chelsea,Northampton Town,1-0,1,0,1,1,1,1,H
1965-12-28,1965,Leeds United,Liverpool,0-1,0,1,1,1,1,-1,A
1965-12-28,1965,Leicester City,Fulham,5-0,5,0,1,1,5,5,H
1965-12-28,1965,Sheffield United,Tottenham Hotspur,1-3,1,3,1,1,4,-2,A
1966-01-01,1965,Aston Villa,Newcastle United,4-2,4,2,1,1,6,2,H
1966-01-01,1965,Blackburn Rovers,Burnley,0-2,0,2,1,1,2,-2,A
1966-01-01,1965,Blackpool,Chelsea,1-2,1,2,1,1,3,-1,A
1966-01-01,1965,Fulham,Arsenal,1-0,1,0,1,1,1,1,H
1966-01-01,1965,Leeds United,Sheffield Wednesday,3-0,3,0,1,1,3,3,H
1966-01-01,1965,Leicester City,Stoke City,1-0,1,0,1,1,1,1,H
1966-01-01,1965,Liverpool,Manchester United,2-1,2,1,1,1,3,1,H
1966-01-01,1965,Sheffield United,Northampton Town,2-2,2,2,1,1,4,0,D
1966-01-01,1965,Sunderland,West Bromwich Albion,1-5,1,5,1,1,6,-4,A
1966-01-01,1965,Tottenham Hotspur,Everton,2-2,2,2,1,1,4,0,D
1966-01-01,1965,West Ham United,Nottingham Forest,0-3,0,3,1,1,3,-3,A
1966-01-03,1965,Sunderland,Newcastle United,2-0,2,0,1,1,2,2,H
1966-01-08,1965,Arsenal,Liverpool,0-1,0,1,1,1,1,-1,A
1966-01-08,1965,Burnley,Fulham,1-0,1,0,1,1,1,1,H
1966-01-08,1965,Chelsea,Tottenham Hotspur,2-1,2,1,1,1,3,1,H
1966-01-08,1965,Everton,Aston Villa,2-0,2,0,1,1,2,2,H
1966-01-08,1965,Manchester United,Sunderland,1-1,1,1,1,1,2,0,D
1966-01-08,1965,Newcastle United,West Ham United,2-1,2,1,1,1,3,1,H
1966-01-08,1965,Northampton Town,Blackburn Rovers,2-1,2,1,1,1,3,1,H
1966-01-08,1965,Nottingham Forest,Sheffield United,1-0,1,0,1,1,1,1,H
1966-01-08,1965,Sheffield Wednesday,Leicester City,1-2,1,2,1,1,3,-1,A
1966-01-08,1965,Stoke City,Blackpool,4-1,4,1,1,1,5,3,H
1966-01-08,1965,West Bromwich Albion,Leeds United,1-2,1,2,1,1,3,-1,A
1966-01-11,1965,Everton,West Ham United,2-2,2,2,1,1,4,0,D
1966-01-12,1965,Leeds United,Manchester United,1-1,1,1,1,1,2,0,D
1966-01-15,1965,Aston Villa,Nottingham Forest,3-0,3,0,1,1,3,3,H
1966-01-15,1965,Blackburn Rovers,Arsenal,2-1,2,1,1,1,3,1,H
1966-01-15,1965,Blackpool,Everton,2-0,2,0,1,1,2,2,H
1966-01-15,1965,Fulham,Manchester United,0-1,0,1,1,1,1,-1,A
1966-01-15,1965,Leeds United,Stoke City,2-2,2,2,1,1,4,0,D
1966-01-15,1965,Liverpool,West Bromwich Albion,2-2,2,2,1,1,4,0,D
1966-01-15,1965,Sheffield United,Burnley,2-1,2,1,1,1,3,1,H
1966-01-15,1965,Tottenham Hotspur,Newcastle United,2-2,2,2,1,1,4,0,D
1966-01-15,1965,West Ham United,Northampton Town,1-1,1,1,1,1,2,0,D
1966-01-26,1965,Sunderland,Sheffield Wednesday,0-2,0,2,1,1,2,-2,A
1966-01-29,1965,Aston Villa,Sheffield United,0-2,0,2,1,1,2,-2,A
1966-01-29,1965,Burnley,Chelsea,1-2,1,2,1,1,3,-1,A
1966-01-29,1965,Fulham,Blackpool,0-0,0,0,1,1,0,0,D
1966-01-29,1965,Liverpool,Leicester City,1-0,1,0,1,1,1,1,H
1966-01-29,1965,Northampton Town,Everton,0-2,0,2,1,1,2,-2,A
1966-01-29,1965,Nottingham Forest,Newcastle United,1-2,1,2,1,1,3,-1,A
1966-01-29,1965,Sheffield Wednesday,Manchester United,0-0,0,0,1,1,0,0,D
1966-01-29,1965,Stoke City,Arsenal,1-3,1,3,1,1,4,-2,A
1966-01-29,1965,Sunderland,Leeds United,2-0,2,0,1,1,2,2,H
1966-01-29,1965,Tottenham Hotspur,Blackburn Rovers,4-0,4,0,1,1,4,4,H
1966-01-29,1965,West Ham United,West Bromwich Albion,4-0,4,0,1,1,4,4,H
1966-02-05,1965,Arsenal,Burnley,1-1,1,1,1,1,2,0,D
1966-02-05,1965,Blackburn Rovers,Liverpool,1-4,1,4,1,1,5,-3,A
1966-02-05,1965,Blackpool,Tottenham Hotspur,0-0,0,0,1,1,0,0,D
1966-02-05,1965,Chelsea,Fulham,2-1,2,1,1,1,3,1,H
1966-02-05,1965,Everton,Stoke City,2-1,2,1,1,1,3,1,H
1966-02-05,1965,Leeds United,West Ham United,5-0,5,0,1,1,5,5,H
1966-02-05,1965,Leicester City,Aston Villa,2-1,2,1,1,1,3,1,H
1966-02-05,1965,Manchester United,Northampton Town,6-2,6,2,1,1,8,4,H
1966-02-05,1965,Newcastle United,Sheffield Wednesday,2-0,2,0,1,1,2,2,H
1966-02-05,1965,Sheffield United,Sunderland,2-2,2,2,1,1,4,0,D
1966-02-05,1965,West Bromwich Albion,Nottingham Forest,5-3,5,3,1,1,8,2,H
1966-02-07,1965,Aston Villa,West Ham United,1-2,1,2,1,1,3,-1,A
1966-02-11,1965,West Bromwich Albion,Aston Villa,2-2,2,2,1,1,4,0,D
1966-02-12,1965,Liverpool,Sunderland,4-0,4,0,1,1,4,4,H
1966-02-12,1965,Stoke City,Northampton Town,6-2,6,2,1,1,8,4,H
1966-02-19,1965,Aston Villa,Blackburn Rovers,3-1,3,1,1,1,4,2,H
1966-02-19,1965,Burnley,Everton,1-1,1,1,1,1,2,0,D
1966-02-19,1965,Chelsea,Arsenal,0-0,0,0,1,1,0,0,D
1966-02-19,1965,Liverpool,Blackpool,4-1,4,1,1,1,5,3,H
1966-02-19,1965,Northampton Town,Newcastle United,3-1,3,1,1,1,4,2,H
1966-02-19,1965,Nottingham Forest,Leeds United,0-4,0,4,1,1,4,-4,A
1966-02-19,1965,Sheffield Wednesday,West Bromwich Albion,1-2,1,2,1,1,3,-1,A
1966-02-19,1965,Stoke City,Manchester United,2-2,2,2,1,1,4,0,D
1966-02-19,1965,Sunderland,Leicester City,0-3,0,3,1,1,3,-3,A
1966-02-19,1965,Tottenham Hotspur,Fulham,4-3,4,3,1,1,7,1,H
1966-02-19,1965,West Ham United,Sheffield United,4-0,4,0,1,1,4,4,H
1966-02-22,1965,Chelsea,Sunderland,3-2,3,2,1,1,5,1,H
1966-02-26,1965,Blackburn Rovers,Sunderland,2-0,2,0,1,1,2,2,H
1966-02-26,1965,Blackpool,Aston Villa,0-1,0,1,1,1,1,-1,A
1966-02-26,1965,Everton,Chelsea,2-1,2,1,1,1,3,1,H
1966-02-26,1965,Fulham,Liverpool,2-0,2,0,1,1,2,2,H
1966-02-26,1965,Manchester United,Burnley,4-2,4,2,1,1,6,2,H
1966-02-26,1965,Newcastle United,Stoke City,3-1,3,1,1,1,4,2,H
1966-02-26,1965,Sheffield United,Leeds United,1-1,1,1,1,1,2,0,D
1966-02-26,1965,West Bromwich Albion,Northampton Town,1-1,1,1,1,1,2,0,D
1966-03-05,1965,Arsenal,Blackpool,0-0,0,0,1,1,0,0,D
1966-03-05,1965,Newcastle United,Sunderland,2-0,2,0,1,1,2,2,H
1966-03-05,1965,Northampton Town,Leeds United,2-1,2,1,1,1,3,1,H
1966-03-05,1965,West Ham United,Aston Villa,4-2,4,2,1,1,6,2,H
1966-03-08,1965,Arsenal,Tottenham Hotspur,1-1,1,1,1,1,2,0,D
1966-03-08,1965,Nottingham Forest,Burnley,1-0,1,0,1,1,1,1,H
1966-03-12,1965,Arsenal,Everton,0-1,0,1,1,1,1,-1,A
1966-03-12,1965,Aston Villa,Fulham,2-5,2,5,1,1,7,-3,A
1966-03-12,1965,Burnley,Newcastle United,1-0,1,0,1,1,1,1,H
1966-03-12,1965,Chelsea,Manchester United,2-0,2,0,1,1,2,2,H
1966-03-12,1965,Leeds United,Leicester City,3-2,3,2,1,1,5,1,H
1966-03-12,1965,Liverpool,Tottenham Hotspur,1-0,1,0,1,1,1,1,H
1966-03-12,1965,Northampton Town,Nottingham Forest,3-3,3,3,1,1,6,0,D
1966-03-12,1965,Sheffield Wednesday,Sheffield United,2-2,2,2,1,1,4,0,D
1966-03-12,1965,Stoke City,West Bromwich Albion,1-1,1,1,1,1,2,0,D
1966-03-12,1965,Sunderland,Blackpool,2-1,2,1,1,1,3,1,H
1966-03-12,1965,West Ham United,Blackburn Rovers,4-1,4,1,1,1,5,3,H
1966-03-15,1965,Everton,Nottingham Forest,3-0,3,0,1,1,3,3,H
1966-03-19,1965,Blackburn Rovers,Leeds United,2-3,2,3,1,1,5,-1,A
1966-03-19,1965,Blackpool,West Ham United,2-1,2,1,1,1,3,1,H
1966-03-19,1965,Everton,Liverpool,0-0,0,0,1,1,0,0,D
1966-03-19,1965,Fulham,Sunderland,3-0,3,0,1,1,3,3,H
1966-03-19,1965,Leicester City,Sheffield United,1-0,1,0,1,1,1,1,H
1966-03-19,1965,Manchester United,Arsenal,2-1,2,1,1,1,3,1,H
1966-03-19,1965,Newcastle United,Chelsea,0-1,0,1,1,1,1,-1,A
1966-03-19,1965,Nottingham Forest,Stoke City,4-3,4,3,1,1,7,1,H
1966-03-19,1965,Sheffield Wednesday,Northampton Town,3-1,3,1,1,1,4,2,H
1966-03-19,1965,Tottenham Hotspur,Aston Villa,5-5,5,5,1,1,10,0,D
1966-03-19,1965,West Bromwich Albion,Burnley,1-2,1,2,1,1,3,-1,A
1966-03-21,1965,Leicester City,Chelsea,1-1,1,1,1,1,2,0,D
1966-03-25,1965,Stoke City,Sheffield United,2-0,2,0,1,1,2,2,H
1966-03-26,1965,Arsenal,Newcastle United,1-3,1,3,1,1,4,-2,A
1966-03-26,1965,Aston Villa,Liverpool,0-3,0,3,1,1,3,-3,A
1966-03-26,1965,Burnley,Nottingham Forest,4-1,4,1,1,1,5,3,H
1966-03-26,1965,Leeds United,Blackpool,1-2,1,2,1,1,3,-1,A
1966-03-26,1965,Northampton Town,Leicester City,2-2,2,2,1,1,4,0,D
1966-03-26,1965,Sunderland,Tottenham Hotspur,2-0,2,0,1,1,2,2,H
1966-03-26,1965,West Ham United,Fulham,1-3,1,3,1,1,4,-2,A
1966-03-28,1965,Blackpool,Leeds United,1-0,1,0,1,1,1,1,H
1966-03-29,1965,Sheffield United,Blackburn Rovers,2-0,2,0,1,1,2,2,H
1966-03-30,1965,Sheffield Wednesday,Stoke City,4-1,4,1,1,1,5,3,H
1966-04-02,1965,Aston Villa,Northampton Town,1-2,1,2,1,1,3,-1,A
1966-04-02,1965,Fulham,West Bromwich Albion,2-1,2,1,1,1,3,1,H
1966-04-02,1965,Sunderland,Stoke City,2-0,2,0,1,1,2,2,H
1966-04-02,1965,Tottenham Hotspur,Nottingham Forest,2-3,2,3,1,1,5,-1,A
1966-04-02,1965,West Ham United,Burnley,1-1,1,1,1,1,2,0,D
1966-04-04,1965,Leeds United,Chelsea,2-0,2,0,1,1,2,2,H
1966-04-04,1965,Sheffield Wednesday,Blackpool,3-0,3,0,1,1,3,3,H
1966-04-05,1965,Arsenal,West Bromwich Albion,1-1,1,1,1,1,2,0,D
1966-04-06,1965,Aston Villa,Manchester United,1-1,1,1,1,1,2,0,D
1966-04-06,1965,Liverpool,Sheffield Wednesday,1-0,1,0,1,1,1,1,H
1966-04-08,1965,Blackburn Rovers,Leicester City,0-2,0,2,1,1,2,-2,A
1966-04-08,1965,Blackpool,Sheffield United,2-1,2,1,1,1,3,1,H
1966-04-08,1965,Fulham,Leeds United,1-3,1,3,1,1,4,-2,A
1966-04-08,1965,Newcastle United,Everton,0-0,0,0,1,1,0,0,D
1966-04-08,1965,Tottenham Hotspur,West Ham United,1-4,1,4,1,1,5,-3,A
1966-04-09,1965,Burnley,Sunderland,1-0,1,0,1,1,1,1,H
1966-04-09,1965,Chelsea,West Ham United,6-2,6,2,1,1,8,4,H
1966-04-09,1965,Everton,Sheffield United,1-3,1,3,1,1,4,-2,A
1966-04-09,1965,Manchester United,Leicester City,1-2,1,2,1,1,3,-1,A
1966-04-09,1965,Newcastle United,Blackburn Rovers,2-1,2,1,1,1,3,1,H
1966-04-09,1965,Northampton Town,Liverpool,0-0,0,0,1,1,0,0,D
1966-04-09,1965,Sheffield Wednesday,Tottenham Hotspur,1-1,1,1,1,1,2,0,D
1966-04-09,1965,Stoke City,Aston Villa,2-0,2,0,1,1,2,2,H
1966-04-09,1965,West Bromwich Albion,Blackpool,2-1,2,1,1,1,3,1,H
1966-04-11,1965,Burnley,Sheffield Wednesday,2-1,2,1,1,1,3,1,H
1966-04-11,1965,Chelsea,Nottingham Forest,1-0,1,0,1,1,1,1,H
1966-04-11,1965,Everton,Newcastle United,1-0,1,0,1,1,1,1,H
1966-04-11,1965,Sheffield United,Blackpool,0-1,0,1,1,1,1,-1,A
1966-04-11,1965,Sunderland,Liverpool,2-2,2,2,1,1,4,0,D
1966-04-11,1965,West Bromwich Albion,Arsenal,4-4,4,4,1,1,8,0,D
1966-04-12,1965,Leeds United,Fulham,0-1,0,1,1,1,1,-1,A
1966-04-12,1965,Leicester City,Blackburn Rovers,2-0,2,0,1,1,2,2,H
1966-04-12,1965,Northampton Town,Stoke City,1-0,1,0,1,1,1,1,H
1966-04-12,1965,Nottingham Forest,Chelsea,1-2,1,2,1,1,3,-1,A
1966-04-16,1965,Aston Villa,Burnley,2-1,2,1,1,1,3,1,H
1966-04-16,1965,Blackburn Rovers,West Bromwich Albion,0-1,0,1,1,1,1,-1,A
1966-04-16,1965,Blackpool,Nottingham Forest,0-3,0,3,1,1,3,-3,A
1966-04-16,1965,Fulham,Sheffield Wednesday,4-2,4,2,1,1,6,2,H
1966-04-16,1965,Leeds United,Everton,4-1,4,1,1,1,5,3,H
1966-04-16,1965,Leicester City,Newcastle United,1-2,1,2,1,1,3,-1,A
1966-04-16,1965,Liverpool,Stoke City,2-0,2,0,1,1,2,2,H
1966-04-16,1965,Sheffield United,Manchester United,3-1,3,1,1,1,4,2,H
1966-04-16,1965,Sunderland,Chelsea,2-0,2,0,1,1,2,2,H
1966-04-16,1965,Tottenham Hotspur,Northampton Town,1-1,1,1,1,1,2,0,D
1966-04-16,1965,West Ham United,Arsenal,2-1,2,1,1,1,3,1,H
1966-04-18,1965,Fulham,Leicester City,0-4,0,4,1,1,4,-4,A
1966-04-20,1965,Blackpool,Newcastle United,1-1,1,1,1,1,2,0,D
1966-04-20,1965,Sunderland,Arsenal,0-2,0,2,1,1,2,-2,A
1966-04-22,1965,West Bromwich Albion,Leicester City,5-1,5,1,1,1,6,4,H
1966-04-23,1965,Arsenal,Sunderland,1-1,1,1,1,1,2,0,D
1966-04-23,1965,Burnley,Liverpool,2-0,2,0,1,1,2,2,H
1966-04-23,1965,Newcastle United,Sheffield United,0-2,0,2,1,1,2,-2,A
1966-04-23,1965,Northampton Town,Fulham,2-4,2,4,1,1,6,-2,A
1966-04-23,1965,Nottingham Forest,Blackburn Rovers,0-3,0,3,1,1,3,-3,A
1966-04-23,1965,Stoke City,Tottenham Hotspur,0-1,0,1,1,1,1,-1,A
1966-04-25,1965,Chelsea,West Bromwich Albion,2-3,2,3,1,1,5,-1,A
1966-04-25,1965,Everton,Manchester United,0-0,0,0,1,1,0,0,D
1966-04-25,1965,Northampton Town,Sunderland,2-1,2,1,1,1,3,1,H
1966-04-25,1965,Sheffield United,Arsenal,3-0,3,0,1,1,3,3,H
1966-04-25,1965,West Ham United,Tottenham Hotspur,2-0,2,0,1,1,2,2,H
1966-04-26,1965,Nottingham Forest,Fulham,1-2,1,2,1,1,3,-1,A
1966-04-27,1965,Manchester United,Blackpool,2-1,2,1,1,1,3,1,H
1966-04-27,1965,Sheffield Wednesday,Aston Villa,2-0,2,0,1,1,2,2,H
1966-04-30,1965,Aston Villa,Arsenal,3-0,3,0,1,1,3,3,H
1966-04-30,1965,Blackburn Rovers,Sheffield Wednesday,1-2,1,2,1,1,3,-1,A
1966-04-30,1965,Blackpool,Northampton Town,3-0,3,0,1,1,3,3,H
1966-04-30,1965,Fulham,Stoke City,1-1,1,1,1,1,2,0,D
1966-04-30,1965,Leeds United,Newcastle United,3-0,3,0,1,1,3,3,H
1966-04-30,1965,Leicester City,Nottingham Forest,2-1,2,1,1,1,3,1,H
1966-04-30,1965,Liverpool,Chelsea,2-1,2,1,1,1,3,1,H
1966-04-30,1965,Sheffield United,West Bromwich Albion,0-2,0,2,1,1,2,-2,A
1966-04-30,1965,Sunderland,Everton,2-0,2,0,1,1,2,2,H
1966-04-30,1965,Tottenham Hotspur,Burnley,0-1,0,1,1,1,1,-1,A
1966-04-30,1965,West Ham United,Manchester United,3-2,3,2,1,1,5,1,H
1966-05-02,1965,Blackburn Rovers,Blackpool,1-3,1,3,1,1,4,-2,A
1966-05-02,1965,Sheffield Wednesday,Chelsea,1-1,1,1,1,1,2,0,D
1966-05-04,1965,Chelsea,Blackburn Rovers,1-0,1,0,1,1,1,1,H
1966-05-04,1965,Leicester City,Everton,3-0,3,0,1,1,3,3,H
1966-05-04,1965,Stoke City,Sheffield Wednesday,3-1,3,1,1,1,4,2,H
1966-05-04,1965,West Bromwich Albion,Manchester United,3-3,3,3,1,1,6,0,D
1966-05-05,1965,Arsenal,Leeds United,0-3,0,3,1,1,3,-3,A
1966-05-07,1965,Arsenal,Leicester City,1-0,1,0,1,1,1,1,H
1966-05-07,1965,Blackburn Rovers,Manchester United,1-4,1,4,1,1,5,-3,A
1966-05-07,1965,Burnley,Leeds United,0-1,0,1,1,1,1,-1,A
1966-05-07,1965,Chelsea,Sheffield United,2-0,2,0,1,1,2,2,H
1966-05-07,1965,Newcastle United,Fulham,1-1,1,1,1,1,2,0,D
1966-05-07,1965,Nottingham Forest,Sheffield Wednesday,1-0,1,0,1,1,1,1,H
1966-05-07,1965,Stoke City,West Ham United,1-0,1,0,1,1,1,1,H
1966-05-07,1965,West Bromwich Albion,Tottenham Hotspur,2-1,2,1,1,1,3,1,H
1966-05-09,1965,Blackburn Rovers,Tottenham Hotspur,0-1,0,1,1,1,1,-1,A
1966-05-09,1965,Leicester City,West Ham United,2-1,2,1,1,1,3,1,H
1966-05-09,1965,Manchester United,Aston Villa,6-1,6,1,1,1,7,5,H
1966-05-09,1965,Sheffield Wednesday,Burnley,0-2,0,2,1,1,2,-2,A
1966-05-10,1965,Nottingham Forest,Liverpool,1-1,1,1,1,1,2,0,D
1966-05-16,1965,Chelsea,Aston Villa,0-2,0,2,1,1,2,-2,A
1966-05-16,1965,Newcastle United,Leeds United,2-0,2,0,1,1,2,2,H
1966-05-19,1965,Manchester United,Leeds United,1-1,1,1,1,1,2,0,D
1966-08-20,1966,Aston Villa,Newcastle United,1-1,1,1,1,1,2,0,D
1966-08-20,1966,Burnley,Sheffield United,4-0,4,0,1,1,4,4,H
1966-08-20,1966,Fulham,Everton,0-1,0,1,1,1,1,-1,A
1966-08-20,1966,Liverpool,Leicester City,3-2,3,2,1,1,5,1,H
1966-08-20,1966,Manchester United,West Bromwich Albion,5-3,5,3,1,1,8,2,H
1966-08-20,1966,Nottingham Forest,Stoke City,1-2,1,2,1,1,3,-1,A
1966-08-20,1966,Sheffield Wednesday,Blackpool,3-0,3,0,1,1,3,3,H
1966-08-20,1966,Southampton,Manchester City,1-1,1,1,1,1,2,0,D
1966-08-20,1966,Sunderland,Arsenal,1-3,1,3,1,1,4,-2,A
1966-08-20,1966,Tottenham Hotspur,Leeds United,3-1,3,1,1,1,4,2,H
1966-08-20,1966,West Ham United,Chelsea,1-2,1,2,1,1,3,-1,A
1966-08-22,1966,Aston Villa,Sheffield Wednesday,0-1,0,1,1,1,1,-1,A
1966-08-22,1966,Blackpool,Leicester City,1-1,1,1,1,1,2,0,D
1966-08-23,1966,Arsenal,West Ham United,2-1,2,1,1,1,3,1,H
1966-08-23,1966,Burnley,Fulham,3-0,3,0,1,1,3,3,H
1966-08-23,1966,Everton,Manchester United,1-2,1,2,1,1,3,-1,A
1966-08-23,1966,Sheffield United,Newcastle United,0-1,0,1,1,1,1,-1,A
1966-08-24,1966,Chelsea,Nottingham Forest,2-1,2,1,1,1,3,1,H
1966-08-24,1966,Leeds United,West Bromwich Albion,2-1,2,1,1,1,3,1,H
1966-08-24,1966,Manchester City,Liverpool,2-1,2,1,1,1,3,1,H
1966-08-24,1966,Stoke City,Tottenham Hotspur,2-0,2,0,1,1,2,2,H
1966-08-24,1966,Sunderland,Southampton,2-0,2,0,1,1,2,2,H
1966-08-27,1966,Arsenal,Aston Villa,1-0,1,0,1,1,1,1,H
1966-08-27,1966,Blackpool,Southampton,2-3,2,3,1,1,5,-1,A
1966-08-27,1966,Chelsea,Sheffield Wednesday,0-0,0,0,1,1,0,0,D
1966-08-27,1966,Everton,Liverpool,3-1,3,1,1,1,4,2,H
1966-08-27,1966,Leeds United,Manchester United,3-1,3,1,1,1,4,2,H
1966-08-27,1966,Leicester City,West Ham United,5-4,5,4,1,1,9,1,H
1966-08-27,1966,Manchester City,Sunderland,1-0,1,0,1,1,1,1,H
1966-08-27,1966,Newcastle United,Tottenham Hotspur,0-2,0,2,1,1,2,-2,A
1966-08-27,1966,Sheffield United,Nottingham Forest,1-2,1,2,1,1,3,-1,A
1966-08-27,1966,Stoke City,Fulham,1-2,1,2,1,1,3,-1,A
1966-08-27,1966,West Bromwich Albion,Burnley,1-2,1,2,1,1,3,-1,A
1966-08-29,1966,Fulham,Burnley,0-0,0,0,1,1,0,0,D
1966-08-29,1966,West Ham United,Arsenal,2-2,2,2,1,1,4,0,D
1966-08-30,1966,Liverpool,Manchester City,3-2,3,2,1,1,5,1,H
1966-08-30,1966,Nottingham Forest,Chelsea,0-0,0,0,1,1,0,0,D
1966-08-31,1966,Leicester City,Blackpool,3-0,3,0,1,1,3,3,H
1966-08-31,1966,Manchester United,Everton,3-0,3,0,1,1,3,3,H
1966-08-31,1966,Newcastle United,Sheffield United,1-0,1,0,1,1,1,1,H
1966-08-31,1966,Sheffield Wednesday,Aston Villa,2-0,2,0,1,1,2,2,H
1966-08-31,1966,Southampton,Sunderland,3-1,3,1,1,1,4,2,H
1966-08-31,1966,Tottenham Hotspur,Stoke City,2-0,2,0,1,1,2,2,H
1966-08-31,1966,West Bromwich Albion,Leeds United,2-0,2,0,1,1,2,2,H
1966-09-03,1966,Aston Villa,Manchester City,3-0,3,0,1,1,3,3,H
1966-09-03,1966,Burnley,Leeds United,1-1,1,1,1,1,2,0,D
1966-09-03,1966,Everton,Stoke City,0-1,0,1,1,1,1,-1,A
1966-09-03,1966,Fulham,Sheffield United,0-1,0,1,1,1,1,-1,A
1966-09-03,1966,Manchester United,Newcastle United,3-2,3,2,1,1,5,1,H
1966-09-03,1966,Nottingham Forest,West Bromwich Albion,2-1,2,1,1,1,3,1,H
1966-09-03,1966,Sheffield Wednesday,Leicester City,1-1,1,1,1,1,2,0,D
1966-09-03,1966,Southampton,Chelsea,0-3,0,3,1,1,3,-3,A
1966-09-03,1966,Sunderland,Blackpool,4-0,4,0,1,1,4,4,H
1966-09-03,1966,Tottenham Hotspur,Arsenal,3-1,3,1,1,1,4,2,H
1966-09-03,1966,West Ham United,Liverpool,1-1,1,1,1,1,2,0,D
1966-09-05,1966,Aston Villa,Southampton,0-1,0,1,1,1,1,-1,A
1966-09-05,1966,Blackpool,Liverpool,1-2,1,2,1,1,3,-1,A
1966-09-06,1966,Arsenal,Sheffield Wednesday,1-1,1,1,1,1,2,0,D
1966-09-06,1966,Everton,Burnley,1-1,1,1,1,1,2,0,D
1966-09-06,1966,Nottingham Forest,Fulham,2-1,2,1,1,1,3,1,H
1966-09-06,1966,Sheffield United,Tottenham Hotspur,2-1,2,1,1,1,3,1,H
1966-09-07,1966,Chelsea,Leicester City,2-2,2,2,1,1,4,0,D
1966-09-07,1966,Leeds United,Sunderland,2-1,2,1,1,1,3,1,H
1966-09-07,1966,Manchester City,West Ham United,1-4,1,4,1,1,5,-3,A
1966-09-07,1966,Newcastle United,West Bromwich Albion,1-3,1,3,1,1,4,-2,A
1966-09-07,1966,Stoke City,Manchester United,3-0,3,0,1,1,3,3,H
1966-09-10,1966,Blackpool,Aston Villa,0-2,0,2,1,1,2,-2,A
1966-09-10,1966,Chelsea,Sunderland,1-1,1,1,1,1,2,0,D
1966-09-10,1966,Leeds United,Nottingham Forest,1-1,1,1,1,1,2,0,D
1966-09-10,1966,Leicester City,Southampton,1-1,1,1,1,1,2,0,D
1966-09-10,1966,Liverpool,Sheffield Wednesday,1-1,1,1,1,1,2,0,D
1966-09-10,1966,Manchester City,Arsenal,1-1,1,1,1,1,2,0,D
1966-09-10,1966,Newcastle United,Burnley,1-1,1,1,1,1,2,0,D
1966-09-10,1966,Sheffield United,Everton,0-0,0,0,1,1,0,0,D
1966-09-10,1966,Stoke City,West Ham United,1-1,1,1,1,1,2,0,D
1966-09-10,1966,Tottenham Hotspur,Manchester United,2-1,2,1,1,1,3,1,H
1966-09-10,1966,West Bromwich Albion,Fulham,5-1,5,1,1,1,6,4,H
1966-09-17,1966,Arsenal,Blackpool,1-1,1,1,1,1,2,0,D
1966-09-17,1966,Aston Villa,Chelsea,2-6,2,6,1,1,8,-4,A
1966-09-17,1966,Burnley,Tottenham Hotspur,2-2,2,2,1,1,4,0,D
1966-09-17,1966,Everton,West Bromwich Albion,5-4,5,4,1,1,9,1,H
1966-09-17,1966,Fulham,Leeds United,2-2,2,2,1,1,4,0,D
1966-09-17,1966,Manchester United,Manchester City,1-0,1,0,1,1,1,1,H
1966-09-17,1966,Nottingham Forest,Newcastle United,3-0,3,0,1,1,3,3,H
1966-09-17,1966,Sheffield Wednesday,West Ham United,0-2,0,2,1,1,2,-2,A
1966-09-17,1966,Southampton,Liverpool,1-2,1,2,1,1,3,-1,A
1966-09-17,1966,Stoke City,Sheffield United,3-0,3,0,1,1,3,3,H
1966-09-17,1966,Sunderland,Leicester City,2-3,2,3,1,1,5,-1,A
1966-09-24,1966,Blackpool,Manchester City,0-1,0,1,1,1,1,-1,A
1966-09-24,1966,Chelsea,Arsenal,3-1,3,1,1,1,4,2,H
1966-09-24,1966,Leeds United,Everton,1-1,1,1,1,1,2,0,D
1966-09-24,1966,Leicester City,Aston Villa,5-0,5,0,1,1,5,5,H
1966-09-24,1966,Liverpool,Sunderland,2-2,2,2,1,1,4,0,D
1966-09-24,1966,Manchester United,Burnley,4-1,4,1,1,1,5,3,H
1966-09-24,1966,Newcastle United,Fulham,1-1,1,1,1,1,2,0,D
1966-09-24,1966,Sheffield Wednesday,Sheffield United,2-2,2,2,1,1,4,0,D
1966-09-24,1966,Tottenham Hotspur,Nottingham Forest,2-1,2,1,1,1,3,1,H
1966-09-24,1966,West Bromwich Albion,Stoke City,0-1,0,1,1,1,1,-1,A
1966-09-24,1966,West Ham United,Southampton,2-2,2,2,1,1,4,0,D
1966-10-01,1966,Arsenal,Leicester City,2-4,2,4,1,1,6,-2,A
1966-10-01,1966,Aston Villa,Liverpool,2-3,2,3,1,1,5,-1,A
1966-10-01,1966,Burnley,Blackpool,1-0,1,0,1,1,1,1,H
1966-10-01,1966,Everton,Newcastle United,1-1,1,1,1,1,2,0,D
1966-10-01,1966,Fulham,Tottenham Hotspur,3-4,3,4,1,1,7,-1,A
1966-10-01,1966,Manchester City,Chelsea,1-4,1,4,1,1,5,-3,A
1966-10-01,1966,Nottingham Forest,Manchester United,4-1,4,1,1,1,5,3,H
1966-10-01,1966,Sheffield United,West Bromwich Albion,4-3,4,3,1,1,7,1,H
1966-10-01,1966,Southampton,Sheffield Wednesday,4-2,4,2,1,1,6,2,H
1966-10-01,1966,Stoke City,Leeds United,0-0,0,0,1,1,0,0,D
1966-10-01,1966,Sunderland,West Ham United,2-4,2,4,1,1,6,-2,A
1966-10-08,1966,Arsenal,Newcastle United,2-0,2,0,1,1,2,2,H
1966-10-08,1966,Aston Villa,Leeds United,3-0,3,0,1,1,3,3,H
1966-10-08,1966,Blackpool,Manchester United,1-2,1,2,1,1,3,-1,A
1966-10-08,1966,Chelsea,Burnley,1-3,1,3,1,1,4,-2,A
1966-10-08,1966,Leicester City,Nottingham Forest,3-0,3,0,1,1,3,3,H
1966-10-08,1966,Liverpool,Fulham,2-2,2,2,1,1,4,0,D
1966-10-08,1966,Manchester City,Tottenham Hotspur,1-2,1,2,1,1,3,-1,A
1966-10-08,1966,Sheffield Wednesday,Stoke City,1-3,1,3,1,1,4,-2,A
1966-10-08,1966,Southampton,Sheffield United,2-3,2,3,1,1,5,-1,A
1966-10-08,1966,Sunderland,West Bromwich Albion,2-2,2,2,1,1,4,0,D
1966-10-08,1966,West Ham United,Everton,2-3,2,3,1,1,5,-1,A
1966-10-15,1966,Burnley,Leicester City,5-2,5,2,1,1,7,3,H
1966-10-15,1966,Everton,Sheffield Wednesday,2-1,2,1,1,1,3,1,H
1966-10-15,1966,Fulham,West Ham United,4-2,4,2,1,1,6,2,H
1966-10-15,1966,Leeds United,Arsenal,3-1,3,1,1,1,4,2,H
1966-10-15,1966,Manchester United,Chelsea,1-1,1,1,1,1,2,0,D
1966-10-15,1966,Newcastle United,Manchester City,2-0,2,0,1,1,2,2,H
1966-10-15,1966,Nottingham Forest,Liverpool,1-1,1,1,1,1,2,0,D
1966-10-15,1966,Sheffield United,Sunderland,2-0,2,0,1,1,2,2,H
1966-10-15,1966,Stoke City,Southampton,3-2,3,2,1,1,5,1,H
1966-10-15,1966,Tottenham Hotspur,Blackpool,1-3,1,3,1,1,4,-2,A
1966-10-15,1966,West Bromwich Albion,Aston Villa,2-1,2,1,1,1,3,1,H
1966-10-22,1966,Arsenal,West Bromwich Albion,2-3,2,3,1,1,5,-1,A
1966-10-22,1966,Aston Villa,Sheffield United,0-0,0,0,1,1,0,0,D
1966-10-22,1966,Blackpool,Newcastle United,6-0,6,0,1,1,6,6,H
1966-10-22,1966,Sheffield Wednesday,Fulham,1-1,1,1,1,1,2,0,D
1966-10-25,1966,Southampton,Everton,1-3,1,3,1,1,4,-2,A
1966-10-25,1966,Sunderland,Stoke City,2-1,2,1,1,1,3,1,H
1966-10-26,1966,Chelsea,Tottenham Hotspur,3-0,3,0,1,1,3,3,H
1966-10-26,1966,West Ham United,Nottingham Forest,3-1,3,1,1,1,4,2,H
1966-10-29,1966,Burnley,Manchester City,2-3,2,3,1,1,5,-1,A
1966-10-29,1966,Everton,Leicester City,2-0,2,0,1,1,2,2,H
1966-10-29,1966,Fulham,Chelsea,1-3,1,3,1,1,4,-2,A
1966-10-29,1966,Leeds United,Southampton,0-1,0,1,1,1,1,-1,A
1966-10-29,1966,Manchester United,Arsenal,1-0,1,0,1,1,1,1,H
1966-10-29,1966,Newcastle United,Sunderland,0-3,0,3,1,1,3,-3,A
1966-10-29,1966,Nottingham Forest,Blackpool,2-0,2,0,1,1,2,2,H
1966-10-29,1966,Sheffield United,West Ham United,3-1,3,1,1,1,4,2,H
1966-10-29,1966,Stoke City,Liverpool,2-0,2,0,1,1,2,2,H
1966-10-29,1966,Tottenham Hotspur,Aston Villa,0-1,0,1,1,1,1,-1,A
1966-10-29,1966,West Bromwich Albion,Sheffield Wednesday,1-2,1,2,1,1,3,-1,A
1966-11-05,1966,Arsenal,Leeds United,0-1,0,1,1,1,1,-1,A
1966-11-05,1966,Aston Villa,West Bromwich Albion,3-2,3,2,1,1,5,1,H
1966-11-05,1966,Blackpool,Tottenham Hotspur,2-2,2,2,1,1,4,0,D
1966-11-05,1966,Chelsea,Manchester United,1-3,1,3,1,1,4,-2,A
1966-11-05,1966,Leicester City,Burnley,5-1,5,1,1,1,6,4,H
1966-11-05,1966,Liverpool,Nottingham Forest,4-0,4,0,1,1,4,4,H
1966-11-05,1966,Manchester City,Newcastle United,1-1,1,1,1,1,2,0,D
1966-11-05,1966,Sheffield Wednesday,Everton,1-2,1,2,1,1,3,-1,A
1966-11-05,1966,Southampton,Stoke City,3-2,3,2,1,1,5,1,H
1966-11-05,1966,Sunderland,Sheffield United,4-1,4,1,1,1,5,3,H
1966-11-05,1966,West Ham United,Fulham,6-1,6,1,1,1,7,5,H
1966-11-09,1966,Liverpool,Burnley,2-0,2,0,1,1,2,2,H
1966-11-12,1966,Burnley,Southampton,4-1,4,1,1,1,5,3,H
1966-11-12,1966,Everton,Arsenal,0-0,0,0,1,1,0,0,D
1966-11-12,1966,Fulham,Aston Villa,5-1,5,1,1,1,6,4,H
1966-11-12,1966,Leeds United,Leicester City,3-1,3,1,1,1,4,2,H
1966-11-12,1966,Manchester United,Sheffield Wednesday,2-0,2,0,1,1,2,2,H
1966-11-12,1966,Newcastle United,Liverpool,0-2,0,2,1,1,2,-2,A
1966-11-12,1966,Nottingham Forest,Sunderland,3-1,3,1,1,1,4,2,H
1966-11-12,1966,Sheffield United,Blackpool,1-1,1,1,1,1,2,0,D
1966-11-12,1966,Stoke City,Manchester City,0-1,0,1,1,1,1,-1,A
1966-11-12,1966,Tottenham Hotspur,West Ham United,3-4,3,4,1,1,7,-1,A
1966-11-12,1966,West Bromwich Albion,Chelsea,0-1,0,1,1,1,1,-1,A
1966-11-19,1966,Arsenal,Fulham,1-0,1,0,1,1,1,1,H
1966-11-19,1966,Aston Villa,Nottingham Forest,1-1,1,1,1,1,2,0,D
1966-11-19,1966,Blackpool,Stoke City,0-1,0,1,1,1,1,-1,A
1966-11-19,1966,Chelsea,Sheffield United,1-1,1,1,1,1,2,0,D
1966-11-19,1966,Leicester City,West Bromwich Albion,2-1,2,1,1,1,3,1,H
1966-11-19,1966,Liverpool,Leeds United,5-0,5,0,1,1,5,5,H
1966-11-19,1966,Manchester City,Everton,1-0,1,0,1,1,1,1,H
1966-11-19,1966,Sheffield Wednesday,Tottenham Hotspur,1-0,1,0,1,1,1,1,H
1966-11-19,1966,Southampton,Manchester United,1-2,1,2,1,1,3,-1,A
1966-11-19,1966,Sunderland,Burnley,4-3,4,3,1,1,7,1,H
1966-11-19,1966,West Ham United,Newcastle United,3-0,3,0,1,1,3,3,H
1966-11-26,1966,Burnley,Aston Villa,4-2,4,2,1,1,6,2,H
1966-11-26,1966,Everton,Blackpool,0-1,0,1,1,1,1,-1,A
1966-11-26,1966,Fulham,Manchester City,4-1,4,1,1,1,5,3,H
1966-11-26,1966,Leeds United,West Ham United,2-1,2,1,1,1,3,1,H
1966-11-26,1966,Manchester United,Sunderland,5-0,5,0,1,1,5,5,H
1966-11-26,1966,Newcastle United,Sheffield Wednesday,3-1,3,1,1,1,4,2,H
1966-11-26,1966,Nottingham Forest,Arsenal,2-1,2,1,1,1,3,1,H
1966-11-26,1966,Sheffield United,Leicester City,0-1,0,1,1,1,1,-1,A
1966-11-26,1966,Stoke City,Chelsea,1-1,1,1,1,1,2,0,D
1966-11-26,1966,Tottenham Hotspur,Southampton,5-3,5,3,1,1,8,2,H
1966-11-26,1966,West Bromwich Albion,Liverpool,2-1,2,1,1,1,3,1,H
1966-11-30,1966,Leicester City,Manchester United,1-2,1,2,1,1,3,-1,A
1966-12-03,1966,Arsenal,Burnley,0-0,0,0,1,1,0,0,D
1966-12-03,1966,Aston Villa,Manchester United,2-1,2,1,1,1,3,1,H
1966-12-03,1966,Blackpool,Fulham,0-1,0,1,1,1,1,-1,A
1966-12-03,1966,Chelsea,Everton,1-1,1,1,1,1,2,0,D
1966-12-03,1966,Leicester City,Stoke City,4-2,4,2,1,1,6,2,H
1966-12-03,1966,Liverpool,Sheffield United,1-0,1,0,1,1,1,1,H
1966-12-03,1966,Manchester City,Nottingham Forest,1-1,1,1,1,1,2,0,D
1966-12-03,1966,Sheffield Wednesday,Leeds United,0-0,0,0,1,1,0,0,D
1966-12-03,1966,Southampton,Newcastle United,2-0,2,0,1,1,2,2,H
1966-12-03,1966,Sunderland,Tottenham Hotspur,0-1,0,1,1,1,1,-1,A
1966-12-03,1966,West Ham United,West Bromwich Albion,3-0,3,0,1,1,3,3,H
1966-12-10,1966,Burnley,West Ham United,4-2,4,2,1,1,6,2,H
1966-12-10,1966,Fulham,Southampton,3-1,3,1,1,1,4,2,H
1966-12-10,1966,Leeds United,Blackpool,1-1,1,1,1,1,2,0,D
1966-12-10,1966,Manchester United,Liverpool,2-2,2,2,1,1,4,0,D
1966-12-10,1966,Newcastle United,Chelsea,2-2,2,2,1,1,4,0,D
1966-12-10,1966,Nottingham Forest,Sheffield Wednesday,1-1,1,1,1,1,2,0,D
1966-12-10,1966,Sheffield United,Arsenal,1-1,1,1,1,1,2,0,D
1966-12-10,1966,Stoke City,Aston Villa,6-1,6,1,1,1,7,5,H
1966-12-10,1966,Tottenham Hotspur,Leicester City,2-0,2,0,1,1,2,2,H
1966-12-10,1966,West Bromwich Albion,Manchester City,0-3,0,3,1,1,3,-3,A
1966-12-17,1966,Arsenal,Sunderland,2-0,2,0,1,1,2,2,H
1966-12-17,1966,Blackpool,Sheffield Wednesday,1-1,1,1,1,1,2,0,D
1966-12-17,1966,Chelsea,West Ham United,5-5,5,5,1,1,10,0,D
1966-12-17,1966,Everton,Fulham,3-2,3,2,1,1,5,1,H
1966-12-17,1966,Leeds United,Tottenham Hotspur,3-2,3,2,1,1,5,1,H
1966-12-17,1966,Manchester City,Southampton,1-1,1,1,1,1,2,0,D
1966-12-17,1966,Newcastle United,Aston Villa,0-3,0,3,1,1,3,-3,A
1966-12-17,1966,Sheffield United,Burnley,1-1,1,1,1,1,2,0,D
1966-12-17,1966,Stoke City,Nottingham Forest,1-2,1,2,1,1,3,-1,A
1966-12-17,1966,West Bromwich Albion,Manchester United,3-4,3,4,1,1,7,-1,A
1966-12-23,1966,Everton,Nottingham Forest,0-1,0,1,1,1,1,-1,A
1966-12-24,1966,Chelsea,Liverpool,1-2,1,2,1,1,3,-1,A
1966-12-24,1966,Newcastle United,Leeds United,1-2,1,2,1,1,3,-1,A
1966-12-26,1966,Arsenal,Southampton,4-1,4,1,1,1,5,3,H
1966-12-26,1966,Blackpool,West Ham United,1-4,1,4,1,1,5,-3,A
1966-12-26,1966,Burnley,Stoke City,0-2,0,2,1,1,2,-2,A
1966-12-26,1966,Leeds United,Newcastle United,5-0,5,0,1,1,5,5,H
1966-12-26,1966,Leicester City,Fulham,0-2,0,2,1,1,2,-2,A
1966-12-26,1966,Liverpool,Chelsea,2-1,2,1,1,1,3,1,H
1966-12-26,1966,Nottingham Forest,Everton,1-0,1,0,1,1,1,1,H
1966-12-26,1966,Sheffield United,Manchester United,2-1,2,1,1,1,3,1,H
1966-12-26,1966,Sunderland,Aston Villa,2-1,2,1,1,1,3,1,H
1966-12-26,1966,West Bromwich Albion,Tottenham Hotspur,3-0,3,0,1,1,3,3,H
1966-12-27,1966,Aston Villa,Sunderland,2-1,2,1,1,1,3,1,H
1966-12-27,1966,Fulham,Leicester City,4-2,4,2,1,1,6,2,H
1966-12-27,1966,Manchester United,Sheffield United,2-0,2,0,1,1,2,2,H
1966-12-27,1966,Sheffield Wednesday,Manchester City,1-0,1,0,1,1,1,1,H
1966-12-27,1966,Southampton,Arsenal,2-1,2,1,1,1,3,1,H
1966-12-27,1966,Stoke City,Burnley,4-3,4,3,1,1,7,1,H
1966-12-27,1966,Tottenham Hotspur,West Bromwich Albion,0-0,0,0,1,1,0,0,D
1966-12-27,1966,West Ham United,Blackpool,4-0,4,0,1,1,4,4,H
1966-12-31,1966,Aston Villa,Arsenal,0-1,0,1,1,1,1,-1,A
1966-12-31,1966,Burnley,West Bromwich Albion,5-1,5,1,1,1,6,4,H
1966-12-31,1966,Fulham,Stoke City,4-1,4,1,1,1,5,3,H
1966-12-31,1966,Liverpool,Everton,0-0,0,0,1,1,0,0,D
1966-12-31,1966,Manchester United,Leeds United,0-0,0,0,1,1,0,0,D
1966-12-31,1966,Nottingham Forest,Sheffield United,3-1,3,1,1,1,4,2,H
1966-12-31,1966,Sheffield Wednesday,Chelsea,6-1,6,1,1,1,7,5,H
1966-12-31,1966,Southampton,Blackpool,1-5,1,5,1,1,6,-4,A
1966-12-31,1966,Sunderland,Manchester City,1-0,1,0,1,1,1,1,H
1966-12-31,1966,Tottenham Hotspur,Newcastle United,4-0,4,0,1,1,4,4,H
1966-12-31,1966,West Ham United,Leicester City,0-1,0,1,1,1,1,-1,A
1967-01-02,1966,Manchester City,Sheffield Wednesday,0-0,0,0,1,1,0,0,D
1967-01-07,1966,Arsenal,Tottenham Hotspur,0-2,0,2,1,1,2,-2,A
1967-01-07,1966,Blackpool,Sunderland,1-1,1,1,1,1,2,0,D
1967-01-07,1966,Chelsea,Southampton,4-1,4,1,1,1,5,3,H
1967-01-07,1966,Leeds United,Burnley,3-1,3,1,1,1,4,2,H
1967-01-07,1966,Leicester City,Sheffield Wednesday,0-1,0,1,1,1,1,-1,A
1967-01-07,1966,Liverpool,West Ham United,2-0,2,0,1,1,2,2,H
1967-01-07,1966,Sheffield United,Fulham,4-0,4,0,1,1,4,4,H
1967-01-07,1966,Stoke City,Everton,2-1,2,1,1,1,3,1,H
1967-01-07,1966,West Bromwich Albion,Nottingham Forest,1-2,1,2,1,1,3,-1,A
1967-01-14,1966,Arsenal,Manchester City,1-0,1,0,1,1,1,1,H
1967-01-14,1966,Aston Villa,Blackpool,3-2,3,2,1,1,5,1,H
1967-01-14,1966,Burnley,Newcastle United,0-2,0,2,1,1,2,-2,A
1967-01-14,1966,Everton,Sheffield United,4-1,4,1,1,1,5,3,H
1967-01-14,1966,Fulham,West Bromwich Albion,2-2,2,2,1,1,4,0,D
1967-01-14,1966,Manchester United,Tottenham Hotspur,1-0,1,0,1,1,1,1,H
1967-01-14,1966,Nottingham Forest,Leeds United,1-0,1,0,1,1,1,1,H
1967-01-14,1966,Sheffield Wednesday,Liverpool,0-1,0,1,1,1,1,-1,A
1967-01-14,1966,Southampton,Leicester City,4-4,4,4,1,1,8,0,D
1967-01-14,1966,Sunderland,Chelsea,2-0,2,0,1,1,2,2,H
1967-01-14,1966,West Ham United,Stoke City,1-1,1,1,1,1,2,0,D
1967-01-18,1966,Leicester City,Liverpool,2-1,2,1,1,1,3,1,H
1967-01-21,1966,Blackpool,Arsenal,0-3,0,3,1,1,3,-3,A
1967-01-21,1966,Chelsea,Aston Villa,3-1,3,1,1,1,4,2,H
1967-01-21,1966,Leeds United,Fulham,3-1,3,1,1,1,4,2,H
1967-01-21,1966,Leicester City,Sunderland,1-2,1,2,1,1,3,-1,A
1967-01-21,1966,Liverpool,Southampton,2-1,2,1,1,1,3,1,H
1967-01-21,1966,Manchester City,Manchester United,1-1,1,1,1,1,2,0,D
1967-01-21,1966,Newcastle United,Nottingham Forest,0-0,0,0,1,1,0,0,D
1967-01-21,1966,Sheffield United,Stoke City,2-1,2,1,1,1,3,1,H
1967-01-21,1966,Tottenham Hotspur,Burnley,2-0,2,0,1,1,2,2,H
1967-01-21,1966,West Bromwich Albion,Everton,1-0,1,0,1,1,1,1,H
1967-01-21,1966,West Ham United,Sheffield Wednesday,3-0,3,0,1,1,3,3,H
1967-02-04,1966,Arsenal,Chelsea,2-1,2,1,1,1,3,1,H
1967-02-04,1966,Aston Villa,Leicester City,0-1,0,1,1,1,1,-1,A
1967-02-04,1966,Burnley,Manchester United,1-1,1,1,1,1,2,0,D
1967-02-04,1966,Everton,Leeds United,2-0,2,0,1,1,2,2,H
1967-02-04,1966,Fulham,Newcastle United,5-1,5,1,1,1,6,4,H
1967-02-04,1966,Manchester City,Blackpool,1-0,1,0,1,1,1,1,H
1967-02-04,1966,Nottingham Forest,Tottenham Hotspur,1-1,1,1,1,1,2,0,D
1967-02-04,1966,Sheffield United,Sheffield Wednesday,1-0,1,0,1,1,1,1,H
1967-02-04,1966,Southampton,West Ham United,6-2,6,2,1,1,8,4,H
1967-02-04,1966,Stoke City,West Bromwich Albion,1-1,1,1,1,1,2,0,D
1967-02-04,1966,Sunderland,Liverpool,2-2,2,2,1,1,4,0,D
1967-02-11,1966,Blackpool,Burnley,0-2,0,2,1,1,2,-2,A
1967-02-11,1966,Chelsea,Manchester City,0-0,0,0,1,1,0,0,D
1967-02-11,1966,Leeds United,Stoke City,3-0,3,0,1,1,3,3,H
1967-02-11,1966,Leicester City,Arsenal,2-1,2,1,1,1,3,1,H
1967-02-11,1966,Liverpool,Aston Villa,1-0,1,0,1,1,1,1,H
1967-02-11,1966,Manchester United,Nottingham Forest,1-0,1,0,1,1,1,1,H
1967-02-11,1966,Newcastle United,Everton,0-3,0,3,1,1,3,-3,A
1967-02-11,1966,Sheffield Wednesday,Southampton,4-1,4,1,1,1,5,3,H
1967-02-11,1966,Tottenham Hotspur,Fulham,4-2,4,2,1,1,6,2,H
1967-02-11,1966,West Bromwich Albion,Sheffield United,1-2,1,2,1,1,3,-1,A
1967-02-11,1966,West Ham United,Sunderland,2-2,2,2,1,1,4,0,D
1967-02-25,1966,Burnley,Chelsea,1-2,1,2,1,1,3,-1,A
1967-02-25,1966,Everton,West Ham United,4-0,4,0,1,1,4,4,H
1967-02-25,1966,Fulham,Liverpool,2-2,2,2,1,1,4,0,D
1967-02-25,1966,Leeds United,Aston Villa,0-2,0,2,1,1,2,-2,A
1967-02-25,1966,Manchester United,Blackpool,4-0,4,0,1,1,4,4,H
1967-02-25,1966,Newcastle United,Arsenal,2-1,2,1,1,1,3,1,H
1967-02-25,1966,Nottingham Forest,Leicester City,1-0,1,0,1,1,1,1,H
1967-02-25,1966,Sheffield United,Southampton,2-0,2,0,1,1,2,2,H
1967-02-25,1966,Stoke City,Sheffield Wednesday,0-2,0,2,1,1,2,-2,A
1967-02-25,1966,Tottenham Hotspur,Manchester City,1-1,1,1,1,1,2,0,D
1967-02-25,1966,West Bromwich Albion,Sunderland,2-2,2,2,1,1,4,0,D
1967-03-03,1966,Arsenal,Manchester United,1-1,1,1,1,1,2,0,D
1967-03-04,1966,Aston Villa,Tottenham Hotspur,3-3,3,3,1,1,6,0,D
1967-03-04,1966,Blackpool,Nottingham Forest,1-1,1,1,1,1,2,0,D
1967-03-04,1966,Chelsea,Fulham,0-0,0,0,1,1,0,0,D
1967-03-04,1966,Leicester City,Everton,2-2,2,2,1,1,4,0,D
1967-03-04,1966,Liverpool,Stoke City,2-1,2,1,1,1,3,1,H
1967-03-04,1966,Manchester City,Burnley,1-0,1,0,1,1,1,1,H
1967-03-04,1966,Southampton,Leeds United,0-2,0,2,1,1,2,-2,A
1967-03-04,1966,Sunderland,Newcastle United,3-0,3,0,1,1,3,3,H
1967-03-11,1966,Newcastle United,Manchester United,0-0,0,0,1,1,0,0,D
1967-03-18,1966,Burnley,Liverpool,1-0,1,0,1,1,1,1,H
1967-03-18,1966,Everton,Southampton,0-1,0,1,1,1,1,-1,A
1967-03-18,1966,Fulham,Sheffield Wednesday,1-2,1,2,1,1,3,-1,A
1967-03-18,1966,Leeds United,Manchester City,0-0,0,0,1,1,0,0,D
1967-03-18,1966,Manchester United,Leicester City,5-2,5,2,1,1,7,3,H
1967-03-18,1966,Newcastle United,Blackpool,2-1,2,1,1,1,3,1,H
1967-03-18,1966,Nottingham Forest,West Ham United,1-0,1,0,1,1,1,1,H
1967-03-18,1966,Sheffield United,Aston Villa,3-3,3,3,1,1,6,0,D
1967-03-18,1966,Stoke City,Sunderland,3-0,3,0,1,1,3,3,H
1967-03-18,1966,Tottenham Hotspur,Chelsea,1-1,1,1,1,1,2,0,D
1967-03-18,1966,West Bromwich Albion,Arsenal,0-1,0,1,1,1,1,-1,A
1967-03-22,1966,Everton,Tottenham Hotspur,0-1,0,1,1,1,1,-1,A
1967-03-24,1966,Chelsea,Blackpool,0-2,0,2,1,1,2,-2,A
1967-03-24,1966,Manchester City,Leicester City,1-3,1,3,1,1,4,-2,A
1967-03-24,1966,Newcastle United,Stoke City,3-1,3,1,1,1,4,2,H
1967-03-24,1966,Sunderland,Sheffield Wednesday,2-0,2,0,1,1,2,2,H
1967-03-24,1966,West Ham United,Aston Villa,2-1,2,1,1,1,3,1,H
1967-03-25,1966,Arsenal,Sheffield United,2-0,2,0,1,1,2,2,H
1967-03-25,1966,Aston Villa,Stoke City,2-1,2,1,1,1,3,1,H
1967-03-25,1966,Blackpool,Leeds United,0-2,0,2,1,1,2,-2,A
1967-03-25,1966,Chelsea,Newcastle United,2-1,2,1,1,1,3,1,H
1967-03-25,1966,Leicester City,Tottenham Hotspur,0-1,0,1,1,1,1,-1,A
1967-03-25,1966,Liverpool,Manchester United,0-0,0,0,1,1,0,0,D
1967-03-25,1966,Manchester City,West Bromwich Albion,2-2,2,2,1,1,4,0,D
1967-03-25,1966,Sheffield Wednesday,Nottingham Forest,0-2,0,2,1,1,2,-2,A
1967-03-25,1966,Southampton,Fulham,4-2,4,2,1,1,6,2,H
1967-03-25,1966,Sunderland,Everton,0-2,0,2,1,1,2,-2,A
1967-03-25,1966,West Ham United,Burnley,3-2,3,2,1,1,5,1,H
1967-03-27,1966,Blackpool,Chelsea,0-2,0,2,1,1,2,-2,A
1967-03-27,1966,Fulham,Manchester United,2-2,2,2,1,1,4,0,D
1967-03-27,1966,Liverpool,Arsenal,0-0,0,0,1,1,0,0,D
1967-03-27,1966,Nottingham Forest,Burnley,4-1,4,1,1,1,5,3,H
1967-03-27,1966,Sheffield United,Leeds United,1-4,1,4,1,1,5,-3,A
1967-03-27,1966,Stoke City,Newcastle United,0-1,0,1,1,1,1,-1,A
1967-03-27,1966,Tottenham Hotspur,Everton,2-0,2,0,1,1,2,2,H
1967-03-27,1966,West Bromwich Albion,Southampton,3-2,3,2,1,1,5,1,H
1967-03-28,1966,Arsenal,Liverpool,1-1,1,1,1,1,2,0,D
1967-03-28,1966,Aston Villa,West Ham United,0-2,0,2,1,1,2,-2,A
1967-03-28,1966,Burnley,Nottingham Forest,0-2,0,2,1,1,2,-2,A
1967-03-28,1966,Leeds United,Sheffield United,2-0,2,0,1,1,2,2,H
1967-03-28,1966,Leicester City,Manchester City,2-1,2,1,1,1,3,1,H
1967-03-28,1966,Manchester United,Fulham,2-1,2,1,1,1,3,1,H
1967-03-28,1966,Sheffield Wednesday,Sunderland,5-0,5,0,1,1,5,5,H
1967-03-29,1966,Southampton,West Bromwich Albion,2-2,2,2,1,1,4,0,D
1967-04-01,1966,Burnley,Sheffield Wednesday,2-0,2,0,1,1,2,2,H
1967-04-01,1966,Everton,Aston Villa,3-1,3,1,1,1,4,2,H
1967-04-01,1966,Fulham,Sunderland,3-1,3,1,1,1,4,2,H
1967-04-01,1966,Leeds United,Chelsea,1-0,1,0,1,1,1,1,H
1967-04-01,1966,Manchester United,West Ham United,3-0,3,0,1,1,3,3,H
1967-04-01,1966,Newcastle United,Leicester City,1-0,1,0,1,1,1,1,H
1967-04-01,1966,Nottingham Forest,Southampton,3-1,3,1,1,1,4,2,H
1967-04-01,1966,Sheffield United,Manchester City,1-0,1,0,1,1,1,1,H
1967-04-01,1966,Stoke City,Arsenal,2-2,2,2,1,1,4,0,D
1967-04-01,1966,Tottenham Hotspur,Liverpool,2-1,2,1,1,1,3,1,H
1967-04-01,1966,West Bromwich Albion,Blackpool,3-1,3,1,1,1,4,2,H
1967-04-04,1966,West Ham United,Sheffield United,0-2,0,2,1,1,2,-2,A
1967-04-07,1966,Liverpool,Newcastle United,3-1,3,1,1,1,4,2,H
1967-04-08,1966,Aston Villa,Fulham,1-1,1,1,1,1,2,0,D
1967-04-08,1966,Blackpool,Sheffield United,0-1,0,1,1,1,1,-1,A
1967-04-08,1966,Southampton,Burnley,4-0,4,0,1,1,4,4,H
1967-04-10,1966,Chelsea,West Bromwich Albion,0-2,0,2,1,1,2,-2,A
1967-04-10,1966,Leicester City,Leeds United,0-0,0,0,1,1,0,0,D
1967-04-10,1966,Sheffield Wednesday,Manchester United,2-2,2,2,1,1,4,0,D
1967-04-12,1966,Manchester City,Stoke City,3-1,3,1,1,1,4,2,H
1967-04-15,1966,Burnley,Sunderland,1-0,1,0,1,1,1,1,H
1967-04-15,1966,Nottingham Forest,Aston Villa,3-0,3,0,1,1,3,3,H
1967-04-15,1966,Stoke City,Blackpool,2-0,2,0,1,1,2,2,H
1967-04-15,1966,Tottenham Hotspur,Sheffield Wednesday,2-1,2,1,1,1,3,1,H
1967-04-15,1966,West Bromwich Albion,Leicester City,1-0,1,0,1,1,1,1,H
1967-04-17,1966,Sheffield United,Chelsea,3-0,3,0,1,1,3,3,H
1967-04-18,1966,Manchester United,Southampton,3-0,3,0,1,1,3,3,H
1967-04-19,1966,Everton,Chelsea,3-1,3,1,1,1,4,2,H
1967-04-19,1966,Fulham,Arsenal,0-0,0,0,1,1,0,0,D
1967-04-19,1966,Manchester City,Aston Villa,1-1,1,1,1,1,2,0,D
1967-04-19,1966,Sheffield Wednesday,West Bromwich Albion,1-0,1,0,1,1,1,1,H
1967-04-19,1966,Sunderland,Nottingham Forest,1-0,1,0,1,1,1,1,H
1967-04-22,1966,Arsenal,Nottingham Forest,1-1,1,1,1,1,2,0,D
1967-04-22,1966,Aston Villa,Burnley,0-1,0,1,1,1,1,-1,A
1967-04-22,1966,Blackpool,Everton,0-1,0,1,1,1,1,-1,A
1967-04-22,1966,Chelsea,Stoke City,1-0,1,0,1,1,1,1,H
1967-04-22,1966,Leicester City,Sheffield United,2-2,2,2,1,1,4,0,D
1967-04-22,1966,Liverpool,West Bromwich Albion,0-1,0,1,1,1,1,-1,A
1967-04-22,1966,Manchester City,Fulham,3-0,3,0,1,1,3,3,H
1967-04-22,1966,Sheffield Wednesday,Newcastle United,0-0,0,0,1,1,0,0,D
1967-04-22,1966,Southampton,Tottenham Hotspur,0-1,0,1,1,1,1,-1,A
1967-04-22,1966,Sunderland,Manchester United,0-0,0,0,1,1,0,0,D
1967-04-22,1966,West Ham United,Leeds United,0-1,0,1,1,1,1,-1,A
1967-04-25,1966,Arsenal,Everton,3-1,3,1,1,1,4,2,H
1967-04-26,1966,Newcastle United,West Ham United,1-0,1,0,1,1,1,1,H
1967-04-28,1966,Sheffield United,Liverpool,0-1,0,1,1,1,1,-1,A
1967-04-28,1966,West Bromwich Albion,West Ham United,3-1,3,1,1,1,4,2,H
1967-04-29,1966,Burnley,Arsenal,1-4,1,4,1,1,5,-3,A
1967-04-29,1966,Everton,Manchester City,1-1,1,1,1,1,2,0,D
1967-04-29,1966,Fulham,Blackpool,2-2,2,2,1,1,4,0,D
1967-04-29,1966,Manchester United,Aston Villa,3-1,3,1,1,1,4,2,H
1967-04-29,1966,Newcastle United,Southampton,3-1,3,1,1,1,4,2,H
1967-04-29,1966,Stoke City,Leicester City,3-1,3,1,1,1,4,2,H
1967-05-02,1966,Nottingham Forest,Manchester City,2-0,2,0,1,1,2,2,H
1967-05-03,1966,Leeds United,Liverpool,2-1,2,1,1,1,3,1,H
1967-05-03,1966,Tottenham Hotspur,Sunderland,1-0,1,0,1,1,1,1,H
1967-05-06,1966,Arsenal,Stoke City,3-1,3,1,1,1,4,2,H
1967-05-06,1966,Aston Villa,Everton,2-4,2,4,1,1,6,-2,A
1967-05-06,1966,Blackpool,West Bromwich Albion,1-3,1,3,1,1,4,-2,A
1967-05-06,1966,Chelsea,Leeds United,2-2,2,2,1,1,4,0,D
1967-05-06,1966,Leicester City,Newcastle United,4-2,4,2,1,1,6,2,H
1967-05-06,1966,Liverpool,Tottenham Hotspur,0-0,0,0,1,1,0,0,D
1967-05-06,1966,Manchester City,Sheffield United,1-1,1,1,1,1,2,0,D
1967-05-06,1966,Sheffield Wednesday,Burnley,7-0,7,0,1,1,7,7,H
1967-05-06,1966,Southampton,Nottingham Forest,2-1,2,1,1,1,3,1,H
1967-05-06,1966,Sunderland,Fulham,3-1,3,1,1,1,4,2,H
1967-05-06,1966,West Ham United,Manchester United,1-6,1,6,1,1,7,-5,A
1967-05-08,1966,Manchester City,Leeds United,2-1,2,1,1,1,3,1,H
1967-05-09,1966,Leicester City,Chelsea,3-2,3,2,1,1,5,1,H
1967-05-09,1966,West Ham United,Tottenham Hotspur,0-2,0,2,1,1,2,-2,A
1967-05-13,1966,Burnley,Everton,1-1,1,1,1,1,2,0,D
1967-05-13,1966,Fulham,Nottingham Forest,2-3,2,3,1,1,5,-1,A
1967-05-13,1966,Liverpool,Blackpool,1-3,1,3,1,1,4,-2,A
1967-05-13,1966,Manchester United,Stoke City,0-0,0,0,1,1,0,0,D
1967-05-13,1966,Sheffield Wednesday,Arsenal,1-1,1,1,1,1,2,0,D
1967-05-13,1966,Southampton,Aston Villa,6-2,6,2,1,1,8,4,H
1967-05-13,1966,Sunderland,Leeds United,0-2,0,2,1,1,2,-2,A
1967-05-13,1966,Tottenham Hotspur,Sheffield United,2-0,2,0,1,1,2,2,H
1967-05-13,1966,West Bromwich Albion,Newcastle United,6-1,6,1,1,1,7,5,H
1967-05-13,1966,West Ham United,Manchester City,1-1,1,1,1,1,2,0,D
1967-05-15,1966,Leeds United,Sheffield Wednesday,1-0,1,0,1,1,1,1,H
1967-05-16,1966,Everton,Sunderland,4-1,4,1,1,1,5,3,H
1967-08-19,1967,Arsenal,Stoke City,2-0,2,0,1,1,2,2,H
1967-08-19,1967,Burnley,Coventry City,2-1,2,1,1,1,3,1,H
1967-08-19,1967,Everton,Manchester United,3-1,3,1,1,1,4,2,H
1967-08-19,1967,Fulham,Wolverhampton Wanderers,1-2,1,2,1,1,3,-1,A
1967-08-19,1967,Leeds United,Sunderland,1-1,1,1,1,1,2,0,D
1967-08-19,1967,Leicester City,Tottenham Hotspur,2-3,2,3,1,1,5,-1,A
1967-08-19,1967,Manchester City,Liverpool,0-0,0,0,1,1,0,0,D
1967-08-19,1967,Newcastle United,Southampton,3-0,3,0,1,1,3,3,H
1967-08-19,1967,Sheffield United,Nottingham Forest,1-3,1,3,1,1,4,-2,A
1967-08-19,1967,West Bromwich Albion,Chelsea,0-1,0,1,1,1,1,-1,A
1967-08-19,1967,West Ham United,Sheffield Wednesday,2-3,2,3,1,1,5,-1,A
1967-08-21,1967,West Ham United,Burnley,4-2,4,2,1,1,6,2,H
1967-08-22,1967,Liverpool,Arsenal,2-0,2,0,1,1,2,2,H
1967-08-22,1967,Nottingham Forest,Coventry City,3-3,3,3,1,1,6,0,D
1967-08-23,1967,Chelsea,Newcastle United,1-1,1,1,1,1,2,0,D
1967-08-23,1967,Manchester United,Leeds United,1-0,1,0,1,1,1,1,H
1967-08-23,1967,Sheffield Wednesday,Leicester City,2-1,2,1,1,1,3,1,H
1967-08-23,1967,Southampton,Manchester City,3-2,3,2,1,1,5,1,H
1967-08-23,1967,Stoke City,Sheffield United,1-1,1,1,1,1,2,0,D
1967-08-23,1967,Sunderland,Fulham,3-0,3,0,1,1,3,3,H
1967-08-23,1967,Tottenham Hotspur,Everton,1-1,1,1,1,1,2,0,D
1967-08-23,1967,Wolverhampton Wanderers,West Bromwich Albion,3-3,3,3,1,1,6,0,D
1967-08-26,1967,Chelsea,Fulham,1-1,1,1,1,1,2,0,D
1967-08-26,1967,Coventry City,Sheffield United,2-2,2,2,1,1,4,0,D
1967-08-26,1967,Liverpool,Newcastle United,6-0,6,0,1,1,6,6,H
1967-08-26,1967,Manchester United,Leicester City,1-1,1,1,1,1,2,0,D
1967-08-26,1967,Nottingham Forest,Arsenal,2-0,2,0,1,1,2,2,H
1967-08-26,1967,Sheffield Wednesday,Burnley,2-1,2,1,1,1,3,1,H
1967-08-26,1967,Southampton,West Bromwich Albion,4-0,4,0,1,1,4,4,H
1967-08-26,1967,Stoke City,Manchester City,3-0,3,0,1,1,3,3,H
1967-08-26,1967,Sunderland,Everton,1-0,1,0,1,1,1,1,H
1967-08-26,1967,Tottenham Hotspur,West Ham United,5-1,5,1,1,1,6,4,H
1967-08-26,1967,Wolverhampton Wanderers,Leeds United,2-0,2,0,1,1,2,2,H
1967-08-28,1967,Arsenal,Liverpool,2-0,2,0,1,1,2,2,H
1967-08-28,1967,Fulham,Sunderland,3-2,3,2,1,1,5,1,H
1967-08-29,1967,Burnley,West Ham United,3-3,3,3,1,1,6,0,D
1967-08-29,1967,Coventry City,Nottingham Forest,1-3,1,3,1,1,4,-2,A
1967-08-29,1967,Everton,Tottenham Hotspur,0-1,0,1,1,1,1,-1,A
1967-08-29,1967,Sheffield United,Stoke City,1-0,1,0,1,1,1,1,H
1967-08-30,1967,Leicester City,Sheffield Wednesday,3-0,3,0,1,1,3,3,H
1967-08-30,1967,Manchester City,Southampton,4-2,4,2,1,1,6,2,H
1967-08-30,1967,Newcastle United,Chelsea,5-1,5,1,1,1,6,4,H
1967-08-30,1967,West Bromwich Albion,Wolverhampton Wanderers,4-1,4,1,1,1,5,3,H
1967-09-02,1967,Arsenal,Coventry City,1-1,1,1,1,1,2,0,D
1967-09-02,1967,Burnley,Tottenham Hotspur,5-1,5,1,1,1,6,4,H
1967-09-02,1967,Chelsea,Southampton,2-6,2,6,1,1,8,-4,A
1967-09-02,1967,Everton,Wolverhampton Wanderers,4-2,4,2,1,1,6,2,H
1967-09-02,1967,Leeds United,Fulham,2-0,2,0,1,1,2,2,H
1967-09-02,1967,Leicester City,Sunderland,0-2,0,2,1,1,2,-2,A
1967-09-02,1967,Manchester City,Nottingham Forest,2-0,2,0,1,1,2,2,H
1967-09-02,1967,Newcastle United,Stoke City,1-1,1,1,1,1,2,0,D
1967-09-02,1967,Sheffield United,Sheffield Wednesday,0-1,0,1,1,1,1,-1,A
1967-09-02,1967,West Bromwich Albion,Liverpool,0-2,0,2,1,1,2,-2,A
1967-09-02,1967,West Ham United,Manchester United,1-3,1,3,1,1,4,-2,A
1967-09-05,1967,Coventry City,Southampton,2-1,2,1,1,1,3,1,H
1967-09-05,1967,Everton,West Ham United,2-0,2,0,1,1,2,2,H
1967-09-05,1967,Nottingham Forest,Liverpool,0-1,0,1,1,1,1,-1,A
1967-09-06,1967,Chelsea,Sheffield United,4-2,4,2,1,1,6,2,H
1967-09-06,1967,Manchester City,Newcastle United,2-0,2,0,1,1,2,2,H
1967-09-06,1967,Sheffield Wednesday,Fulham,4-2,4,2,1,1,6,2,H
1967-09-06,1967,Stoke City,Leicester City,3-2,3,2,1,1,5,1,H
1967-09-06,1967,Sunderland,Manchester United,1-1,1,1,1,1,2,0,D
1967-09-06,1967,Tottenham Hotspur,Wolverhampton Wanderers,2-1,2,1,1,1,3,1,H
1967-09-06,1967,West Bromwich Albion,Arsenal,1-3,1,3,1,1,4,-2,A
1967-09-09,1967,Coventry City,Manchester City,0-3,0,3,1,1,3,-3,A
1967-09-09,1967,Fulham,Everton,2-1,2,1,1,1,3,1,H
1967-09-09,1967,Liverpool,Chelsea,3-1,3,1,1,1,4,2,H
1967-09-09,1967,Manchester United,Burnley,2-2,2,2,1,1,4,0,D
1967-09-09,1967,Nottingham Forest,Newcastle United,4-0,4,0,1,1,4,4,H
1967-09-09,1967,Sheffield United,Arsenal,2-4,2,4,1,1,6,-2,A
1967-09-09,1967,Southampton,Leeds United,1-1,1,1,1,1,2,0,D
1967-09-09,1967,Stoke City,West Bromwich Albion,0-0,0,0,1,1,0,0,D
1967-09-09,1967,Sunderland,West Ham United,1-5,1,5,1,1,6,-4,A
1967-09-09,1967,Tottenham Hotspur,Sheffield Wednesday,2-1,2,1,1,1,3,1,H
1967-09-09,1967,Wolverhampton Wanderers,Leicester City,1-3,1,3,1,1,4,-2,A
1967-09-16,1967,Arsenal,Tottenham Hotspur,4-0,4,0,1,1,4,4,H
1967-09-16,1967,Burnley,Sunderland,3-0,3,0,1,1,3,3,H
1967-09-16,1967,Chelsea,Stoke City,2-2,2,2,1,1,4,0,D
1967-09-16,1967,Everton,Leeds United,0-1,0,1,1,1,1,-1,A
1967-09-16,1967,Leicester City,Fulham,1-2,1,2,1,1,3,-1,A
1967-09-16,1967,Manchester City,Sheffield United,5-2,5,2,1,1,7,3,H
1967-09-16,1967,Newcastle United,Coventry City,3-2,3,2,1,1,5,1,H
1967-09-16,1967,Sheffield Wednesday,Manchester United,1-1,1,1,1,1,2,0,D
1967-09-16,1967,Southampton,Liverpool,1-0,1,0,1,1,1,1,H
1967-09-16,1967,West Bromwich Albion,Nottingham Forest,2-1,2,1,1,1,3,1,H
1967-09-16,1967,West Ham United,Wolverhampton Wanderers,1-2,1,2,1,1,3,-1,A
1967-09-20,1967,Leeds United,Burnley,2-1,2,1,1,1,3,1,H
1967-09-23,1967,Arsenal,Manchester City,1-0,1,0,1,1,1,1,H
1967-09-23,1967,Coventry City,West Bromwich Albion,4-2,4,2,1,1,6,2,H
1967-09-23,1967,Fulham,West Ham United,0-3,0,3,1,1,3,-3,A
1967-09-23,1967,Leeds United,Leicester City,3-2,3,2,1,1,5,1,H
1967-09-23,1967,Liverpool,Everton,1-0,1,0,1,1,1,1,H
1967-09-23,1967,Manchester United,Tottenham Hotspur,3-1,3,1,1,1,4,2,H
1967-09-23,1967,Nottingham Forest,Chelsea,3-0,3,0,1,1,3,3,H
1967-09-23,1967,Sheffield United,Newcastle United,2-1,2,1,1,1,3,1,H
1967-09-23,1967,Stoke City,Southampton,3-2,3,2,1,1,5,1,H
1967-09-23,1967,Sunderland,Sheffield Wednesday,0-2,0,2,1,1,2,-2,A
1967-09-23,1967,Wolverhampton Wanderers,Burnley,3-2,3,2,1,1,5,1,H
1967-09-30,1967,Burnley,Fulham,2-0,2,0,1,1,2,2,H
1967-09-30,1967,Chelsea,Coventry City,1-1,1,1,1,1,2,0,D
1967-09-30,1967,Leicester City,Everton,0-2,0,2,1,1,2,-2,A
1967-09-30,1967,Liverpool,Stoke City,2-1,2,1,1,1,3,1,H
1967-09-30,1967,Manchester City,Manchester United,1-2,1,2,1,1,3,-1,A
1967-09-30,1967,Newcastle United,Arsenal,2-1,2,1,1,1,3,1,H
1967-09-30,1967,Sheffield Wednesday,Wolverhampton Wanderers,2-2,2,2,1,1,4,0,D
1967-09-30,1967,Southampton,Nottingham Forest,2-1,2,1,1,1,3,1,H
1967-09-30,1967,Tottenham Hotspur,Sunderland,3-0,3,0,1,1,3,3,H
1967-09-30,1967,West Bromwich Albion,Sheffield United,4-1,4,1,1,1,5,3,H
1967-09-30,1967,West Ham United,Leeds United,0-0,0,0,1,1,0,0,D
1967-10-07,1967,Burnley,Nottingham Forest,1-1,1,1,1,1,2,0,D
1967-10-07,1967,Everton,Southampton,4-2,4,2,1,1,6,2,H
1967-10-07,1967,Fulham,West Bromwich Albion,1-2,1,2,1,1,3,-1,A
1967-10-07,1967,Leeds United,Chelsea,7-0,7,0,1,1,7,7,H
1967-10-07,1967,Leicester City,Liverpool,2-1,2,1,1,1,3,1,H
1967-10-07,1967,Manchester United,Arsenal,1-0,1,0,1,1,1,1,H
1967-10-07,1967,Sheffield Wednesday,Coventry City,4-0,4,0,1,1,4,4,H
1967-10-07,1967,Sunderland,Manchester City,1-0,1,0,1,1,1,1,H
1967-10-07,1967,Tottenham Hotspur,Sheffield United,1-1,1,1,1,1,2,0,D
1967-10-07,1967,West Ham United,Stoke City,3-4,3,4,1,1,7,-1,A
1967-10-07,1967,Wolverhampton Wanderers,Newcastle United,2-2,2,2,1,1,4,0,D
1967-10-14,1967,Arsenal,Sunderland,2-1,2,1,1,1,3,1,H
1967-10-14,1967,Chelsea,Everton,1-1,1,1,1,1,2,0,D
1967-10-14,1967,Coventry City,Tottenham Hotspur,2-3,2,3,1,1,5,-1,A
1967-10-14,1967,Liverpool,West Ham United,3-1,3,1,1,1,4,2,H
1967-10-14,1967,Manchester City,Wolverhampton Wanderers,2-0,2,0,1,1,2,2,H
1967-10-14,1967,Newcastle United,Fulham,2-1,2,1,1,1,3,1,H
1967-10-14,1967,Nottingham Forest,Sheffield Wednesday,0-0,0,0,1,1,0,0,D
1967-10-14,1967,Sheffield United,Manchester United,0-3,0,3,1,1,3,-3,A
1967-10-14,1967,Southampton,Leicester City,1-5,1,5,1,1,6,-4,A
1967-10-14,1967,Stoke City,Burnley,0-2,0,2,1,1,2,-2,A
1967-10-14,1967,West Bromwich Albion,Leeds United,2-0,2,0,1,1,2,2,H
1967-10-21,1967,Fulham,Manchester City,2-4,2,4,1,1,6,-2,A
1967-10-23,1967,Sheffield Wednesday,Stoke City,1-1,1,1,1,1,2,0,D
1967-10-23,1967,West Ham United,Southampton,0-1,0,1,1,1,1,-1,A
1967-10-23,1967,Wolverhampton Wanderers,Arsenal,3-2,3,2,1,1,5,1,H
1967-10-24,1967,Burnley,Liverpool,1-1,1,1,1,1,2,0,D
1967-10-24,1967,Everton,West Bromwich Albion,2-1,2,1,1,1,3,1,H
1967-10-25,1967,Leeds United,Newcastle United,2-0,2,0,1,1,2,2,H
1967-10-25,1967,Leicester City,Chelsea,2-2,2,2,1,1,4,0,D
1967-10-25,1967,Manchester United,Coventry City,4-0,4,0,1,1,4,4,H
1967-10-25,1967,Sunderland,Sheffield United,2-1,2,1,1,1,3,1,H
1967-10-25,1967,Tottenham Hotspur,Nottingham Forest,1-1,1,1,1,1,2,0,D
1967-10-28,1967,Arsenal,Fulham,5-3,5,3,1,1,8,2,H
1967-10-28,1967,Chelsea,West Ham United,1-3,1,3,1,1,4,-2,A
1967-10-28,1967,Coventry City,Sunderland,2-2,2,2,1,1,4,0,D
1967-10-28,1967,Liverpool,Sheffield Wednesday,1-0,1,0,1,1,1,1,H
1967-10-28,1967,Manchester City,Leeds United,1-0,1,0,1,1,1,1,H
1967-10-28,1967,Newcastle United,Everton,1-0,1,0,1,1,1,1,H
1967-10-28,1967,Nottingham Forest,Manchester United,3-1,3,1,1,1,4,2,H
1967-10-28,1967,Sheffield United,Wolverhampton Wanderers,1-1,1,1,1,1,2,0,D
1967-10-28,1967,Southampton,Burnley,2-2,2,2,1,1,4,0,D
1967-10-28,1967,Stoke City,Tottenham Hotspur,2-1,2,1,1,1,3,1,H
1967-10-28,1967,West Bromwich Albion,Leicester City,0-0,0,0,1,1,0,0,D
1967-11-04,1967,Burnley,Chelsea,1-1,1,1,1,1,2,0,D
1967-11-04,1967,Everton,Manchester City,1-1,1,1,1,1,2,0,D
1967-11-04,1967,Leeds United,Arsenal,3-1,3,1,1,1,4,2,H
1967-11-04,1967,Leicester City,Newcastle United,2-2,2,2,1,1,4,0,D
1967-11-04,1967,Manchester United,Stoke City,1-0,1,0,1,1,1,1,H
1967-11-04,1967,Sheffield Wednesday,Southampton,2-0,2,0,1,1,2,2,H
1967-11-04,1967,Sunderland,Nottingham Forest,1-0,1,0,1,1,1,1,H
1967-11-04,1967,Tottenham Hotspur,Liverpool,1-1,1,1,1,1,2,0,D
1967-11-04,1967,Wolverhampton Wanderers,Coventry City,2-0,2,0,1,1,2,2,H
1967-11-08,1967,Leeds United,Manchester United,1-0,1,0,1,1,1,1,H
1967-11-11,1967,Arsenal,Everton,2-2,2,2,1,1,4,0,D
1967-11-11,1967,Chelsea,Sheffield Wednesday,3-0,3,0,1,1,3,3,H
1967-11-11,1967,Coventry City,Fulham,0-3,0,3,1,1,3,-3,A
1967-11-11,1967,Liverpool,Manchester United,1-2,1,2,1,1,3,-1,A
1967-11-11,1967,Manchester City,Leicester City,6-0,6,0,1,1,6,6,H
1967-11-11,1967,Newcastle United,West Ham United,1-0,1,0,1,1,1,1,H
1967-11-11,1967,Nottingham Forest,Wolverhampton Wanderers,3-1,3,1,1,1,4,2,H
1967-11-11,1967,Sheffield United,Leeds United,1-0,1,0,1,1,1,1,H
1967-11-11,1967,Southampton,Tottenham Hotspur,1-2,1,2,1,1,3,-1,A
1967-11-11,1967,Stoke City,Sunderland,2-1,2,1,1,1,3,1,H
1967-11-11,1967,West Bromwich Albion,Burnley,8-1,8,1,1,1,9,7,H
1967-11-18,1967,Burnley,Newcastle United,2-0,2,0,1,1,2,2,H
1967-11-18,1967,Everton,Sheffield United,1-0,1,0,1,1,1,1,H
1967-11-18,1967,Fulham,Nottingham Forest,2-0,2,0,1,1,2,2,H
1967-11-18,1967,Leeds United,Coventry City,1-1,1,1,1,1,2,0,D
1967-11-18,1967,Leicester City,Arsenal,2-2,2,2,1,1,4,0,D
1967-11-18,1967,Manchester United,Southampton,3-2,3,2,1,1,5,1,H
1967-11-18,1967,Sheffield Wednesday,West Bromwich Albion,2-2,2,2,1,1,4,0,D
1967-11-18,1967,Sunderland,Liverpool,1-1,1,1,1,1,2,0,D
1967-11-18,1967,Tottenham Hotspur,Chelsea,2-0,2,0,1,1,2,2,H
1967-11-18,1967,West Ham United,Manchester City,2-3,2,3,1,1,5,-1,A
1967-11-18,1967,Wolverhampton Wanderers,Stoke City,3-4,3,4,1,1,7,-1,A
1967-11-25,1967,Arsenal,West Ham United,0-0,0,0,1,1,0,0,D
1967-11-25,1967,Chelsea,Manchester United,1-1,1,1,1,1,2,0,D
1967-11-25,1967,Coventry City,Everton,0-2,0,2,1,1,2,-2,A
1967-11-25,1967,Liverpool,Wolverhampton Wanderers,2-1,2,1,1,1,3,1,H
1967-11-25,1967,Manchester City,Burnley,4-2,4,2,1,1,6,2,H
1967-11-25,1967,Newcastle United,Sheffield Wednesday,4-0,4,0,1,1,4,4,H
1967-11-25,1967,Nottingham Forest,Leeds United,0-2,0,2,1,1,2,-2,A
1967-11-25,1967,Sheffield United,Leicester City,0-0,0,0,1,1,0,0,D
1967-11-25,1967,Southampton,Sunderland,3-2,3,2,1,1,5,1,H
1967-11-25,1967,Stoke City,Fulham,0-1,0,1,1,1,1,-1,A
1967-11-25,1967,West Bromwich Albion,Tottenham Hotspur,2-0,2,0,1,1,2,2,H
1967-12-02,1967,Burnley,Arsenal,1-0,1,0,1,1,1,1,H
1967-12-02,1967,Everton,Nottingham Forest,1-0,1,0,1,1,1,1,H
1967-12-02,1967,Fulham,Liverpool,1-1,1,1,1,1,2,0,D
1967-12-02,1967,Leeds United,Stoke City,2-0,2,0,1,1,2,2,H
1967-12-02,1967,Leicester City,Coventry City,0-0,0,0,1,1,0,0,D
1967-12-02,1967,Manchester United,West Bromwich Albion,2-1,2,1,1,1,3,1,H
1967-12-02,1967,Sheffield Wednesday,Manchester City,1-1,1,1,1,1,2,0,D
1967-12-02,1967,Sunderland,Chelsea,2-3,2,3,1,1,5,-1,A
1967-12-02,1967,Tottenham Hotspur,Newcastle United,1-1,1,1,1,1,2,0,D
1967-12-02,1967,West Ham United,Sheffield United,3-0,3,0,1,1,3,3,H
1967-12-02,1967,Wolverhampton Wanderers,Southampton,2-0,2,0,1,1,2,2,H
1967-12-08,1967,Coventry City,West Ham United,1-1,1,1,1,1,2,0,D
1967-12-09,1967,Liverpool,Leeds United,2-0,2,0,1,1,2,2,H
1967-12-09,1967,Manchester City,Tottenham Hotspur,4-1,4,1,1,1,5,3,H
1967-12-09,1967,Newcastle United,Manchester United,2-2,2,2,1,1,4,0,D
1967-12-09,1967,Sheffield United,Burnley,1-0,1,0,1,1,1,1,H
1967-12-09,1967,Stoke City,Everton,1-0,1,0,1,1,1,1,H
1967-12-11,1967,West Ham United,West Bromwich Albion,2-3,2,3,1,1,5,-1,A
1967-12-16,1967,Chelsea,West Bromwich Albion,0-3,0,3,1,1,3,-3,A
1967-12-16,1967,Coventry City,Burnley,5-1,5,1,1,1,6,4,H
1967-12-16,1967,Liverpool,Manchester City,1-1,1,1,1,1,2,0,D
1967-12-16,1967,Manchester United,Everton,3-1,3,1,1,1,4,2,H
1967-12-16,1967,Nottingham Forest,Sheffield United,1-0,1,0,1,1,1,1,H
1967-12-16,1967,Sheffield Wednesday,West Ham United,4-1,4,1,1,1,5,3,H
1967-12-16,1967,Southampton,Newcastle United,0-0,0,0,1,1,0,0,D
1967-12-16,1967,Stoke City,Arsenal,0-1,0,1,1,1,1,-1,A
1967-12-16,1967,Sunderland,Leeds United,2-2,2,2,1,1,4,0,D
1967-12-16,1967,Tottenham Hotspur,Leicester City,0-1,0,1,1,1,1,-1,A
1967-12-16,1967,Wolverhampton Wanderers,Fulham,3-2,3,2,1,1,5,1,H
1967-12-23,1967,Arsenal,Nottingham Forest,3-0,3,0,1,1,3,3,H
1967-12-23,1967,Burnley,Sheffield Wednesday,2-1,2,1,1,1,3,1,H
1967-12-23,1967,Everton,Sunderland,3-0,3,0,1,1,3,3,H
1967-12-23,1967,Fulham,Chelsea,2-2,2,2,1,1,4,0,D
1967-12-23,1967,Leeds United,Wolverhampton Wanderers,2-1,2,1,1,1,3,1,H
1967-12-23,1967,Leicester City,Manchester United,2-2,2,2,1,1,4,0,D
1967-12-23,1967,Manchester City,Stoke City,4-2,4,2,1,1,6,2,H
1967-12-23,1967,Newcastle United,Liverpool,1-1,1,1,1,1,2,0,D
1967-12-23,1967,Sheffield United,Coventry City,2-0,2,0,1,1,2,2,H
1967-12-23,1967,West Bromwich Albion,Southampton,0-0,0,0,1,1,0,0,D
1967-12-23,1967,West Ham United,Tottenham Hotspur,2-1,2,1,1,1,3,1,H
1967-12-26,1967,Chelsea,Arsenal,2-1,2,1,1,1,3,1,H
1967-12-26,1967,Coventry City,Liverpool,1-1,1,1,1,1,2,0,D
1967-12-26,1967,Everton,Burnley,2-0,2,0,1,1,2,2,H
1967-12-26,1967,Manchester United,Wolverhampton Wanderers,4-0,4,0,1,1,4,4,H
1967-12-26,1967,Newcastle United,Sunderland,2-1,2,1,1,1,3,1,H
1967-12-26,1967,Nottingham Forest,Stoke City,3-0,3,0,1,1,3,3,H
1967-12-26,1967,Sheffield Wednesday,Leeds United,0-1,0,1,1,1,1,-1,A
1967-12-26,1967,Southampton,Sheffield United,3-3,3,3,1,1,6,0,D
1967-12-26,1967,Tottenham Hotspur,Fulham,2-2,2,2,1,1,4,0,D
1967-12-26,1967,West Bromwich Albion,Manchester City,3-2,3,2,1,1,5,1,H
1967-12-26,1967,West Ham United,Leicester City,4-2,4,2,1,1,6,2,H
1967-12-30,1967,Arsenal,Chelsea,1-1,1,1,1,1,2,0,D
1967-12-30,1967,Burnley,Everton,2-1,2,1,1,1,3,1,H
1967-12-30,1967,Fulham,Tottenham Hotspur,1-2,1,2,1,1,3,-1,A
1967-12-30,1967,Leeds United,Sheffield Wednesday,3-2,3,2,1,1,5,1,H
1967-12-30,1967,Leicester City,West Ham United,2-4,2,4,1,1,6,-2,A
1967-12-30,1967,Liverpool,Coventry City,1-0,1,0,1,1,1,1,H
1967-12-30,1967,Manchester City,West Bromwich Albion,0-2,0,2,1,1,2,-2,A
1967-12-30,1967,Sheffield United,Southampton,4-1,4,1,1,1,5,3,H
1967-12-30,1967,Stoke City,Nottingham Forest,1-3,1,3,1,1,4,-2,A
1967-12-30,1967,Sunderland,Newcastle United,3-3,3,3,1,1,6,0,D
1967-12-30,1967,Wolverhampton Wanderers,Manchester United,2-3,2,3,1,1,5,-1,A
1968-01-06,1967,Coventry City,Arsenal,1-1,1,1,1,1,2,0,D
1968-01-06,1967,Fulham,Leeds United,0-5,0,5,1,1,5,-5,A
1968-01-06,1967,Liverpool,West Bromwich Albion,4-1,4,1,1,1,5,3,H
1968-01-06,1967,Manchester United,West Ham United,3-1,3,1,1,1,4,2,H
1968-01-06,1967,Nottingham Forest,Manchester City,0-3,0,3,1,1,3,-3,A
1968-01-06,1967,Sheffield Wednesday,Sheffield United,1-1,1,1,1,1,2,0,D
1968-01-06,1967,Southampton,Chelsea,3-5,3,5,1,1,8,-2,A
1968-01-06,1967,Stoke City,Newcastle United,2-1,2,1,1,1,3,1,H
1968-01-06,1967,Sunderland,Leicester City,0-2,0,2,1,1,2,-2,A
1968-01-06,1967,Wolverhampton Wanderers,Everton,1-3,1,3,1,1,4,-2,A
1968-01-13,1967,Arsenal,Sheffield United,1-1,1,1,1,1,2,0,D
1968-01-13,1967,Leeds United,Southampton,5-0,5,0,1,1,5,5,H
1968-01-13,1967,Leicester City,Wolverhampton Wanderers,3-1,3,1,1,1,4,2,H
1968-01-13,1967,Newcastle United,Nottingham Forest,0-0,0,0,1,1,0,0,D
1968-01-17,1967,Sheffield Wednesday,Tottenham Hotspur,1-2,1,2,1,1,3,-1,A
1968-01-20,1967,Coventry City,Newcastle United,1-4,1,4,1,1,5,-3,A
1968-01-20,1967,Fulham,Leicester City,0-1,0,1,1,1,1,-1,A
1968-01-20,1967,Leeds United,Everton,2-0,2,0,1,1,2,2,H
1968-01-20,1967,Liverpool,Southampton,2-0,2,0,1,1,2,2,H
1968-01-20,1967,Manchester United,Sheffield Wednesday,4-2,4,2,1,1,6,2,H
1968-01-20,1967,Nottingham Forest,West Bromwich Albion,3-2,3,2,1,1,5,1,H
1968-01-20,1967,Sheffield United,Manchester City,0-3,0,3,1,1,3,-3,A
1968-01-20,1967,Stoke City,Chelsea,0-1,0,1,1,1,1,-1,A
1968-01-20,1967,Sunderland,Burnley,2-2,2,2,1,1,4,0,D
1968-01-20,1967,Tottenham Hotspur,Arsenal,1-0,1,0,1,1,1,1,H
1968-01-20,1967,Wolverhampton Wanderers,West Ham United,1-2,1,2,1,1,3,-1,A
1968-02-03,1967,Burnley,Wolverhampton Wanderers,1-1,1,1,1,1,2,0,D
1968-02-03,1967,Chelsea,Nottingham Forest,1-0,1,0,1,1,1,1,H
1968-02-03,1967,Everton,Liverpool,1-0,1,0,1,1,1,1,H
1968-02-03,1967,Leicester City,Leeds United,2-2,2,2,1,1,4,0,D
1968-02-03,1967,Manchester City,Arsenal,1-1,1,1,1,1,2,0,D
1968-02-03,1967,Newcastle United,Sheffield United,1-0,1,0,1,1,1,1,H
1968-02-03,1967,Sheffield Wednesday,Sunderland,0-1,0,1,1,1,1,-1,A
1968-02-03,1967,Southampton,Stoke City,1-2,1,2,1,1,3,-1,A
1968-02-03,1967,Tottenham Hotspur,Manchester United,1-2,1,2,1,1,3,-1,A
1968-02-03,1967,West Bromwich Albion,Coventry City,0-1,0,1,1,1,1,-1,A
1968-02-03,1967,West Ham United,Fulham,7-2,7,2,1,1,9,5,H
1968-02-10,1967,Arsenal,Newcastle United,0-0,0,0,1,1,0,0,D
1968-02-10,1967,Coventry City,Chelsea,2-1,2,1,1,1,3,1,H
1968-02-10,1967,Fulham,Burnley,4-3,4,3,1,1,7,1,H
1968-02-10,1967,Leeds United,West Ham United,2-1,2,1,1,1,3,1,H
1968-02-10,1967,Nottingham Forest,Southampton,2-2,2,2,1,1,4,0,D
1968-02-10,1967,Sheffield United,West Bromwich Albion,1-1,1,1,1,1,2,0,D
1968-02-10,1967,Sunderland,Tottenham Hotspur,0-1,0,1,1,1,1,-1,A
1968-02-12,1967,Chelsea,Liverpool,3-1,3,1,1,1,4,2,H
1968-02-17,1967,Burnley,Manchester United,2-1,2,1,1,1,3,1,H
1968-02-24,1967,Arsenal,Manchester United,0-2,0,2,1,1,2,-2,A
1968-02-24,1967,Coventry City,Sheffield Wednesday,3-0,3,0,1,1,3,3,H
1968-02-24,1967,Liverpool,Leicester City,3-1,3,1,1,1,4,2,H
1968-02-24,1967,Manchester City,Sunderland,1-0,1,0,1,1,1,1,H
1968-02-24,1967,Newcastle United,Wolverhampton Wanderers,2-0,2,0,1,1,2,2,H
1968-02-24,1967,Nottingham Forest,Burnley,1-0,1,0,1,1,1,1,H
1968-02-24,1967,West Bromwich Albion,Fulham,2-1,2,1,1,1,3,1,H
1968-02-26,1967,Sheffield United,Tottenham Hotspur,3-2,3,2,1,1,5,1,H
1968-02-26,1967,Southampton,Everton,3-2,3,2,1,1,5,1,H
1968-02-26,1967,Stoke City,West Ham United,2-0,2,0,1,1,2,2,H
1968-02-28,1967,Fulham,Sheffield Wednesday,2-0,2,0,1,1,2,2,H
1968-03-01,1967,Tottenham Hotspur,West Bromwich Albion,0-0,0,0,1,1,0,0,D
1968-03-02,1967,Burnley,Manchester City,0-1,0,1,1,1,1,-1,A
1968-03-02,1967,Everton,Coventry City,3-1,3,1,1,1,4,2,H
1968-03-02,1967,Leicester City,Sheffield United,3-1,3,1,1,1,4,2,H
1968-03-02,1967,Manchester United,Chelsea,1-3,1,3,1,1,4,-2,A
1968-03-02,1967,Sheffield Wednesday,Newcastle United,1-1,1,1,1,1,2,0,D
1968-03-02,1967,Sunderland,Southampton,0-3,0,3,1,1,3,-3,A
1968-03-02,1967,Wolverhampton Wanderers,Liverpool,1-1,1,1,1,1,2,0,D
1968-03-08,1967,Southampton,Fulham,2-1,2,1,1,1,3,1,H
1968-03-09,1967,Manchester City,Coventry City,3-1,3,1,1,1,4,2,H
1968-03-09,1967,Wolverhampton Wanderers,Sunderland,2-1,2,1,1,1,3,1,H
1968-03-13,1967,Fulham,Sheffield United,0-1,0,1,1,1,1,-1,A
1968-03-13,1967,Leeds United,Nottingham Forest,1-1,1,1,1,1,2,0,D
1968-03-13,1967,West Bromwich Albion,Stoke City,3-0,3,0,1,1,3,3,H
1968-03-16,1967,Arsenal,Wolverhampton Wanderers,0-2,0,2,1,1,2,-2,A
1968-03-16,1967,Chelsea,Leicester City,4-1,4,1,1,1,5,3,H
1968-03-16,1967,Coventry City,Manchester United,2-0,2,0,1,1,2,2,H
1968-03-16,1967,Liverpool,Burnley,3-2,3,2,1,1,5,1,H
1968-03-16,1967,Manchester City,Fulham,5-1,5,1,1,1,6,4,H
1968-03-16,1967,Newcastle United,Leeds United,1-1,1,1,1,1,2,0,D
1968-03-16,1967,Nottingham Forest,Tottenham Hotspur,0-0,0,0,1,1,0,0,D
1968-03-16,1967,Sheffield United,Sunderland,1-2,1,2,1,1,3,-1,A
1968-03-16,1967,Southampton,West Ham United,0-0,0,0,1,1,0,0,D
1968-03-16,1967,Stoke City,Sheffield Wednesday,0-1,0,1,1,1,1,-1,A
1968-03-16,1967,West Bromwich Albion,Everton,2-6,2,6,1,1,8,-4,A
1968-03-19,1967,Nottingham Forest,Leicester City,2-1,2,1,1,1,3,1,H
1968-03-19,1967,Wolverhampton Wanderers,Sheffield Wednesday,2-3,2,3,1,1,5,-1,A
1968-03-20,1967,Chelsea,Leeds United,0-0,0,0,1,1,0,0,D
1968-03-23,1967,Burnley,Southampton,2-0,2,0,1,1,2,2,H
1968-03-23,1967,Everton,Newcastle United,1-0,1,0,1,1,1,1,H
1968-03-23,1967,Fulham,Arsenal,1-3,1,3,1,1,4,-2,A
1968-03-23,1967,Leeds United,Manchester City,2-0,2,0,1,1,2,2,H
1968-03-23,1967,Leicester City,West Bromwich Albion,2-3,2,3,1,1,5,-1,A
1968-03-23,1967,Manchester United,Nottingham Forest,3-0,3,0,1,1,3,3,H
1968-03-23,1967,Sheffield Wednesday,Liverpool,1-2,1,2,1,1,3,-1,A
1968-03-23,1967,Sunderland,Coventry City,1-1,1,1,1,1,2,0,D
1968-03-23,1967,Tottenham Hotspur,Stoke City,3-0,3,0,1,1,3,3,H
1968-03-23,1967,West Ham United,Chelsea,0-1,0,1,1,1,1,-1,A
1968-03-23,1967,Wolverhampton Wanderers,Sheffield United,1-3,1,3,1,1,4,-2,A
1968-03-27,1967,Manchester United,Manchester City,1-3,1,3,1,1,4,-2,A
1968-03-29,1967,West Ham United,Arsenal,1-1,1,1,1,1,2,0,D
1968-03-30,1967,Coventry City,Wolverhampton Wanderers,1-0,1,0,1,1,1,1,H
1968-03-30,1967,Nottingham Forest,Sunderland,0-3,0,3,1,1,3,-3,A
1968-03-30,1967,Southampton,Sheffield Wednesday,2-0,2,0,1,1,2,2,H
1968-03-30,1967,Stoke City,Manchester United,2-4,2,4,1,1,6,-2,A
1968-03-30,1967,Tottenham Hotspur,Burnley,5-0,5,0,1,1,5,5,H
1968-04-02,1967,West Bromwich Albion,Sunderland,0-0,0,0,1,1,0,0,D
1968-04-03,1967,Newcastle United,Leicester City,0-0,0,0,1,1,0,0,D
1968-04-06,1967,Burnley,West Bromwich Albion,0-0,0,0,1,1,0,0,D
1968-04-06,1967,Everton,Arsenal,2-0,2,0,1,1,2,2,H
1968-04-06,1967,Fulham,Coventry City,1-1,1,1,1,1,2,0,D
1968-04-06,1967,Leeds United,Sheffield United,3-0,3,0,1,1,3,3,H
1968-04-06,1967,Leicester City,Manchester City,1-0,1,0,1,1,1,1,H
1968-04-06,1967,Manchester United,Liverpool,1-2,1,2,1,1,3,-1,A
1968-04-06,1967,Sheffield Wednesday,Chelsea,2-2,2,2,1,1,4,0,D
1968-04-06,1967,Sunderland,Stoke City,3-1,3,1,1,1,4,2,H
1968-04-06,1967,Tottenham Hotspur,Southampton,6-1,6,1,1,1,7,5,H
1968-04-06,1967,West Ham United,Newcastle United,5-0,5,0,1,1,5,5,H
1968-04-06,1967,Wolverhampton Wanderers,Nottingham Forest,6-1,6,1,1,1,7,5,H
1968-04-09,1967,Everton,Leicester City,2-1,2,1,1,1,3,1,H
1968-04-10,1967,Southampton,Arsenal,2-0,2,0,1,1,2,2,H
1968-04-12,1967,Fulham,Manchester United,0-4,0,4,1,1,4,-4,A
1968-04-12,1967,Liverpool,Sheffield United,1-2,1,2,1,1,3,-1,A
1968-04-12,1967,Manchester City,Chelsea,1-0,1,0,1,1,1,1,H
1968-04-12,1967,Newcastle United,West Bromwich Albion,2-2,2,2,1,1,4,0,D
1968-04-12,1967,Tottenham Hotspur,Leeds United,2-1,2,1,1,1,3,1,H
1968-04-12,1967,West Ham United,Nottingham Forest,3-0,3,0,1,1,3,3,H
1968-04-13,1967,Arsenal,Leicester City,2-1,2,1,1,1,3,1,H
1968-04-13,1967,Chelsea,Tottenham Hotspur,2-0,2,0,1,1,2,2,H
1968-04-13,1967,Coventry City,Leeds United,0-1,0,1,1,1,1,-1,A
1968-04-13,1967,Liverpool,Sunderland,2-1,2,1,1,1,3,1,H
1968-04-13,1967,Manchester City,West Ham United,3-0,3,0,1,1,3,3,H
1968-04-13,1967,Newcastle United,Burnley,1-0,1,0,1,1,1,1,H
1968-04-13,1967,Nottingham Forest,Fulham,2-2,2,2,1,1,4,0,D
1968-04-13,1967,Sheffield United,Everton,0-1,0,1,1,1,1,-1,A
1968-04-13,1967,Southampton,Manchester United,2-2,2,2,1,1,4,0,D
1968-04-13,1967,Stoke City,Wolverhampton Wanderers,0-2,0,2,1,1,2,-2,A
1968-04-13,1967,West Bromwich Albion,Sheffield Wednesday,1-1,1,1,1,1,2,0,D
1968-04-15,1967,Arsenal,Southampton,0-3,0,3,1,1,3,-3,A
1968-04-15,1967,Burnley,Leicester City,1-1,1,1,1,1,2,0,D
1968-04-15,1967,Coventry City,Stoke City,2-0,2,0,1,1,2,2,H
1968-04-15,1967,Everton,Sheffield Wednesday,1-0,1,0,1,1,1,1,H
1968-04-15,1967,Manchester United,Fulham,3-0,3,0,1,1,3,3,H
1968-04-15,1967,Sheffield United,Liverpool,1-1,1,1,1,1,2,0,D
1968-04-15,1967,Sunderland,Wolverhampton Wanderers,2-0,2,0,1,1,2,2,H
1968-04-15,1967,West Bromwich Albion,Newcastle United,2-0,2,0,1,1,2,2,H
1968-04-16,1967,Chelsea,Manchester City,1-0,1,0,1,1,1,1,H
1968-04-16,1967,Leicester City,Burnley,0-2,0,2,1,1,2,-2,A
1968-04-16,1967,Nottingham Forest,West Ham United,1-1,1,1,1,1,2,0,D
1968-04-16,1967,Sheffield Wednesday,Everton,0-0,0,0,1,1,0,0,D
1968-04-16,1967,Stoke City,Coventry City,3-3,3,3,1,1,6,0,D
1968-04-17,1967,Leeds United,Tottenham Hotspur,1-0,1,0,1,1,1,1,H
1968-04-20,1967,Burnley,Stoke City,4-0,4,0,1,1,4,4,H
1968-04-20,1967,Everton,Chelsea,2-1,2,1,1,1,3,1,H
1968-04-20,1967,Fulham,Newcastle United,2-0,2,0,1,1,2,2,H
1968-04-20,1967,Leeds United,West Bromwich Albion,3-1,3,1,1,1,4,2,H
1968-04-20,1967,Leicester City,Southampton,4-1,4,1,1,1,5,3,H
1968-04-20,1967,Manchester United,Sheffield United,1-0,1,0,1,1,1,1,H
1968-04-20,1967,Sheffield Wednesday,Nottingham Forest,0-0,0,0,1,1,0,0,D
1968-04-20,1967,Sunderland,Arsenal,2-0,2,0,1,1,2,2,H
1968-04-20,1967,Tottenham Hotspur,Coventry City,4-2,4,2,1,1,6,2,H
1968-04-20,1967,West Ham United,Liverpool,1-0,1,0,1,1,1,1,H
1968-04-20,1967,Wolverhampton Wanderers,Manchester City,0-0,0,0,1,1,0,0,D
1968-04-22,1967,Chelsea,Burnley,2-1,2,1,1,1,3,1,H
1968-04-22,1967,Nottingham Forest,Everton,1-0,1,0,1,1,1,1,H
1968-04-23,1967,Sheffield United,Fulham,2-3,2,3,1,1,5,-1,A
1968-04-23,1967,Stoke City,Leeds United,3-2,3,2,1,1,5,1,H
1968-04-24,1967,West Ham United,Sunderland,1-1,1,1,1,1,2,0,D
1968-04-25,1967,Manchester City,Sheffield Wednesday,1-0,1,0,1,1,1,1,H
1968-04-27,1967,Arsenal,Burnley,2-0,2,0,1,1,2,2,H
1968-04-27,1967,Chelsea,Sunderland,1-0,1,0,1,1,1,1,H
1968-04-27,1967,Coventry City,Leicester City,0-1,0,1,1,1,1,-1,A
1968-04-27,1967,Liverpool,Fulham,4-1,4,1,1,1,5,3,H
1968-04-27,1967,Newcastle United,Tottenham Hotspur,1-3,1,3,1,1,4,-2,A
1968-04-27,1967,Sheffield United,West Ham United,1-2,1,2,1,1,3,-1,A
1968-04-27,1967,Southampton,Wolverhampton Wanderers,1-1,1,1,1,1,2,0,D
1968-04-29,1967,Chelsea,Wolverhampton Wanderers,1-0,1,0,1,1,1,1,H
1968-04-29,1967,Liverpool,Tottenham Hotspur,1-1,1,1,1,1,2,0,D
1968-04-29,1967,Manchester City,Everton,2-0,2,0,1,1,2,2,H
1968-04-29,1967,West Bromwich Albion,Manchester United,6-3,6,3,1,1,9,3,H
1968-04-30,1967,Arsenal,Sheffield Wednesday,3-2,3,2,1,1,5,1,H
1968-05-01,1967,Fulham,Stoke City,0-2,0,2,1,1,2,-2,A
1968-05-01,1967,West Bromwich Albion,West Ham United,3-1,3,1,1,1,4,2,H
1968-05-04,1967,Burnley,Sheffield United,0-2,0,2,1,1,2,-2,A
1968-05-04,1967,Everton,Stoke City,3-0,3,0,1,1,3,3,H
1968-05-04,1967,Fulham,Southampton,2-2,2,2,1,1,4,0,D
1968-05-04,1967,Leeds United,Liverpool,1-2,1,2,1,1,3,-1,A
1968-05-04,1967,Leicester City,Nottingham Forest,4-2,4,2,1,1,6,2,H
1968-05-04,1967,Manchester United,Newcastle United,6-0,6,0,1,1,6,6,H
1968-05-04,1967,Sheffield Wednesday,Arsenal,1-2,1,2,1,1,3,-1,A
1968-05-04,1967,Sunderland,West Bromwich Albion,0-0,0,0,1,1,0,0,D
1968-05-04,1967,Tottenham Hotspur,Manchester City,1-3,1,3,1,1,4,-2,A
1968-05-04,1967,West Ham United,Coventry City,0-0,0,0,1,1,0,0,D
1968-05-04,1967,Wolverhampton Wanderers,Chelsea,3-0,3,0,1,1,3,3,H
1968-05-07,1967,Arsenal,Leeds United,4-3,4,3,1,1,7,1,H
1968-05-11,1967,Arsenal,West Bromwich Albion,2-1,2,1,1,1,3,1,H
1968-05-11,1967,Burnley,Leeds United,3-0,3,0,1,1,3,3,H
1968-05-11,1967,Leicester City,Stoke City,0-0,0,0,1,1,0,0,D
1968-05-11,1967,Liverpool,Nottingham Forest,6-1,6,1,1,1,7,5,H
1968-05-11,1967,Manchester United,Sunderland,1-2,1,2,1,1,3,-1,A
1968-05-11,1967,Newcastle United,Manchester City,3-4,3,4,1,1,7,-1,A
1968-05-11,1967,Sheffield United,Chelsea,1-2,1,2,1,1,3,-1,A
1968-05-11,1967,Southampton,Coventry City,0-0,0,0,1,1,0,0,D
1968-05-11,1967,West Ham United,Everton,1-1,1,1,1,1,2,0,D
1968-05-11,1967,Wolverhampton Wanderers,Tottenham Hotspur,2-1,2,1,1,1,3,1,H
1968-05-15,1967,Stoke City,Liverpool,2-1,2,1,1,1,3,1,H
1968-05-21,1967,Everton,Fulham,5-1,5,1,1,1,6,4,H
1968-08-10,1968,Ipswich Town,Wolverhampton Wanderers,1-0,1,0,1,1,1,1,H
1968-08-10,1968,Liverpool,Manchester City,2-1,2,1,1,1,3,1,H
1968-08-10,1968,Manchester United,Everton,2-1,2,1,1,1,3,1,H
1968-08-10,1968,Newcastle United,West Ham United,1-1,1,1,1,1,2,0,D
1968-08-10,1968,Nottingham Forest,Burnley,2-2,2,2,1,1,4,0,D
1968-08-10,1968,Queens Park Rangers,Leicester City,1-1,1,1,1,1,2,0,D
1968-08-10,1968,Southampton,Leeds United,1-3,1,3,1,1,4,-2,A
1968-08-10,1968,Stoke City,Sunderland,2-1,2,1,1,1,3,1,H
1968-08-10,1968,Tottenham Hotspur,Arsenal,1-2,1,2,1,1,3,-1,A
1968-08-10,1968,West Bromwich Albion,Sheffield Wednesday,0-0,0,0,1,1,0,0,D
1968-08-13,1968,Arsenal,Leicester City,3-0,3,0,1,1,3,3,H
1968-08-13,1968,Everton,Burnley,3-0,3,0,1,1,3,3,H
1968-08-14,1968,Chelsea,Nottingham Forest,1-1,1,1,1,1,2,0,D
1968-08-14,1968,Leeds United,Queens Park Rangers,4-1,4,1,1,1,5,3,H
1968-08-14,1968,Manchester City,Wolverhampton Wanderers,3-2,3,2,1,1,5,1,H
1968-08-14,1968,Sheffield Wednesday,Newcastle United,1-1,1,1,1,1,2,0,D
1968-08-14,1968,Southampton,Liverpool,2-0,2,0,1,1,2,2,H
1968-08-14,1968,Stoke City,West Ham United,0-2,0,2,1,1,2,-2,A
1968-08-14,1968,Sunderland,Ipswich Town,3-0,3,0,1,1,3,3,H
1968-08-14,1968,West Bromwich Albion,Manchester United,3-1,3,1,1,1,4,2,H
1968-08-17,1968,Arsenal,Liverpool,1-1,1,1,1,1,2,0,D
1968-08-17,1968,Burnley,Newcastle United,1-0,1,0,1,1,1,1,H
1968-08-17,1968,Chelsea,West Bromwich Albion,3-1,3,1,1,1,4,2,H
1968-08-17,1968,Everton,Tottenham Hotspur,0-2,0,2,1,1,2,-2,A
1968-08-17,1968,Leeds United,Stoke City,2-0,2,0,1,1,2,2,H
1968-08-17,1968,Leicester City,Ipswich Town,1-3,1,3,1,1,4,-2,A
1968-08-17,1968,Manchester City,Manchester United,0-0,0,0,1,1,0,0,D
1968-08-17,1968,Sheffield Wednesday,Coventry City,3-0,3,0,1,1,3,3,H
1968-08-17,1968,Sunderland,Southampton,1-0,1,0,1,1,1,1,H
1968-08-17,1968,West Ham United,Nottingham Forest,1-0,1,0,1,1,1,1,H
1968-08-17,1968,Wolverhampton Wanderers,Queens Park Rangers,3-1,3,1,1,1,4,2,H
1968-08-19,1968,West Ham United,Everton,1-4,1,4,1,1,5,-3,A
1968-08-20,1968,Burnley,Southampton,3-1,3,1,1,1,4,2,H
1968-08-20,1968,Ipswich Town,Leeds United,2-3,2,3,1,1,5,-1,A
1968-08-20,1968,Liverpool,Stoke City,2-1,2,1,1,1,3,1,H
1968-08-20,1968,Nottingham Forest,Sheffield Wednesday,0-0,0,0,1,1,0,0,D
1968-08-20,1968,Queens Park Rangers,Sunderland,2-2,2,2,1,1,4,0,D
1968-08-21,1968,Leicester City,Manchester City,3-0,3,0,1,1,3,3,H
1968-08-21,1968,Manchester United,Coventry City,1-0,1,0,1,1,1,1,H
1968-08-21,1968,Newcastle United,Chelsea,3-2,3,2,1,1,5,1,H
1968-08-21,1968,Tottenham Hotspur,West Bromwich Albion,1-1,1,1,1,1,2,0,D
1968-08-21,1968,Wolverhampton Wanderers,Arsenal,0-0,0,0,1,1,0,0,D
1968-08-24,1968,Coventry City,West Ham United,1-2,1,2,1,1,3,-1,A
1968-08-24,1968,Ipswich Town,Arsenal,1-2,1,2,1,1,3,-1,A
1968-08-24,1968,Liverpool,Sunderland,4-1,4,1,1,1,5,3,H
1968-08-24,1968,Manchester United,Chelsea,0-4,0,4,1,1,4,-4,A
1968-08-24,1968,Newcastle United,Everton,0-0,0,0,1,1,0,0,D
1968-08-24,1968,Queens Park Rangers,Manchester City,1-1,1,1,1,1,2,0,D
1968-08-24,1968,Southampton,Wolverhampton Wanderers,2-1,2,1,1,1,3,1,H
1968-08-24,1968,Stoke City,Leicester City,1-0,1,0,1,1,1,1,H
1968-08-24,1968,Tottenham Hotspur,Sheffield Wednesday,1-2,1,2,1,1,3,-1,A
1968-08-24,1968,West Bromwich Albion,Burnley,3-2,3,2,1,1,5,1,H
1968-08-26,1968,West Ham United,Burnley,5-0,5,0,1,1,5,5,H
1968-08-27,1968,Arsenal,Manchester City,4-1,4,1,1,1,5,3,H
1968-08-27,1968,Coventry City,West Bromwich Albion,4-2,4,2,1,1,6,2,H
1968-08-27,1968,Everton,Liverpool,0-0,0,0,1,1,0,0,D
1968-08-27,1968,Ipswich Town,Queens Park Rangers,3-0,3,0,1,1,3,3,H
1968-08-28,1968,Chelsea,Sheffield Wednesday,1-0,1,0,1,1,1,1,H
1968-08-28,1968,Leeds United,Sunderland,1-1,1,1,1,1,2,0,D
1968-08-28,1968,Manchester United,Tottenham Hotspur,3-1,3,1,1,1,4,2,H
1968-08-28,1968,Newcastle United,Nottingham Forest,1-1,1,1,1,1,2,0,D
1968-08-28,1968,Southampton,Stoke City,2-0,2,0,1,1,2,2,H
1968-08-28,1968,Wolverhampton Wanderers,Leicester City,1-0,1,0,1,1,1,1,H
1968-08-31,1968,Arsenal,Queens Park Rangers,2-1,2,1,1,1,3,1,H
1968-08-31,1968,Burnley,Coventry City,1-1,1,1,1,1,2,0,D
1968-08-31,1968,Chelsea,Tottenham Hotspur,2-2,2,2,1,1,4,0,D
1968-08-31,1968,Everton,Nottingham Forest,2-1,2,1,1,1,3,1,H
1968-08-31,1968,Leeds United,Liverpool,1-0,1,0,1,1,1,1,H
1968-08-31,1968,Leicester City,Southampton,3-1,3,1,1,1,4,2,H
1968-08-31,1968,Manchester City,Ipswich Town,1-1,1,1,1,1,2,0,D
1968-08-31,1968,Sheffield Wednesday,Manchester United,5-4,5,4,1,1,9,1,H
1968-08-31,1968,Sunderland,Newcastle United,1-1,1,1,1,1,2,0,D
1968-08-31,1968,West Ham United,West Bromwich Albion,4-0,4,0,1,1,4,4,H
1968-08-31,1968,Wolverhampton Wanderers,Stoke City,1-1,1,1,1,1,2,0,D
1968-09-07,1968,Chelsea,Everton,1-1,1,1,1,1,2,0,D
1968-09-07,1968,Coventry City,Newcastle United,2-1,2,1,1,1,3,1,H
1968-09-07,1968,Leeds United,Wolverhampton Wanderers,2-1,2,1,1,1,3,1,H
1968-09-07,1968,Liverpool,Queens Park Rangers,2-0,2,0,1,1,2,2,H
1968-09-07,1968,Manchester United,West Ham United,1-1,1,1,1,1,2,0,D
1968-09-07,1968,Sheffield Wednesday,Ipswich Town,2-1,2,1,1,1,3,1,H
1968-09-07,1968,Southampton,Arsenal,1-2,1,2,1,1,3,-1,A
1968-09-07,1968,Stoke City,Manchester City,1-0,1,0,1,1,1,1,H
1968-09-07,1968,Sunderland,Leicester City,2-0,2,0,1,1,2,2,H
1968-09-07,1968,Tottenham Hotspur,Burnley,7-0,7,0,1,1,7,7,H
1968-09-07,1968,West Bromwich Albion,Nottingham Forest,2-5,2,5,1,1,7,-3,A
1968-09-10,1968,Coventry City,Chelsea,0-1,0,1,1,1,1,-1,A
1968-09-14,1968,Arsenal,Stoke City,1-0,1,0,1,1,1,1,H
1968-09-14,1968,Burnley,Manchester United,1-0,1,0,1,1,1,1,H
1968-09-14,1968,Everton,Sheffield Wednesday,3-0,3,0,1,1,3,3,H
1968-09-14,1968,Ipswich Town,Liverpool,0-2,0,2,1,1,2,-2,A
1968-09-14,1968,Leicester City,Leeds United,1-1,1,1,1,1,2,0,D
1968-09-14,1968,Manchester City,Southampton,1-1,1,1,1,1,2,0,D
1968-09-14,1968,Newcastle United,West Bromwich Albion,2-3,2,3,1,1,5,-1,A
1968-09-14,1968,Nottingham Forest,Coventry City,0-0,0,0,1,1,0,0,D
1968-09-14,1968,Queens Park Rangers,Chelsea,0-4,0,4,1,1,4,-4,A
1968-09-14,1968,West Ham United,Tottenham Hotspur,2-2,2,2,1,1,4,0,D
1968-09-14,1968,Wolverhampton Wanderers,Sunderland,1-1,1,1,1,1,2,0,D
1968-09-17,1968,Coventry City,Tottenham Hotspur,1-2,1,2,1,1,3,-1,A
1968-09-21,1968,Chelsea,West Ham United,1-1,1,1,1,1,2,0,D
1968-09-21,1968,Coventry City,Everton,2-2,2,2,1,1,4,0,D
1968-09-21,1968,Leeds United,Arsenal,2-0,2,0,1,1,2,2,H
1968-09-21,1968,Liverpool,Leicester City,4-0,4,0,1,1,4,4,H
1968-09-21,1968,Manchester United,Newcastle United,3-1,3,1,1,1,4,2,H
1968-09-21,1968,Sheffield Wednesday,Burnley,1-0,1,0,1,1,1,1,H
1968-09-21,1968,Southampton,Ipswich Town,2-2,2,2,1,1,4,0,D
1968-09-21,1968,Stoke City,Queens Park Rangers,1-1,1,1,1,1,2,0,D
1968-09-21,1968,Sunderland,Manchester City,0-4,0,4,1,1,4,-4,A
1968-09-21,1968,Tottenham Hotspur,Nottingham Forest,2-1,2,1,1,1,3,1,H
1968-09-21,1968,West Bromwich Albion,Wolverhampton Wanderers,0-0,0,0,1,1,0,0,D
1968-09-28,1968,Arsenal,Sunderland,0-0,0,0,1,1,0,0,D
1968-09-28,1968,Burnley,Chelsea,2-1,2,1,1,1,3,1,H
1968-09-28,1968,Everton,West Bromwich Albion,4-0,4,0,1,1,4,4,H
1968-09-28,1968,Ipswich Town,Stoke City,3-1,3,1,1,1,4,2,H
1968-09-28,1968,Leicester City,Coventry City,1-1,1,1,1,1,2,0,D
1968-09-28,1968,Manchester City,Leeds United,3-1,3,1,1,1,4,2,H
1968-09-28,1968,Newcastle United,Tottenham Hotspur,2-2,2,2,1,1,4,0,D
1968-09-28,1968,Queens Park Rangers,Southampton,1-1,1,1,1,1,2,0,D
1968-09-28,1968,West Ham United,Sheffield Wednesday,1-1,1,1,1,1,2,0,D
1968-09-28,1968,Wolverhampton Wanderers,Liverpool,0-6,0,6,1,1,6,-6,A
1968-10-05,1968,Burnley,Liverpool,0-4,0,4,1,1,4,-4,A
1968-10-05,1968,Chelsea,Ipswich Town,3-1,3,1,1,1,4,2,H
1968-10-05,1968,Coventry City,Wolverhampton Wanderers,0-1,0,1,1,1,1,-1,A
1968-10-05,1968,Everton,Manchester City,2-0,2,0,1,1,2,2,H
1968-10-05,1968,Manchester United,Arsenal,0-0,0,0,1,1,0,0,D
1968-10-05,1968,Newcastle United,Leeds United,0-1,0,1,1,1,1,-1,A
1968-10-05,1968,Nottingham Forest,Stoke City,3-3,3,3,1,1,6,0,D
1968-10-05,1968,Sheffield Wednesday,Sunderland,1-1,1,1,1,1,2,0,D
1968-10-05,1968,Tottenham Hotspur,Leicester City,3-2,3,2,1,1,5,1,H
1968-10-05,1968,West Bromwich Albion,Queens Park Rangers,3-1,3,1,1,1,4,2,H
1968-10-05,1968,West Ham United,Southampton,0-0,0,0,1,1,0,0,D
1968-10-08,1968,Burnley,West Ham United,3-1,3,1,1,1,4,2,H
1968-10-08,1968,Liverpool,Everton,1-1,1,1,1,1,2,0,D
1968-10-08,1968,Nottingham Forest,Newcastle United,2-4,2,4,1,1,6,-2,A
1968-10-08,1968,Queens Park Rangers,Ipswich Town,2-1,2,1,1,1,3,1,H
1968-10-09,1968,Leicester City,Wolverhampton Wanderers,2-0,2,0,1,1,2,2,H
1968-10-09,1968,Manchester City,Arsenal,1-1,1,1,1,1,2,0,D
1968-10-09,1968,Sheffield Wednesday,Chelsea,1-1,1,1,1,1,2,0,D
1968-10-09,1968,Stoke City,Southampton,1-0,1,0,1,1,1,1,H
1968-10-09,1968,Sunderland,Leeds United,0-1,0,1,1,1,1,-1,A
1968-10-09,1968,Tottenham Hotspur,Manchester United,2-2,2,2,1,1,4,0,D
1968-10-09,1968,West Bromwich Albion,Coventry City,6-1,6,1,1,1,7,5,H
1968-10-12,1968,Arsenal,Coventry City,2-1,2,1,1,1,3,1,H
1968-10-12,1968,Ipswich Town,Newcastle United,1-4,1,4,1,1,5,-3,A
1968-10-12,1968,Leeds United,West Ham United,2-0,2,0,1,1,2,2,H
1968-10-12,1968,Leicester City,West Bromwich Albion,0-2,0,2,1,1,2,-2,A
1968-10-12,1968,Liverpool,Manchester United,2-0,2,0,1,1,2,2,H
1968-10-12,1968,Manchester City,Tottenham Hotspur,4-0,4,0,1,1,4,4,H
1968-10-12,1968,Queens Park Rangers,Sheffield Wednesday,3-2,3,2,1,1,5,1,H
1968-10-12,1968,Southampton,Everton,2-5,2,5,1,1,7,-3,A
1968-10-12,1968,Stoke City,Burnley,1-3,1,3,1,1,4,-2,A
1968-10-12,1968,Sunderland,Nottingham Forest,3-1,3,1,1,1,4,2,H
1968-10-12,1968,Wolverhampton Wanderers,Chelsea,1-1,1,1,1,1,2,0,D
1968-10-19,1968,Burnley,Leeds United,5-1,5,1,1,1,6,4,H
1968-10-19,1968,Chelsea,Leicester City,3-0,3,0,1,1,3,3,H
1968-10-19,1968,Coventry City,Manchester City,1-1,1,1,1,1,2,0,D
1968-10-19,1968,Everton,Stoke City,2-1,2,1,1,1,3,1,H
1968-10-19,1968,Manchester United,Southampton,1-2,1,2,1,1,3,-1,A
1968-10-19,1968,Newcastle United,Queens Park Rangers,3-2,3,2,1,1,5,1,H
1968-10-19,1968,Nottingham Forest,Ipswich Town,1-2,1,2,1,1,3,-1,A
1968-10-19,1968,Sheffield Wednesday,Wolverhampton Wanderers,0-2,0,2,1,1,2,-2,A
1968-10-19,1968,Tottenham Hotspur,Liverpool,2-1,2,1,1,1,3,1,H
1968-10-19,1968,West Bromwich Albion,Arsenal,1-0,1,0,1,1,1,1,H
1968-10-19,1968,West Ham United,Sunderland,8-0,8,0,1,1,8,8,H
1968-10-26,1968,Arsenal,West Ham United,0-0,0,0,1,1,0,0,D
1968-10-26,1968,Ipswich Town,Tottenham Hotspur,0-1,0,1,1,1,1,-1,A
1968-10-26,1968,Leeds United,West Bromwich Albion,0-0,0,0,1,1,0,0,D
1968-10-26,1968,Leicester City,Burnley,0-2,0,2,1,1,2,-2,A
1968-10-26,1968,Liverpool,Newcastle United,2-1,2,1,1,1,3,1,H
1968-10-26,1968,Manchester City,Nottingham Forest,3-3,3,3,1,1,6,0,D
1968-10-26,1968,Queens Park Rangers,Manchester United,2-3,2,3,1,1,5,-1,A
1968-10-26,1968,Southampton,Sheffield Wednesday,1-1,1,1,1,1,2,0,D
1968-10-26,1968,Stoke City,Chelsea,2-0,2,0,1,1,2,2,H
1968-10-26,1968,Sunderland,Coventry City,3-0,3,0,1,1,3,3,H
1968-10-26,1968,Wolverhampton Wanderers,Everton,1-2,1,2,1,1,3,-1,A
1968-11-02,1968,Burnley,Ipswich Town,1-0,1,0,1,1,1,1,H
1968-11-02,1968,Chelsea,Manchester City,2-0,2,0,1,1,2,2,H
1968-11-02,1968,Coventry City,Southampton,1-1,1,1,1,1,2,0,D
1968-11-02,1968,Everton,Sunderland,2-0,2,0,1,1,2,2,H
1968-11-02,1968,Manchester United,Leeds United,0-0,0,0,1,1,0,0,D
1968-11-02,1968,Newcastle United,Leicester City,0-0,0,0,1,1,0,0,D
1968-11-02,1968,Nottingham Forest,Wolverhampton Wanderers,0-0,0,0,1,1,0,0,D
1968-11-02,1968,Tottenham Hotspur,Stoke City,1-1,1,1,1,1,2,0,D
1968-11-02,1968,West Bromwich Albion,Liverpool,0-0,0,0,1,1,0,0,D
1968-11-02,1968,West Ham United,Queens Park Rangers,4-3,4,3,1,1,7,1,H
1968-11-09,1968,Arsenal,Newcastle United,0-0,0,0,1,1,0,0,D
1968-11-09,1968,Ipswich Town,Everton,2-2,2,2,1,1,4,0,D
1968-11-09,1968,Leeds United,Tottenham Hotspur,0-0,0,0,1,1,0,0,D
1968-11-09,1968,Leicester City,Nottingham Forest,2-2,2,2,1,1,4,0,D
1968-11-09,1968,Liverpool,Chelsea,2-1,2,1,1,1,3,1,H
1968-11-09,1968,Manchester City,Sheffield Wednesday,0-1,0,1,1,1,1,-1,A
1968-11-09,1968,Queens Park Rangers,Burnley,0-2,0,2,1,1,2,-2,A
1968-11-09,1968,Southampton,West Bromwich Albion,2-0,2,0,1,1,2,2,H
1968-11-09,1968,Stoke City,Coventry City,0-3,0,3,1,1,3,-3,A
1968-11-09,1968,Sunderland,Manchester United,1-1,1,1,1,1,2,0,D
1968-11-09,1968,Wolverhampton Wanderers,West Ham United,2-0,2,0,1,1,2,2,H
1968-11-16,1968,Burnley,Wolverhampton Wanderers,1-1,1,1,1,1,2,0,D
1968-11-16,1968,Chelsea,Southampton,2-3,2,3,1,1,5,-1,A
1968-11-16,1968,Coventry City,Leeds United,0-1,0,1,1,1,1,-1,A
1968-11-16,1968,Everton,Queens Park Rangers,4-0,4,0,1,1,4,4,H
1968-11-16,1968,Manchester United,Ipswich Town,0-0,0,0,1,1,0,0,D
1968-11-16,1968,Newcastle United,Manchester City,1-0,1,0,1,1,1,1,H
1968-11-16,1968,Nottingham Forest,Arsenal,0-2,0,2,1,1,2,-2,A
1968-11-16,1968,Sheffield Wednesday,Liverpool,1-2,1,2,1,1,3,-1,A
1968-11-16,1968,Tottenham Hotspur,Sunderland,5-1,5,1,1,1,6,4,H
1968-11-16,1968,West Bromwich Albion,Stoke City,2-1,2,1,1,1,3,1,H
1968-11-16,1968,West Ham United,Leicester City,4-0,4,0,1,1,4,4,H
1968-11-23,1968,Arsenal,Chelsea,0-1,0,1,1,1,1,-1,A
1968-11-23,1968,Ipswich Town,West Ham United,2-2,2,2,1,1,4,0,D
1968-11-23,1968,Leeds United,Everton,2-1,2,1,1,1,3,1,H
1968-11-23,1968,Leicester City,Sheffield Wednesday,1-1,1,1,1,1,2,0,D
1968-11-23,1968,Liverpool,Coventry City,2-0,2,0,1,1,2,2,H
1968-11-23,1968,Manchester City,West Bromwich Albion,5-1,5,1,1,1,6,4,H
1968-11-23,1968,Queens Park Rangers,Nottingham Forest,2-1,2,1,1,1,3,1,H
1968-11-23,1968,Southampton,Tottenham Hotspur,2-1,2,1,1,1,3,1,H
1968-11-23,1968,Stoke City,Manchester United,0-0,0,0,1,1,0,0,D
1968-11-23,1968,Sunderland,Burnley,2-0,2,0,1,1,2,2,H
1968-11-23,1968,Wolverhampton Wanderers,Newcastle United,5-0,5,0,1,1,5,5,H
1968-11-30,1968,Burnley,Arsenal,0-1,0,1,1,1,1,-1,A
1968-11-30,1968,Chelsea,Leeds United,1-1,1,1,1,1,2,0,D
1968-11-30,1968,Coventry City,Ipswich Town,0-2,0,2,1,1,2,-2,A
1968-11-30,1968,Everton,Leicester City,7-1,7,1,1,1,8,6,H
1968-11-30,1968,Manchester United,Wolverhampton Wanderers,2-0,2,0,1,1,2,2,H
1968-11-30,1968,Newcastle United,Southampton,4-1,4,1,1,1,5,3,H
1968-11-30,1968,Nottingham Forest,Liverpool,0-1,0,1,1,1,1,-1,A
1968-11-30,1968,Sheffield Wednesday,Stoke City,2-1,2,1,1,1,3,1,H
1968-11-30,1968,West Bromwich Albion,Sunderland,3-0,3,0,1,1,3,3,H
1968-11-30,1968,West Ham United,Manchester City,2-1,2,1,1,1,3,1,H
1968-12-03,1968,Liverpool,Southampton,1-0,1,0,1,1,1,1,H
1968-12-07,1968,Arsenal,Everton,3-1,3,1,1,1,4,2,H
1968-12-07,1968,Ipswich Town,West Bromwich Albion,4-1,4,1,1,1,5,3,H
1968-12-07,1968,Leeds United,Sheffield Wednesday,2-0,2,0,1,1,2,2,H
1968-12-07,1968,Leicester City,Manchester United,2-1,2,1,1,1,3,1,H
1968-12-07,1968,Liverpool,West Ham United,2-0,2,0,1,1,2,2,H
1968-12-07,1968,Manchester City,Burnley,7-0,7,0,1,1,7,7,H
1968-12-07,1968,Queens Park Rangers,Coventry City,0-1,0,1,1,1,1,-1,A
1968-12-07,1968,Southampton,Nottingham Forest,1-1,1,1,1,1,2,0,D
1968-12-07,1968,Stoke City,Newcastle United,1-0,1,0,1,1,1,1,H
1968-12-07,1968,Sunderland,Chelsea,3-2,3,2,1,1,5,1,H
1968-12-07,1968,Wolverhampton Wanderers,Tottenham Hotspur,2-0,2,0,1,1,2,2,H
1968-12-14,1968,Burnley,Stoke City,1-1,1,1,1,1,2,0,D
1968-12-14,1968,Chelsea,Wolverhampton Wanderers,1-1,1,1,1,1,2,0,D
1968-12-14,1968,Coventry City,Arsenal,0-1,0,1,1,1,1,-1,A
1968-12-14,1968,Everton,Southampton,1-0,1,0,1,1,1,1,H
1968-12-14,1968,Manchester United,Liverpool,1-0,1,0,1,1,1,1,H
1968-12-14,1968,Newcastle United,Ipswich Town,2-1,2,1,1,1,3,1,H
1968-12-14,1968,Nottingham Forest,Sunderland,1-0,1,0,1,1,1,1,H
1968-12-14,1968,Sheffield Wednesday,Queens Park Rangers,4-0,4,0,1,1,4,4,H
1968-12-14,1968,Tottenham Hotspur,Manchester City,1-1,1,1,1,1,2,0,D
1968-12-14,1968,West Bromwich Albion,Leicester City,1-1,1,1,1,1,2,0,D
1968-12-14,1968,West Ham United,Leeds United,1-1,1,1,1,1,2,0,D
1968-12-21,1968,Arsenal,West Bromwich Albion,2-0,2,0,1,1,2,2,H
1968-12-21,1968,Ipswich Town,Nottingham Forest,2-3,2,3,1,1,5,-1,A
1968-12-21,1968,Leeds United,Burnley,6-1,6,1,1,1,7,5,H
1968-12-21,1968,Leicester City,Chelsea,1-4,1,4,1,1,5,-3,A
1968-12-21,1968,Liverpool,Tottenham Hotspur,1-0,1,0,1,1,1,1,H
1968-12-21,1968,Manchester City,Coventry City,4-2,4,2,1,1,6,2,H
1968-12-21,1968,Queens Park Rangers,Newcastle United,1-1,1,1,1,1,2,0,D
1968-12-21,1968,Southampton,Manchester United,2-0,2,0,1,1,2,2,H
1968-12-21,1968,Stoke City,Everton,0-0,0,0,1,1,0,0,D
1968-12-21,1968,Sunderland,West Ham United,2-1,2,1,1,1,3,1,H
1968-12-21,1968,Wolverhampton Wanderers,Sheffield Wednesday,0-3,0,3,1,1,3,-3,A
1968-12-26,1968,Arsenal,Manchester United,3-0,3,0,1,1,3,3,H
1968-12-26,1968,Ipswich Town,Chelsea,1-3,1,3,1,1,4,-2,A
1968-12-26,1968,Leeds United,Newcastle United,2-1,2,1,1,1,3,1,H
1968-12-26,1968,Liverpool,Burnley,1-1,1,1,1,1,2,0,D
1968-12-26,1968,Manchester City,Everton,1-3,1,3,1,1,4,-2,A
1968-12-26,1968,Queens Park Rangers,West Bromwich Albion,0-4,0,4,1,1,4,-4,A
1968-12-26,1968,Southampton,West Ham United,2-2,2,2,1,1,4,0,D
1968-12-26,1968,Stoke City,Nottingham Forest,3-1,3,1,1,1,4,2,H
1968-12-26,1968,Sunderland,Sheffield Wednesday,0-0,0,0,1,1,0,0,D
1968-12-28,1968,Burnley,Leicester City,2-1,2,1,1,1,3,1,H
1968-12-28,1968,Sheffield Wednesday,Southampton,0-0,0,0,1,1,0,0,D
1969-01-11,1968,Arsenal,Sheffield Wednesday,2-0,2,0,1,1,2,2,H
1969-01-11,1968,Ipswich Town,Burnley,2-0,2,0,1,1,2,2,H
1969-01-11,1968,Leeds United,Manchester United,2-1,2,1,1,1,3,1,H
1969-01-11,1968,Leicester City,Newcastle United,2-1,2,1,1,1,3,1,H
1969-01-11,1968,Liverpool,West Bromwich Albion,1-0,1,0,1,1,1,1,H
1969-01-11,1968,Manchester City,Chelsea,4-1,4,1,1,1,5,3,H
1969-01-11,1968,Queens Park Rangers,West Ham United,1-1,1,1,1,1,2,0,D
1969-01-11,1968,Southampton,Coventry City,1-0,1,0,1,1,1,1,H
1969-01-11,1968,Stoke City,Tottenham Hotspur,1-1,1,1,1,1,2,0,D
1969-01-11,1968,Sunderland,Everton,1-3,1,3,1,1,4,-2,A
1969-01-11,1968,Wolverhampton Wanderers,Nottingham Forest,1-0,1,0,1,1,1,1,H
1969-01-18,1968,Burnley,Queens Park Rangers,2-2,2,2,1,1,4,0,D
1969-01-18,1968,Chelsea,Liverpool,1-2,1,2,1,1,3,-1,A
1969-01-18,1968,Everton,Ipswich Town,2-2,2,2,1,1,4,0,D
1969-01-18,1968,Manchester United,Sunderland,4-1,4,1,1,1,5,3,H
1969-01-18,1968,Newcastle United,Arsenal,2-1,2,1,1,1,3,1,H
1969-01-18,1968,Nottingham Forest,Leicester City,0-0,0,0,1,1,0,0,D
1969-01-18,1968,Sheffield Wednesday,Manchester City,1-1,1,1,1,1,2,0,D
1969-01-18,1968,Tottenham Hotspur,Leeds United,0-0,0,0,1,1,0,0,D
1969-01-18,1968,West Bromwich Albion,Southampton,1-2,1,2,1,1,3,-1,A
1969-01-24,1968,Queens Park Rangers,Leeds United,0-1,0,1,1,1,1,-1,A
1969-01-28,1968,Everton,Wolverhampton Wanderers,4-0,4,0,1,1,4,4,H
1969-01-29,1968,Tottenham Hotspur,Queens Park Rangers,3-2,3,2,1,1,5,1,H
1969-02-01,1968,Arsenal,Nottingham Forest,1-1,1,1,1,1,2,0,D
1969-02-01,1968,Ipswich Town,Manchester United,1-0,1,0,1,1,1,1,H
1969-02-01,1968,Leeds United,Coventry City,3-0,3,0,1,1,3,3,H
1969-02-01,1968,Leicester City,West Ham United,1-1,1,1,1,1,2,0,D
1969-02-01,1968,Liverpool,Sheffield Wednesday,1-0,1,0,1,1,1,1,H
1969-02-01,1968,Queens Park Rangers,Everton,0-1,0,1,1,1,1,-1,A
1969-02-01,1968,Southampton,Chelsea,5-0,5,0,1,1,5,5,H
1969-02-01,1968,Stoke City,West Bromwich Albion,1-1,1,1,1,1,2,0,D
1969-02-01,1968,Sunderland,Tottenham Hotspur,0-0,0,0,1,1,0,0,D
1969-02-01,1968,Wolverhampton Wanderers,Burnley,1-1,1,1,1,1,2,0,D
1969-02-12,1968,Leeds United,Ipswich Town,2-0,2,0,1,1,2,2,H
1969-02-15,1968,Arsenal,Burnley,2-0,2,0,1,1,2,2,H
1969-02-15,1968,Leeds United,Chelsea,1-0,1,0,1,1,1,1,H
1969-02-15,1968,Liverpool,Nottingham Forest,0-2,0,2,1,1,2,-2,A
1969-02-15,1968,Queens Park Rangers,Tottenham Hotspur,1-1,1,1,1,1,2,0,D
1969-02-15,1968,Southampton,Newcastle United,0-0,0,0,1,1,0,0,D
1969-02-15,1968,Wolverhampton Wanderers,Manchester United,2-2,2,2,1,1,4,0,D
1969-02-18,1968,Arsenal,Ipswich Town,0-2,0,2,1,1,2,-2,A
1969-02-22,1968,Chelsea,Sunderland,5-1,5,1,1,1,6,4,H
1969-02-22,1968,Tottenham Hotspur,Wolverhampton Wanderers,1-1,1,1,1,1,2,0,D
1969-02-22,1968,West Ham United,Liverpool,1-1,1,1,1,1,2,0,D
1969-02-25,1968,Coventry City,Queens Park Rangers,5-0,5,0,1,1,5,5,H
1969-02-25,1968,Nottingham Forest,Leeds United,0-2,0,2,1,1,2,-2,A
1969-03-01,1968,Burnley,Nottingham Forest,3-1,3,1,1,1,4,2,H
1969-03-01,1968,Leeds United,Southampton,3-2,3,2,1,1,5,1,H
1969-03-01,1968,Sheffield Wednesday,Arsenal,0-5,0,5,1,1,5,-5,A
1969-03-01,1968,Sunderland,Stoke City,4-1,4,1,1,1,5,3,H
1969-03-01,1968,West Ham United,Newcastle United,3-1,3,1,1,1,4,2,H
1969-03-01,1968,Wolverhampton Wanderers,Ipswich Town,1-1,1,1,1,1,2,0,D
1969-03-04,1968,Burnley,Manchester City,2-1,2,1,1,1,3,1,H
1969-03-04,1968,Coventry City,Sunderland,3-1,3,1,1,1,4,2,H
1969-03-04,1968,Nottingham Forest,Queens Park Rangers,1-0,1,0,1,1,1,1,H
1969-03-05,1968,Chelsea,Stoke City,1-0,1,0,1,1,1,1,H
1969-03-05,1968,Sheffield Wednesday,West Bromwich Albion,1-0,1,0,1,1,1,1,H
1969-03-08,1968,Coventry City,Sheffield Wednesday,3-0,3,0,1,1,3,3,H
1969-03-08,1968,Manchester United,Manchester City,0-1,0,1,1,1,1,-1,A
1969-03-08,1968,Newcastle United,Burnley,1-0,1,0,1,1,1,1,H
1969-03-08,1968,Nottingham Forest,West Ham United,0-1,0,1,1,1,1,-1,A
1969-03-08,1968,Queens Park Rangers,Wolverhampton Wanderers,0-1,0,1,1,1,1,-1,A
1969-03-08,1968,Southampton,Sunderland,1-0,1,0,1,1,1,1,H
1969-03-08,1968,Stoke City,Leeds United,1-5,1,5,1,1,6,-4,A
1969-03-08,1968,Tottenham Hotspur,Everton,1-1,1,1,1,1,2,0,D
1969-03-08,1968,West Bromwich Albion,Chelsea,0-3,0,3,1,1,3,-3,A
1969-03-10,1968,Chelsea,Coventry City,2-1,2,1,1,1,3,1,H
1969-03-10,1968,Everton,Manchester United,0-0,0,0,1,1,0,0,D
1969-03-10,1968,Sunderland,West Bromwich Albion,0-1,0,1,1,1,1,-1,A
1969-03-11,1968,Ipswich Town,Manchester City,2-1,2,1,1,1,3,1,H
1969-03-11,1968,Nottingham Forest,Southampton,1-0,1,0,1,1,1,1,H
1969-03-12,1968,Leicester City,Queens Park Rangers,2-0,2,0,1,1,2,2,H
1969-03-14,1968,West Ham United,Coventry City,5-2,5,2,1,1,7,3,H
1969-03-15,1968,Burnley,West Bromwich Albion,2-2,2,2,1,1,4,0,D
1969-03-15,1968,Chelsea,Manchester United,3-2,3,2,1,1,5,1,H
1969-03-15,1968,Leicester City,Stoke City,0-0,0,0,1,1,0,0,D
1969-03-15,1968,Manchester City,Queens Park Rangers,3-1,3,1,1,1,4,2,H
1969-03-15,1968,Sunderland,Liverpool,0-2,0,2,1,1,2,-2,A
1969-03-15,1968,Wolverhampton Wanderers,Southampton,0-0,0,0,1,1,0,0,D
1969-03-18,1968,Coventry City,Stoke City,1-1,1,1,1,1,2,0,D
1969-03-18,1968,Tottenham Hotspur,Ipswich Town,2-2,2,2,1,1,4,0,D
1969-03-19,1968,Manchester United,Queens Park Rangers,8-1,8,1,1,1,9,7,H
1969-03-21,1968,West Ham United,Ipswich Town,1-3,1,3,1,1,4,-2,A
1969-03-22,1968,Coventry City,Burnley,4-1,4,1,1,1,5,3,H
1969-03-22,1968,Manchester United,Sheffield Wednesday,1-0,1,0,1,1,1,1,H
1969-03-22,1968,Newcastle United,Sunderland,1-1,1,1,1,1,2,0,D
1969-03-22,1968,Nottingham Forest,West Bromwich Albion,3-0,3,0,1,1,3,3,H
1969-03-22,1968,Queens Park Rangers,Arsenal,0-1,0,1,1,1,1,-1,A
1969-03-22,1968,Southampton,Leicester City,1-0,1,0,1,1,1,1,H
1969-03-22,1968,Stoke City,Wolverhampton Wanderers,4-1,4,1,1,1,5,3,H
1969-03-22,1968,Tottenham Hotspur,Chelsea,1-0,1,0,1,1,1,1,H
1969-03-24,1968,Arsenal,Tottenham Hotspur,1-0,1,0,1,1,1,1,H
1969-03-24,1968,Manchester United,Stoke City,1-1,1,1,1,1,2,0,D
1969-03-24,1968,Nottingham Forest,Manchester City,1-0,1,0,1,1,1,1,H
1969-03-24,1968,West Ham United,Wolverhampton Wanderers,3-1,3,1,1,1,4,2,H
1969-03-25,1968,Ipswich Town,Coventry City,0-0,0,0,1,1,0,0,D
1969-03-29,1968,Arsenal,Southampton,0-0,0,0,1,1,0,0,D
1969-03-29,1968,Burnley,Tottenham Hotspur,2-2,2,2,1,1,4,0,D
1969-03-29,1968,Everton,Chelsea,1-2,1,2,1,1,3,-1,A
1969-03-29,1968,Manchester City,Stoke City,3-1,3,1,1,1,4,2,H
1969-03-29,1968,Newcastle United,Coventry City,2-0,2,0,1,1,2,2,H
1969-03-29,1968,Queens Park Rangers,Liverpool,1-2,1,2,1,1,3,-1,A
1969-03-29,1968,West Ham United,Manchester United,0-0,0,0,1,1,0,0,D
1969-03-29,1968,Wolverhampton Wanderers,Leeds United,0-0,0,0,1,1,0,0,D
1969-03-31,1968,Liverpool,Arsenal,1-1,1,1,1,1,2,0,D
1969-03-31,1968,Nottingham Forest,Manchester United,0-1,0,1,1,1,1,-1,A
1969-04-01,1968,Coventry City,Leicester City,1-0,1,0,1,1,1,1,H
1969-04-01,1968,Everton,West Ham United,1-0,1,0,1,1,1,1,H
1969-04-01,1968,Sheffield Wednesday,Leeds United,0-0,0,0,1,1,0,0,D
1969-04-02,1968,Manchester United,West Bromwich Albion,2-1,2,1,1,1,3,1,H
1969-04-02,1968,Tottenham Hotspur,Newcastle United,0-1,0,1,1,1,1,-1,A
1969-04-04,1968,Chelsea,Newcastle United,1-1,1,1,1,1,2,0,D
1969-04-04,1968,Ipswich Town,Sunderland,1-0,1,0,1,1,1,1,H
1969-04-04,1968,Manchester City,Leicester City,2-0,2,0,1,1,2,2,H
1969-04-04,1968,Tottenham Hotspur,Coventry City,2-0,2,0,1,1,2,2,H
1969-04-05,1968,Chelsea,Burnley,2-3,2,3,1,1,5,-1,A
1969-04-05,1968,Leeds United,Manchester City,1-0,1,0,1,1,1,1,H
1969-04-05,1968,Liverpool,Wolverhampton Wanderers,1-0,1,0,1,1,1,1,H
1969-04-05,1968,Manchester United,Nottingham Forest,3-1,3,1,1,1,4,2,H
1969-04-05,1968,Sheffield Wednesday,West Ham United,1-1,1,1,1,1,2,0,D
1969-04-05,1968,Southampton,Queens Park Rangers,3-2,3,2,1,1,5,1,H
1969-04-05,1968,Stoke City,Ipswich Town,2-1,2,1,1,1,3,1,H
1969-04-05,1968,Sunderland,Arsenal,0-0,0,0,1,1,0,0,D
1969-04-05,1968,West Bromwich Albion,Everton,1-1,1,1,1,1,2,0,D
1969-04-07,1968,Arsenal,Wolverhampton Wanderers,3-1,3,1,1,1,4,2,H
1969-04-07,1968,Sheffield Wednesday,Nottingham Forest,0-1,0,1,1,1,1,-1,A
1969-04-07,1968,Southampton,Burnley,5-1,5,1,1,1,6,4,H
1969-04-07,1968,Stoke City,Liverpool,0-0,0,0,1,1,0,0,D
1969-04-07,1968,Sunderland,Queens Park Rangers,0-0,0,0,1,1,0,0,D
1969-04-07,1968,West Bromwich Albion,Tottenham Hotspur,4-3,4,3,1,1,7,1,H
1969-04-08,1968,Burnley,Everton,1-2,1,2,1,1,3,-1,A
1969-04-08,1968,Coventry City,Manchester United,2-1,2,1,1,1,3,1,H
1969-04-08,1968,Leicester City,Arsenal,0-0,0,0,1,1,0,0,D
1969-04-08,1968,Nottingham Forest,Chelsea,1-2,1,2,1,1,3,-1,A
1969-04-08,1968,West Ham United,Stoke City,0-0,0,0,1,1,0,0,D
1969-04-08,1968,Wolverhampton Wanderers,Manchester City,3-1,3,1,1,1,4,2,H
1969-04-09,1968,Newcastle United,Sheffield Wednesday,3-2,3,2,1,1,5,1,H
1969-04-09,1968,West Bromwich Albion,Leeds United,1-1,1,1,1,1,2,0,D
1969-04-12,1968,Arsenal,Leeds United,1-2,1,2,1,1,3,-1,A
1969-04-12,1968,Burnley,Sheffield Wednesday,2-0,2,0,1,1,2,2,H
1969-04-12,1968,Everton,Coventry City,3-0,3,0,1,1,3,3,H
1969-04-12,1968,Ipswich Town,Southampton,0-0,0,0,1,1,0,0,D
1969-04-12,1968,Leicester City,Liverpool,1-2,1,2,1,1,3,-1,A
1969-04-12,1968,Manchester City,Sunderland,1-0,1,0,1,1,1,1,H
1969-04-12,1968,Newcastle United,Manchester United,2-0,2,0,1,1,2,2,H
1969-04-12,1968,Nottingham Forest,Tottenham Hotspur,0-2,0,2,1,1,2,-2,A
1969-04-12,1968,Queens Park Rangers,Stoke City,2-1,2,1,1,1,3,1,H
1969-04-12,1968,West Ham United,Chelsea,0-0,0,0,1,1,0,0,D
1969-04-12,1968,Wolverhampton Wanderers,West Bromwich Albion,0-1,0,1,1,1,1,-1,A
1969-04-14,1968,Chelsea,Arsenal,2-1,2,1,1,1,3,1,H
1969-04-14,1968,Everton,Newcastle United,1-1,1,1,1,1,2,0,D
1969-04-14,1968,Sheffield Wednesday,Leicester City,1-3,1,3,1,1,4,-2,A
1969-04-14,1968,West Bromwich Albion,West Ham United,3-1,3,1,1,1,4,2,H
1969-04-15,1968,Wolverhampton Wanderers,Coventry City,1-1,1,1,1,1,2,0,D
1969-04-16,1968,West Bromwich Albion,Manchester City,2-0,2,0,1,1,2,2,H
1969-04-19,1968,Chelsea,Queens Park Rangers,2-1,2,1,1,1,3,1,H
1969-04-19,1968,Coventry City,Nottingham Forest,1-1,1,1,1,1,2,0,D
1969-04-19,1968,Leeds United,Leicester City,2-0,2,0,1,1,2,2,H
1969-04-19,1968,Liverpool,Ipswich Town,4-0,4,0,1,1,4,4,H
1969-04-19,1968,Manchester United,Burnley,2-0,2,0,1,1,2,2,H
1969-04-19,1968,Sheffield Wednesday,Everton,2-2,2,2,1,1,4,0,D
1969-04-19,1968,Southampton,Manchester City,3-0,3,0,1,1,3,3,H
1969-04-19,1968,Stoke City,Arsenal,1-3,1,3,1,1,4,-2,A
1969-04-19,1968,Sunderland,Wolverhampton Wanderers,2-0,2,0,1,1,2,2,H
1969-04-19,1968,Tottenham Hotspur,West Ham United,1-0,1,0,1,1,1,1,H
1969-04-19,1968,West Bromwich Albion,Newcastle United,5-1,5,1,1,1,6,4,H
1969-04-21,1968,Newcastle United,Wolverhampton Wanderers,4-1,4,1,1,1,5,3,H
1969-04-21,1968,West Ham United,Arsenal,1-2,1,2,1,1,3,-1,A
1969-04-22,1968,Coventry City,Liverpool,0-0,0,0,1,1,0,0,D
1969-04-22,1968,Everton,Leeds United,0-0,0,0,1,1,0,0,D
1969-04-22,1968,Stoke City,Sheffield Wednesday,1-1,1,1,1,1,2,0,D
1969-04-22,1968,Tottenham Hotspur,Southampton,2-1,2,1,1,1,3,1,H
1969-04-23,1968,Burnley,Sunderland,1-2,1,2,1,1,3,-1,A
1969-04-23,1968,West Bromwich Albion,Ipswich Town,2-2,2,2,1,1,4,0,D
1969-04-25,1968,Ipswich Town,Sheffield Wednesday,2-0,2,0,1,1,2,2,H
1969-04-25,1968,Nottingham Forest,Everton,1-0,1,0,1,1,1,1,H
1969-04-28,1968,Liverpool,Leeds United,0-0,0,0,1,1,0,0,D
1969-04-29,1968,Everton,Arsenal,1-0,1,0,1,1,1,1,H
1969-04-29,1968,Leicester City,Tottenham Hotspur,1-0,1,0,1,1,1,1,H
1969-04-30,1968,Leeds United,Nottingham Forest,1-0,1,0,1,1,1,1,H
1969-04-30,1968,Manchester City,West Ham United,1-1,1,1,1,1,2,0,D
1969-04-30,1968,Newcastle United,Stoke City,5-0,5,0,1,1,5,5,H
1969-05-03,1968,Ipswich Town,Leicester City,2-1,2,1,1,1,3,1,H
1969-05-05,1968,Leicester City,Sunderland,2-1,2,1,1,1,3,1,H
1969-05-05,1968,Manchester City,Newcastle United,1-0,1,0,1,1,1,1,H
1969-05-12,1968,Manchester City,Liverpool,1-0,1,0,1,1,1,1,H
1969-05-12,1968,Sheffield Wednesday,Tottenham Hotspur,0-0,0,0,1,1,0,0,D
1969-05-14,1968,Leicester City,Everton,1-1,1,1,1,1,2,0,D
1969-05-17,1968,Manchester United,Leicester City,3-2,3,2,1,1,5,1,H
1969-05-17,1968,Newcastle United,Liverpool,1-1,1,1,1,1,2,0,D
1969-08-09,1969,Arsenal,Everton,0-1,0,1,1,1,1,-1,A
1969-08-09,1969,Crystal Palace,Manchester United,2-2,2,2,1,1,4,0,D
1969-08-09,1969,Derby County,Burnley,0-0,0,0,1,1,0,0,D
1969-08-09,1969,Ipswich Town,Nottingham Forest,0-0,0,0,1,1,0,0,D
1969-08-09,1969,Leeds United,Tottenham Hotspur,3-1,3,1,1,1,4,2,H
1969-08-09,1969,Liverpool,Chelsea,4-1,4,1,1,1,5,3,H
1969-08-09,1969,Manchester City,Sheffield Wednesday,4-1,4,1,1,1,5,3,H
1969-08-09,1969,Southampton,West Bromwich Albion,0-2,0,2,1,1,2,-2,A
1969-08-09,1969,Sunderland,Coventry City,0-0,0,0,1,1,0,0,D
1969-08-09,1969,West Ham United,Newcastle United,1-0,1,0,1,1,1,1,H
1969-08-09,1969,Wolverhampton Wanderers,Stoke City,3-1,3,1,1,1,4,2,H
1969-08-11,1969,West Ham United,Chelsea,2-0,2,0,1,1,2,2,H
1969-08-12,1969,Coventry City,West Bromwich Albion,3-1,3,1,1,1,4,2,H
1969-08-12,1969,Ipswich Town,Derby County,0-1,0,1,1,1,1,-1,A
1969-08-12,1969,Liverpool,Manchester City,3-2,3,2,1,1,5,1,H
1969-08-12,1969,Nottingham Forest,Stoke City,0-0,0,0,1,1,0,0,D
1969-08-13,1969,Crystal Palace,Sunderland,2-0,2,0,1,1,2,2,H
1969-08-13,1969,Leeds United,Arsenal,0-0,0,0,1,1,0,0,D
1969-08-13,1969,Manchester United,Everton,0-2,0,2,1,1,2,-2,A
1969-08-13,1969,Newcastle United,Sheffield Wednesday,3-1,3,1,1,1,4,2,H
1969-08-13,1969,Tottenham Hotspur,Burnley,4-0,4,0,1,1,4,4,H
1969-08-13,1969,Wolverhampton Wanderers,Southampton,2-1,2,1,1,1,3,1,H
1969-08-16,1969,Burnley,Sunderland,3-0,3,0,1,1,3,3,H
1969-08-16,1969,Chelsea,Ipswich Town,1-0,1,0,1,1,1,1,H
1969-08-16,1969,Coventry City,Derby County,1-1,1,1,1,1,2,0,D
1969-08-16,1969,Everton,Crystal Palace,2-1,2,1,1,1,3,1,H
1969-08-16,1969,Manchester United,Southampton,1-4,1,4,1,1,5,-3,A
1969-08-16,1969,Newcastle United,Manchester City,1-0,1,0,1,1,1,1,H
1969-08-16,1969,Nottingham Forest,Leeds United,1-4,1,4,1,1,5,-3,A
1969-08-16,1969,Sheffield Wednesday,Wolverhampton Wanderers,2-3,2,3,1,1,5,-1,A
1969-08-16,1969,Stoke City,West Ham United,2-1,2,1,1,1,3,1,H
1969-08-16,1969,Tottenham Hotspur,Liverpool,0-2,0,2,1,1,2,-2,A
1969-08-16,1969,West Bromwich Albion,Arsenal,0-1,0,1,1,1,1,-1,A
1969-08-19,1969,Arsenal,Leeds United,1-1,1,1,1,1,2,0,D
1969-08-19,1969,Burnley,Tottenham Hotspur,0-2,0,2,1,1,2,-2,A
1969-08-19,1969,Everton,Manchester United,3-0,3,0,1,1,3,3,H
1969-08-20,1969,Chelsea,West Ham United,0-0,0,0,1,1,0,0,D
1969-08-20,1969,Derby County,Ipswich Town,3-1,3,1,1,1,4,2,H
1969-08-20,1969,Manchester City,Liverpool,0-2,0,2,1,1,2,-2,A
1969-08-20,1969,Sheffield Wednesday,Newcastle United,1-0,1,0,1,1,1,1,H
1969-08-20,1969,Southampton,Wolverhampton Wanderers,2-3,2,3,1,1,5,-1,A
1969-08-20,1969,Stoke City,Nottingham Forest,1-1,1,1,1,1,2,0,D
1969-08-20,1969,Sunderland,Crystal Palace,0-0,0,0,1,1,0,0,D
1969-08-20,1969,West Bromwich Albion,Coventry City,0-1,0,1,1,1,1,-1,A
1969-08-23,1969,Arsenal,Nottingham Forest,2-1,2,1,1,1,3,1,H
1969-08-23,1969,Crystal Palace,Tottenham Hotspur,0-2,0,2,1,1,2,-2,A
1969-08-23,1969,Derby County,Stoke City,0-0,0,0,1,1,0,0,D
1969-08-23,1969,Ipswich Town,Coventry City,0-1,0,1,1,1,1,-1,A
1969-08-23,1969,Leeds United,Newcastle United,1-1,1,1,1,1,2,0,D
1969-08-23,1969,Liverpool,Burnley,3-3,3,3,1,1,6,0,D
1969-08-23,1969,Manchester City,Everton,1-1,1,1,1,1,2,0,D
1969-08-23,1969,Southampton,Chelsea,2-2,2,2,1,1,4,0,D
1969-08-23,1969,Sunderland,Sheffield Wednesday,1-2,1,2,1,1,3,-1,A
1969-08-23,1969,West Ham United,West Bromwich Albion,1-3,1,3,1,1,4,-2,A
1969-08-23,1969,Wolverhampton Wanderers,Manchester United,0-0,0,0,1,1,0,0,D
1969-08-25,1969,West Ham United,Arsenal,1-1,1,1,1,1,2,0,D
1969-08-26,1969,Burnley,Leeds United,1-1,1,1,1,1,2,0,D
1969-08-26,1969,Everton,Sheffield Wednesday,2-1,2,1,1,1,3,1,H
1969-08-26,1969,Nottingham Forest,West Bromwich Albion,1-0,1,0,1,1,1,1,H
1969-08-27,1969,Crystal Palace,Liverpool,1-3,1,3,1,1,4,-2,A
1969-08-27,1969,Manchester United,Newcastle United,0-0,0,0,1,1,0,0,D
1969-08-27,1969,Southampton,Ipswich Town,4-2,4,2,1,1,6,2,H
1969-08-27,1969,Stoke City,Coventry City,2-0,2,0,1,1,2,2,H
1969-08-27,1969,Sunderland,Manchester City,0-4,0,4,1,1,4,-4,A
1969-08-27,1969,Tottenham Hotspur,Chelsea,1-1,1,1,1,1,2,0,D
1969-08-27,1969,Wolverhampton Wanderers,Derby County,1-1,1,1,1,1,2,0,D
1969-08-30,1969,Burnley,Manchester City,1-1,1,1,1,1,2,0,D
1969-08-30,1969,Chelsea,Crystal Palace,1-1,1,1,1,1,2,0,D
1969-08-30,1969,Coventry City,Wolverhampton Wanderers,1-0,1,0,1,1,1,1,H
1969-08-30,1969,Everton,Leeds United,3-2,3,2,1,1,5,1,H
1969-08-30,1969,Manchester United,Sunderland,3-1,3,1,1,1,4,2,H
1969-08-30,1969,Newcastle United,Arsenal,3-1,3,1,1,1,4,2,H
1969-08-30,1969,Nottingham Forest,West Ham United,1-0,1,0,1,1,1,1,H
1969-08-30,1969,Sheffield Wednesday,Liverpool,1-1,1,1,1,1,2,0,D
1969-08-30,1969,Stoke City,Southampton,2-1,2,1,1,1,3,1,H
1969-08-30,1969,Tottenham Hotspur,Ipswich Town,3-2,3,2,1,1,5,1,H
1969-08-30,1969,West Bromwich Albion,Derby County,0-2,0,2,1,1,2,-2,A
1969-09-06,1969,Arsenal,Sheffield Wednesday,0-0,0,0,1,1,0,0,D
1969-09-06,1969,Crystal Palace,Stoke City,3-1,3,1,1,1,4,2,H
1969-09-06,1969,Derby County,Everton,2-1,2,1,1,1,3,1,H
1969-09-06,1969,Ipswich Town,Newcastle United,2-0,2,0,1,1,2,2,H
1969-09-06,1969,Leeds United,Manchester United,2-2,2,2,1,1,4,0,D
1969-09-06,1969,Liverpool,Coventry City,2-1,2,1,1,1,3,1,H
1969-09-06,1969,Manchester City,Chelsea,0-0,0,0,1,1,0,0,D
1969-09-06,1969,Southampton,Burnley,1-1,1,1,1,1,2,0,D
1969-09-06,1969,Sunderland,West Bromwich Albion,2-2,2,2,1,1,4,0,D
1969-09-06,1969,West Ham United,Tottenham Hotspur,0-1,0,1,1,1,1,-1,A
1969-09-06,1969,Wolverhampton Wanderers,Nottingham Forest,3-3,3,3,1,1,6,0,D
1969-09-09,1969,Liverpool,Sunderland,2-0,2,0,1,1,2,2,H
1969-09-10,1969,Derby County,Southampton,3-0,3,0,1,1,3,3,H
1969-09-13,1969,Burnley,Arsenal,0-1,0,1,1,1,1,-1,A
1969-09-13,1969,Chelsea,Wolverhampton Wanderers,2-2,2,2,1,1,4,0,D
1969-09-13,1969,Coventry City,Crystal Palace,2-2,2,2,1,1,4,0,D
1969-09-13,1969,Everton,West Ham United,2-0,2,0,1,1,2,2,H
1969-09-13,1969,Manchester United,Liverpool,1-0,1,0,1,1,1,1,H
1969-09-13,1969,Newcastle United,Derby County,0-1,0,1,1,1,1,-1,A
1969-09-13,1969,Nottingham Forest,Southampton,2-1,2,1,1,1,3,1,H
1969-09-13,1969,Sheffield Wednesday,Leeds United,1-2,1,2,1,1,3,-1,A
1969-09-13,1969,Stoke City,Sunderland,4-2,4,2,1,1,6,2,H
1969-09-13,1969,Tottenham Hotspur,Manchester City,0-3,0,3,1,1,3,-3,A
1969-09-13,1969,West Bromwich Albion,Ipswich Town,2-2,2,2,1,1,4,0,D
1969-09-16,1969,Arsenal,Tottenham Hotspur,2-3,2,3,1,1,5,-1,A
1969-09-16,1969,Coventry City,Nottingham Forest,3-2,3,2,1,1,5,1,H
1969-09-16,1969,Ipswich Town,Wolverhampton Wanderers,1-1,1,1,1,1,2,0,D
1969-09-17,1969,Chelsea,Burnley,2-0,2,0,1,1,2,2,H
1969-09-17,1969,Newcastle United,Everton,1-2,1,2,1,1,3,-1,A
1969-09-17,1969,Sheffield Wednesday,Manchester United,1-3,1,3,1,1,4,-2,A
1969-09-17,1969,West Bromwich Albion,Stoke City,1-3,1,3,1,1,4,-2,A
1969-09-20,1969,Arsenal,Manchester United,2-2,2,2,1,1,4,0,D
1969-09-20,1969,Crystal Palace,West Bromwich Albion,1-3,1,3,1,1,4,-2,A
1969-09-20,1969,Derby County,Tottenham Hotspur,5-0,5,0,1,1,5,5,H
1969-09-20,1969,Ipswich Town,Everton,0-3,0,3,1,1,3,-3,A
1969-09-20,1969,Leeds United,Chelsea,2-0,2,0,1,1,2,2,H
1969-09-20,1969,Liverpool,Stoke City,3-1,3,1,1,1,4,2,H
1969-09-20,1969,Manchester City,Coventry City,3-1,3,1,1,1,4,2,H
1969-09-20,1969,Southampton,Newcastle United,1-1,1,1,1,1,2,0,D
1969-09-20,1969,Sunderland,Nottingham Forest,2-1,2,1,1,1,3,1,H
1969-09-20,1969,West Ham United,Sheffield Wednesday,3-0,3,0,1,1,3,3,H
1969-09-20,1969,Wolverhampton Wanderers,Burnley,1-1,1,1,1,1,2,0,D
1969-09-27,1969,Burnley,Ipswich Town,0-1,0,1,1,1,1,-1,A
1969-09-27,1969,Chelsea,Arsenal,3-0,3,0,1,1,3,3,H
1969-09-27,1969,Coventry City,Leeds United,1-2,1,2,1,1,3,-1,A
1969-09-27,1969,Everton,Southampton,4-2,4,2,1,1,6,2,H
1969-09-27,1969,Manchester United,West Ham United,5-2,5,2,1,1,7,3,H
1969-09-27,1969,Newcastle United,Wolverhampton Wanderers,1-1,1,1,1,1,2,0,D
1969-09-27,1969,Nottingham Forest,Crystal Palace,0-0,0,0,1,1,0,0,D
1969-09-27,1969,Sheffield Wednesday,Derby County,1-0,1,0,1,1,1,1,H
1969-09-27,1969,Stoke City,Manchester City,2-0,2,0,1,1,2,2,H
1969-09-27,1969,Tottenham Hotspur,Sunderland,0-1,0,1,1,1,1,-1,A
1969-09-27,1969,West Bromwich Albion,Liverpool,2-2,2,2,1,1,4,0,D
1969-10-04,1969,Arsenal,Coventry City,0-1,0,1,1,1,1,-1,A
1969-10-04,1969,Crystal Palace,Newcastle United,0-3,0,3,1,1,3,-3,A
1969-10-04,1969,Derby County,Manchester United,2-0,2,0,1,1,2,2,H
1969-10-04,1969,Ipswich Town,Sheffield Wednesday,1-0,1,0,1,1,1,1,H
1969-10-04,1969,Leeds United,Stoke City,2-1,2,1,1,1,3,1,H
1969-10-04,1969,Liverpool,Nottingham Forest,1-1,1,1,1,1,2,0,D
1969-10-04,1969,Manchester City,West Bromwich Albion,2-1,2,1,1,1,3,1,H
1969-10-04,1969,Southampton,Tottenham Hotspur,2-2,2,2,1,1,4,0,D
1969-10-04,1969,Sunderland,Chelsea,0-0,0,0,1,1,0,0,D
1969-10-04,1969,West Ham United,Burnley,3-1,3,1,1,1,4,2,H
1969-10-04,1969,Wolverhampton Wanderers,Everton,2-3,2,3,1,1,5,-1,A
1969-10-06,1969,West Ham United,Stoke City,3-3,3,3,1,1,6,0,D
1969-10-07,1969,Arsenal,West Bromwich Albion,1-1,1,1,1,1,2,0,D
1969-10-07,1969,Liverpool,Tottenham Hotspur,0-0,0,0,1,1,0,0,D
1969-10-08,1969,Crystal Palace,Everton,0-0,0,0,1,1,0,0,D
1969-10-08,1969,Derby County,Coventry City,1-3,1,3,1,1,4,-2,A
1969-10-08,1969,Manchester City,Newcastle United,2-1,2,1,1,1,3,1,H
1969-10-08,1969,Southampton,Manchester United,0-3,0,3,1,1,3,-3,A
1969-10-08,1969,Sunderland,Burnley,0-1,0,1,1,1,1,-1,A
1969-10-08,1969,Wolverhampton Wanderers,Sheffield Wednesday,2-2,2,2,1,1,4,0,D
1969-10-11,1969,Burnley,Crystal Palace,4-2,4,2,1,1,6,2,H
1969-10-11,1969,Chelsea,Derby County,2-2,2,2,1,1,4,0,D
1969-10-11,1969,Coventry City,West Ham United,2-2,2,2,1,1,4,0,D
1969-10-11,1969,Everton,Sunderland,3-1,3,1,1,1,4,2,H
1969-10-11,1969,Manchester United,Ipswich Town,2-1,2,1,1,1,3,1,H
1969-10-11,1969,Newcastle United,Liverpool,1-0,1,0,1,1,1,1,H
1969-10-11,1969,Nottingham Forest,Manchester City,2-2,2,2,1,1,4,0,D
1969-10-11,1969,Sheffield Wednesday,Southampton,1-1,1,1,1,1,2,0,D
1969-10-11,1969,Stoke City,Arsenal,0-0,0,0,1,1,0,0,D
1969-10-11,1969,Tottenham Hotspur,Wolverhampton Wanderers,0-1,0,1,1,1,1,-1,A
1969-10-11,1969,West Bromwich Albion,Leeds United,1-1,1,1,1,1,2,0,D
1969-10-18,1969,Burnley,Sheffield Wednesday,4-2,4,2,1,1,6,2,H
1969-10-18,1969,Chelsea,West Bromwich Albion,2-0,2,0,1,1,2,2,H
1969-10-18,1969,Crystal Palace,Leeds United,1-1,1,1,1,1,2,0,D
1969-10-18,1969,Derby County,Manchester City,0-1,0,1,1,1,1,-1,A
1969-10-18,1969,Everton,Stoke City,6-2,6,2,1,1,8,4,H
1969-10-18,1969,Ipswich Town,Liverpool,2-2,2,2,1,1,4,0,D
1969-10-18,1969,Manchester United,Nottingham Forest,1-1,1,1,1,1,2,0,D
1969-10-18,1969,Southampton,Coventry City,0-0,0,0,1,1,0,0,D
1969-10-18,1969,Sunderland,Arsenal,1-1,1,1,1,1,2,0,D
1969-10-18,1969,Tottenham Hotspur,Newcastle United,2-1,2,1,1,1,3,1,H
1969-10-18,1969,Wolverhampton Wanderers,West Ham United,1-0,1,0,1,1,1,1,H
1969-10-25,1969,Arsenal,Ipswich Town,0-0,0,0,1,1,0,0,D
1969-10-25,1969,Coventry City,Everton,0-1,0,1,1,1,1,-1,A
1969-10-25,1969,Leeds United,Derby County,2-0,2,0,1,1,2,2,H
1969-10-25,1969,Liverpool,Southampton,4-1,4,1,1,1,5,3,H
1969-10-25,1969,Manchester City,Wolverhampton Wanderers,1-0,1,0,1,1,1,1,H
1969-10-25,1969,Newcastle United,Chelsea,0-1,0,1,1,1,1,-1,A
1969-10-25,1969,Nottingham Forest,Burnley,1-1,1,1,1,1,2,0,D
1969-10-25,1969,Sheffield Wednesday,Crystal Palace,0-0,0,0,1,1,0,0,D
1969-10-25,1969,Stoke City,Tottenham Hotspur,1-1,1,1,1,1,2,0,D
1969-10-25,1969,West Bromwich Albion,Manchester United,2-1,2,1,1,1,3,1,H
1969-10-25,1969,West Ham United,Sunderland,1-1,1,1,1,1,2,0,D
1969-10-29,1969,Leeds United,Nottingham Forest,6-1,6,1,1,1,7,5,H
1969-11-01,1969,Burnley,Newcastle United,0-1,0,1,1,1,1,-1,A
1969-11-01,1969,Chelsea,Coventry City,1-0,1,0,1,1,1,1,H
1969-11-01,1969,Crystal Palace,Arsenal,1-5,1,5,1,1,6,-4,A
1969-11-01,1969,Derby County,Liverpool,4-0,4,0,1,1,4,4,H
1969-11-01,1969,Everton,Nottingham Forest,1-0,1,0,1,1,1,1,H
1969-11-01,1969,Ipswich Town,Manchester City,1-1,1,1,1,1,2,0,D
1969-11-01,1969,Manchester United,Stoke City,1-1,1,1,1,1,2,0,D
1969-11-01,1969,Southampton,West Ham United,1-1,1,1,1,1,2,0,D
1969-11-01,1969,Sunderland,Leeds United,0-0,0,0,1,1,0,0,D
1969-11-01,1969,Tottenham Hotspur,Sheffield Wednesday,1-0,1,0,1,1,1,1,H
1969-11-01,1969,Wolverhampton Wanderers,West Bromwich Albion,1-0,1,0,1,1,1,1,H
1969-11-08,1969,Arsenal,Derby County,4-0,4,0,1,1,4,4,H
1969-11-08,1969,Coventry City,Manchester United,1-2,1,2,1,1,3,-1,A
1969-11-08,1969,Leeds United,Ipswich Town,4-0,4,0,1,1,4,4,H
1969-11-08,1969,Liverpool,Wolverhampton Wanderers,0-0,0,0,1,1,0,0,D
1969-11-08,1969,Manchester City,Southampton,1-0,1,0,1,1,1,1,H
1969-11-08,1969,Newcastle United,Sunderland,3-0,3,0,1,1,3,3,H
1969-11-08,1969,Nottingham Forest,Tottenham Hotspur,2-2,2,2,1,1,4,0,D
1969-11-08,1969,Sheffield Wednesday,Chelsea,1-3,1,3,1,1,4,-2,A
1969-11-08,1969,Stoke City,Burnley,2-1,2,1,1,1,3,1,H
1969-11-08,1969,West Bromwich Albion,Everton,2-0,2,0,1,1,2,2,H
1969-11-08,1969,West Ham United,Crystal Palace,2-1,2,1,1,1,3,1,H
1969-11-15,1969,Burnley,Coventry City,0-0,0,0,1,1,0,0,D
1969-11-15,1969,Chelsea,Everton,1-1,1,1,1,1,2,0,D
1969-11-15,1969,Derby County,Sunderland,3-0,3,0,1,1,3,3,H
1969-11-15,1969,Ipswich Town,Crystal Palace,2-0,2,0,1,1,2,2,H
1969-11-15,1969,Liverpool,West Ham United,2-0,2,0,1,1,2,2,H
1969-11-15,1969,Manchester City,Manchester United,4-0,4,0,1,1,4,4,H
1969-11-15,1969,Newcastle United,Nottingham Forest,3-1,3,1,1,1,4,2,H
1969-11-15,1969,Sheffield Wednesday,Stoke City,0-2,0,2,1,1,2,-2,A
1969-11-15,1969,Southampton,Leeds United,1-1,1,1,1,1,2,0,D
1969-11-15,1969,Tottenham Hotspur,West Bromwich Albion,2-0,2,0,1,1,2,2,H
1969-11-15,1969,Wolverhampton Wanderers,Arsenal,2-0,2,0,1,1,2,2,H
1969-11-18,1969,Ipswich Town,Chelsea,1-4,1,4,1,1,5,-3,A
1969-11-19,1969,Leeds United,Sunderland,2-0,2,0,1,1,2,2,H
1969-11-22,1969,Arsenal,Manchester City,1-1,1,1,1,1,2,0,D
1969-11-22,1969,Coventry City,Newcastle United,1-0,1,0,1,1,1,1,H
1969-11-22,1969,Crystal Palace,Wolverhampton Wanderers,2-1,2,1,1,1,3,1,H
1969-11-22,1969,Everton,Burnley,2-1,2,1,1,1,3,1,H
1969-11-22,1969,Leeds United,Liverpool,1-1,1,1,1,1,2,0,D
1969-11-22,1969,Manchester United,Tottenham Hotspur,3-1,3,1,1,1,4,2,H
1969-11-22,1969,Nottingham Forest,Chelsea,1-1,1,1,1,1,2,0,D
1969-11-22,1969,Stoke City,Ipswich Town,3-3,3,3,1,1,6,0,D
1969-11-22,1969,Sunderland,Southampton,2-2,2,2,1,1,4,0,D
1969-11-22,1969,West Bromwich Albion,Sheffield Wednesday,3-0,3,0,1,1,3,3,H
1969-11-22,1969,West Ham United,Derby County,3-0,3,0,1,1,3,3,H
1969-11-29,1969,Burnley,Manchester United,1-1,1,1,1,1,2,0,D
1969-11-29,1969,Derby County,Nottingham Forest,0-2,0,2,1,1,2,-2,A
1969-11-29,1969,Ipswich Town,West Ham United,1-0,1,0,1,1,1,1,H
1969-11-29,1969,Liverpool,Arsenal,0-1,0,1,1,1,1,-1,A
1969-11-29,1969,Manchester City,Leeds United,1-2,1,2,1,1,3,-1,A
1969-11-29,1969,Southampton,Crystal Palace,1-1,1,1,1,1,2,0,D
1969-11-29,1969,Wolverhampton Wanderers,Sunderland,1-0,1,0,1,1,1,1,H
1969-12-06,1969,Arsenal,Southampton,2-2,2,2,1,1,4,0,D
1969-12-06,1969,Coventry City,Tottenham Hotspur,3-2,3,2,1,1,5,1,H
1969-12-06,1969,Crystal Palace,Derby County,0-1,0,1,1,1,1,-1,A
1969-12-06,1969,Everton,Liverpool,0-3,0,3,1,1,3,-3,A
1969-12-06,1969,Leeds United,Wolverhampton Wanderers,3-1,3,1,1,1,4,2,H
1969-12-06,1969,Manchester United,Chelsea,0-2,0,2,1,1,2,-2,A
1969-12-06,1969,Nottingham Forest,Sheffield Wednesday,2-1,2,1,1,1,3,1,H
1969-12-06,1969,Stoke City,Newcastle United,0-1,0,1,1,1,1,-1,A
1969-12-06,1969,Sunderland,Ipswich Town,2-1,2,1,1,1,3,1,H
1969-12-06,1969,West Bromwich Albion,Burnley,0-1,0,1,1,1,1,-1,A
1969-12-06,1969,West Ham United,Manchester City,0-4,0,4,1,1,4,-4,A
1969-12-13,1969,Arsenal,Burnley,3-2,3,2,1,1,5,1,H
1969-12-13,1969,Crystal Palace,Coventry City,0-3,0,3,1,1,3,-3,A
1969-12-13,1969,Derby County,Newcastle United,2-0,2,0,1,1,2,2,H
1969-12-13,1969,Ipswich Town,West Bromwich Albion,0-1,0,1,1,1,1,-1,A
1969-12-13,1969,Leeds United,Sheffield Wednesday,2-0,2,0,1,1,2,2,H
1969-12-13,1969,Liverpool,Manchester United,1-4,1,4,1,1,5,-3,A
1969-12-13,1969,Manchester City,Tottenham Hotspur,1-1,1,1,1,1,2,0,D
1969-12-13,1969,Southampton,Nottingham Forest,1-2,1,2,1,1,3,-1,A
1969-12-13,1969,Sunderland,Stoke City,0-3,0,3,1,1,3,-3,A
1969-12-13,1969,West Ham United,Everton,0-1,0,1,1,1,1,-1,A
1969-12-13,1969,Wolverhampton Wanderers,Chelsea,3-0,3,0,1,1,3,3,H
1969-12-17,1969,Leeds United,West Ham United,4-1,4,1,1,1,5,3,H
1969-12-20,1969,Chelsea,Manchester City,3-1,3,1,1,1,4,2,H
1969-12-20,1969,Everton,Derby County,1-0,1,0,1,1,1,1,H
1969-12-20,1969,Newcastle United,Ipswich Town,4-0,4,0,1,1,4,4,H
1969-12-20,1969,Nottingham Forest,Wolverhampton Wanderers,4-2,4,2,1,1,6,2,H
1969-12-20,1969,Sheffield Wednesday,Arsenal,1-1,1,1,1,1,2,0,D
1969-12-20,1969,Stoke City,Crystal Palace,1-0,1,0,1,1,1,1,H
1969-12-20,1969,Tottenham Hotspur,West Ham United,0-2,0,2,1,1,2,-2,A
1969-12-23,1969,Everton,Manchester City,1-0,1,0,1,1,1,1,H
1969-12-26,1969,Burnley,Liverpool,1-5,1,5,1,1,6,-4,A
1969-12-26,1969,Chelsea,Southampton,3-1,3,1,1,1,4,2,H
1969-12-26,1969,Coventry City,Ipswich Town,3-1,3,1,1,1,4,2,H
1969-12-26,1969,Manchester United,Wolverhampton Wanderers,0-0,0,0,1,1,0,0,D
1969-12-26,1969,Newcastle United,Leeds United,2-1,2,1,1,1,3,1,H
1969-12-26,1969,Nottingham Forest,Arsenal,1-1,1,1,1,1,2,0,D
1969-12-26,1969,Sheffield Wednesday,Sunderland,2-0,2,0,1,1,2,2,H
1969-12-26,1969,Stoke City,Derby County,1-0,1,0,1,1,1,1,H
1969-12-26,1969,Tottenham Hotspur,Crystal Palace,2-0,2,0,1,1,2,2,H
1969-12-26,1969,West Bromwich Albion,West Ham United,3-1,3,1,1,1,4,2,H
1969-12-27,1969,Arsenal,Newcastle United,0-0,0,0,1,1,0,0,D
1969-12-27,1969,Crystal Palace,Chelsea,1-5,1,5,1,1,6,-4,A
1969-12-27,1969,Derby County,West Bromwich Albion,2-0,2,0,1,1,2,2,H
1969-12-27,1969,Ipswich Town,Tottenham Hotspur,2-0,2,0,1,1,2,2,H
1969-12-27,1969,Leeds United,Everton,2-1,2,1,1,1,3,1,H
1969-12-27,1969,Southampton,Stoke City,0-0,0,0,1,1,0,0,D
1969-12-27,1969,Sunderland,Manchester United,1-1,1,1,1,1,2,0,D
1969-12-27,1969,West Ham United,Nottingham Forest,1-1,1,1,1,1,2,0,D
1970-01-06,1969,Manchester City,Burnley,1-1,1,1,1,1,2,0,D
1970-01-10,1969,Burnley,Wolverhampton Wanderers,1-3,1,3,1,1,4,-2,A
1970-01-10,1969,Chelsea,Leeds United,2-5,2,5,1,1,7,-3,A
1970-01-10,1969,Coventry City,Manchester City,3-0,3,0,1,1,3,3,H
1970-01-10,1969,Everton,Ipswich Town,3-0,3,0,1,1,3,3,H
1970-01-10,1969,Manchester United,Arsenal,2-1,2,1,1,1,3,1,H
1970-01-10,1969,Sheffield Wednesday,West Ham United,2-3,2,3,1,1,5,-1,A
1970-01-10,1969,Stoke City,Liverpool,0-2,0,2,1,1,2,-2,A
1970-01-10,1969,Tottenham Hotspur,Derby County,2-1,2,1,1,1,3,1,H
1970-01-10,1969,West Bromwich Albion,Crystal Palace,3-2,3,2,1,1,5,1,H
1970-01-17,1969,Arsenal,Chelsea,0-3,0,3,1,1,3,-3,A
1970-01-17,1969,Crystal Palace,Nottingham Forest,1-1,1,1,1,1,2,0,D
1970-01-17,1969,Derby County,Sheffield Wednesday,1-0,1,0,1,1,1,1,H
1970-01-17,1969,Ipswich Town,Burnley,0-1,0,1,1,1,1,-1,A
1970-01-17,1969,Leeds United,Coventry City,3-1,3,1,1,1,4,2,H
1970-01-17,1969,Liverpool,West Bromwich Albion,1-1,1,1,1,1,2,0,D
1970-01-17,1969,Manchester City,Stoke City,0-1,0,1,1,1,1,-1,A
1970-01-17,1969,Southampton,Everton,2-1,2,1,1,1,3,1,H
1970-01-17,1969,Sunderland,Tottenham Hotspur,2-1,2,1,1,1,3,1,H
1970-01-17,1969,West Ham United,Manchester United,0-0,0,0,1,1,0,0,D
1970-01-17,1969,Wolverhampton Wanderers,Newcastle United,1-1,1,1,1,1,2,0,D
1970-01-24,1969,Everton,Newcastle United,0-0,0,0,1,1,0,0,D
1970-01-24,1969,Nottingham Forest,Sunderland,2-1,2,1,1,1,3,1,H
1970-01-24,1969,Wolverhampton Wanderers,Ipswich Town,2-0,2,0,1,1,2,2,H
1970-01-26,1969,Manchester United,Leeds United,2-2,2,2,1,1,4,0,D
1970-01-27,1969,West Bromwich Albion,Sunderland,3-1,3,1,1,1,4,2,H
1970-01-28,1969,Sheffield Wednesday,Coventry City,0-1,0,1,1,1,1,-1,A
1970-01-31,1969,Burnley,West Ham United,3-2,3,2,1,1,5,1,H
1970-01-31,1969,Chelsea,Sunderland,3-1,3,1,1,1,4,2,H
1970-01-31,1969,Coventry City,Arsenal,2-0,2,0,1,1,2,2,H
1970-01-31,1969,Everton,Wolverhampton Wanderers,1-0,1,0,1,1,1,1,H
1970-01-31,1969,Manchester United,Derby County,1-0,1,0,1,1,1,1,H
1970-01-31,1969,Newcastle United,Crystal Palace,0-0,0,0,1,1,0,0,D
1970-01-31,1969,Nottingham Forest,Liverpool,1-0,1,0,1,1,1,1,H
1970-01-31,1969,Sheffield Wednesday,Ipswich Town,2-2,2,2,1,1,4,0,D
1970-01-31,1969,Stoke City,Leeds United,1-1,1,1,1,1,2,0,D
1970-01-31,1969,Tottenham Hotspur,Southampton,0-1,0,1,1,1,1,-1,A
1970-01-31,1969,West Bromwich Albion,Manchester City,3-0,3,0,1,1,3,3,H
1970-02-06,1969,Newcastle United,West Bromwich Albion,1-0,1,0,1,1,1,1,H
1970-02-07,1969,Arsenal,Stoke City,0-0,0,0,1,1,0,0,D
1970-02-07,1969,Manchester City,Nottingham Forest,1-1,1,1,1,1,2,0,D
1970-02-07,1969,Southampton,Sheffield Wednesday,4-0,4,0,1,1,4,4,H
1970-02-07,1969,Wolverhampton Wanderers,Tottenham Hotspur,2-2,2,2,1,1,4,0,D
1970-02-10,1969,Ipswich Town,Manchester United,0-1,0,1,1,1,1,-1,A
1970-02-10,1969,Leeds United,West Bromwich Albion,5-1,5,1,1,1,6,4,H
1970-02-11,1969,Crystal Palace,Burnley,1-2,1,2,1,1,3,-1,A
1970-02-11,1969,Derby County,Chelsea,2-2,2,2,1,1,4,0,D
1970-02-11,1969,Newcastle United,Southampton,2-1,2,1,1,1,3,1,H
1970-02-11,1969,West Ham United,Coventry City,1-2,1,2,1,1,3,-1,A
1970-02-14,1969,Burnley,Derby County,1-1,1,1,1,1,2,0,D
1970-02-14,1969,Everton,Arsenal,2-2,2,2,1,1,4,0,D
1970-02-14,1969,Manchester United,Crystal Palace,1-1,1,1,1,1,2,0,D
1970-02-14,1969,Stoke City,Wolverhampton Wanderers,1-1,1,1,1,1,2,0,D
1970-02-14,1969,Tottenham Hotspur,Leeds United,1-1,1,1,1,1,2,0,D
1970-02-16,1969,Liverpool,Newcastle United,0-0,0,0,1,1,0,0,D
1970-02-18,1969,Manchester City,Arsenal,1-1,1,1,1,1,2,0,D
1970-02-20,1969,West Bromwich Albion,Southampton,1-0,1,0,1,1,1,1,H
1970-02-21,1969,Burnley,Nottingham Forest,5-0,5,0,1,1,5,5,H
1970-02-21,1969,Crystal Palace,Sheffield Wednesday,0-2,0,2,1,1,2,-2,A
1970-02-21,1969,Derby County,Arsenal,3-2,3,2,1,1,5,1,H
1970-02-21,1969,Everton,Coventry City,0-0,0,0,1,1,0,0,D
1970-02-21,1969,Sunderland,West Ham United,0-1,0,1,1,1,1,-1,A
1970-02-21,1969,Tottenham Hotspur,Stoke City,1-0,1,0,1,1,1,1,H
1970-02-21,1969,Wolverhampton Wanderers,Manchester City,1-3,1,3,1,1,4,-2,A
1970-02-25,1969,Chelsea,Newcastle United,0-0,0,0,1,1,0,0,D
1970-02-28,1969,Arsenal,Sunderland,3-1,3,1,1,1,4,2,H
1970-02-28,1969,Coventry City,Chelsea,0-3,0,3,1,1,3,-3,A
1970-02-28,1969,Leeds United,Crystal Palace,2-0,2,0,1,1,2,2,H
1970-02-28,1969,Liverpool,Derby County,0-2,0,2,1,1,2,-2,A
1970-02-28,1969,Manchester City,Ipswich Town,1-0,1,0,1,1,1,1,H
1970-02-28,1969,Newcastle United,Tottenham Hotspur,1-2,1,2,1,1,3,-1,A
1970-02-28,1969,Nottingham Forest,Everton,1-1,1,1,1,1,2,0,D
1970-02-28,1969,Sheffield Wednesday,Burnley,2-0,2,0,1,1,2,2,H
1970-02-28,1969,Stoke City,Manchester United,2-2,2,2,1,1,4,0,D
1970-02-28,1969,West Bromwich Albion,Wolverhampton Wanderers,3-3,3,3,1,1,6,0,D
1970-02-28,1969,West Ham United,Southampton,0-0,0,0,1,1,0,0,D
1970-03-02,1969,Newcastle United,West Ham United,4-1,4,1,1,1,5,3,H
1970-03-03,1969,Coventry City,Liverpool,2-3,2,3,1,1,5,-1,A
1970-03-07,1969,Burnley,Everton,1-2,1,2,1,1,3,-1,A
1970-03-07,1969,Chelsea,Nottingham Forest,1-1,1,1,1,1,2,0,D
1970-03-07,1969,Derby County,West Ham United,3-0,3,0,1,1,3,3,H
1970-03-07,1969,Ipswich Town,Stoke City,1-1,1,1,1,1,2,0,D
1970-03-07,1969,Liverpool,Leeds United,0-0,0,0,1,1,0,0,D
1970-03-07,1969,Southampton,Sunderland,1-1,1,1,1,1,2,0,D
1970-03-10,1969,Sheffield Wednesday,West Bromwich Albion,2-0,2,0,1,1,2,2,H
1970-03-11,1969,Manchester City,Crystal Palace,0-1,0,1,1,1,1,-1,A
1970-03-11,1969,Southampton,Liverpool,0-1,0,1,1,1,1,-1,A
1970-03-11,1969,Tottenham Hotspur,Everton,0-1,0,1,1,1,1,-1,A
1970-03-14,1969,Arsenal,Liverpool,2-1,2,1,1,1,3,1,H
1970-03-14,1969,Coventry City,Sheffield Wednesday,1-1,1,1,1,1,2,0,D
1970-03-14,1969,Crystal Palace,Southampton,2-0,2,0,1,1,2,2,H
1970-03-14,1969,Everton,Tottenham Hotspur,3-2,3,2,1,1,5,1,H
1970-03-14,1969,Nottingham Forest,Derby County,1-3,1,3,1,1,4,-2,A
1970-03-14,1969,Sunderland,Wolverhampton Wanderers,2-1,2,1,1,1,3,1,H
1970-03-14,1969,West Bromwich Albion,Newcastle United,2-2,2,2,1,1,4,0,D
1970-03-14,1969,West Ham United,Ipswich Town,0-0,0,0,1,1,0,0,D
1970-03-16,1969,Liverpool,Sheffield Wednesday,3-0,3,0,1,1,3,3,H
1970-03-17,1969,Chelsea,Stoke City,1-0,1,0,1,1,1,1,H
1970-03-17,1969,Manchester United,Burnley,3-3,3,3,1,1,6,0,D
1970-03-18,1969,Wolverhampton Wanderers,Crystal Palace,1-1,1,1,1,1,2,0,D
1970-03-21,1969,Burnley,West Bromwich Albion,2-1,2,1,1,1,3,1,H
1970-03-21,1969,Chelsea,Manchester United,2-1,2,1,1,1,3,1,H
1970-03-21,1969,Derby County,Crystal Palace,3-1,3,1,1,1,4,2,H
1970-03-21,1969,Ipswich Town,Sunderland,2-0,2,0,1,1,2,2,H
1970-03-21,1969,Liverpool,Everton,0-2,0,2,1,1,2,-2,A
1970-03-21,1969,Manchester City,West Ham United,1-5,1,5,1,1,6,-4,A
1970-03-21,1969,Newcastle United,Stoke City,3-1,3,1,1,1,4,2,H
1970-03-21,1969,Sheffield Wednesday,Nottingham Forest,2-1,2,1,1,1,3,1,H
1970-03-21,1969,Southampton,Arsenal,0-2,0,2,1,1,2,-2,A
1970-03-21,1969,Tottenham Hotspur,Coventry City,1-2,1,2,1,1,3,-1,A
1970-03-21,1969,Wolverhampton Wanderers,Leeds United,1-2,1,2,1,1,3,-1,A
1970-03-24,1969,Burnley,Southampton,1-1,1,1,1,1,2,0,D
1970-03-24,1969,Coventry City,Sunderland,1-1,1,1,1,1,2,0,D
1970-03-24,1969,Crystal Palace,West Ham United,0-0,0,0,1,1,0,0,D
1970-03-24,1969,Liverpool,Ipswich Town,2-0,2,0,1,1,2,2,H
1970-03-25,1969,Chelsea,Sheffield Wednesday,3-1,3,1,1,1,4,2,H
1970-03-27,1969,Burnley,Stoke City,1-1,1,1,1,1,2,0,D
1970-03-27,1969,Manchester City,Derby County,0-1,0,1,1,1,1,-1,A
1970-03-27,1969,Sunderland,Newcastle United,1-1,1,1,1,1,2,0,D
1970-03-27,1969,Tottenham Hotspur,Nottingham Forest,4-1,4,1,1,1,5,3,H
1970-03-28,1969,Arsenal,Wolverhampton Wanderers,2-2,2,2,1,1,4,0,D
1970-03-28,1969,Coventry City,Burnley,1-1,1,1,1,1,2,0,D
1970-03-28,1969,Crystal Palace,Ipswich Town,1-1,1,1,1,1,2,0,D
1970-03-28,1969,Everton,Chelsea,5-2,5,2,1,1,7,3,H
1970-03-28,1969,Leeds United,Southampton,1-3,1,3,1,1,4,-2,A
1970-03-28,1969,Manchester United,Manchester City,1-2,1,2,1,1,3,-1,A
1970-03-28,1969,Nottingham Forest,Newcastle United,2-2,2,2,1,1,4,0,D
1970-03-28,1969,Stoke City,Sheffield Wednesday,2-1,2,1,1,1,3,1,H
1970-03-28,1969,Sunderland,Derby County,1-1,1,1,1,1,2,0,D
1970-03-28,1969,West Bromwich Albion,Tottenham Hotspur,1-1,1,1,1,1,2,0,D
1970-03-28,1969,West Ham United,Liverpool,1-0,1,0,1,1,1,1,H
1970-03-30,1969,Arsenal,Crystal Palace,2-0,2,0,1,1,2,2,H
1970-03-30,1969,Derby County,Leeds United,4-1,4,1,1,1,5,3,H
1970-03-30,1969,Manchester United,Coventry City,1-1,1,1,1,1,2,0,D
1970-03-30,1969,Newcastle United,Burnley,0-1,0,1,1,1,1,-1,A
1970-03-30,1969,Sheffield Wednesday,Tottenham Hotspur,0-1,0,1,1,1,1,-1,A
1970-03-30,1969,Stoke City,Everton,0-1,0,1,1,1,1,-1,A
1970-03-30,1969,West Bromwich Albion,Chelsea,3-1,3,1,1,1,4,2,H
1970-03-30,1969,Wolverhampton Wanderers,Liverpool,0-1,0,1,1,1,1,-1,A
1970-03-31,1969,Coventry City,Southampton,4-0,4,0,1,1,4,4,H
1970-03-31,1969,Ipswich Town,Arsenal,2-1,2,1,1,1,3,1,H
1970-03-31,1969,Nottingham Forest,Manchester United,1-2,1,2,1,1,3,-1,A
1970-03-31,1969,West Ham United,Wolverhampton Wanderers,3-0,3,0,1,1,3,3,H
1970-04-01,1969,Everton,West Bromwich Albion,2-0,2,0,1,1,2,2,H
1970-04-02,1969,West Ham United,Leeds United,2-2,2,2,1,1,4,0,D
1970-04-03,1969,Liverpool,Crystal Palace,3-0,3,0,1,1,3,3,H
1970-04-04,1969,Arsenal,West Ham United,2-1,2,1,1,1,3,1,H
1970-04-04,1969,Chelsea,Tottenham Hotspur,1-0,1,0,1,1,1,1,H
1970-04-04,1969,Coventry City,Stoke City,0-3,0,3,1,1,3,-3,A
1970-04-04,1969,Derby County,Wolverhampton Wanderers,2-0,2,0,1,1,2,2,H
1970-04-04,1969,Ipswich Town,Southampton,2-0,2,0,1,1,2,2,H
1970-04-04,1969,Leeds United,Burnley,2-1,2,1,1,1,3,1,H
1970-04-04,1969,Manchester City,Sunderland,0-1,0,1,1,1,1,-1,A
1970-04-04,1969,Newcastle United,Manchester United,5-1,5,1,1,1,6,4,H
1970-04-04,1969,Sheffield Wednesday,Everton,0-1,0,1,1,1,1,-1,A
1970-04-04,1969,West Bromwich Albion,Nottingham Forest,4-0,4,0,1,1,4,4,H
1970-04-06,1969,Crystal Palace,Manchester City,1-0,1,0,1,1,1,1,H
1970-04-07,1969,Nottingham Forest,Coventry City,1-4,1,4,1,1,5,-3,A
1970-04-08,1969,Manchester United,West Bromwich Albion,7-0,7,0,1,1,7,7,H
1970-04-08,1969,Southampton,Manchester City,0-0,0,0,1,1,0,0,D
1970-04-08,1969,Sunderland,Everton,0-0,0,0,1,1,0,0,D
1970-04-10,1969,Nottingham Forest,Ipswich Town,1-0,1,0,1,1,1,1,H
1970-04-10,1969,Wolverhampton Wanderers,Coventry City,0-1,0,1,1,1,1,-1,A
1970-04-13,1969,Stoke City,Chelsea,1-2,1,2,1,1,3,-1,A
1970-04-13,1969,Tottenham Hotspur,Manchester United,2-1,2,1,1,1,3,1,H
1970-04-14,1969,Newcastle United,Coventry City,4-0,4,0,1,1,4,4,H
1970-04-15,1969,Burnley,Chelsea,3-1,3,1,1,1,4,2,H
1970-04-15,1969,Manchester United,Sheffield Wednesday,2-2,2,2,1,1,4,0,D
1970-04-15,1969,Southampton,Derby County,1-1,1,1,1,1,2,0,D
1970-04-15,1969,Stoke City,West Bromwich Albion,3-2,3,2,1,1,5,1,H
1970-04-15,1969,Sunderland,Liverpool,0-1,0,1,1,1,1,-1,A
1970-04-18,1969,Chelsea,Liverpool,2-1,2,1,1,1,3,1,H
1970-04-18,1969,Leeds United,Manchester City,1-3,1,3,1,1,4,-2,A
1970-04-21,1969,Ipswich Town,Leeds United,3-2,3,2,1,1,5,1,H
1970-04-22,1969,Sheffield Wednesday,Manchester City,1-2,1,2,1,1,3,-1,A
1970-05-02,1969,Tottenham Hotspur,Arsenal,1-0,1,0,1,1,1,1,H
1970-08-15,1970,Burnley,Liverpool,1-2,1,2,1,1,3,-1,A
1970-08-15,1970,Chelsea,Derby County,2-1,2,1,1,1,3,1,H
1970-08-15,1970,Everton,Arsenal,2-2,2,2,1,1,4,0,D
1970-08-15,1970,Huddersfield Town,Blackpool,3-0,3,0,1,1,3,3,H
1970-08-15,1970,Manchester United,Leeds United,0-1,0,1,1,1,1,-1,A
1970-08-15,1970,Newcastle United,Wolverhampton Wanderers,3-2,3,2,1,1,5,1,H
1970-08-15,1970,Nottingham Forest,Coventry City,2-0,2,0,1,1,2,2,H
1970-08-15,1970,Southampton,Manchester City,1-1,1,1,1,1,2,0,D
1970-08-15,1970,Stoke City,Ipswich Town,0-0,0,0,1,1,0,0,D
1970-08-15,1970,Tottenham Hotspur,West Ham United,2-2,2,2,1,1,4,0,D
1970-08-15,1970,West Bromwich Albion,Crystal Palace,0-0,0,0,1,1,0,0,D
1970-08-17,1970,Blackpool,Liverpool,0-0,0,0,1,1,0,0,D
1970-08-17,1970,West Ham United,Arsenal,0-0,0,0,1,1,0,0,D
1970-08-18,1970,Everton,Burnley,1-1,1,1,1,1,2,0,D
1970-08-18,1970,Huddersfield Town,Southampton,3-1,3,1,1,1,4,2,H
1970-08-18,1970,Ipswich Town,Coventry City,0-2,0,2,1,1,2,-2,A
1970-08-18,1970,Nottingham Forest,West Bromwich Albion,3-3,3,3,1,1,6,0,D
1970-08-19,1970,Crystal Palace,Manchester City,0-1,0,1,1,1,1,-1,A
1970-08-19,1970,Manchester United,Chelsea,0-0,0,0,1,1,0,0,D
1970-08-19,1970,Stoke City,Newcastle United,3-0,3,0,1,1,3,3,H
1970-08-19,1970,Tottenham Hotspur,Leeds United,0-2,0,2,1,1,2,-2,A
1970-08-19,1970,Wolverhampton Wanderers,Derby County,2-4,2,4,1,1,6,-2,A
1970-08-22,1970,Arsenal,Manchester United,4-0,4,0,1,1,4,4,H
1970-08-22,1970,Blackpool,West Bromwich Albion,3-1,3,1,1,1,4,2,H
1970-08-22,1970,Coventry City,Southampton,1-0,1,0,1,1,1,1,H
1970-08-22,1970,Crystal Palace,Newcastle United,1-0,1,0,1,1,1,1,H
1970-08-22,1970,Derby County,Stoke City,2-0,2,0,1,1,2,2,H
1970-08-22,1970,Ipswich Town,Nottingham Forest,0-0,0,0,1,1,0,0,D
1970-08-22,1970,Leeds United,Everton,3-2,3,2,1,1,5,1,H
1970-08-22,1970,Liverpool,Huddersfield Town,4-0,4,0,1,1,4,4,H
1970-08-22,1970,Manchester City,Burnley,0-0,0,0,1,1,0,0,D
1970-08-22,1970,West Ham United,Chelsea,2-2,2,2,1,1,4,0,D
1970-08-22,1970,Wolverhampton Wanderers,Tottenham Hotspur,0-3,0,3,1,1,3,-3,A
1970-08-25,1970,Arsenal,Huddersfield Town,1-0,1,0,1,1,1,1,H
1970-08-25,1970,Burnley,Manchester United,0-2,0,2,1,1,2,-2,A
1970-08-25,1970,Coventry City,Wolverhampton Wanderers,0-1,0,1,1,1,1,-1,A
1970-08-25,1970,Liverpool,Crystal Palace,1-1,1,1,1,1,2,0,D
1970-08-25,1970,Southampton,Tottenham Hotspur,0-0,0,0,1,1,0,0,D
1970-08-26,1970,Chelsea,Everton,2-2,2,2,1,1,4,0,D
1970-08-26,1970,Derby County,Ipswich Town,2-0,2,0,1,1,2,2,H
1970-08-26,1970,Leeds United,West Ham United,3-0,3,0,1,1,3,3,H
1970-08-26,1970,Manchester City,Blackpool,2-0,2,0,1,1,2,2,H
1970-08-26,1970,Newcastle United,Nottingham Forest,1-1,1,1,1,1,2,0,D
1970-08-26,1970,West Bromwich Albion,Stoke City,5-2,5,2,1,1,7,3,H
1970-08-29,1970,Burnley,Leeds United,0-3,0,3,1,1,3,-3,A
1970-08-29,1970,Chelsea,Arsenal,2-1,2,1,1,1,3,1,H
1970-08-29,1970,Everton,Manchester City,0-1,0,1,1,1,1,-1,A
1970-08-29,1970,Huddersfield Town,Derby County,0-0,0,0,1,1,0,0,D
1970-08-29,1970,Manchester United,West Ham United,1-1,1,1,1,1,2,0,D
1970-08-29,1970,Newcastle United,Blackpool,1-2,1,2,1,1,3,-1,A
1970-08-29,1970,Nottingham Forest,Wolverhampton Wanderers,4-1,4,1,1,1,5,3,H
1970-08-29,1970,Southampton,Ipswich Town,1-0,1,0,1,1,1,1,H
1970-08-29,1970,Stoke City,Crystal Palace,0-0,0,0,1,1,0,0,D
1970-08-29,1970,Tottenham Hotspur,Coventry City,1-0,1,0,1,1,1,1,H
1970-08-29,1970,West Bromwich Albion,Liverpool,1-1,1,1,1,1,2,0,D
1970-08-31,1970,West Ham United,Southampton,1-1,1,1,1,1,2,0,D
1970-09-01,1970,Arsenal,Leeds United,0-0,0,0,1,1,0,0,D
1970-09-01,1970,Burnley,Chelsea,0-0,0,0,1,1,0,0,D
1970-09-01,1970,Huddersfield Town,Tottenham Hotspur,1-1,1,1,1,1,2,0,D
1970-09-01,1970,Ipswich Town,Wolverhampton Wanderers,2-3,2,3,1,1,5,-1,A
1970-09-02,1970,Crystal Palace,Blackpool,1-0,1,0,1,1,1,1,H
1970-09-02,1970,Derby County,Coventry City,3-4,3,4,1,1,7,-1,A
1970-09-02,1970,Manchester United,Everton,2-0,2,0,1,1,2,2,H
1970-09-02,1970,Stoke City,Nottingham Forest,0-0,0,0,1,1,0,0,D
1970-09-02,1970,West Bromwich Albion,Newcastle United,1-2,1,2,1,1,3,-1,A
1970-09-05,1970,Arsenal,Tottenham Hotspur,2-0,2,0,1,1,2,2,H
1970-09-05,1970,Blackpool,Southampton,0-3,0,3,1,1,3,-3,A
1970-09-05,1970,Coventry City,Huddersfield Town,0-0,0,0,1,1,0,0,D
1970-09-05,1970,Crystal Palace,Nottingham Forest,2-0,2,0,1,1,2,2,H
1970-09-05,1970,Derby County,Newcastle United,1-2,1,2,1,1,3,-1,A
1970-09-05,1970,Ipswich Town,Burnley,3-0,3,0,1,1,3,3,H
1970-09-05,1970,Leeds United,Chelsea,1-0,1,0,1,1,1,1,H
1970-09-05,1970,Liverpool,Manchester United,1-1,1,1,1,1,2,0,D
1970-09-05,1970,Manchester City,West Bromwich Albion,4-1,4,1,1,1,5,3,H
1970-09-05,1970,West Ham United,Everton,1-2,1,2,1,1,3,-1,A
1970-09-05,1970,Wolverhampton Wanderers,Stoke City,1-1,1,1,1,1,2,0,D
1970-09-12,1970,Burnley,Arsenal,1-2,1,2,1,1,3,-1,A
1970-09-12,1970,Chelsea,Wolverhampton Wanderers,2-2,2,2,1,1,4,0,D
1970-09-12,1970,Everton,Ipswich Town,2-0,2,0,1,1,2,2,H
1970-09-12,1970,Huddersfield Town,Crystal Palace,0-2,0,2,1,1,2,-2,A
1970-09-12,1970,Manchester United,Coventry City,2-0,2,0,1,1,2,2,H
1970-09-12,1970,Newcastle United,Liverpool,0-0,0,0,1,1,0,0,D
1970-09-12,1970,Nottingham Forest,Manchester City,0-1,0,1,1,1,1,-1,A
1970-09-12,1970,Southampton,Derby County,4-0,4,0,1,1,4,4,H
1970-09-12,1970,Stoke City,Leeds United,3-0,3,0,1,1,3,3,H
1970-09-12,1970,Tottenham Hotspur,Blackpool,3-0,3,0,1,1,3,3,H
1970-09-12,1970,West Bromwich Albion,West Ham United,2-1,2,1,1,1,3,1,H
1970-09-19,1970,Arsenal,West Bromwich Albion,6-2,6,2,1,1,8,4,H
1970-09-19,1970,Blackpool,Everton,0-2,0,2,1,1,2,-2,A
1970-09-19,1970,Coventry City,Chelsea,0-1,0,1,1,1,1,-1,A
1970-09-19,1970,Crystal Palace,Tottenham Hotspur,0-3,0,3,1,1,3,-3,A
1970-09-19,1970,Derby County,Burnley,1-0,1,0,1,1,1,1,H
1970-09-19,1970,Ipswich Town,Manchester United,4-0,4,0,1,1,4,4,H
1970-09-19,1970,Leeds United,Southampton,1-0,1,0,1,1,1,1,H
1970-09-19,1970,Liverpool,Nottingham Forest,3-0,3,0,1,1,3,3,H
1970-09-19,1970,Manchester City,Stoke City,4-1,4,1,1,1,5,3,H
1970-09-19,1970,West Ham United,Newcastle United,0-2,0,2,1,1,2,-2,A
1970-09-19,1970,Wolverhampton Wanderers,Huddersfield Town,3-1,3,1,1,1,4,2,H
1970-09-26,1970,Burnley,Wolverhampton Wanderers,2-3,2,3,1,1,5,-1,A
1970-09-26,1970,Chelsea,Ipswich Town,2-1,2,1,1,1,3,1,H
1970-09-26,1970,Everton,Crystal Palace,3-1,3,1,1,1,4,2,H
1970-09-26,1970,Huddersfield Town,West Ham United,1-1,1,1,1,1,2,0,D
1970-09-26,1970,Manchester United,Blackpool,1-1,1,1,1,1,2,0,D
1970-09-26,1970,Newcastle United,Coventry City,0-0,0,0,1,1,0,0,D
1970-09-26,1970,Nottingham Forest,Leeds United,0-0,0,0,1,1,0,0,D
1970-09-26,1970,Southampton,Liverpool,1-0,1,0,1,1,1,1,H
1970-09-26,1970,Stoke City,Arsenal,5-0,5,0,1,1,5,5,H
1970-09-26,1970,Tottenham Hotspur,Manchester City,2-0,2,0,1,1,2,2,H
1970-09-26,1970,West Bromwich Albion,Derby County,2-1,2,1,1,1,3,1,H
1970-10-03,1970,Arsenal,Nottingham Forest,4-0,4,0,1,1,4,4,H
1970-10-03,1970,Blackpool,Stoke City,1-1,1,1,1,1,2,0,D
1970-10-03,1970,Coventry City,Everton,3-1,3,1,1,1,4,2,H
1970-10-03,1970,Crystal Palace,Southampton,3-1,3,1,1,1,4,2,H
1970-10-03,1970,Derby County,Tottenham Hotspur,1-1,1,1,1,1,2,0,D
1970-10-03,1970,Ipswich Town,West Bromwich Albion,2-2,2,2,1,1,4,0,D
1970-10-03,1970,Leeds United,Huddersfield Town,2-0,2,0,1,1,2,2,H
1970-10-03,1970,Liverpool,Chelsea,1-0,1,0,1,1,1,1,H
1970-10-03,1970,Manchester City,Newcastle United,1-1,1,1,1,1,2,0,D
1970-10-03,1970,West Ham United,Burnley,3-1,3,1,1,1,4,2,H
1970-10-03,1970,Wolverhampton Wanderers,Manchester United,3-2,3,2,1,1,5,1,H
1970-10-10,1970,Burnley,Coventry City,0-0,0,0,1,1,0,0,D
1970-10-10,1970,Chelsea,Manchester City,1-1,1,1,1,1,2,0,D
1970-10-10,1970,Everton,Derby County,1-1,1,1,1,1,2,0,D
1970-10-10,1970,Huddersfield Town,Ipswich Town,1-0,1,0,1,1,1,1,H
1970-10-10,1970,Manchester United,Crystal Palace,0-1,0,1,1,1,1,-1,A
1970-10-10,1970,Newcastle United,Arsenal,1-1,1,1,1,1,2,0,D
1970-10-10,1970,Nottingham Forest,Blackpool,3-1,3,1,1,1,4,2,H
1970-10-10,1970,Southampton,Wolverhampton Wanderers,1-2,1,2,1,1,3,-1,A
1970-10-10,1970,Stoke City,West Ham United,2-1,2,1,1,1,3,1,H
1970-10-10,1970,Tottenham Hotspur,Liverpool,1-0,1,0,1,1,1,1,H
1970-10-10,1970,West Bromwich Albion,Leeds United,2-2,2,2,1,1,4,0,D
1970-10-17,1970,Arsenal,Everton,4-0,4,0,1,1,4,4,H
1970-10-17,1970,Blackpool,Huddersfield Town,2-2,2,2,1,1,4,0,D
1970-10-17,1970,Coventry City,Nottingham Forest,2-0,2,0,1,1,2,2,H
1970-10-17,1970,Crystal Palace,West Bromwich Albion,3-0,3,0,1,1,3,3,H
1970-10-17,1970,Derby County,Chelsea,1-2,1,2,1,1,3,-1,A
1970-10-17,1970,Ipswich Town,Stoke City,2-0,2,0,1,1,2,2,H
1970-10-17,1970,Leeds United,Manchester United,2-2,2,2,1,1,4,0,D
1970-10-17,1970,Liverpool,Burnley,2-0,2,0,1,1,2,2,H
1970-10-17,1970,Manchester City,Southampton,1-1,1,1,1,1,2,0,D
1970-10-17,1970,West Ham United,Tottenham Hotspur,2-2,2,2,1,1,4,0,D
1970-10-17,1970,Wolverhampton Wanderers,Newcastle United,3-2,3,2,1,1,5,1,H
1970-10-24,1970,Blackpool,Chelsea,3-4,3,4,1,1,7,-1,A
1970-10-24,1970,Coventry City,Arsenal,1-3,1,3,1,1,4,-2,A
1970-10-24,1970,Crystal Palace,West Ham United,1-1,1,1,1,1,2,0,D
1970-10-24,1970,Derby County,Leeds United,0-2,0,2,1,1,2,-2,A
1970-10-24,1970,Everton,Newcastle United,3-1,3,1,1,1,4,2,H
1970-10-24,1970,Huddersfield Town,Nottingham Forest,0-0,0,0,1,1,0,0,D
1970-10-24,1970,Ipswich Town,Liverpool,1-0,1,0,1,1,1,1,H
1970-10-24,1970,Manchester United,West Bromwich Albion,2-1,2,1,1,1,3,1,H
1970-10-24,1970,Southampton,Burnley,2-0,2,0,1,1,2,2,H
1970-10-24,1970,Tottenham Hotspur,Stoke City,3-0,3,0,1,1,3,3,H
1970-10-24,1970,Wolverhampton Wanderers,Manchester City,3-0,3,0,1,1,3,3,H
1970-10-31,1970,Arsenal,Derby County,2-0,2,0,1,1,2,2,H
1970-10-31,1970,Burnley,Crystal Palace,2-1,2,1,1,1,3,1,H
1970-10-31,1970,Chelsea,Southampton,2-2,2,2,1,1,4,0,D
1970-10-31,1970,Leeds United,Coventry City,2-0,2,0,1,1,2,2,H
1970-10-31,1970,Liverpool,Wolverhampton Wanderers,2-0,2,0,1,1,2,2,H
1970-10-31,1970,Manchester City,Ipswich Town,2-0,2,0,1,1,2,2,H
1970-10-31,1970,Newcastle United,Manchester United,1-0,1,0,1,1,1,1,H
1970-10-31,1970,Nottingham Forest,Tottenham Hotspur,0-1,0,1,1,1,1,-1,A
1970-10-31,1970,Stoke City,Huddersfield Town,3-1,3,1,1,1,4,2,H
1970-10-31,1970,West Bromwich Albion,Everton,3-0,3,0,1,1,3,3,H
1970-10-31,1970,West Ham United,Blackpool,2-1,2,1,1,1,3,1,H
1970-11-07,1970,Blackpool,Arsenal,0-1,0,1,1,1,1,-1,A
1970-11-07,1970,Coventry City,Manchester City,2-1,2,1,1,1,3,1,H
1970-11-07,1970,Crystal Palace,Leeds United,1-1,1,1,1,1,2,0,D
1970-11-07,1970,Derby County,Liverpool,0-0,0,0,1,1,0,0,D
1970-11-07,1970,Everton,Nottingham Forest,1-0,1,0,1,1,1,1,H
1970-11-07,1970,Huddersfield Town,Chelsea,0-1,0,1,1,1,1,-1,A
1970-11-07,1970,Ipswich Town,West Ham United,2-1,2,1,1,1,3,1,H
1970-11-07,1970,Manchester United,Stoke City,2-2,2,2,1,1,4,0,D
1970-11-07,1970,Southampton,Newcastle United,2-0,2,0,1,1,2,2,H
1970-11-07,1970,Tottenham Hotspur,Burnley,4-0,4,0,1,1,4,4,H
1970-11-07,1970,Wolverhampton Wanderers,West Bromwich Albion,2-1,2,1,1,1,3,1,H
1970-11-14,1970,Arsenal,Crystal Palace,1-1,1,1,1,1,2,0,D
1970-11-14,1970,Burnley,Huddersfield Town,2-3,2,3,1,1,5,-1,A
1970-11-14,1970,Chelsea,Tottenham Hotspur,0-2,0,2,1,1,2,-2,A
1970-11-14,1970,Leeds United,Blackpool,3-1,3,1,1,1,4,2,H
1970-11-14,1970,Liverpool,Coventry City,0-0,0,0,1,1,0,0,D
1970-11-14,1970,Manchester City,Derby County,1-1,1,1,1,1,2,0,D
1970-11-14,1970,Newcastle United,Ipswich Town,0-0,0,0,1,1,0,0,D
1970-11-14,1970,Nottingham Forest,Manchester United,1-2,1,2,1,1,3,-1,A
1970-11-14,1970,Stoke City,Everton,1-1,1,1,1,1,2,0,D
1970-11-14,1970,West Bromwich Albion,Southampton,1-0,1,0,1,1,1,1,H
1970-11-14,1970,West Ham United,Wolverhampton Wanderers,3-3,3,3,1,1,6,0,D
1970-11-18,1970,Leeds United,Stoke City,4-1,4,1,1,1,5,3,H
1970-11-21,1970,Burnley,Nottingham Forest,2-1,2,1,1,1,3,1,H
1970-11-21,1970,Chelsea,Stoke City,2-1,2,1,1,1,3,1,H
1970-11-21,1970,Coventry City,Crystal Palace,2-1,2,1,1,1,3,1,H
1970-11-21,1970,Derby County,Blackpool,2-0,2,0,1,1,2,2,H
1970-11-21,1970,Huddersfield Town,West Bromwich Albion,2-1,2,1,1,1,3,1,H
1970-11-21,1970,Ipswich Town,Arsenal,0-1,0,1,1,1,1,-1,A
1970-11-21,1970,Liverpool,Everton,3-2,3,2,1,1,5,1,H
1970-11-21,1970,Manchester City,West Ham United,2-0,2,0,1,1,2,2,H
1970-11-21,1970,Southampton,Manchester United,1-0,1,0,1,1,1,1,H
1970-11-21,1970,Tottenham Hotspur,Newcastle United,1-2,1,2,1,1,3,-1,A
1970-11-21,1970,Wolverhampton Wanderers,Leeds United,2-3,2,3,1,1,5,-1,A
1970-11-28,1970,Arsenal,Liverpool,2-0,2,0,1,1,2,2,H
1970-11-28,1970,Blackpool,Ipswich Town,0-2,0,2,1,1,2,-2,A
1970-11-28,1970,Crystal Palace,Wolverhampton Wanderers,1-1,1,1,1,1,2,0,D
1970-11-28,1970,Everton,Tottenham Hotspur,0-0,0,0,1,1,0,0,D
1970-11-28,1970,Leeds United,Manchester City,1-0,1,0,1,1,1,1,H
1970-11-28,1970,Manchester United,Huddersfield Town,1-1,1,1,1,1,2,0,D
1970-11-28,1970,Newcastle United,Burnley,3-1,3,1,1,1,4,2,H
1970-11-28,1970,Nottingham Forest,Derby County,2-4,2,4,1,1,6,-2,A
1970-11-28,1970,Stoke City,Southampton,0-0,0,0,1,1,0,0,D
1970-11-28,1970,West Bromwich Albion,Chelsea,2-2,2,2,1,1,4,0,D
1970-11-28,1970,West Ham United,Coventry City,1-2,1,2,1,1,3,-1,A
1970-12-05,1970,Burnley,West Bromwich Albion,1-1,1,1,1,1,2,0,D
1970-12-05,1970,Chelsea,Newcastle United,1-0,1,0,1,1,1,1,H
1970-12-05,1970,Coventry City,Stoke City,1-0,1,0,1,1,1,1,H
1970-12-05,1970,Derby County,West Ham United,2-4,2,4,1,1,6,-2,A
1970-12-05,1970,Huddersfield Town,Everton,1-1,1,1,1,1,2,0,D
1970-12-05,1970,Ipswich Town,Crystal Palace,1-2,1,2,1,1,3,-1,A
1970-12-05,1970,Liverpool,Leeds United,1-1,1,1,1,1,2,0,D
1970-12-05,1970,Manchester City,Arsenal,0-2,0,2,1,1,2,-2,A
1970-12-05,1970,Southampton,Nottingham Forest,4-1,4,1,1,1,5,3,H
1970-12-05,1970,Tottenham Hotspur,Manchester United,2-2,2,2,1,1,4,0,D
1970-12-05,1970,Wolverhampton Wanderers,Blackpool,1-0,1,0,1,1,1,1,H
1970-12-12,1970,Arsenal,Wolverhampton Wanderers,2-1,2,1,1,1,3,1,H
1970-12-12,1970,Blackpool,Coventry City,1-0,1,0,1,1,1,1,H
1970-12-12,1970,Crystal Palace,Derby County,0-0,0,0,1,1,0,0,D
1970-12-12,1970,Everton,Southampton,4-1,4,1,1,1,5,3,H
1970-12-12,1970,Leeds United,Ipswich Town,0-0,0,0,1,1,0,0,D
1970-12-12,1970,Manchester United,Manchester City,1-4,1,4,1,1,5,-3,A
1970-12-12,1970,Newcastle United,Huddersfield Town,2-0,2,0,1,1,2,2,H
1970-12-12,1970,Nottingham Forest,Chelsea,1-1,1,1,1,1,2,0,D
1970-12-12,1970,Stoke City,Burnley,0-0,0,0,1,1,0,0,D
1970-12-12,1970,West Bromwich Albion,Tottenham Hotspur,3-1,3,1,1,1,4,2,H
1970-12-12,1970,West Ham United,Liverpool,1-2,1,2,1,1,3,-1,A
1970-12-19,1970,Burnley,Manchester City,0-4,0,4,1,1,4,-4,A
1970-12-19,1970,Chelsea,West Ham United,2-1,2,1,1,1,3,1,H
1970-12-19,1970,Everton,Leeds United,0-1,0,1,1,1,1,-1,A
1970-12-19,1970,Huddersfield Town,Liverpool,0-0,0,0,1,1,0,0,D
1970-12-19,1970,Manchester United,Arsenal,1-3,1,3,1,1,4,-2,A
1970-12-19,1970,Newcastle United,Crystal Palace,2-0,2,0,1,1,2,2,H
1970-12-19,1970,Nottingham Forest,Ipswich Town,0-1,0,1,1,1,1,-1,A
1970-12-19,1970,Southampton,Coventry City,3-0,3,0,1,1,3,3,H
1970-12-19,1970,Stoke City,Derby County,1-0,1,0,1,1,1,1,H
1970-12-19,1970,Tottenham Hotspur,Wolverhampton Wanderers,0-0,0,0,1,1,0,0,D
1970-12-19,1970,West Bromwich Albion,Blackpool,1-1,1,1,1,1,2,0,D
1970-12-26,1970,Arsenal,Southampton,0-0,0,0,1,1,0,0,D
1970-12-26,1970,Blackpool,Burnley,1-1,1,1,1,1,2,0,D
1970-12-26,1970,Coventry City,West Bromwich Albion,1-1,1,1,1,1,2,0,D
1970-12-26,1970,Derby County,Manchester United,4-4,4,4,1,1,8,0,D
1970-12-26,1970,Leeds United,Newcastle United,3-0,3,0,1,1,3,3,H
1970-12-26,1970,Liverpool,Stoke City,0-0,0,0,1,1,0,0,D
1970-12-26,1970,Manchester City,Huddersfield Town,1-1,1,1,1,1,2,0,D
1970-12-26,1970,Wolverhampton Wanderers,Everton,2-0,2,0,1,1,2,2,H
1971-01-09,1970,Arsenal,West Ham United,2-0,2,0,1,1,2,2,H
1971-01-09,1970,Burnley,Everton,2-2,2,2,1,1,4,0,D
1971-01-09,1970,Chelsea,Manchester United,1-2,1,2,1,1,3,-1,A
1971-01-09,1970,Coventry City,Ipswich Town,1-0,1,0,1,1,1,1,H
1971-01-09,1970,Derby County,Wolverhampton Wanderers,1-2,1,2,1,1,3,-1,A
1971-01-09,1970,Leeds United,Tottenham Hotspur,1-2,1,2,1,1,3,-1,A
1971-01-09,1970,Liverpool,Blackpool,2-2,2,2,1,1,4,0,D
1971-01-09,1970,Manchester City,Crystal Palace,1-0,1,0,1,1,1,1,H
1971-01-09,1970,Newcastle United,Stoke City,0-2,0,2,1,1,2,-2,A
1971-01-09,1970,Southampton,Huddersfield Town,1-0,1,0,1,1,1,1,H
1971-01-09,1970,West Bromwich Albion,Nottingham Forest,0-1,0,1,1,1,1,-1,A
1971-01-12,1970,Liverpool,Manchester City,0-0,0,0,1,1,0,0,D
1971-01-13,1970,Crystal Palace,Chelsea,0-0,0,0,1,1,0,0,D
1971-01-16,1970,Blackpool,Manchester City,3-3,3,3,1,1,6,0,D
1971-01-16,1970,Crystal Palace,Liverpool,1-0,1,0,1,1,1,1,H
1971-01-16,1970,Everton,Chelsea,3-0,3,0,1,1,3,3,H
1971-01-16,1970,Huddersfield Town,Arsenal,2-1,2,1,1,1,3,1,H
1971-01-16,1970,Ipswich Town,Derby County,0-1,0,1,1,1,1,-1,A
1971-01-16,1970,Manchester United,Burnley,1-1,1,1,1,1,2,0,D
1971-01-16,1970,Nottingham Forest,Newcastle United,2-1,2,1,1,1,3,1,H
1971-01-16,1970,Stoke City,West Bromwich Albion,2-0,2,0,1,1,2,2,H
1971-01-16,1970,Tottenham Hotspur,Southampton,1-3,1,3,1,1,4,-2,A
1971-01-16,1970,West Ham United,Leeds United,2-3,2,3,1,1,5,-1,A
1971-01-16,1970,Wolverhampton Wanderers,Coventry City,0-0,0,0,1,1,0,0,D
1971-01-30,1970,Burnley,Newcastle United,1-1,1,1,1,1,2,0,D
1971-01-30,1970,Chelsea,West Bromwich Albion,4-1,4,1,1,1,5,3,H
1971-01-30,1970,Huddersfield Town,Manchester United,1-2,1,2,1,1,3,-1,A
1971-01-30,1970,Ipswich Town,Blackpool,2-1,2,1,1,1,3,1,H
1971-01-30,1970,Liverpool,Arsenal,2-0,2,0,1,1,2,2,H
1971-01-30,1970,Manchester City,Leeds United,0-2,0,2,1,1,2,-2,A
1971-01-30,1970,Southampton,Stoke City,2-1,2,1,1,1,3,1,H
1971-01-30,1970,Tottenham Hotspur,Everton,2-1,2,1,1,1,3,1,H
1971-01-30,1970,Wolverhampton Wanderers,Crystal Palace,2-1,2,1,1,1,3,1,H
1971-02-06,1970,Arsenal,Manchester City,1-0,1,0,1,1,1,1,H
1971-02-06,1970,Blackpool,Wolverhampton Wanderers,0-2,0,2,1,1,2,-2,A
1971-02-06,1970,Crystal Palace,Ipswich Town,1-0,1,0,1,1,1,1,H
1971-02-06,1970,Everton,Huddersfield Town,2-1,2,1,1,1,3,1,H
1971-02-06,1970,Leeds United,Liverpool,0-1,0,1,1,1,1,-1,A
1971-02-06,1970,Manchester United,Tottenham Hotspur,2-1,2,1,1,1,3,1,H
1971-02-06,1970,Newcastle United,Chelsea,0-1,0,1,1,1,1,-1,A
1971-02-06,1970,Nottingham Forest,Southampton,2-0,2,0,1,1,2,2,H
1971-02-06,1970,Stoke City,Coventry City,2-1,2,1,1,1,3,1,H
1971-02-06,1970,West Bromwich Albion,Burnley,1-0,1,0,1,1,1,1,H
1971-02-06,1970,West Ham United,Derby County,1-4,1,4,1,1,5,-3,A
1971-02-08,1970,Coventry City,West Ham United,0-1,0,1,1,1,1,-1,A
1971-02-13,1970,Coventry City,Blackpool,2-0,2,0,1,1,2,2,H
1971-02-13,1970,Huddersfield Town,Newcastle United,1-1,1,1,1,1,2,0,D
1971-02-13,1970,Wolverhampton Wanderers,Chelsea,1-0,1,0,1,1,1,1,H
1971-02-16,1970,Liverpool,West Ham United,1-0,1,0,1,1,1,1,H
1971-02-16,1970,Southampton,Everton,2-2,2,2,1,1,4,0,D
1971-02-17,1970,Chelsea,Nottingham Forest,2-0,2,0,1,1,2,2,H
1971-02-17,1970,Derby County,Crystal Palace,1-0,1,0,1,1,1,1,H
1971-02-17,1970,Tottenham Hotspur,West Bromwich Albion,2-2,2,2,1,1,4,0,D
1971-02-20,1970,Arsenal,Ipswich Town,3-2,3,2,1,1,5,1,H
1971-02-20,1970,Blackpool,Derby County,0-1,0,1,1,1,1,-1,A
1971-02-20,1970,Crystal Palace,Coventry City,1-2,1,2,1,1,3,-1,A
1971-02-20,1970,Everton,Liverpool,0-0,0,0,1,1,0,0,D
1971-02-20,1970,Leeds United,Wolverhampton Wanderers,3-0,3,0,1,1,3,3,H
1971-02-20,1970,Manchester United,Southampton,5-1,5,1,1,1,6,4,H
1971-02-20,1970,Newcastle United,Tottenham Hotspur,1-0,1,0,1,1,1,1,H
1971-02-20,1970,Nottingham Forest,Burnley,1-0,1,0,1,1,1,1,H
1971-02-20,1970,Stoke City,Chelsea,1-2,1,2,1,1,3,-1,A
1971-02-20,1970,West Bromwich Albion,Huddersfield Town,2-1,2,1,1,1,3,1,H
1971-02-20,1970,West Ham United,Manchester City,0-0,0,0,1,1,0,0,D
1971-02-23,1970,Burnley,Stoke City,1-1,1,1,1,1,2,0,D
1971-02-23,1970,Everton,Manchester United,1-0,1,0,1,1,1,1,H
1971-02-23,1970,Ipswich Town,Leeds United,2-4,2,4,1,1,6,-2,A
1971-02-24,1970,West Ham United,Nottingham Forest,2-0,2,0,1,1,2,2,H
1971-02-26,1970,Coventry City,Leeds United,0-1,0,1,1,1,1,-1,A
1971-02-26,1970,Ipswich Town,Manchester City,2-0,2,0,1,1,2,2,H
1971-02-27,1970,Blackpool,West Ham United,1-1,1,1,1,1,2,0,D
1971-02-27,1970,Crystal Palace,Burnley,0-2,0,2,1,1,2,-2,A
1971-02-27,1970,Derby County,Arsenal,2-0,2,0,1,1,2,2,H
1971-02-27,1970,Everton,West Bromwich Albion,3-3,3,3,1,1,6,0,D
1971-02-27,1970,Huddersfield Town,Stoke City,0-1,0,1,1,1,1,-1,A
1971-02-27,1970,Manchester United,Newcastle United,1-0,1,0,1,1,1,1,H
1971-02-27,1970,Southampton,Chelsea,0-0,0,0,1,1,0,0,D
1971-02-27,1970,Wolverhampton Wanderers,Liverpool,1-0,1,0,1,1,1,1,H
1971-03-02,1970,Wolverhampton Wanderers,Arsenal,0-3,0,3,1,1,3,-3,A
1971-03-06,1970,Burnley,Southampton,0-1,0,1,1,1,1,-1,A
1971-03-06,1970,Chelsea,Blackpool,2-0,2,0,1,1,2,2,H
1971-03-06,1970,Leeds United,Derby County,1-0,1,0,1,1,1,1,H
1971-03-06,1970,Manchester City,Wolverhampton Wanderers,0-0,0,0,1,1,0,0,D
1971-03-06,1970,Nottingham Forest,Huddersfield Town,1-3,1,3,1,1,4,-2,A
1971-03-06,1970,West Bromwich Albion,Manchester United,4-3,4,3,1,1,7,1,H
1971-03-06,1970,West Ham United,Crystal Palace,0-0,0,0,1,1,0,0,D
1971-03-10,1970,Tottenham Hotspur,Nottingham Forest,0-1,0,1,1,1,1,-1,A
1971-03-13,1970,Blackpool,Leeds United,1-1,1,1,1,1,2,0,D
1971-03-13,1970,Coventry City,Liverpool,1-0,1,0,1,1,1,1,H
1971-03-13,1970,Crystal Palace,Arsenal,0-2,0,2,1,1,2,-2,A
1971-03-13,1970,Derby County,Manchester City,0-0,0,0,1,1,0,0,D
1971-03-13,1970,Everton,Stoke City,2-0,2,0,1,1,2,2,H
1971-03-13,1970,Huddersfield Town,Burnley,0-1,0,1,1,1,1,-1,A
1971-03-13,1970,Ipswich Town,Newcastle United,1-0,1,0,1,1,1,1,H
1971-03-13,1970,Manchester United,Nottingham Forest,2-0,2,0,1,1,2,2,H
1971-03-13,1970,Southampton,West Bromwich Albion,1-0,1,0,1,1,1,1,H
1971-03-13,1970,Tottenham Hotspur,Chelsea,2-1,2,1,1,1,3,1,H
1971-03-13,1970,Wolverhampton Wanderers,West Ham United,2-0,2,0,1,1,2,2,H
1971-03-18,1970,Newcastle United,Everton,2-1,2,1,1,1,3,1,H
1971-03-20,1970,Arsenal,Blackpool,1-0,1,0,1,1,1,1,H
1971-03-20,1970,Burnley,Tottenham Hotspur,0-0,0,0,1,1,0,0,D
1971-03-20,1970,Chelsea,Huddersfield Town,0-0,0,0,1,1,0,0,D
1971-03-20,1970,Leeds United,Crystal Palace,2-1,2,1,1,1,3,1,H
1971-03-20,1970,Liverpool,Derby County,2-0,2,0,1,1,2,2,H
1971-03-20,1970,Manchester City,Coventry City,1-1,1,1,1,1,2,0,D
1971-03-20,1970,Newcastle United,Southampton,2-2,2,2,1,1,4,0,D
1971-03-20,1970,Nottingham Forest,Everton,3-2,3,2,1,1,5,1,H
1971-03-20,1970,Stoke City,Manchester United,1-2,1,2,1,1,3,-1,A
1971-03-20,1970,West Bromwich Albion,Wolverhampton Wanderers,2-4,2,4,1,1,6,-2,A
1971-03-20,1970,West Ham United,Ipswich Town,2-2,2,2,1,1,4,0,D
1971-03-23,1970,Ipswich Town,Tottenham Hotspur,1-2,1,2,1,1,3,-1,A
1971-03-24,1970,Crystal Palace,Huddersfield Town,0-3,0,3,1,1,3,-3,A
1971-03-27,1970,Burnley,Ipswich Town,2-2,2,2,1,1,4,0,D
1971-03-27,1970,Chelsea,Leeds United,3-1,3,1,1,1,4,2,H
1971-03-27,1970,Huddersfield Town,Coventry City,1-0,1,0,1,1,1,1,H
1971-03-27,1970,Newcastle United,Derby County,3-1,3,1,1,1,4,2,H
1971-03-27,1970,Nottingham Forest,Crystal Palace,3-1,3,1,1,1,4,2,H
1971-03-27,1970,Southampton,Blackpool,1-1,1,1,1,1,2,0,D
1971-03-27,1970,West Bromwich Albion,Manchester City,0-0,0,0,1,1,0,0,D
1971-03-29,1970,Liverpool,Ipswich Town,2-1,2,1,1,1,3,1,H
1971-03-30,1970,Everton,West Ham United,0-1,0,1,1,1,1,-1,A
1971-03-31,1970,Derby County,Nottingham Forest,1-2,1,2,1,1,3,-1,A
1971-04-02,1970,Liverpool,West Bromwich Albion,1-1,1,1,1,1,2,0,D
1971-04-03,1970,Arsenal,Chelsea,2-0,2,0,1,1,2,2,H
1971-04-03,1970,Blackpool,Newcastle United,0-1,0,1,1,1,1,-1,A
1971-04-03,1970,Coventry City,Tottenham Hotspur,0-0,0,0,1,1,0,0,D
1971-04-03,1970,Crystal Palace,Stoke City,3-2,3,2,1,1,5,1,H
1971-04-03,1970,Derby County,Huddersfield Town,3-2,3,2,1,1,5,1,H
1971-04-03,1970,Ipswich Town,Southampton,1-3,1,3,1,1,4,-2,A
1971-04-03,1970,Leeds United,Burnley,4-0,4,0,1,1,4,4,H
1971-04-03,1970,Manchester City,Everton,3-0,3,0,1,1,3,3,H
1971-04-03,1970,West Ham United,Manchester United,2-1,2,1,1,1,3,1,H
1971-04-03,1970,Wolverhampton Wanderers,Nottingham Forest,4-0,4,0,1,1,4,4,H
1971-04-06,1970,Arsenal,Coventry City,1-0,1,0,1,1,1,1,H
1971-04-06,1970,Ipswich Town,Everton,0-0,0,0,1,1,0,0,D
1971-04-06,1970,Liverpool,Newcastle United,1-1,1,1,1,1,2,0,D
1971-04-07,1970,Stoke City,Wolverhampton Wanderers,1-0,1,0,1,1,1,1,H
1971-04-07,1970,Tottenham Hotspur,Derby County,2-1,2,1,1,1,3,1,H
1971-04-09,1970,Manchester City,Nottingham Forest,1-3,1,3,1,1,4,-2,A
1971-04-09,1970,West Ham United,West Bromwich Albion,2-1,2,1,1,1,3,1,H
1971-04-10,1970,Burnley,Blackpool,1-0,1,0,1,1,1,1,H
1971-04-10,1970,Chelsea,Crystal Palace,1-1,1,1,1,1,2,0,D
1971-04-10,1970,Everton,Wolverhampton Wanderers,1-2,1,2,1,1,3,-1,A
1971-04-10,1970,Huddersfield Town,Manchester City,1-0,1,0,1,1,1,1,H
1971-04-10,1970,Manchester United,Derby County,1-2,1,2,1,1,3,-1,A
1971-04-10,1970,Newcastle United,Leeds United,1-1,1,1,1,1,2,0,D
1971-04-10,1970,Nottingham Forest,West Ham United,1-0,1,0,1,1,1,1,H
1971-04-10,1970,Southampton,Arsenal,1-2,1,2,1,1,3,-1,A
1971-04-10,1970,Stoke City,Liverpool,0-1,0,1,1,1,1,-1,A
1971-04-10,1970,Tottenham Hotspur,Ipswich Town,2-0,2,0,1,1,2,2,H
1971-04-10,1970,West Bromwich Albion,Coventry City,0-0,0,0,1,1,0,0,D
1971-04-12,1970,Blackpool,Tottenham Hotspur,0-0,0,0,1,1,0,0,D
1971-04-12,1970,Chelsea,Liverpool,1-0,1,0,1,1,1,1,H
1971-04-12,1970,Derby County,Southampton,0-0,0,0,1,1,0,0,D
1971-04-12,1970,Everton,Coventry City,3-0,3,0,1,1,3,3,H
1971-04-12,1970,Huddersfield Town,Leeds United,0-0,0,0,1,1,0,0,D
1971-04-12,1970,Manchester United,Wolverhampton Wanderers,1-0,1,0,1,1,1,1,H
1971-04-12,1970,Newcastle United,Manchester City,0-0,0,0,1,1,0,0,D
1971-04-12,1970,West Bromwich Albion,Ipswich Town,0-1,0,1,1,1,1,-1,A
1971-04-13,1970,Burnley,West Ham United,1-0,1,0,1,1,1,1,H
1971-04-13,1970,Coventry City,Manchester United,2-1,2,1,1,1,3,1,H
1971-04-13,1970,Nottingham Forest,Arsenal,0-3,0,3,1,1,3,-3,A
1971-04-13,1970,Stoke City,Blackpool,1-1,1,1,1,1,2,0,D
1971-04-17,1970,Arsenal,Newcastle United,1-0,1,0,1,1,1,1,H
1971-04-17,1970,Blackpool,Nottingham Forest,2-3,2,3,1,1,5,-1,A
1971-04-17,1970,Coventry City,Burnley,3-0,3,0,1,1,3,3,H
1971-04-17,1970,Crystal Palace,Manchester United,3-5,3,5,1,1,8,-2,A
1971-04-17,1970,Derby County,Everton,3-1,3,1,1,1,4,2,H
1971-04-17,1970,Ipswich Town,Huddersfield Town,2-0,2,0,1,1,2,2,H
1971-04-17,1970,Leeds United,West Bromwich Albion,1-2,1,2,1,1,3,-1,A
1971-04-17,1970,Liverpool,Tottenham Hotspur,0-0,0,0,1,1,0,0,D
1971-04-17,1970,Manchester City,Chelsea,1-1,1,1,1,1,2,0,D
1971-04-17,1970,West Ham United,Stoke City,1-0,1,0,1,1,1,1,H
1971-04-17,1970,Wolverhampton Wanderers,Southampton,0-1,0,1,1,1,1,-1,A
1971-04-19,1970,Manchester United,Liverpool,0-2,0,2,1,1,2,-2,A
1971-04-20,1970,Arsenal,Burnley,1-0,1,0,1,1,1,1,H
1971-04-24,1970,Burnley,Derby County,1-2,1,2,1,1,3,-1,A
1971-04-24,1970,Chelsea,Coventry City,2-1,2,1,1,1,3,1,H
1971-04-24,1970,Everton,Blackpool,0-0,0,0,1,1,0,0,D
1971-04-24,1970,Huddersfield Town,Wolverhampton Wanderers,1-2,1,2,1,1,3,-1,A
1971-04-24,1970,Manchester United,Ipswich Town,3-2,3,2,1,1,5,1,H
1971-04-24,1970,Newcastle United,West Ham United,1-1,1,1,1,1,2,0,D
1971-04-24,1970,Nottingham Forest,Liverpool,0-1,0,1,1,1,1,-1,A
1971-04-24,1970,Southampton,Leeds United,0-3,0,3,1,1,3,-3,A
1971-04-24,1970,Stoke City,Manchester City,2-0,2,0,1,1,2,2,H
1971-04-24,1970,Tottenham Hotspur,Crystal Palace,2-0,2,0,1,1,2,2,H
1971-04-24,1970,West Bromwich Albion,Arsenal,2-2,2,2,1,1,4,0,D
1971-04-26,1970,Blackpool,Crystal Palace,3-1,3,1,1,1,4,2,H
1971-04-26,1970,Chelsea,Burnley,0-1,0,1,1,1,1,-1,A
1971-04-26,1970,Leeds United,Arsenal,1-0,1,0,1,1,1,1,H
1971-04-26,1970,Manchester City,Liverpool,2-2,2,2,1,1,4,0,D
1971-04-27,1970,Coventry City,Derby County,0-0,0,0,1,1,0,0,D
1971-04-27,1970,Nottingham Forest,Stoke City,0-0,0,0,1,1,0,0,D
1971-04-27,1970,Southampton,West Ham United,1-2,1,2,1,1,3,-1,A
1971-04-28,1970,Newcastle United,West Bromwich Albion,3-0,3,0,1,1,3,3,H
1971-04-28,1970,Tottenham Hotspur,Huddersfield Town,1-1,1,1,1,1,2,0,D
1971-04-28,1970,Wolverhampton Wanderers,Ipswich Town,0-0,0,0,1,1,0,0,D
1971-05-01,1970,Arsenal,Stoke City,1-0,1,0,1,1,1,1,H
1971-05-01,1970,Blackpool,Manchester United,1-1,1,1,1,1,2,0,D
1971-05-01,1970,Coventry City,Newcastle United,2-0,2,0,1,1,2,2,H
1971-05-01,1970,Crystal Palace,Everton,2-0,2,0,1,1,2,2,H
1971-05-01,1970,Derby County,West Bromwich Albion,2-0,2,0,1,1,2,2,H
1971-05-01,1970,Ipswich Town,Chelsea,0-0,0,0,1,1,0,0,D
1971-05-01,1970,Leeds United,Nottingham Forest,2-0,2,0,1,1,2,2,H
1971-05-01,1970,Liverpool,Southampton,1-0,1,0,1,1,1,1,H
1971-05-01,1970,Manchester City,Tottenham Hotspur,0-1,0,1,1,1,1,-1,A
1971-05-01,1970,West Ham United,Huddersfield Town,0-1,0,1,1,1,1,-1,A
1971-05-01,1970,Wolverhampton Wanderers,Burnley,1-0,1,0,1,1,1,1,H
1971-05-03,1970,Tottenham Hotspur,Arsenal,0-1,0,1,1,1,1,-1,A
1971-05-04,1970,Southampton,Crystal Palace,6-0,6,0,1,1,6,6,H
1971-05-05,1970,Manchester City,Manchester United,3-4,3,4,1,1,7,-1,A
1971-05-05,1970,Stoke City,Tottenham Hotspur,0-1,0,1,1,1,1,-1,A
1971-08-14,1971,Arsenal,Chelsea,3-0,3,0,1,1,3,3,H
1971-08-14,1971,Coventry City,Stoke City,1-1,1,1,1,1,2,0,D
1971-08-14,1971,Crystal Palace,Newcastle United,2-0,2,0,1,1,2,2,H
1971-08-14,1971,Derby County,Manchester United,2-2,2,2,1,1,4,0,D
1971-08-14,1971,Huddersfield Town,Leicester City,2-2,2,2,1,1,4,0,D
1971-08-14,1971,Ipswich Town,Everton,0-0,0,0,1,1,0,0,D
1971-08-14,1971,Liverpool,Nottingham Forest,3-1,3,1,1,1,4,2,H
1971-08-14,1971,Manchester City,Leeds United,0-1,0,1,1,1,1,-1,A
1971-08-14,1971,Sheffield United,Southampton,3-1,3,1,1,1,4,2,H
1971-08-14,1971,West Ham United,West Bromwich Albion,0-1,0,1,1,1,1,-1,A
1971-08-14,1971,Wolverhampton Wanderers,Tottenham Hotspur,2-2,2,2,1,1,4,0,D
1971-08-17,1971,Huddersfield Town,Arsenal,0-1,0,1,1,1,1,-1,A
1971-08-17,1971,Ipswich Town,Coventry City,3-1,3,1,1,1,4,2,H
1971-08-17,1971,Liverpool,Wolverhampton Wanderers,3-2,3,2,1,1,5,1,H
1971-08-17,1971,Sheffield United,Leeds United,3-0,3,0,1,1,3,3,H
1971-08-17,1971,Southampton,Stoke City,3-1,3,1,1,1,4,2,H
1971-08-18,1971,Chelsea,Manchester United,2-3,2,3,1,1,5,-1,A
1971-08-18,1971,Derby County,West Ham United,2-0,2,0,1,1,2,2,H
1971-08-18,1971,Leicester City,Nottingham Forest,2-1,2,1,1,1,3,1,H
1971-08-18,1971,Manchester City,Crystal Palace,4-0,4,0,1,1,4,4,H
1971-08-18,1971,Tottenham Hotspur,Newcastle United,0-0,0,0,1,1,0,0,D
1971-08-18,1971,West Bromwich Albion,Everton,2-0,2,0,1,1,2,2,H
1971-08-20,1971,Manchester United,Arsenal,3-1,3,1,1,1,4,2,H
1971-08-21,1971,Chelsea,Manchester City,2-2,2,2,1,1,4,0,D
1971-08-21,1971,Everton,Sheffield United,0-1,0,1,1,1,1,-1,A
1971-08-21,1971,Leeds United,Wolverhampton Wanderers,0-0,0,0,1,1,0,0,D
1971-08-21,1971,Leicester City,Derby County,0-2,0,2,1,1,2,-2,A
1971-08-21,1971,Newcastle United,Liverpool,3-2,3,2,1,1,5,1,H
1971-08-21,1971,Nottingham Forest,West Ham United,1-0,1,0,1,1,1,1,H
1971-08-21,1971,Southampton,Ipswich Town,0-0,0,0,1,1,0,0,D
1971-08-21,1971,Stoke City,Crystal Palace,3-1,3,1,1,1,4,2,H
1971-08-21,1971,Tottenham Hotspur,Huddersfield Town,4-1,4,1,1,1,5,3,H
1971-08-21,1971,West Bromwich Albion,Coventry City,1-1,1,1,1,1,2,0,D
1971-08-23,1971,Manchester United,West Bromwich Albion,3-1,3,1,1,1,4,2,H
1971-08-23,1971,West Ham United,Ipswich Town,0-0,0,0,1,1,0,0,D
1971-08-24,1971,Arsenal,Sheffield United,0-1,0,1,1,1,1,-1,A
1971-08-24,1971,Coventry City,Derby County,2-2,2,2,1,1,4,0,D
1971-08-24,1971,Crystal Palace,Liverpool,0-1,0,1,1,1,1,-1,A
1971-08-24,1971,Everton,Chelsea,2-0,2,0,1,1,2,2,H
1971-08-24,1971,Nottingham Forest,Southampton,2-3,2,3,1,1,5,-1,A
1971-08-24,1971,Wolverhampton Wanderers,Manchester City,2-1,2,1,1,1,3,1,H
1971-08-25,1971,Leeds United,Tottenham Hotspur,1-1,1,1,1,1,2,0,D
1971-08-25,1971,Newcastle United,Huddersfield Town,0-0,0,0,1,1,0,0,D
1971-08-25,1971,Stoke City,Leicester City,3-1,3,1,1,1,4,2,H
1971-08-28,1971,Arsenal,Stoke City,0-1,0,1,1,1,1,-1,A
1971-08-28,1971,Coventry City,Newcastle United,1-0,1,0,1,1,1,1,H
1971-08-28,1971,Crystal Palace,Nottingham Forest,1-1,1,1,1,1,2,0,D
1971-08-28,1971,Derby County,Southampton,2-2,2,2,1,1,4,0,D
1971-08-28,1971,Huddersfield Town,Chelsea,1-2,1,2,1,1,3,-1,A
1971-08-28,1971,Ipswich Town,Leeds United,0-2,0,2,1,1,2,-2,A
1971-08-28,1971,Liverpool,Leicester City,3-2,3,2,1,1,5,1,H
1971-08-28,1971,Manchester City,Tottenham Hotspur,4-0,4,0,1,1,4,4,H
1971-08-28,1971,Sheffield United,West Bromwich Albion,0-0,0,0,1,1,0,0,D
1971-08-28,1971,West Ham United,Everton,1-0,1,0,1,1,1,1,H
1971-08-28,1971,Wolverhampton Wanderers,Manchester United,1-1,1,1,1,1,2,0,D
1971-08-30,1971,West Ham United,Coventry City,4-0,4,0,1,1,4,4,H
1971-08-31,1971,Everton,Manchester United,1-0,1,0,1,1,1,1,H
1971-08-31,1971,Ipswich Town,Derby County,0-0,0,0,1,1,0,0,D
1971-08-31,1971,Nottingham Forest,Stoke City,0-0,0,0,1,1,0,0,D
1971-08-31,1971,Sheffield United,Huddersfield Town,3-1,3,1,1,1,4,2,H
1971-08-31,1971,Wolverhampton Wanderers,Crystal Palace,1-0,1,0,1,1,1,1,H
1971-09-01,1971,Chelsea,West Bromwich Albion,1-0,1,0,1,1,1,1,H
1971-09-01,1971,Leeds United,Newcastle United,5-1,5,1,1,1,6,4,H
1971-09-01,1971,Leicester City,Southampton,0-1,0,1,1,1,1,-1,A
1971-09-01,1971,Manchester City,Liverpool,1-0,1,0,1,1,1,1,H
1971-09-04,1971,Chelsea,Coventry City,3-3,3,3,1,1,6,0,D
1971-09-04,1971,Everton,Derby County,0-2,0,2,1,1,2,-2,A
1971-09-04,1971,Leeds United,Crystal Palace,2-0,2,0,1,1,2,2,H
1971-09-04,1971,Leicester City,Manchester City,0-0,0,0,1,1,0,0,D
1971-09-04,1971,Manchester United,Ipswich Town,1-0,1,0,1,1,1,1,H
1971-09-04,1971,Newcastle United,West Ham United,2-2,2,2,1,1,4,0,D
1971-09-04,1971,Nottingham Forest,Sheffield United,2-3,2,3,1,1,5,-1,A
1971-09-04,1971,Southampton,Huddersfield Town,1-2,1,2,1,1,3,-1,A
1971-09-04,1971,Stoke City,Wolverhampton Wanderers,0-1,0,1,1,1,1,-1,A
1971-09-04,1971,Tottenham Hotspur,Liverpool,2-0,2,0,1,1,2,2,H
1971-09-04,1971,West Bromwich Albion,Arsenal,0-1,0,1,1,1,1,-1,A
1971-09-11,1971,Arsenal,Leeds United,2-0,2,0,1,1,2,2,H
1971-09-11,1971,Coventry City,Nottingham Forest,1-1,1,1,1,1,2,0,D
1971-09-11,1971,Crystal Palace,Manchester United,1-3,1,3,1,1,4,-2,A
1971-09-11,1971,Derby County,Stoke City,4-0,4,0,1,1,4,4,H
1971-09-11,1971,Huddersfield Town,West Bromwich Albion,1-0,1,0,1,1,1,1,H
1971-09-11,1971,Ipswich Town,Leicester City,1-2,1,2,1,1,3,-1,A
1971-09-11,1971,Liverpool,Southampton,1-0,1,0,1,1,1,1,H
1971-09-11,1971,Manchester City,Newcastle United,2-1,2,1,1,1,3,1,H
1971-09-11,1971,Sheffield United,Tottenham Hotspur,2-2,2,2,1,1,4,0,D
1971-09-11,1971,West Ham United,Chelsea,2-1,2,1,1,1,3,1,H
1971-09-11,1971,Wolverhampton Wanderers,Everton,1-1,1,1,1,1,2,0,D
1971-09-18,1971,Chelsea,Derby County,1-1,1,1,1,1,2,0,D
1971-09-18,1971,Everton,Arsenal,2-1,2,1,1,1,3,1,H
1971-09-18,1971,Leeds United,Liverpool,1-0,1,0,1,1,1,1,H
1971-09-18,1971,Leicester City,Sheffield United,0-1,0,1,1,1,1,-1,A
1971-09-18,1971,Manchester United,West Ham United,4-2,4,2,1,1,6,2,H
1971-09-18,1971,Newcastle United,Wolverhampton Wanderers,2-0,2,0,1,1,2,2,H
1971-09-18,1971,Nottingham Forest,Manchester City,2-2,2,2,1,1,4,0,D
1971-09-18,1971,Southampton,Coventry City,3-1,3,1,1,1,4,2,H
1971-09-18,1971,Stoke City,Huddersfield Town,1-0,1,0,1,1,1,1,H
1971-09-18,1971,Tottenham Hotspur,Crystal Palace,3-0,3,0,1,1,3,3,H
1971-09-18,1971,West Bromwich Albion,Ipswich Town,1-2,1,2,1,1,3,-1,A
1971-09-25,1971,Arsenal,Leicester City,3-0,3,0,1,1,3,3,H
1971-09-25,1971,Coventry City,Tottenham Hotspur,1-0,1,0,1,1,1,1,H
1971-09-25,1971,Crystal Palace,Everton,2-1,2,1,1,1,3,1,H
1971-09-25,1971,Derby County,West Bromwich Albion,0-0,0,0,1,1,0,0,D
1971-09-25,1971,Huddersfield Town,Leeds United,2-1,2,1,1,1,3,1,H
1971-09-25,1971,Ipswich Town,Newcastle United,0-0,0,0,1,1,0,0,D
1971-09-25,1971,Liverpool,Manchester United,2-2,2,2,1,1,4,0,D
1971-09-25,1971,Manchester City,Southampton,3-0,3,0,1,1,3,3,H
1971-09-25,1971,Sheffield United,Chelsea,1-0,1,0,1,1,1,1,H
1971-09-25,1971,West Ham United,Stoke City,2-1,2,1,1,1,3,1,H
1971-09-25,1971,Wolverhampton Wanderers,Nottingham Forest,4-2,4,2,1,1,6,2,H
1971-10-02,1971,Chelsea,Wolverhampton Wanderers,3-1,3,1,1,1,4,2,H
1971-10-02,1971,Everton,Coventry City,1-2,1,2,1,1,3,-1,A
1971-10-02,1971,Leeds United,West Ham United,0-0,0,0,1,1,0,0,D
1971-10-02,1971,Leicester City,Crystal Palace,0-0,0,0,1,1,0,0,D
1971-10-02,1971,Manchester United,Sheffield United,2-0,2,0,1,1,2,2,H
1971-10-02,1971,Newcastle United,Derby County,0-1,0,1,1,1,1,-1,A
1971-10-02,1971,Nottingham Forest,Huddersfield Town,1-2,1,2,1,1,3,-1,A
1971-10-02,1971,Southampton,Arsenal,0-1,0,1,1,1,1,-1,A
1971-10-02,1971,Stoke City,Liverpool,0-0,0,0,1,1,0,0,D
1971-10-02,1971,Tottenham Hotspur,Ipswich Town,2-1,2,1,1,1,3,1,H
1971-10-02,1971,West Bromwich Albion,Manchester City,0-2,0,2,1,1,2,-2,A
1971-10-09,1971,Arsenal,Newcastle United,4-2,4,2,1,1,6,2,H
1971-10-09,1971,Coventry City,Leeds United,3-1,3,1,1,1,4,2,H
1971-10-09,1971,Crystal Palace,West Bromwich Albion,0-2,0,2,1,1,2,-2,A
1971-10-09,1971,Derby County,Tottenham Hotspur,2-2,2,2,1,1,4,0,D
1971-10-09,1971,Huddersfield Town,Manchester United,0-3,0,3,1,1,3,-3,A
1971-10-09,1971,Ipswich Town,Nottingham Forest,1-1,1,1,1,1,2,0,D
1971-10-09,1971,Liverpool,Chelsea,0-0,0,0,1,1,0,0,D
1971-10-09,1971,Manchester City,Everton,1-0,1,0,1,1,1,1,H
1971-10-09,1971,Sheffield United,Stoke City,2-3,2,3,1,1,5,-1,A
1971-10-09,1971,West Ham United,Leicester City,1-1,1,1,1,1,2,0,D
1971-10-09,1971,Wolverhampton Wanderers,Southampton,4-2,4,2,1,1,6,2,H
1971-10-16,1971,Chelsea,Arsenal,1-2,1,2,1,1,3,-1,A
1971-10-16,1971,Everton,Ipswich Town,1-1,1,1,1,1,2,0,D
1971-10-16,1971,Leeds United,Manchester City,3-0,3,0,1,1,3,3,H
1971-10-16,1971,Leicester City,Huddersfield Town,2-0,2,0,1,1,2,2,H
1971-10-16,1971,Manchester United,Derby County,1-0,1,0,1,1,1,1,H
1971-10-16,1971,Newcastle United,Crystal Palace,1-2,1,2,1,1,3,-1,A
1971-10-16,1971,Nottingham Forest,Liverpool,2-3,2,3,1,1,5,-1,A
1971-10-16,1971,Southampton,Sheffield United,3-2,3,2,1,1,5,1,H
1971-10-16,1971,Stoke City,Coventry City,1-0,1,0,1,1,1,1,H
1971-10-16,1971,Tottenham Hotspur,Wolverhampton Wanderers,4-1,4,1,1,1,5,3,H
1971-10-16,1971,West Bromwich Albion,West Ham United,0-0,0,0,1,1,0,0,D
1971-10-22,1971,Coventry City,Crystal Palace,1-1,1,1,1,1,2,0,D
1971-10-23,1971,Chelsea,Southampton,3-0,3,0,1,1,3,3,H
1971-10-23,1971,Derby County,Arsenal,2-1,2,1,1,1,3,1,H
1971-10-23,1971,Ipswich Town,Stoke City,2-1,2,1,1,1,3,1,H
1971-10-23,1971,Leeds United,Everton,3-2,3,2,1,1,5,1,H
1971-10-23,1971,Liverpool,Huddersfield Town,2-0,2,0,1,1,2,2,H
1971-10-23,1971,Manchester City,Sheffield United,2-1,2,1,1,1,3,1,H
1971-10-23,1971,Newcastle United,Manchester United,0-1,0,1,1,1,1,-1,A
1971-10-23,1971,Tottenham Hotspur,Nottingham Forest,6-1,6,1,1,1,7,5,H
1971-10-23,1971,West Bromwich Albion,Leicester City,0-1,0,1,1,1,1,-1,A
1971-10-23,1971,West Ham United,Wolverhampton Wanderers,1-0,1,0,1,1,1,1,H
1971-10-26,1971,Huddersfield Town,Nottingham Forest,0-1,0,1,1,1,1,-1,A
1971-10-30,1971,Arsenal,Ipswich Town,2-1,2,1,1,1,3,1,H
1971-10-30,1971,Crystal Palace,West Ham United,0-3,0,3,1,1,3,-3,A
1971-10-30,1971,Everton,Newcastle United,1-0,1,0,1,1,1,1,H
1971-10-30,1971,Huddersfield Town,Manchester City,1-1,1,1,1,1,2,0,D
1971-10-30,1971,Leicester City,Chelsea,1-1,1,1,1,1,2,0,D
1971-10-30,1971,Manchester United,Leeds United,0-1,0,1,1,1,1,-1,A
1971-10-30,1971,Nottingham Forest,Derby County,0-2,0,2,1,1,2,-2,A
1971-10-30,1971,Sheffield United,Liverpool,1-1,1,1,1,1,2,0,D
1971-10-30,1971,Southampton,West Bromwich Albion,1-1,1,1,1,1,2,0,D
1971-10-30,1971,Stoke City,Tottenham Hotspur,2-0,2,0,1,1,2,2,H
1971-10-30,1971,Wolverhampton Wanderers,Coventry City,1-1,1,1,1,1,2,0,D
1971-11-06,1971,Chelsea,Nottingham Forest,2-0,2,0,1,1,2,2,H
1971-11-06,1971,Coventry City,Huddersfield Town,2-1,2,1,1,1,3,1,H
1971-11-06,1971,Derby County,Crystal Palace,3-0,3,0,1,1,3,3,H
1971-11-06,1971,Ipswich Town,Wolverhampton Wanderers,2-1,2,1,1,1,3,1,H
1971-11-06,1971,Leeds United,Leicester City,2-1,2,1,1,1,3,1,H
1971-11-06,1971,Liverpool,Arsenal,3-2,3,2,1,1,5,1,H
1971-11-06,1971,Manchester City,Manchester United,3-3,3,3,1,1,6,0,D
1971-11-06,1971,Newcastle United,Southampton,3-1,3,1,1,1,4,2,H
1971-11-06,1971,Tottenham Hotspur,Everton,3-0,3,0,1,1,3,3,H
1971-11-06,1971,West Bromwich Albion,Stoke City,0-1,0,1,1,1,1,-1,A
1971-11-06,1971,West Ham United,Sheffield United,1-2,1,2,1,1,3,-1,A
1971-11-13,1971,Arsenal,Manchester City,1-2,1,2,1,1,3,-1,A
1971-11-13,1971,Crystal Palace,Ipswich Town,1-1,1,1,1,1,2,0,D
1971-11-13,1971,Everton,Liverpool,1-0,1,0,1,1,1,1,H
1971-11-13,1971,Huddersfield Town,West Ham United,1-0,1,0,1,1,1,1,H
1971-11-13,1971,Leicester City,Newcastle United,3-0,3,0,1,1,3,3,H
1971-11-13,1971,Manchester United,Tottenham Hotspur,3-1,3,1,1,1,4,2,H
1971-11-13,1971,Nottingham Forest,West Bromwich Albion,4-1,4,1,1,1,5,3,H
1971-11-13,1971,Sheffield United,Coventry City,2-0,2,0,1,1,2,2,H
1971-11-13,1971,Southampton,Leeds United,2-1,2,1,1,1,3,1,H
1971-11-13,1971,Stoke City,Chelsea,0-1,0,1,1,1,1,-1,A
1971-11-13,1971,Wolverhampton Wanderers,Derby County,2-1,2,1,1,1,3,1,H
1971-11-20,1971,Coventry City,Liverpool,0-2,0,2,1,1,2,-2,A
1971-11-20,1971,Crystal Palace,Chelsea,2-3,2,3,1,1,5,-1,A
1971-11-20,1971,Derby County,Sheffield United,3-0,3,0,1,1,3,3,H
1971-11-20,1971,Everton,Southampton,8-0,8,0,1,1,8,8,H
1971-11-20,1971,Ipswich Town,Huddersfield Town,1-0,1,0,1,1,1,1,H
1971-11-20,1971,Leeds United,Stoke City,1-0,1,0,1,1,1,1,H
1971-11-20,1971,Manchester United,Leicester City,3-2,3,2,1,1,5,1,H
1971-11-20,1971,Newcastle United,Nottingham Forest,2-1,2,1,1,1,3,1,H
1971-11-20,1971,Tottenham Hotspur,West Bromwich Albion,3-2,3,2,1,1,5,1,H
1971-11-20,1971,West Ham United,Manchester City,0-2,0,2,1,1,2,-2,A
1971-11-20,1971,Wolverhampton Wanderers,Arsenal,5-1,5,1,1,1,6,4,H
1971-11-24,1971,Tottenham Hotspur,Arsenal,1-1,1,1,1,1,2,0,D
1971-11-27,1971,Arsenal,Crystal Palace,2-1,2,1,1,1,3,1,H
1971-11-27,1971,Chelsea,Tottenham Hotspur,1-0,1,0,1,1,1,1,H
1971-11-27,1971,Huddersfield Town,Derby County,2-1,2,1,1,1,3,1,H
1971-11-27,1971,Leicester City,Everton,0-0,0,0,1,1,0,0,D
1971-11-27,1971,Liverpool,West Ham United,1-0,1,0,1,1,1,1,H
1971-11-27,1971,Manchester City,Coventry City,4-0,4,0,1,1,4,4,H
1971-11-27,1971,Nottingham Forest,Leeds United,0-2,0,2,1,1,2,-2,A
1971-11-27,1971,Sheffield United,Ipswich Town,7-0,7,0,1,1,7,7,H
1971-11-27,1971,Southampton,Manchester United,2-5,2,5,1,1,7,-3,A
1971-11-27,1971,Stoke City,Newcastle United,3-3,3,3,1,1,6,0,D
1971-11-27,1971,West Bromwich Albion,Wolverhampton Wanderers,2-3,2,3,1,1,5,-1,A
1971-12-04,1971,Coventry City,Leicester City,1-1,1,1,1,1,2,0,D
1971-12-04,1971,Crystal Palace,Sheffield United,5-1,5,1,1,1,6,4,H
1971-12-04,1971,Derby County,Manchester City,3-1,3,1,1,1,4,2,H
1971-12-04,1971,Everton,Stoke City,0-0,0,0,1,1,0,0,D
1971-12-04,1971,Ipswich Town,Liverpool,0-0,0,0,1,1,0,0,D
1971-12-04,1971,Leeds United,West Bromwich Albion,3-0,3,0,1,1,3,3,H
1971-12-04,1971,Manchester United,Nottingham Forest,3-2,3,2,1,1,5,1,H
1971-12-04,1971,Newcastle United,Chelsea,0-0,0,0,1,1,0,0,D
1971-12-04,1971,Tottenham Hotspur,Southampton,1-0,1,0,1,1,1,1,H
1971-12-04,1971,West Ham United,Arsenal,0-0,0,0,1,1,0,0,D
1971-12-04,1971,Wolverhampton Wanderers,Huddersfield Town,2-2,2,2,1,1,4,0,D
1971-12-11,1971,Arsenal,Coventry City,2-0,2,0,1,1,2,2,H
1971-12-11,1971,Chelsea,Leeds United,0-0,0,0,1,1,0,0,D
1971-12-11,1971,Huddersfield Town,Crystal Palace,0-1,0,1,1,1,1,-1,A
1971-12-11,1971,Leicester City,Tottenham Hotspur,0-1,0,1,1,1,1,-1,A
1971-12-11,1971,Liverpool,Derby County,3-2,3,2,1,1,5,1,H
1971-12-11,1971,Manchester City,Ipswich Town,4-0,4,0,1,1,4,4,H
1971-12-11,1971,Nottingham Forest,Everton,1-0,1,0,1,1,1,1,H
1971-12-11,1971,Sheffield United,Wolverhampton Wanderers,2-2,2,2,1,1,4,0,D
1971-12-11,1971,Southampton,West Ham United,3-3,3,3,1,1,6,0,D
1971-12-11,1971,Stoke City,Manchester United,1-1,1,1,1,1,2,0,D
1971-12-11,1971,West Bromwich Albion,Newcastle United,0-3,0,3,1,1,3,-3,A
1971-12-17,1971,Coventry City,Chelsea,1-1,1,1,1,1,2,0,D
1971-12-18,1971,Arsenal,West Bromwich Albion,2-0,2,0,1,1,2,2,H
1971-12-18,1971,Crystal Palace,Leeds United,1-1,1,1,1,1,2,0,D
1971-12-18,1971,Derby County,Everton,2-0,2,0,1,1,2,2,H
1971-12-18,1971,Huddersfield Town,Southampton,0-2,0,2,1,1,2,-2,A
1971-12-18,1971,Ipswich Town,Manchester United,0-0,0,0,1,1,0,0,D
1971-12-18,1971,Liverpool,Tottenham Hotspur,0-0,0,0,1,1,0,0,D
1971-12-18,1971,Manchester City,Leicester City,1-1,1,1,1,1,2,0,D
1971-12-18,1971,Sheffield United,Nottingham Forest,2-1,2,1,1,1,3,1,H
1971-12-18,1971,West Ham United,Newcastle United,0-1,0,1,1,1,1,-1,A
1971-12-18,1971,Wolverhampton Wanderers,Stoke City,2-0,2,0,1,1,2,2,H
1971-12-27,1971,Chelsea,Ipswich Town,2-0,2,0,1,1,2,2,H
1971-12-27,1971,Everton,Huddersfield Town,2-2,2,2,1,1,4,0,D
1971-12-27,1971,Leeds United,Derby County,3-0,3,0,1,1,3,3,H
1971-12-27,1971,Leicester City,Wolverhampton Wanderers,1-2,1,2,1,1,3,-1,A
1971-12-27,1971,Manchester United,Coventry City,2-2,2,2,1,1,4,0,D
1971-12-27,1971,Newcastle United,Sheffield United,1-2,1,2,1,1,3,-1,A
1971-12-27,1971,Nottingham Forest,Arsenal,1-1,1,1,1,1,2,0,D
1971-12-27,1971,Southampton,Crystal Palace,1-0,1,0,1,1,1,1,H
1971-12-27,1971,Stoke City,Manchester City,1-3,1,3,1,1,4,-2,A
1971-12-27,1971,Tottenham Hotspur,West Ham United,0-1,0,1,1,1,1,-1,A
1971-12-27,1971,West Bromwich Albion,Liverpool,1-0,1,0,1,1,1,1,H
1972-01-01,1971,Arsenal,Everton,1-1,1,1,1,1,2,0,D
1972-01-01,1971,Coventry City,Southampton,1-0,1,0,1,1,1,1,H
1972-01-01,1971,Crystal Palace,Tottenham Hotspur,1-1,1,1,1,1,2,0,D
1972-01-01,1971,Derby County,Chelsea,1-0,1,0,1,1,1,1,H
1972-01-01,1971,Huddersfield Town,Stoke City,0-0,0,0,1,1,0,0,D
1972-01-01,1971,Ipswich Town,West Bromwich Albion,2-3,2,3,1,1,5,-1,A
1972-01-01,1971,Liverpool,Leeds United,0-2,0,2,1,1,2,-2,A
1972-01-01,1971,Manchester City,Nottingham Forest,2-2,2,2,1,1,4,0,D
1972-01-01,1971,Sheffield United,Leicester City,1-1,1,1,1,1,2,0,D
1972-01-01,1971,West Ham United,Manchester United,3-0,3,0,1,1,3,3,H
1972-01-01,1971,Wolverhampton Wanderers,Newcastle United,2-0,2,0,1,1,2,2,H
1972-01-08,1971,Chelsea,Huddersfield Town,2-2,2,2,1,1,4,0,D
1972-01-08,1971,Everton,West Ham United,2-1,2,1,1,1,3,1,H
1972-01-08,1971,Leeds United,Ipswich Town,2-2,2,2,1,1,4,0,D
1972-01-08,1971,Leicester City,Liverpool,1-0,1,0,1,1,1,1,H
1972-01-08,1971,Manchester United,Wolverhampton Wanderers,1-3,1,3,1,1,4,-2,A
1972-01-08,1971,Newcastle United,Coventry City,4-2,4,2,1,1,6,2,H
1972-01-08,1971,Nottingham Forest,Crystal Palace,0-1,0,1,1,1,1,-1,A
1972-01-08,1971,Southampton,Derby County,1-2,1,2,1,1,3,-1,A
1972-01-08,1971,Stoke City,Arsenal,0-0,0,0,1,1,0,0,D
1972-01-08,1971,Tottenham Hotspur,Manchester City,1-1,1,1,1,1,2,0,D
1972-01-08,1971,West Bromwich Albion,Sheffield United,2-2,2,2,1,1,4,0,D
1972-01-22,1971,Arsenal,Huddersfield Town,1-0,1,0,1,1,1,1,H
1972-01-22,1971,Coventry City,Ipswich Town,1-1,1,1,1,1,2,0,D
1972-01-22,1971,Crystal Palace,Manchester City,1-2,1,2,1,1,3,-1,A
1972-01-22,1971,Everton,West Bromwich Albion,2-1,2,1,1,1,3,1,H
1972-01-22,1971,Leeds United,Sheffield United,1-0,1,0,1,1,1,1,H
1972-01-22,1971,Manchester United,Chelsea,0-1,0,1,1,1,1,-1,A
1972-01-22,1971,Newcastle United,Tottenham Hotspur,3-1,3,1,1,1,4,2,H
1972-01-22,1971,Nottingham Forest,Leicester City,1-2,1,2,1,1,3,-1,A
1972-01-22,1971,Stoke City,Southampton,3-1,3,1,1,1,4,2,H
1972-01-22,1971,West Ham United,Derby County,3-3,3,3,1,1,6,0,D
1972-01-22,1971,Wolverhampton Wanderers,Liverpool,0-0,0,0,1,1,0,0,D
1972-01-29,1971,Chelsea,Everton,4-0,4,0,1,1,4,4,H
1972-01-29,1971,Derby County,Coventry City,1-0,1,0,1,1,1,1,H
1972-01-29,1971,Huddersfield Town,Newcastle United,0-0,0,0,1,1,0,0,D
1972-01-29,1971,Ipswich Town,West Ham United,1-0,1,0,1,1,1,1,H
1972-01-29,1971,Leicester City,Stoke City,2-1,2,1,1,1,3,1,H
1972-01-29,1971,Liverpool,Crystal Palace,4-1,4,1,1,1,5,3,H
1972-01-29,1971,Manchester City,Wolverhampton Wanderers,5-2,5,2,1,1,7,3,H
1972-01-29,1971,Sheffield United,Arsenal,0-5,0,5,1,1,5,-5,A
1972-01-29,1971,Southampton,Nottingham Forest,4-1,4,1,1,1,5,3,H
1972-01-29,1971,Tottenham Hotspur,Leeds United,1-0,1,0,1,1,1,1,H
1972-01-29,1971,West Bromwich Albion,Manchester United,2-1,2,1,1,1,3,1,H
1972-02-12,1971,Arsenal,Derby County,2-0,2,0,1,1,2,2,H
1972-02-12,1971,Crystal Palace,Coventry City,2-2,2,2,1,1,4,0,D
1972-02-12,1971,Everton,Leeds United,0-0,0,0,1,1,0,0,D
1972-02-12,1971,Huddersfield Town,Liverpool,0-1,0,1,1,1,1,-1,A
1972-02-12,1971,Leicester City,West Bromwich Albion,0-1,0,1,1,1,1,-1,A
1972-02-12,1971,Manchester United,Newcastle United,0-2,0,2,1,1,2,-2,A
1972-02-12,1971,Nottingham Forest,Tottenham Hotspur,0-1,0,1,1,1,1,-1,A
1972-02-12,1971,Sheffield United,Manchester City,3-3,3,3,1,1,6,0,D
1972-02-12,1971,Stoke City,Ipswich Town,3-3,3,3,1,1,6,0,D
1972-02-12,1971,Wolverhampton Wanderers,West Ham United,1-0,1,0,1,1,1,1,H
1972-02-19,1971,Chelsea,Leicester City,2-1,2,1,1,1,3,1,H
1972-02-19,1971,Coventry City,Wolverhampton Wanderers,0-0,0,0,1,1,0,0,D
1972-02-19,1971,Derby County,Nottingham Forest,4-0,4,0,1,1,4,4,H
1972-02-19,1971,Ipswich Town,Arsenal,0-1,0,1,1,1,1,-1,A
1972-02-19,1971,Leeds United,Manchester United,5-1,5,1,1,1,6,4,H
1972-02-19,1971,Liverpool,Sheffield United,2-0,2,0,1,1,2,2,H
1972-02-19,1971,Manchester City,Huddersfield Town,1-0,1,0,1,1,1,1,H
1972-02-19,1971,Newcastle United,Everton,0-0,0,0,1,1,0,0,D
1972-02-19,1971,Tottenham Hotspur,Stoke City,2-0,2,0,1,1,2,2,H
1972-02-19,1971,West Bromwich Albion,Southampton,3-2,3,2,1,1,5,1,H
1972-02-19,1971,West Ham United,Crystal Palace,1-1,1,1,1,1,2,0,D
1972-02-26,1971,Liverpool,Manchester City,3-0,3,0,1,1,3,3,H
1972-02-26,1971,Southampton,Newcastle United,1-2,1,2,1,1,3,-1,A
1972-02-26,1971,Wolverhampton Wanderers,Ipswich Town,2-2,2,2,1,1,4,0,D
1972-02-29,1971,Sheffield United,West Ham United,3-0,3,0,1,1,3,3,H
1972-03-01,1971,Everton,Tottenham Hotspur,1-1,1,1,1,1,2,0,D
1972-03-01,1971,Manchester City,West Bromwich Albion,2-1,2,1,1,1,3,1,H
1972-03-04,1971,Derby County,Wolverhampton Wanderers,2-1,2,1,1,1,3,1,H
1972-03-04,1971,Ipswich Town,Crystal Palace,0-2,0,2,1,1,2,-2,A
1972-03-04,1971,Leeds United,Southampton,7-0,7,0,1,1,7,7,H
1972-03-04,1971,Liverpool,Everton,4-0,4,0,1,1,4,4,H
1972-03-04,1971,Manchester City,Arsenal,2-0,2,0,1,1,2,2,H
1972-03-04,1971,Newcastle United,Leicester City,2-0,2,0,1,1,2,2,H
1972-03-04,1971,Tottenham Hotspur,Manchester United,2-0,2,0,1,1,2,2,H
1972-03-04,1971,West Bromwich Albion,Nottingham Forest,1-0,1,0,1,1,1,1,H
1972-03-04,1971,West Ham United,Huddersfield Town,3-0,3,0,1,1,3,3,H
1972-03-08,1971,Manchester United,Everton,0-0,0,0,1,1,0,0,D
1972-03-11,1971,Chelsea,Liverpool,0-0,0,0,1,1,0,0,D
1972-03-11,1971,Everton,Manchester City,1-2,1,2,1,1,3,-1,A
1972-03-11,1971,Leeds United,Coventry City,1-0,1,0,1,1,1,1,H
1972-03-11,1971,Leicester City,West Ham United,2-0,2,0,1,1,2,2,H
1972-03-11,1971,Manchester United,Huddersfield Town,2-0,2,0,1,1,2,2,H
1972-03-11,1971,Newcastle United,Arsenal,2-0,2,0,1,1,2,2,H
1972-03-11,1971,Nottingham Forest,Ipswich Town,0-2,0,2,1,1,2,-2,A
1972-03-11,1971,Southampton,Wolverhampton Wanderers,1-2,1,2,1,1,3,-1,A
1972-03-11,1971,Stoke City,Sheffield United,2-2,2,2,1,1,4,0,D
1972-03-11,1971,Tottenham Hotspur,Derby County,0-1,0,1,1,1,1,-1,A
1972-03-11,1971,West Bromwich Albion,Crystal Palace,1-1,1,1,1,1,2,0,D
1972-03-14,1971,Nottingham Forest,Chelsea,2-1,2,1,1,1,3,1,H
1972-03-17,1971,Coventry City,West Bromwich Albion,0-2,0,2,1,1,2,-2,A
1972-03-18,1971,Crystal Palace,Wolverhampton Wanderers,0-2,0,2,1,1,2,-2,A
1972-03-18,1971,Derby County,Leicester City,3-0,3,0,1,1,3,3,H
1972-03-18,1971,Ipswich Town,Southampton,1-1,1,1,1,1,2,0,D
1972-03-18,1971,Liverpool,Newcastle United,5-0,5,0,1,1,5,5,H
1972-03-18,1971,Manchester City,Chelsea,1-0,1,0,1,1,1,1,H
1972-03-18,1971,Sheffield United,Everton,1-1,1,1,1,1,2,0,D
1972-03-18,1971,West Ham United,Nottingham Forest,4-2,4,2,1,1,6,2,H
1972-03-21,1971,Coventry City,West Ham United,1-1,1,1,1,1,2,0,D
1972-03-21,1971,Everton,Crystal Palace,0-0,0,0,1,1,0,0,D
1972-03-21,1971,Huddersfield Town,Sheffield United,0-0,0,0,1,1,0,0,D
1972-03-22,1971,Derby County,Ipswich Town,1-0,1,0,1,1,1,1,H
1972-03-22,1971,Leicester City,Leeds United,0-0,0,0,1,1,0,0,D
1972-03-25,1971,Chelsea,West Ham United,3-1,3,1,1,1,4,2,H
1972-03-25,1971,Everton,Wolverhampton Wanderers,2-2,2,2,1,1,4,0,D
1972-03-25,1971,Leeds United,Arsenal,3-0,3,0,1,1,3,3,H
1972-03-25,1971,Leicester City,Ipswich Town,1-0,1,0,1,1,1,1,H
1972-03-25,1971,Manchester United,Crystal Palace,4-0,4,0,1,1,4,4,H
1972-03-25,1971,Newcastle United,Manchester City,0-0,0,0,1,1,0,0,D
1972-03-25,1971,Nottingham Forest,Coventry City,4-0,4,0,1,1,4,4,H
1972-03-25,1971,Southampton,Liverpool,0-1,0,1,1,1,1,-1,A
1972-03-25,1971,Stoke City,Derby County,1-1,1,1,1,1,2,0,D
1972-03-25,1971,Tottenham Hotspur,Sheffield United,2-0,2,0,1,1,2,2,H
1972-03-25,1971,West Bromwich Albion,Huddersfield Town,1-1,1,1,1,1,2,0,D
1972-03-27,1971,Leeds United,Nottingham Forest,6-1,6,1,1,1,7,5,H
1972-03-28,1971,Arsenal,Southampton,1-0,1,0,1,1,1,1,H
1972-03-28,1971,Crystal Palace,Derby County,0-1,0,1,1,1,1,-1,A
1972-03-28,1971,Huddersfield Town,Tottenham Hotspur,1-1,1,1,1,1,2,0,D
1972-03-28,1971,Liverpool,Stoke City,2-1,2,1,1,1,3,1,H
1972-03-29,1971,Chelsea,Sheffield United,2-0,2,0,1,1,2,2,H
1972-03-31,1971,Tottenham Hotspur,Coventry City,1-0,1,0,1,1,1,1,H
1972-03-31,1971,West Ham United,Leeds United,2-2,2,2,1,1,4,0,D
1972-04-01,1971,Arsenal,Nottingham Forest,3-0,3,0,1,1,3,3,H
1972-04-01,1971,Coventry City,Manchester United,2-3,2,3,1,1,5,-1,A
1972-04-01,1971,Crystal Palace,Southampton,2-3,2,3,1,1,5,-1,A
1972-04-01,1971,Derby County,Leeds United,2-0,2,0,1,1,2,2,H
1972-04-01,1971,Huddersfield Town,Everton,0-0,0,0,1,1,0,0,D
1972-04-01,1971,Ipswich Town,Chelsea,1-2,1,2,1,1,3,-1,A
1972-04-01,1971,Liverpool,West Bromwich Albion,2-0,2,0,1,1,2,2,H
1972-04-01,1971,Manchester City,Stoke City,1-2,1,2,1,1,3,-1,A
1972-04-01,1971,Sheffield United,Newcastle United,1-0,1,0,1,1,1,1,H
1972-04-01,1971,West Ham United,Tottenham Hotspur,2-0,2,0,1,1,2,2,H
1972-04-01,1971,Wolverhampton Wanderers,Leicester City,0-1,0,1,1,1,1,-1,A
1972-04-03,1971,Crystal Palace,Leicester City,1-1,1,1,1,1,2,0,D
1972-04-03,1971,Derby County,Newcastle United,0-1,0,1,1,1,1,-1,A
1972-04-03,1971,Ipswich Town,Tottenham Hotspur,2-1,2,1,1,1,3,1,H
1972-04-03,1971,Manchester United,Liverpool,0-3,0,3,1,1,3,-3,A
1972-04-04,1971,Coventry City,Everton,4-1,4,1,1,1,5,3,H
1972-04-04,1971,Leicester City,Arsenal,0-0,0,0,1,1,0,0,D
1972-04-04,1971,Sheffield United,Manchester United,1-1,1,1,1,1,2,0,D
1972-04-04,1971,Southampton,Manchester City,2-0,2,0,1,1,2,2,H
1972-04-04,1971,Stoke City,West Ham United,0-0,0,0,1,1,0,0,D
1972-04-05,1971,Leeds United,Huddersfield Town,3-1,3,1,1,1,4,2,H
1972-04-05,1971,Newcastle United,Ipswich Town,0-1,0,1,1,1,1,-1,A
1972-04-05,1971,West Bromwich Albion,Derby County,0-0,0,0,1,1,0,0,D
1972-04-08,1971,Arsenal,Wolverhampton Wanderers,2-1,2,1,1,1,3,1,H
1972-04-08,1971,Chelsea,Crystal Palace,2-1,2,1,1,1,3,1,H
1972-04-08,1971,Huddersfield Town,Ipswich Town,1-3,1,3,1,1,4,-2,A
1972-04-08,1971,Leicester City,Manchester United,2-0,2,0,1,1,2,2,H
1972-04-08,1971,Liverpool,Coventry City,3-1,3,1,1,1,4,2,H
1972-04-08,1971,Manchester City,West Ham United,3-1,3,1,1,1,4,2,H
1972-04-08,1971,Nottingham Forest,Newcastle United,1-0,1,0,1,1,1,1,H
1972-04-08,1971,Sheffield United,Derby County,0-4,0,4,1,1,4,-4,A
1972-04-08,1971,Southampton,Everton,0-1,0,1,1,1,1,-1,A
1972-04-08,1971,Stoke City,Leeds United,0-3,0,3,1,1,3,-3,A
1972-04-08,1971,West Bromwich Albion,Tottenham Hotspur,1-1,1,1,1,1,2,0,D
1972-04-10,1971,Stoke City,Nottingham Forest,0-2,0,2,1,1,2,-2,A
1972-04-11,1971,Crystal Palace,Arsenal,2-2,2,2,1,1,4,0,D
1972-04-11,1971,Huddersfield Town,Coventry City,0-1,0,1,1,1,1,-1,A
1972-04-11,1971,Southampton,Leicester City,1-0,1,0,1,1,1,1,H
1972-04-12,1971,Manchester United,Manchester City,1-3,1,3,1,1,4,-2,A
1972-04-12,1971,Wolverhampton Wanderers,Chelsea,0-2,0,2,1,1,2,-2,A
1972-04-15,1971,Coventry City,Manchester City,1-1,1,1,1,1,2,0,D
1972-04-15,1971,Derby County,Huddersfield Town,3-0,3,0,1,1,3,3,H
1972-04-15,1971,Everton,Leicester City,0-0,0,0,1,1,0,0,D
1972-04-15,1971,Ipswich Town,Sheffield United,0-0,0,0,1,1,0,0,D
1972-04-15,1971,Manchester United,Southampton,3-2,3,2,1,1,5,1,H
1972-04-15,1971,Tottenham Hotspur,Chelsea,3-0,3,0,1,1,3,3,H
1972-04-15,1971,West Ham United,Liverpool,0-2,0,2,1,1,2,-2,A
1972-04-15,1971,Wolverhampton Wanderers,West Bromwich Albion,0-1,0,1,1,1,1,-1,A
1972-04-18,1971,Coventry City,Sheffield United,3-2,3,2,1,1,5,1,H
1972-04-18,1971,Ipswich Town,Manchester City,2-1,2,1,1,1,3,1,H
1972-04-18,1971,Southampton,Chelsea,2-2,2,2,1,1,4,0,D
1972-04-19,1971,Newcastle United,Leeds United,1-0,1,0,1,1,1,1,H
1972-04-22,1971,Arsenal,West Ham United,2-1,2,1,1,1,3,1,H
1972-04-22,1971,Chelsea,Newcastle United,3-3,3,3,1,1,6,0,D
1972-04-22,1971,Huddersfield Town,Wolverhampton Wanderers,0-1,0,1,1,1,1,-1,A
1972-04-22,1971,Leicester City,Coventry City,1-0,1,0,1,1,1,1,H
1972-04-22,1971,Liverpool,Ipswich Town,2-0,2,0,1,1,2,2,H
1972-04-22,1971,Manchester City,Derby County,2-0,2,0,1,1,2,2,H
1972-04-22,1971,Nottingham Forest,Manchester United,0-0,0,0,1,1,0,0,D
1972-04-22,1971,Sheffield United,Crystal Palace,1-0,1,0,1,1,1,1,H
1972-04-22,1971,Southampton,Tottenham Hotspur,0-0,0,0,1,1,0,0,D
1972-04-22,1971,Stoke City,Everton,1-1,1,1,1,1,2,0,D
1972-04-22,1971,West Bromwich Albion,Leeds United,0-1,0,1,1,1,1,-1,A
1972-04-24,1971,Chelsea,Stoke City,2-0,2,0,1,1,2,2,H
1972-04-25,1971,Arsenal,Manchester United,3-0,3,0,1,1,3,3,H
1972-04-25,1971,Nottingham Forest,Wolverhampton Wanderers,1-3,1,3,1,1,4,-2,A
1972-04-26,1971,Crystal Palace,Stoke City,2-0,2,0,1,1,2,2,H
1972-04-27,1971,West Bromwich Albion,Chelsea,4-0,4,0,1,1,4,4,H
1972-04-28,1971,Wolverhampton Wanderers,Sheffield United,1-2,1,2,1,1,3,-1,A
1972-04-29,1971,Crystal Palace,Huddersfield Town,0-0,0,0,1,1,0,0,D
1972-04-29,1971,Manchester United,Stoke City,3-0,3,0,1,1,3,3,H
1972-04-29,1971,Tottenham Hotspur,Leicester City,4-3,4,3,1,1,7,1,H
1972-05-01,1971,Coventry City,Arsenal,0-1,0,1,1,1,1,-1,A
1972-05-01,1971,Derby County,Liverpool,1-0,1,0,1,1,1,1,H
1972-05-01,1971,Leeds United,Chelsea,2-0,2,0,1,1,2,2,H
1972-05-01,1971,West Ham United,Southampton,1-0,1,0,1,1,1,1,H
1972-05-02,1971,Everton,Nottingham Forest,1-1,1,1,1,1,2,0,D
1972-05-03,1971,Newcastle United,West Bromwich Albion,4-2,4,2,1,1,6,2,H
1972-05-05,1971,Stoke City,West Bromwich Albion,1-1,1,1,1,1,2,0,D
1972-05-08,1971,Arsenal,Liverpool,0-0,0,0,1,1,0,0,D
1972-05-08,1971,Newcastle United,Stoke City,0-0,0,0,1,1,0,0,D
1972-05-08,1971,Wolverhampton Wanderers,Leeds United,2-1,2,1,1,1,3,1,H
1972-05-11,1971,Arsenal,Tottenham Hotspur,0-2,0,2,1,1,2,-2,A
1972-08-12,1972,Birmingham City,Sheffield United,1-2,1,2,1,1,3,-1,A
1972-08-12,1972,Chelsea,Leeds United,4-0,4,0,1,1,4,4,H
1972-08-12,1972,Leicester City,Arsenal,0-1,0,1,1,1,1,-1,A
1972-08-12,1972,Liverpool,Manchester City,2-0,2,0,1,1,2,2,H
1972-08-12,1972,Manchester United,Ipswich Town,1-2,1,2,1,1,3,-1,A
1972-08-12,1972,Newcastle United,Wolverhampton Wanderers,2-1,2,1,1,1,3,1,H
1972-08-12,1972,Norwich City,Everton,1-1,1,1,1,1,2,0,D
1972-08-12,1972,Southampton,Derby County,1-1,1,1,1,1,2,0,D
1972-08-12,1972,Stoke City,Crystal Palace,2-0,2,0,1,1,2,2,H
1972-08-12,1972,Tottenham Hotspur,Coventry City,2-1,2,1,1,1,3,1,H
1972-08-12,1972,West Bromwich Albion,West Ham United,0-0,0,0,1,1,0,0,D
1972-08-14,1972,West Ham United,Coventry City,1-0,1,0,1,1,1,1,H
1972-08-15,1972,Arsenal,Wolverhampton Wanderers,5-2,5,2,1,1,7,3,H
1972-08-15,1972,Birmingham City,Newcastle United,3-2,3,2,1,1,5,1,H
1972-08-15,1972,Crystal Palace,Derby County,0-0,0,0,1,1,0,0,D
1972-08-15,1972,Ipswich Town,Norwich City,1-2,1,2,1,1,3,-1,A
1972-08-15,1972,Liverpool,Manchester United,2-0,2,0,1,1,2,2,H
1972-08-15,1972,Sheffield United,Leeds United,0-2,0,2,1,1,2,-2,A
1972-08-15,1972,Southampton,Stoke City,1-0,1,0,1,1,1,1,H
1972-08-16,1972,Leicester City,Chelsea,1-1,1,1,1,1,2,0,D
1972-08-16,1972,Manchester City,Everton,0-1,0,1,1,1,1,-1,A
1972-08-16,1972,West Bromwich Albion,Tottenham Hotspur,0-1,0,1,1,1,1,-1,A
1972-08-19,1972,Arsenal,Stoke City,2-0,2,0,1,1,2,2,H
1972-08-19,1972,Coventry City,Southampton,1-1,1,1,1,1,2,0,D
1972-08-19,1972,Crystal Palace,Liverpool,1-1,1,1,1,1,2,0,D
1972-08-19,1972,Derby County,Chelsea,1-2,1,2,1,1,3,-1,A
1972-08-19,1972,Everton,Manchester United,2-0,2,0,1,1,2,2,H
1972-08-19,1972,Ipswich Town,Birmingham City,2-0,2,0,1,1,2,2,H
1972-08-19,1972,Leeds United,West Bromwich Albion,2-0,2,0,1,1,2,2,H
1972-08-19,1972,Manchester City,Norwich City,3-0,3,0,1,1,3,3,H
1972-08-19,1972,Sheffield United,Newcastle United,1-2,1,2,1,1,3,-1,A
1972-08-19,1972,West Ham United,Leicester City,5-2,5,2,1,1,7,3,H
1972-08-19,1972,Wolverhampton Wanderers,Tottenham Hotspur,3-2,3,2,1,1,5,1,H
1972-08-22,1972,Coventry City,Arsenal,1-1,1,1,1,1,2,0,D
1972-08-22,1972,Everton,Crystal Palace,1-1,1,1,1,1,2,0,D
1972-08-22,1972,Wolverhampton Wanderers,West Ham United,3-0,3,0,1,1,3,3,H
1972-08-23,1972,Chelsea,Liverpool,1-2,1,2,1,1,3,-1,A
1972-08-23,1972,Derby County,Manchester City,1-0,1,0,1,1,1,1,H
1972-08-23,1972,Leeds United,Ipswich Town,3-3,3,3,1,1,6,0,D
1972-08-23,1972,Manchester United,Leicester City,1-1,1,1,1,1,2,0,D
1972-08-23,1972,Newcastle United,West Bromwich Albion,1-1,1,1,1,1,2,0,D
1972-08-23,1972,Norwich City,Southampton,0-0,0,0,1,1,0,0,D
1972-08-23,1972,Stoke City,Sheffield United,2-2,2,2,1,1,4,0,D
1972-08-23,1972,Tottenham Hotspur,Birmingham City,2-0,2,0,1,1,2,2,H
1972-08-26,1972,Birmingham City,Crystal Palace,1-1,1,1,1,1,2,0,D
1972-08-26,1972,Chelsea,Manchester City,2-1,2,1,1,1,3,1,H
1972-08-26,1972,Leicester City,Coventry City,0-0,0,0,1,1,0,0,D
1972-08-26,1972,Liverpool,West Ham United,3-2,3,2,1,1,5,1,H
1972-08-26,1972,Manchester United,Arsenal,0-0,0,0,1,1,0,0,D
1972-08-26,1972,Newcastle United,Ipswich Town,1-2,1,2,1,1,3,-1,A
1972-08-26,1972,Norwich City,Derby County,1-0,1,0,1,1,1,1,H
1972-08-26,1972,Southampton,Wolverhampton Wanderers,1-1,1,1,1,1,2,0,D
1972-08-26,1972,Stoke City,Everton,1-1,1,1,1,1,2,0,D
1972-08-26,1972,Tottenham Hotspur,Leeds United,0-0,0,0,1,1,0,0,D
1972-08-26,1972,West Bromwich Albion,Sheffield United,0-2,0,2,1,1,2,-2,A
1972-08-29,1972,Arsenal,West Ham United,1-0,1,0,1,1,1,1,H
1972-08-29,1972,Coventry City,Wolverhampton Wanderers,0-1,0,1,1,1,1,-1,A
1972-08-29,1972,Crystal Palace,Manchester City,1-0,1,0,1,1,1,1,H
1972-08-29,1972,Everton,Derby County,1-0,1,0,1,1,1,1,H
1972-08-29,1972,Sheffield United,Ipswich Town,0-0,0,0,1,1,0,0,D
1972-08-30,1972,Leeds United,Southampton,1-0,1,0,1,1,1,1,H
1972-08-30,1972,Leicester City,Liverpool,3-2,3,2,1,1,5,1,H
1972-08-30,1972,Manchester United,Chelsea,0-0,0,0,1,1,0,0,D
1972-08-30,1972,Newcastle United,Tottenham Hotspur,0-1,0,1,1,1,1,-1,A
1972-08-30,1972,Norwich City,Stoke City,2-0,2,0,1,1,2,2,H
1972-08-30,1972,West Bromwich Albion,Birmingham City,2-2,2,2,1,1,4,0,D
1972-09-02,1972,Arsenal,Chelsea,1-1,1,1,1,1,2,0,D
1972-09-02,1972,Coventry City,Stoke City,2-1,2,1,1,1,3,1,H
1972-09-02,1972,Crystal Palace,Newcastle United,2-1,2,1,1,1,3,1,H
1972-09-02,1972,Derby County,Liverpool,2-1,2,1,1,1,3,1,H
1972-09-02,1972,Everton,West Bromwich Albion,1-0,1,0,1,1,1,1,H
1972-09-02,1972,Ipswich Town,Tottenham Hotspur,1-1,1,1,1,1,2,0,D
1972-09-02,1972,Leeds United,Norwich City,2-0,2,0,1,1,2,2,H
1972-09-02,1972,Manchester City,Leicester City,1-0,1,0,1,1,1,1,H
1972-09-02,1972,Sheffield United,Southampton,3-1,3,1,1,1,4,2,H
1972-09-02,1972,West Ham United,Manchester United,2-2,2,2,1,1,4,0,D
1972-09-02,1972,Wolverhampton Wanderers,Birmingham City,3-2,3,2,1,1,5,1,H
1972-09-09,1972,Birmingham City,Manchester City,4-1,4,1,1,1,5,3,H
1972-09-09,1972,Chelsea,West Ham United,1-3,1,3,1,1,4,-2,A
1972-09-09,1972,Leicester City,Everton,1-2,1,2,1,1,3,-1,A
1972-09-09,1972,Liverpool,Wolverhampton Wanderers,4-2,4,2,1,1,6,2,H
1972-09-09,1972,Manchester United,Coventry City,0-1,0,1,1,1,1,-1,A
1972-09-09,1972,Newcastle United,Arsenal,2-1,2,1,1,1,3,1,H
1972-09-09,1972,Norwich City,Sheffield United,1-1,1,1,1,1,2,0,D
1972-09-09,1972,Southampton,Ipswich Town,1-2,1,2,1,1,3,-1,A
1972-09-09,1972,Stoke City,Leeds United,2-2,2,2,1,1,4,0,D
1972-09-09,1972,Tottenham Hotspur,Crystal Palace,2-1,2,1,1,1,3,1,H
1972-09-09,1972,West Bromwich Albion,Derby County,2-1,2,1,1,1,3,1,H
1972-09-16,1972,Arsenal,Liverpool,0-0,0,0,1,1,0,0,D
1972-09-16,1972,Coventry City,Newcastle United,0-3,0,3,1,1,3,-3,A
1972-09-16,1972,Crystal Palace,West Bromwich Albion,0-2,0,2,1,1,2,-2,A
1972-09-16,1972,Derby County,Birmingham City,1-0,1,0,1,1,1,1,H
1972-09-16,1972,Everton,Southampton,0-1,0,1,1,1,1,-1,A
1972-09-16,1972,Ipswich Town,Stoke City,2-0,2,0,1,1,2,2,H
1972-09-16,1972,Leeds United,Leicester City,3-1,3,1,1,1,4,2,H
1972-09-16,1972,Manchester City,Tottenham Hotspur,2-1,2,1,1,1,3,1,H
1972-09-16,1972,Sheffield United,Chelsea,2-1,2,1,1,1,3,1,H
1972-09-16,1972,West Ham United,Norwich City,4-0,4,0,1,1,4,4,H
1972-09-16,1972,Wolverhampton Wanderers,Manchester United,2-0,2,0,1,1,2,2,H
1972-09-23,1972,Birmingham City,Everton,2-1,2,1,1,1,3,1,H
1972-09-23,1972,Chelsea,Ipswich Town,2-0,2,0,1,1,2,2,H
1972-09-23,1972,Leicester City,Wolverhampton Wanderers,1-1,1,1,1,1,2,0,D
1972-09-23,1972,Liverpool,Sheffield United,5-0,5,0,1,1,5,5,H
1972-09-23,1972,Manchester United,Derby County,3-0,3,0,1,1,3,3,H
1972-09-23,1972,Newcastle United,Leeds United,3-2,3,2,1,1,5,1,H
1972-09-23,1972,Norwich City,Arsenal,3-2,3,2,1,1,5,1,H
1972-09-23,1972,Southampton,Crystal Palace,2-0,2,0,1,1,2,2,H
1972-09-23,1972,Stoke City,Manchester City,5-1,5,1,1,1,6,4,H
1972-09-23,1972,Tottenham Hotspur,West Ham United,1-0,1,0,1,1,1,1,H
1972-09-23,1972,West Bromwich Albion,Coventry City,1-0,1,0,1,1,1,1,H
1972-09-26,1972,Arsenal,Birmingham City,2-0,2,0,1,1,2,2,H
1972-09-30,1972,Arsenal,Southampton,1-0,1,0,1,1,1,1,H
1972-09-30,1972,Coventry City,Chelsea,1-3,1,3,1,1,4,-2,A
1972-09-30,1972,Crystal Palace,Norwich City,0-2,0,2,1,1,2,-2,A
1972-09-30,1972,Derby County,Tottenham Hotspur,2-1,2,1,1,1,3,1,H
1972-09-30,1972,Everton,Newcastle United,3-1,3,1,1,1,4,2,H
1972-09-30,1972,Ipswich Town,Leicester City,0-2,0,2,1,1,2,-2,A
1972-09-30,1972,Leeds United,Liverpool,1-2,1,2,1,1,3,-1,A
1972-09-30,1972,Manchester City,West Bromwich Albion,2-1,2,1,1,1,3,1,H
1972-09-30,1972,Sheffield United,Manchester United,1-0,1,0,1,1,1,1,H
1972-09-30,1972,West Ham United,Birmingham City,2-0,2,0,1,1,2,2,H
1972-09-30,1972,Wolverhampton Wanderers,Stoke City,5-3,5,3,1,1,8,2,H
1972-10-07,1972,Birmingham City,Chelsea,2-2,2,2,1,1,4,0,D
1972-10-07,1972,Crystal Palace,Coventry City,0-1,0,1,1,1,1,-1,A
1972-10-07,1972,Ipswich Town,West Ham United,1-1,1,1,1,1,2,0,D
1972-10-07,1972,Leeds United,Derby County,5-0,5,0,1,1,5,5,H
1972-10-07,1972,Leicester City,Southampton,1-0,1,0,1,1,1,1,H
1972-10-07,1972,Liverpool,Everton,1-0,1,0,1,1,1,1,H
1972-10-07,1972,Manchester City,Wolverhampton Wanderers,1-1,1,1,1,1,2,0,D
1972-10-07,1972,Newcastle United,Norwich City,3-1,3,1,1,1,4,2,H
1972-10-07,1972,Sheffield United,Arsenal,1-0,1,0,1,1,1,1,H
1972-10-07,1972,Tottenham Hotspur,Stoke City,4-3,4,3,1,1,7,1,H
1972-10-07,1972,West Bromwich Albion,Manchester United,2-2,2,2,1,1,4,0,D
1972-10-14,1972,Arsenal,Ipswich Town,1-0,1,0,1,1,1,1,H
1972-10-14,1972,Chelsea,West Bromwich Albion,3-1,3,1,1,1,4,2,H
1972-10-14,1972,Coventry City,Manchester City,3-2,3,2,1,1,5,1,H
1972-10-14,1972,Derby County,Leicester City,2-1,2,1,1,1,3,1,H
1972-10-14,1972,Everton,Leeds United,1-2,1,2,1,1,3,-1,A
1972-10-14,1972,Manchester United,Birmingham City,1-0,1,0,1,1,1,1,H
1972-10-14,1972,Norwich City,Tottenham Hotspur,2-1,2,1,1,1,3,1,H
1972-10-14,1972,Southampton,Liverpool,1-1,1,1,1,1,2,0,D
1972-10-14,1972,Stoke City,Newcastle United,2-0,2,0,1,1,2,2,H
1972-10-14,1972,West Ham United,Sheffield United,3-1,3,1,1,1,4,2,H
1972-10-14,1972,Wolverhampton Wanderers,Crystal Palace,1-1,1,1,1,1,2,0,D
1972-10-21,1972,Birmingham City,Southampton,1-1,1,1,1,1,2,0,D
1972-10-21,1972,Crystal Palace,Arsenal,2-3,2,3,1,1,5,-1,A
1972-10-21,1972,Ipswich Town,Derby County,3-1,3,1,1,1,4,2,H
1972-10-21,1972,Leeds United,Coventry City,1-1,1,1,1,1,2,0,D
1972-10-21,1972,Leicester City,Norwich City,1-2,1,2,1,1,3,-1,A
1972-10-21,1972,Liverpool,Stoke City,2-1,2,1,1,1,3,1,H
1972-10-21,1972,Manchester City,West Ham United,4-3,4,3,1,1,7,1,H
1972-10-21,1972,Newcastle United,Manchester United,2-1,2,1,1,1,3,1,H
1972-10-21,1972,Sheffield United,Everton,0-1,0,1,1,1,1,-1,A
1972-10-21,1972,Tottenham Hotspur,Chelsea,0-1,0,1,1,1,1,-1,A
1972-10-21,1972,West Bromwich Albion,Wolverhampton Wanderers,1-0,1,0,1,1,1,1,H
1972-10-28,1972,Arsenal,Manchester City,0-0,0,0,1,1,0,0,D
1972-10-28,1972,Chelsea,Newcastle United,1-1,1,1,1,1,2,0,D
1972-10-28,1972,Coventry City,Birmingham City,0-0,0,0,1,1,0,0,D
1972-10-28,1972,Derby County,Sheffield United,2-1,2,1,1,1,3,1,H
1972-10-28,1972,Everton,Ipswich Town,2-2,2,2,1,1,4,0,D
1972-10-28,1972,Manchester United,Tottenham Hotspur,1-4,1,4,1,1,5,-3,A
1972-10-28,1972,Norwich City,Liverpool,1-1,1,1,1,1,2,0,D
1972-10-28,1972,Southampton,West Bromwich Albion,2-1,2,1,1,1,3,1,H
1972-10-28,1972,Stoke City,Leicester City,1-0,1,0,1,1,1,1,H
1972-10-28,1972,West Ham United,Crystal Palace,4-0,4,0,1,1,4,4,H
1972-10-28,1972,Wolverhampton Wanderers,Leeds United,0-2,0,2,1,1,2,-2,A
1972-11-04,1972,Arsenal,Coventry City,0-2,0,2,1,1,2,-2,A
1972-11-04,1972,Birmingham City,Tottenham Hotspur,0-0,0,0,1,1,0,0,D
1972-11-04,1972,Crystal Palace,Everton,1-0,1,0,1,1,1,1,H
1972-11-04,1972,Ipswich Town,Leeds United,2-2,2,2,1,1,4,0,D
1972-11-04,1972,Leicester City,Manchester United,2-2,2,2,1,1,4,0,D
1972-11-04,1972,Liverpool,Chelsea,3-1,3,1,1,1,4,2,H
1972-11-04,1972,Manchester City,Derby County,4-0,4,0,1,1,4,4,H
1972-11-04,1972,Sheffield United,Stoke City,0-0,0,0,1,1,0,0,D
1972-11-04,1972,Southampton,Norwich City,1-0,1,0,1,1,1,1,H
1972-11-04,1972,West Bromwich Albion,Newcastle United,2-3,2,3,1,1,5,-1,A
1972-11-04,1972,West Ham United,Wolverhampton Wanderers,2-2,2,2,1,1,4,0,D
1972-11-11,1972,Chelsea,Leicester City,1-1,1,1,1,1,2,0,D
1972-11-11,1972,Coventry City,West Ham United,3-1,3,1,1,1,4,2,H
1972-11-11,1972,Derby County,Crystal Palace,2-2,2,2,1,1,4,0,D
1972-11-11,1972,Everton,Manchester City,2-3,2,3,1,1,5,-1,A
1972-11-11,1972,Leeds United,Sheffield United,2-1,2,1,1,1,3,1,H
1972-11-11,1972,Manchester United,Liverpool,2-0,2,0,1,1,2,2,H
1972-11-11,1972,Newcastle United,Birmingham City,3-0,3,0,1,1,3,3,H
1972-11-11,1972,Norwich City,Ipswich Town,0-0,0,0,1,1,0,0,D
1972-11-11,1972,Stoke City,Southampton,3-3,3,3,1,1,6,0,D
1972-11-11,1972,Tottenham Hotspur,West Bromwich Albion,1-1,1,1,1,1,2,0,D
1972-11-11,1972,Wolverhampton Wanderers,Arsenal,1-3,1,3,1,1,4,-2,A
1972-11-18,1972,Arsenal,Everton,1-0,1,0,1,1,1,1,H
1972-11-18,1972,Coventry City,Sheffield United,3-0,3,0,1,1,3,3,H
1972-11-18,1972,Crystal Palace,Leeds United,2-2,2,2,1,1,4,0,D
1972-11-18,1972,Leicester City,Tottenham Hotspur,0-1,0,1,1,1,1,-1,A
1972-11-18,1972,Liverpool,Newcastle United,3-2,3,2,1,1,5,1,H
1972-11-18,1972,Manchester City,Manchester United,3-0,3,0,1,1,3,3,H
1972-11-18,1972,Norwich City,West Bromwich Albion,2-0,2,0,1,1,2,2,H
1972-11-18,1972,Southampton,Chelsea,3-1,3,1,1,1,4,2,H
1972-11-18,1972,Stoke City,Birmingham City,1-2,1,2,1,1,3,-1,A
1972-11-18,1972,West Ham United,Derby County,1-2,1,2,1,1,3,-1,A
1972-11-18,1972,Wolverhampton Wanderers,Ipswich Town,0-1,0,1,1,1,1,-1,A
1972-11-25,1972,Birmingham City,Norwich City,4-1,4,1,1,1,5,3,H
1972-11-25,1972,Chelsea,Crystal Palace,0-0,0,0,1,1,0,0,D
1972-11-25,1972,Derby County,Arsenal,5-0,5,0,1,1,5,5,H
1972-11-25,1972,Everton,West Ham United,1-2,1,2,1,1,3,-1,A
1972-11-25,1972,Leeds United,Manchester City,3-0,3,0,1,1,3,3,H
1972-11-25,1972,Manchester United,Southampton,2-1,2,1,1,1,3,1,H
1972-11-25,1972,Sheffield United,Wolverhampton Wanderers,1-2,1,2,1,1,3,-1,A
1972-11-25,1972,Tottenham Hotspur,Liverpool,1-2,1,2,1,1,3,-1,A
1972-11-25,1972,West Bromwich Albion,Stoke City,2-1,2,1,1,1,3,1,H
1972-12-02,1972,Arsenal,Leeds United,2-1,2,1,1,1,3,1,H
1972-12-02,1972,Coventry City,Everton,1-0,1,0,1,1,1,1,H
1972-12-02,1972,Leicester City,West Bromwich Albion,3-1,3,1,1,1,4,2,H
1972-12-02,1972,Liverpool,Birmingham City,4-3,4,3,1,1,7,1,H
1972-12-02,1972,Manchester City,Ipswich Town,1-1,1,1,1,1,2,0,D
1972-12-02,1972,Norwich City,Manchester United,0-2,0,2,1,1,2,-2,A
1972-12-02,1972,Southampton,Tottenham Hotspur,1-1,1,1,1,1,2,0,D
1972-12-02,1972,Stoke City,Chelsea,1-1,1,1,1,1,2,0,D
1972-12-02,1972,West Ham United,Newcastle United,1-1,1,1,1,1,2,0,D
1972-12-02,1972,Wolverhampton Wanderers,Derby County,1-2,1,2,1,1,3,-1,A
1972-12-05,1972,Ipswich Town,Coventry City,2-0,2,0,1,1,2,2,H
1972-12-09,1972,Birmingham City,Leicester City,1-1,1,1,1,1,2,0,D
1972-12-09,1972,Chelsea,Norwich City,3-1,3,1,1,1,4,2,H
1972-12-09,1972,Derby County,Coventry City,2-0,2,0,1,1,2,2,H
1972-12-09,1972,Everton,Wolverhampton Wanderers,0-1,0,1,1,1,1,-1,A
1972-12-09,1972,Ipswich Town,Crystal Palace,2-1,2,1,1,1,3,1,H
1972-12-09,1972,Leeds United,West Ham United,1-0,1,0,1,1,1,1,H
1972-12-09,1972,Manchester United,Stoke City,0-2,0,2,1,1,2,-2,A
1972-12-09,1972,Newcastle United,Southampton,0-0,0,0,1,1,0,0,D
1972-12-09,1972,Sheffield United,Manchester City,1-1,1,1,1,1,2,0,D
1972-12-09,1972,Tottenham Hotspur,Arsenal,1-2,1,2,1,1,3,-1,A
1972-12-09,1972,West Bromwich Albion,Liverpool,1-1,1,1,1,1,2,0,D
1972-12-16,1972,Arsenal,West Bromwich Albion,2-1,2,1,1,1,3,1,H
1972-12-16,1972,Coventry City,Norwich City,3-1,3,1,1,1,4,2,H
1972-12-16,1972,Crystal Palace,Manchester United,5-0,5,0,1,1,5,5,H
1972-12-16,1972,Derby County,Newcastle United,1-1,1,1,1,1,2,0,D
1972-12-16,1972,Everton,Tottenham Hotspur,3-1,3,1,1,1,4,2,H
1972-12-16,1972,Ipswich Town,Liverpool,1-1,1,1,1,1,2,0,D
1972-12-16,1972,Leeds United,Birmingham City,4-0,4,0,1,1,4,4,H
1972-12-16,1972,Manchester City,Southampton,2-1,2,1,1,1,3,1,H
1972-12-16,1972,Sheffield United,Leicester City,2-0,2,0,1,1,2,2,H
1972-12-16,1972,West Ham United,Stoke City,3-2,3,2,1,1,5,1,H
1972-12-16,1972,Wolverhampton Wanderers,Chelsea,1-0,1,0,1,1,1,1,H
1972-12-23,1972,Birmingham City,Arsenal,1-1,1,1,1,1,2,0,D
1972-12-23,1972,Chelsea,Everton,1-1,1,1,1,1,2,0,D
1972-12-23,1972,Leicester City,Crystal Palace,2-1,2,1,1,1,3,1,H
1972-12-23,1972,Liverpool,Coventry City,2-0,2,0,1,1,2,2,H
1972-12-23,1972,Manchester United,Leeds United,1-1,1,1,1,1,2,0,D
1972-12-23,1972,Newcastle United,Manchester City,2-1,2,1,1,1,3,1,H
1972-12-23,1972,Norwich City,Wolverhampton Wanderers,1-1,1,1,1,1,2,0,D
1972-12-23,1972,Southampton,West Ham United,0-0,0,0,1,1,0,0,D
1972-12-23,1972,Stoke City,Derby County,4-0,4,0,1,1,4,4,H
1972-12-23,1972,Tottenham Hotspur,Sheffield United,2-0,2,0,1,1,2,2,H
1972-12-23,1972,West Bromwich Albion,Ipswich Town,2-0,2,0,1,1,2,2,H
1972-12-26,1972,Arsenal,Norwich City,2-0,2,0,1,1,2,2,H
1972-12-26,1972,Coventry City,West Bromwich Albion,0-0,0,0,1,1,0,0,D
1972-12-26,1972,Crystal Palace,Southampton,3-0,3,0,1,1,3,3,H
1972-12-26,1972,Derby County,Manchester United,3-1,3,1,1,1,4,2,H
1972-12-26,1972,Everton,Birmingham City,1-1,1,1,1,1,2,0,D
1972-12-26,1972,Ipswich Town,Chelsea,3-0,3,0,1,1,3,3,H
1972-12-26,1972,Leeds United,Newcastle United,1-0,1,0,1,1,1,1,H
1972-12-26,1972,Manchester City,Stoke City,1-1,1,1,1,1,2,0,D
1972-12-26,1972,Sheffield United,Liverpool,0-3,0,3,1,1,3,-3,A
1972-12-26,1972,West Ham United,Tottenham Hotspur,2-2,2,2,1,1,4,0,D
1972-12-26,1972,Wolverhampton Wanderers,Leicester City,2-0,2,0,1,1,2,2,H
1972-12-30,1972,Birmingham City,Ipswich Town,1-2,1,2,1,1,3,-1,A
1972-12-30,1972,Chelsea,Derby County,1-1,1,1,1,1,2,0,D
1972-12-30,1972,Leicester City,West Ham United,2-1,2,1,1,1,3,1,H
1972-12-30,1972,Liverpool,Crystal Palace,1-0,1,0,1,1,1,1,H
1972-12-30,1972,Newcastle United,Sheffield United,4-1,4,1,1,1,5,3,H
1972-12-30,1972,Norwich City,Manchester City,1-1,1,1,1,1,2,0,D
1972-12-30,1972,Southampton,Coventry City,2-1,2,1,1,1,3,1,H
1972-12-30,1972,Stoke City,Arsenal,0-0,0,0,1,1,0,0,D
1973-01-01,1972,Newcastle United,Leicester City,2-2,2,2,1,1,4,0,D
1973-01-06,1972,Arsenal,Manchester United,3-1,3,1,1,1,4,2,H
1973-01-06,1972,Coventry City,Leicester City,3-2,3,2,1,1,5,1,H
1973-01-06,1972,Derby County,Norwich City,1-0,1,0,1,1,1,1,H
1973-01-06,1972,Everton,Stoke City,2-0,2,0,1,1,2,2,H
1973-01-06,1972,Ipswich Town,Newcastle United,1-0,1,0,1,1,1,1,H
1973-01-06,1972,Leeds United,Tottenham Hotspur,2-1,2,1,1,1,3,1,H
1973-01-06,1972,Sheffield United,West Bromwich Albion,3-0,3,0,1,1,3,3,H
1973-01-06,1972,West Ham United,Liverpool,0-1,0,1,1,1,1,-1,A
1973-01-06,1972,Wolverhampton Wanderers,Southampton,0-1,0,1,1,1,1,-1,A
1973-01-20,1972,Chelsea,Arsenal,0-1,0,1,1,1,1,-1,A
1973-01-20,1972,Leicester City,Manchester City,1-1,1,1,1,1,2,0,D
1973-01-20,1972,Liverpool,Derby County,1-1,1,1,1,1,2,0,D
1973-01-20,1972,Manchester United,West Ham United,2-2,2,2,1,1,4,0,D
1973-01-20,1972,Newcastle United,Crystal Palace,2-0,2,0,1,1,2,2,H
1973-01-20,1972,Norwich City,Leeds United,1-2,1,2,1,1,3,-1,A
1973-01-20,1972,Southampton,Sheffield United,1-1,1,1,1,1,2,0,D
1973-01-20,1972,Tottenham Hotspur,Ipswich Town,0-1,0,1,1,1,1,-1,A
1973-01-24,1972,Manchester United,Everton,0-0,0,0,1,1,0,0,D
1973-01-27,1972,Arsenal,Newcastle United,2-2,2,2,1,1,4,0,D
1973-01-27,1972,Coventry City,Manchester United,1-1,1,1,1,1,2,0,D
1973-01-27,1972,Crystal Palace,Tottenham Hotspur,0-0,0,0,1,1,0,0,D
1973-01-27,1972,Derby County,West Bromwich Albion,2-0,2,0,1,1,2,2,H
1973-01-27,1972,Everton,Leicester City,0-1,0,1,1,1,1,-1,A
1973-01-27,1972,Ipswich Town,Southampton,2-2,2,2,1,1,4,0,D
1973-01-27,1972,Leeds United,Stoke City,1-0,1,0,1,1,1,1,H
1973-01-27,1972,Manchester City,Birmingham City,1-0,1,0,1,1,1,1,H
1973-01-27,1972,Sheffield United,Norwich City,2-0,2,0,1,1,2,2,H
1973-01-27,1972,West Ham United,Chelsea,3-1,3,1,1,1,4,2,H
1973-01-27,1972,Wolverhampton Wanderers,Liverpool,2-1,2,1,1,1,3,1,H
1973-02-10,1972,Birmingham City,Derby County,2-0,2,0,1,1,2,2,H
1973-02-10,1972,Chelsea,Sheffield United,4-2,4,2,1,1,6,2,H
1973-02-10,1972,Leicester City,Leeds United,2-0,2,0,1,1,2,2,H
1973-02-10,1972,Liverpool,Arsenal,0-2,0,2,1,1,2,-2,A
1973-02-10,1972,Manchester United,Wolverhampton Wanderers,2-1,2,1,1,1,3,1,H
1973-02-10,1972,Newcastle United,Coventry City,1-1,1,1,1,1,2,0,D
1973-02-10,1972,Norwich City,West Ham United,0-1,0,1,1,1,1,-1,A
1973-02-10,1972,Southampton,Everton,0-0,0,0,1,1,0,0,D
1973-02-10,1972,Tottenham Hotspur,Manchester City,2-3,2,3,1,1,5,-1,A
1973-02-10,1972,West Bromwich Albion,Crystal Palace,0-4,0,4,1,1,4,-4,A
1973-02-14,1972,Derby County,Stoke City,0-3,0,3,1,1,3,-3,A
1973-02-17,1972,Arsenal,Leicester City,1-0,1,0,1,1,1,1,H
1973-02-17,1972,Coventry City,Tottenham Hotspur,0-1,0,1,1,1,1,-1,A
1973-02-17,1972,Crystal Palace,Stoke City,3-2,3,2,1,1,5,1,H
1973-02-17,1972,Derby County,Southampton,4-0,4,0,1,1,4,4,H
1973-02-17,1972,Ipswich Town,Manchester United,4-1,4,1,1,1,5,3,H
1973-02-17,1972,Leeds United,Chelsea,1-1,1,1,1,1,2,0,D
1973-02-17,1972,Manchester City,Liverpool,1-1,1,1,1,1,2,0,D
1973-02-17,1972,Sheffield United,Birmingham City,0-1,0,1,1,1,1,-1,A
1973-02-17,1972,West Ham United,West Bromwich Albion,2-1,2,1,1,1,3,1,H
1973-02-17,1972,Wolverhampton Wanderers,Newcastle United,1-1,1,1,1,1,2,0,D
1973-02-24,1972,Leicester City,Sheffield United,0-0,0,0,1,1,0,0,D
1973-02-24,1972,Liverpool,Ipswich Town,2-1,2,1,1,1,3,1,H
1973-02-24,1972,Norwich City,Newcastle United,0-1,0,1,1,1,1,-1,A
1973-02-24,1972,Stoke City,West Ham United,2-0,2,0,1,1,2,2,H
1973-02-24,1972,Tottenham Hotspur,Everton,3-0,3,0,1,1,3,3,H
1973-02-27,1972,Birmingham City,Wolverhampton Wanderers,0-1,0,1,1,1,1,-1,A
1973-02-28,1972,Newcastle United,Derby County,2-0,2,0,1,1,2,2,H
1973-02-28,1972,West Bromwich Albion,Arsenal,1-0,1,0,1,1,1,1,H
1973-03-02,1972,Coventry City,Crystal Palace,2-0,2,0,1,1,2,2,H
1973-03-02,1972,West Ham United,Ipswich Town,0-1,0,1,1,1,1,-1,A
1973-03-03,1972,Arsenal,Sheffield United,3-2,3,2,1,1,5,1,H
1973-03-03,1972,Chelsea,Birmingham City,0-0,0,0,1,1,0,0,D
1973-03-03,1972,Derby County,Leeds United,2-3,2,3,1,1,5,-1,A
1973-03-03,1972,Everton,Liverpool,0-2,0,2,1,1,2,-2,A
1973-03-03,1972,Manchester United,West Bromwich Albion,2-1,2,1,1,1,3,1,H
1973-03-03,1972,Southampton,Leicester City,0-0,0,0,1,1,0,0,D
1973-03-03,1972,Wolverhampton Wanderers,Manchester City,5-1,5,1,1,1,6,4,H
1973-03-06,1972,Chelsea,Wolverhampton Wanderers,0-2,0,2,1,1,2,-2,A
1973-03-06,1972,Crystal Palace,Birmingham City,0-0,0,0,1,1,0,0,D
1973-03-06,1972,Southampton,Manchester City,1-1,1,1,1,1,2,0,D
1973-03-07,1972,Norwich City,Coventry City,1-1,1,1,1,1,2,0,D
1973-03-10,1972,Birmingham City,Manchester United,3-1,3,1,1,1,4,2,H
1973-03-10,1972,Crystal Palace,Wolverhampton Wanderers,1-1,1,1,1,1,2,0,D
1973-03-10,1972,Ipswich Town,Arsenal,1-2,1,2,1,1,3,-1,A
1973-03-10,1972,Leeds United,Everton,2-1,2,1,1,1,3,1,H
1973-03-10,1972,Leicester City,Derby County,0-0,0,0,1,1,0,0,D
1973-03-10,1972,Liverpool,Southampton,3-2,3,2,1,1,5,1,H
1973-03-10,1972,Manchester City,Coventry City,1-2,1,2,1,1,3,-1,A
1973-03-10,1972,Newcastle United,Stoke City,1-0,1,0,1,1,1,1,H
1973-03-10,1972,Sheffield United,West Ham United,0-0,0,0,1,1,0,0,D
1973-03-10,1972,Tottenham Hotspur,Norwich City,3-0,3,0,1,1,3,3,H
1973-03-10,1972,West Bromwich Albion,Chelsea,1-1,1,1,1,1,2,0,D
1973-03-13,1972,Crystal Palace,Sheffield United,0-1,0,1,1,1,1,-1,A
1973-03-14,1972,Stoke City,Tottenham Hotspur,1-1,1,1,1,1,2,0,D
1973-03-17,1972,Everton,Sheffield United,2-1,2,1,1,1,3,1,H
1973-03-17,1972,Ipswich Town,West Bromwich Albion,2-0,2,0,1,1,2,2,H
1973-03-17,1972,Manchester United,Newcastle United,2-1,2,1,1,1,3,1,H
1973-03-17,1972,Norwich City,Leicester City,1-1,1,1,1,1,2,0,D
1973-03-17,1972,Southampton,Birmingham City,2-0,2,0,1,1,2,2,H
1973-03-17,1972,Stoke City,Liverpool,0-1,0,1,1,1,1,-1,A
1973-03-17,1972,West Ham United,Manchester City,2-1,2,1,1,1,3,1,H
1973-03-20,1972,Wolverhampton Wanderers,West Bromwich Albion,2-0,2,0,1,1,2,2,H
1973-03-24,1972,Birmingham City,Coventry City,3-0,3,0,1,1,3,3,H
1973-03-24,1972,Crystal Palace,West Ham United,1-3,1,3,1,1,4,-2,A
1973-03-24,1972,Ipswich Town,Everton,0-1,0,1,1,1,1,-1,A
1973-03-24,1972,Leeds United,Wolverhampton Wanderers,0-0,0,0,1,1,0,0,D
1973-03-24,1972,Leicester City,Stoke City,2-0,2,0,1,1,2,2,H
1973-03-24,1972,Liverpool,Norwich City,3-1,3,1,1,1,4,2,H
1973-03-24,1972,Manchester City,Arsenal,1-2,1,2,1,1,3,-1,A
1973-03-24,1972,Newcastle United,Chelsea,1-1,1,1,1,1,2,0,D
1973-03-24,1972,Sheffield United,Derby County,3-1,3,1,1,1,4,2,H
1973-03-24,1972,Tottenham Hotspur,Manchester United,1-1,1,1,1,1,2,0,D
1973-03-24,1972,West Bromwich Albion,Southampton,1-1,1,1,1,1,2,0,D
1973-03-26,1972,Arsenal,Crystal Palace,1-0,1,0,1,1,1,1,H
1973-03-26,1972,Stoke City,Coventry City,2-1,2,1,1,1,3,1,H
1973-03-27,1972,Manchester City,Chelsea,0-1,0,1,1,1,1,-1,A
1973-03-28,1972,West Bromwich Albion,Leeds United,1-1,1,1,1,1,2,0,D
1973-03-31,1972,Arsenal,Derby County,0-1,0,1,1,1,1,-1,A
1973-03-31,1972,Coventry City,Ipswich Town,2-1,2,1,1,1,3,1,H
1973-03-31,1972,Crystal Palace,Chelsea,2-0,2,0,1,1,2,2,H
1973-03-31,1972,Leicester City,Newcastle United,0-0,0,0,1,1,0,0,D
1973-03-31,1972,Liverpool,Tottenham Hotspur,1-1,1,1,1,1,2,0,D
1973-03-31,1972,Manchester City,Leeds United,1-0,1,0,1,1,1,1,H
1973-03-31,1972,Norwich City,Birmingham City,1-2,1,2,1,1,3,-1,A
1973-03-31,1972,Southampton,Manchester United,0-2,0,2,1,1,2,-2,A
1973-03-31,1972,Stoke City,West Bromwich Albion,2-0,2,0,1,1,2,2,H
1973-03-31,1972,West Ham United,Everton,2-0,2,0,1,1,2,2,H
1973-03-31,1972,Wolverhampton Wanderers,Sheffield United,1-1,1,1,1,1,2,0,D
1973-04-02,1972,Coventry City,Leeds United,0-1,0,1,1,1,1,-1,A
1973-04-03,1972,Chelsea,Tottenham Hotspur,0-1,0,1,1,1,1,-1,A
1973-04-03,1972,Everton,Norwich City,2-2,2,2,1,1,4,0,D
1973-04-04,1972,Stoke City,Ipswich Town,1-0,1,0,1,1,1,1,H
1973-04-07,1972,Birmingham City,Liverpool,2-1,2,1,1,1,3,1,H
1973-04-07,1972,Chelsea,Stoke City,1-3,1,3,1,1,4,-2,A
1973-04-07,1972,Everton,Coventry City,2-0,2,0,1,1,2,2,H
1973-04-07,1972,Ipswich Town,Manchester City,1-1,1,1,1,1,2,0,D
1973-04-07,1972,Manchester United,Norwich City,1-0,1,0,1,1,1,1,H
1973-04-07,1972,Newcastle United,West Ham United,1-2,1,2,1,1,3,-1,A
1973-04-07,1972,Sheffield United,Crystal Palace,2-0,2,0,1,1,2,2,H
1973-04-07,1972,Tottenham Hotspur,Southampton,1-2,1,2,1,1,3,-1,A
1973-04-07,1972,West Bromwich Albion,Leicester City,1-0,1,0,1,1,1,1,H
1973-04-11,1972,Manchester United,Crystal Palace,2-0,2,0,1,1,2,2,H
1973-04-11,1972,West Bromwich Albion,Everton,4-1,4,1,1,1,5,3,H
1973-04-14,1972,Arsenal,Tottenham Hotspur,1-1,1,1,1,1,2,0,D
1973-04-14,1972,Coventry City,Derby County,0-2,0,2,1,1,2,-2,A
1973-04-14,1972,Crystal Palace,Ipswich Town,1-1,1,1,1,1,2,0,D
1973-04-14,1972,Leicester City,Birmingham City,0-1,0,1,1,1,1,-1,A
1973-04-14,1972,Liverpool,West Bromwich Albion,1-0,1,0,1,1,1,1,H
1973-04-14,1972,Manchester City,Sheffield United,3-1,3,1,1,1,4,2,H
1973-04-14,1972,Norwich City,Chelsea,1-0,1,0,1,1,1,1,H
1973-04-14,1972,Southampton,Newcastle United,1-1,1,1,1,1,2,0,D
1973-04-14,1972,Stoke City,Manchester United,2-2,2,2,1,1,4,0,D
1973-04-14,1972,West Ham United,Leeds United,1-1,1,1,1,1,2,0,D
1973-04-14,1972,Wolverhampton Wanderers,Everton,4-2,4,2,1,1,6,2,H
1973-04-17,1972,Coventry City,Liverpool,1-2,1,2,1,1,3,-1,A
1973-04-17,1972,Everton,Chelsea,1-0,1,0,1,1,1,1,H
1973-04-18,1972,Leeds United,Manchester United,0-1,0,1,1,1,1,-1,A
1973-04-18,1972,Manchester City,Newcastle United,2-0,2,0,1,1,2,2,H
1973-04-18,1972,Tottenham Hotspur,Derby County,1-0,1,0,1,1,1,1,H
1973-04-20,1972,Crystal Palace,Leicester City,0-1,0,1,1,1,1,-1,A
1973-04-20,1972,West Ham United,Southampton,4-3,4,3,1,1,7,1,H
1973-04-21,1972,Birmingham City,Stoke City,3-1,3,1,1,1,4,2,H
1973-04-21,1972,Chelsea,Southampton,2-1,2,1,1,1,3,1,H
1973-04-21,1972,Derby County,West Ham United,1-1,1,1,1,1,2,0,D
1973-04-21,1972,Everton,Arsenal,0-0,0,0,1,1,0,0,D
1973-04-21,1972,Ipswich Town,Wolverhampton Wanderers,2-1,2,1,1,1,3,1,H
1973-04-21,1972,Leeds United,Crystal Palace,4-0,4,0,1,1,4,4,H
1973-04-21,1972,Manchester United,Manchester City,0-0,0,0,1,1,0,0,D
1973-04-21,1972,Newcastle United,Liverpool,2-1,2,1,1,1,3,1,H
1973-04-21,1972,Sheffield United,Coventry City,3-1,3,1,1,1,4,2,H
1973-04-21,1972,Tottenham Hotspur,Leicester City,1-1,1,1,1,1,2,0,D
1973-04-21,1972,West Bromwich Albion,Norwich City,0-1,0,1,1,1,1,-1,A
1973-04-23,1972,Birmingham City,West Ham United,0-0,0,0,1,1,0,0,D
1973-04-23,1972,Chelsea,Coventry City,2-0,2,0,1,1,2,2,H
1973-04-23,1972,Liverpool,Leeds United,2-0,2,0,1,1,2,2,H
1973-04-23,1972,Manchester United,Sheffield United,1-2,1,2,1,1,3,-1,A
1973-04-23,1972,Southampton,Arsenal,2-2,2,2,1,1,4,0,D
1973-04-23,1972,Wolverhampton Wanderers,Norwich City,3-0,3,0,1,1,3,3,H
1973-04-24,1972,Leicester City,Ipswich Town,1-1,1,1,1,1,2,0,D
1973-04-24,1972,Norwich City,Crystal Palace,2-1,2,1,1,1,3,1,H
1973-04-24,1972,Stoke City,Wolverhampton Wanderers,2-0,2,0,1,1,2,2,H
1973-04-25,1972,Newcastle United,Everton,0-0,0,0,1,1,0,0,D
1973-04-25,1972,West Bromwich Albion,Manchester City,1-2,1,2,1,1,3,-1,A
1973-04-28,1972,Birmingham City,West Bromwich Albion,3-2,3,2,1,1,5,1,H
1973-04-28,1972,Chelsea,Manchester United,1-0,1,0,1,1,1,1,H
1973-04-28,1972,Derby County,Everton,3-1,3,1,1,1,4,2,H
1973-04-28,1972,Ipswich Town,Sheffield United,1-1,1,1,1,1,2,0,D
1973-04-28,1972,Liverpool,Leicester City,0-0,0,0,1,1,0,0,D
1973-04-28,1972,Manchester City,Crystal Palace,2-3,2,3,1,1,5,-1,A
1973-04-28,1972,Southampton,Leeds United,3-1,3,1,1,1,4,2,H
1973-04-28,1972,Stoke City,Norwich City,2-0,2,0,1,1,2,2,H
1973-04-28,1972,Tottenham Hotspur,Newcastle United,3-2,3,2,1,1,5,1,H
1973-04-28,1972,West Ham United,Arsenal,1-2,1,2,1,1,3,-1,A
1973-04-28,1972,Wolverhampton Wanderers,Coventry City,3-0,3,0,1,1,3,3,H
1973-04-30,1972,Birmingham City,Leeds United,2-1,2,1,1,1,3,1,H
1973-04-30,1972,Derby County,Ipswich Town,3-0,3,0,1,1,3,3,H
1973-04-30,1972,Tottenham Hotspur,Wolverhampton Wanderers,2-2,2,2,1,1,4,0,D
1973-05-02,1972,Sheffield United,Tottenham Hotspur,3-2,3,2,1,1,5,1,H
1973-05-04,1972,Derby County,Wolverhampton Wanderers,3-0,3,0,1,1,3,3,H
1973-05-09,1972,Leeds United,Arsenal,6-1,6,1,1,1,7,5,H
1973-08-25,1973,Arsenal,Manchester United,3-0,3,0,1,1,3,3,H
1973-08-25,1973,Coventry City,Tottenham Hotspur,1-0,1,0,1,1,1,1,H
1973-08-25,1973,Derby County,Chelsea,1-0,1,0,1,1,1,1,H
1973-08-25,1973,Ipswich Town,Leicester City,1-1,1,1,1,1,2,0,D
1973-08-25,1973,Leeds United,Everton,3-1,3,1,1,1,4,2,H
1973-08-25,1973,Liverpool,Stoke City,1-0,1,0,1,1,1,1,H
1973-08-25,1973,Manchester City,Birmingham City,3-1,3,1,1,1,4,2,H
1973-08-25,1973,Queens Park Rangers,Southampton,1-1,1,1,1,1,2,0,D
1973-08-25,1973,Sheffield United,Burnley,0-2,0,2,1,1,2,-2,A
1973-08-25,1973,West Ham United,Newcastle United,1-2,1,2,1,1,3,-1,A
1973-08-25,1973,Wolverhampton Wanderers,Norwich City,3-1,3,1,1,1,4,2,H
1973-08-27,1973,West Ham United,Ipswich Town,3-3,3,3,1,1,6,0,D
1973-08-28,1973,Arsenal,Leeds United,1-2,1,2,1,1,3,-1,A
1973-08-28,1973,Birmingham City,Tottenham Hotspur,1-2,1,2,1,1,3,-1,A
1973-08-28,1973,Burnley,Chelsea,1-0,1,0,1,1,1,1,H
1973-08-28,1973,Coventry City,Liverpool,1-0,1,0,1,1,1,1,H
1973-08-28,1973,Everton,Leicester City,1-1,1,1,1,1,2,0,D
1973-08-28,1973,Wolverhampton Wanderers,Sheffield United,2-0,2,0,1,1,2,2,H
1973-08-29,1973,Derby County,Manchester City,1-0,1,0,1,1,1,1,H
1973-08-29,1973,Manchester United,Stoke City,1-0,1,0,1,1,1,1,H
1973-08-29,1973,Newcastle United,Southampton,0-1,0,1,1,1,1,-1,A
1973-08-29,1973,Norwich City,Queens Park Rangers,0-0,0,0,1,1,0,0,D
1973-09-01,1973,Birmingham City,Derby County,0-0,0,0,1,1,0,0,D
1973-09-01,1973,Burnley,Coventry City,2-2,2,2,1,1,4,0,D
1973-09-01,1973,Chelsea,Sheffield United,1-2,1,2,1,1,3,-1,A
1973-09-01,1973,Everton,Ipswich Town,3-0,3,0,1,1,3,3,H
1973-09-01,1973,Leicester City,Liverpool,1-1,1,1,1,1,2,0,D
1973-09-01,1973,Manchester United,Queens Park Rangers,2-1,2,1,1,1,3,1,H
1973-09-01,1973,Newcastle United,Arsenal,1-1,1,1,1,1,2,0,D
1973-09-01,1973,Norwich City,West Ham United,2-2,2,2,1,1,4,0,D
1973-09-01,1973,Southampton,Wolverhampton Wanderers,2-1,2,1,1,1,3,1,H
1973-09-01,1973,Stoke City,Manchester City,1-1,1,1,1,1,2,0,D
1973-09-01,1973,Tottenham Hotspur,Leeds United,0-3,0,3,1,1,3,-3,A
1973-09-04,1973,Ipswich Town,Newcastle United,1-3,1,3,1,1,4,-2,A
1973-09-04,1973,Liverpool,Derby County,2-0,2,0,1,1,2,2,H
1973-09-04,1973,Queens Park Rangers,West Ham United,0-0,0,0,1,1,0,0,D
1973-09-04,1973,Sheffield United,Arsenal,5-0,5,0,1,1,5,5,H
1973-09-04,1973,Southampton,Norwich City,2-2,2,2,1,1,4,0,D
1973-09-05,1973,Chelsea,Birmingham City,3-1,3,1,1,1,4,2,H
1973-09-05,1973,Leeds United,Wolverhampton Wanderers,4-1,4,1,1,1,5,3,H
1973-09-05,1973,Leicester City,Manchester United,1-0,1,0,1,1,1,1,H
1973-09-05,1973,Manchester City,Coventry City,1-0,1,0,1,1,1,1,H
1973-09-05,1973,Stoke City,Everton,0-0,0,0,1,1,0,0,D
1973-09-05,1973,Tottenham Hotspur,Burnley,2-3,2,3,1,1,5,-1,A
1973-09-08,1973,Arsenal,Leicester City,0-2,0,2,1,1,2,-2,A
1973-09-08,1973,Coventry City,Southampton,2-0,2,0,1,1,2,2,H
1973-09-08,1973,Derby County,Everton,2-1,2,1,1,1,3,1,H
1973-09-08,1973,Ipswich Town,Manchester United,2-1,2,1,1,1,3,1,H
1973-09-08,1973,Leeds United,Birmingham City,3-0,3,0,1,1,3,3,H
1973-09-08,1973,Liverpool,Chelsea,1-0,1,0,1,1,1,1,H
1973-09-08,1973,Manchester City,Norwich City,2-1,2,1,1,1,3,1,H
1973-09-08,1973,Queens Park Rangers,Stoke City,3-3,3,3,1,1,6,0,D
1973-09-08,1973,Sheffield United,Newcastle United,1-1,1,1,1,1,2,0,D
1973-09-08,1973,West Ham United,Tottenham Hotspur,0-1,0,1,1,1,1,-1,A
1973-09-08,1973,Wolverhampton Wanderers,Burnley,0-2,0,2,1,1,2,-2,A
1973-09-10,1973,West Ham United,Queens Park Rangers,2-3,2,3,1,1,5,-1,A
1973-09-11,1973,Arsenal,Sheffield United,1-0,1,0,1,1,1,1,H
1973-09-11,1973,Birmingham City,Chelsea,2-4,2,4,1,1,6,-2,A
1973-09-11,1973,Burnley,Tottenham Hotspur,2-2,2,2,1,1,4,0,D
1973-09-11,1973,Coventry City,Manchester City,2-1,2,1,1,1,3,1,H
1973-09-11,1973,Everton,Stoke City,1-1,1,1,1,1,2,0,D
1973-09-11,1973,Wolverhampton Wanderers,Leeds United,0-2,0,2,1,1,2,-2,A
1973-09-12,1973,Derby County,Liverpool,3-1,3,1,1,1,4,2,H
1973-09-12,1973,Manchester United,Leicester City,1-2,1,2,1,1,3,-1,A
1973-09-12,1973,Newcastle United,Ipswich Town,3-1,3,1,1,1,4,2,H
1973-09-12,1973,Norwich City,Southampton,2-0,2,0,1,1,2,2,H
1973-09-15,1973,Birmingham City,Liverpool,1-1,1,1,1,1,2,0,D
1973-09-15,1973,Burnley,Derby County,1-1,1,1,1,1,2,0,D
1973-09-15,1973,Chelsea,Coventry City,1-0,1,0,1,1,1,1,H
1973-09-15,1973,Everton,Queens Park Rangers,1-0,1,0,1,1,1,1,H
1973-09-15,1973,Leicester City,Manchester City,1-1,1,1,1,1,2,0,D
1973-09-15,1973,Manchester United,West Ham United,3-1,3,1,1,1,4,2,H
1973-09-15,1973,Newcastle United,Wolverhampton Wanderers,2-0,2,0,1,1,2,2,H
1973-09-15,1973,Norwich City,Arsenal,0-4,0,4,1,1,4,-4,A
1973-09-15,1973,Southampton,Leeds United,1-2,1,2,1,1,3,-1,A
1973-09-15,1973,Stoke City,Ipswich Town,1-1,1,1,1,1,2,0,D
1973-09-15,1973,Tottenham Hotspur,Sheffield United,1-2,1,2,1,1,3,-1,A
1973-09-18,1973,Coventry City,Derby County,1-0,1,0,1,1,1,1,H
1973-09-22,1973,Arsenal,Stoke City,2-1,2,1,1,1,3,1,H
1973-09-22,1973,Coventry City,Newcastle United,2-2,2,2,1,1,4,0,D
1973-09-22,1973,Derby County,Southampton,6-2,6,2,1,1,8,4,H
1973-09-22,1973,Ipswich Town,Burnley,3-2,3,2,1,1,5,1,H
1973-09-22,1973,Leeds United,Manchester United,0-0,0,0,1,1,0,0,D
1973-09-22,1973,Liverpool,Tottenham Hotspur,3-2,3,2,1,1,5,1,H
1973-09-22,1973,Manchester City,Chelsea,3-2,3,2,1,1,5,1,H
1973-09-22,1973,Queens Park Rangers,Birmingham City,2-2,2,2,1,1,4,0,D
1973-09-22,1973,Sheffield United,Norwich City,1-0,1,0,1,1,1,1,H
1973-09-22,1973,West Ham United,Leicester City,1-1,1,1,1,1,2,0,D
1973-09-22,1973,Wolverhampton Wanderers,Everton,1-1,1,1,1,1,2,0,D
1973-09-29,1973,Birmingham City,Ipswich Town,0-3,0,3,1,1,3,-3,A
1973-09-29,1973,Burnley,Manchester City,3-0,3,0,1,1,3,3,H
1973-09-29,1973,Chelsea,Wolverhampton Wanderers,2-2,2,2,1,1,4,0,D
1973-09-29,1973,Everton,Arsenal,1-0,1,0,1,1,1,1,H
1973-09-29,1973,Leicester City,Coventry City,0-2,0,2,1,1,2,-2,A
1973-09-29,1973,Manchester United,Liverpool,0-0,0,0,1,1,0,0,D
1973-09-29,1973,Newcastle United,Queens Park Rangers,2-3,2,3,1,1,5,-1,A
1973-09-29,1973,Norwich City,Leeds United,0-1,0,1,1,1,1,-1,A
1973-09-29,1973,Southampton,Sheffield United,3-0,3,0,1,1,3,3,H
1973-09-29,1973,Stoke City,West Ham United,2-0,2,0,1,1,2,2,H
1973-09-29,1973,Tottenham Hotspur,Derby County,1-0,1,0,1,1,1,1,H
1973-10-06,1973,Arsenal,Birmingham City,1-0,1,0,1,1,1,1,H
1973-10-06,1973,Coventry City,Everton,1-2,1,2,1,1,3,-1,A
1973-10-06,1973,Derby County,Norwich City,1-1,1,1,1,1,2,0,D
1973-10-06,1973,Ipswich Town,Tottenham Hotspur,0-0,0,0,1,1,0,0,D
1973-10-06,1973,Leeds United,Stoke City,1-1,1,1,1,1,2,0,D
1973-10-06,1973,Liverpool,Newcastle United,2-1,2,1,1,1,3,1,H
1973-10-06,1973,Manchester City,Southampton,1-1,1,1,1,1,2,0,D
1973-10-06,1973,Queens Park Rangers,Chelsea,1-1,1,1,1,1,2,0,D
1973-10-06,1973,Sheffield United,Leicester City,1-1,1,1,1,1,2,0,D
1973-10-06,1973,West Ham United,Burnley,0-1,0,1,1,1,1,-1,A
1973-10-06,1973,Wolverhampton Wanderers,Manchester United,2-1,2,1,1,1,3,1,H
1973-10-13,1973,Birmingham City,Wolverhampton Wanderers,2-1,2,1,1,1,3,1,H
1973-10-13,1973,Burnley,Queens Park Rangers,2-1,2,1,1,1,3,1,H
1973-10-13,1973,Chelsea,Ipswich Town,2-3,2,3,1,1,5,-1,A
1973-10-13,1973,Everton,West Ham United,1-0,1,0,1,1,1,1,H
1973-10-13,1973,Leicester City,Leeds United,2-2,2,2,1,1,4,0,D
1973-10-13,1973,Manchester United,Derby County,0-1,0,1,1,1,1,-1,A
1973-10-13,1973,Newcastle United,Manchester City,1-0,1,0,1,1,1,1,H
1973-10-13,1973,Norwich City,Coventry City,0-0,0,0,1,1,0,0,D
1973-10-13,1973,Southampton,Liverpool,1-0,1,0,1,1,1,1,H
1973-10-13,1973,Stoke City,Sheffield United,1-2,1,2,1,1,3,-1,A
1973-10-13,1973,Tottenham Hotspur,Arsenal,2-0,2,0,1,1,2,2,H
1973-10-20,1973,Arsenal,Ipswich Town,1-1,1,1,1,1,2,0,D
1973-10-20,1973,Coventry City,West Ham United,0-1,0,1,1,1,1,-1,A
1973-10-20,1973,Derby County,Leicester City,2-1,2,1,1,1,3,1,H
1973-10-20,1973,Everton,Burnley,1-0,1,0,1,1,1,1,H
1973-10-20,1973,Leeds United,Liverpool,1-0,1,0,1,1,1,1,H
1973-10-20,1973,Manchester United,Birmingham City,1-0,1,0,1,1,1,1,H
1973-10-20,1973,Newcastle United,Chelsea,2-0,2,0,1,1,2,2,H
1973-10-20,1973,Norwich City,Tottenham Hotspur,1-1,1,1,1,1,2,0,D
1973-10-20,1973,Sheffield United,Manchester City,1-2,1,2,1,1,3,-1,A
1973-10-20,1973,Southampton,Stoke City,3-0,3,0,1,1,3,3,H
1973-10-20,1973,Wolverhampton Wanderers,Queens Park Rangers,2-4,2,4,1,1,6,-2,A
1973-10-26,1973,Chelsea,Norwich City,3-0,3,0,1,1,3,3,H
1973-10-27,1973,Birmingham City,Everton,0-2,0,2,1,1,2,-2,A
1973-10-27,1973,Burnley,Manchester United,0-0,0,0,1,1,0,0,D
1973-10-27,1973,Ipswich Town,Wolverhampton Wanderers,2-0,2,0,1,1,2,2,H
1973-10-27,1973,Leicester City,Southampton,0-1,0,1,1,1,1,-1,A
1973-10-27,1973,Liverpool,Sheffield United,1-0,1,0,1,1,1,1,H
1973-10-27,1973,Manchester City,Leeds United,0-1,0,1,1,1,1,-1,A
1973-10-27,1973,Queens Park Rangers,Arsenal,2-0,2,0,1,1,2,2,H
1973-10-27,1973,Stoke City,Coventry City,3-0,3,0,1,1,3,3,H
1973-10-27,1973,Tottenham Hotspur,Newcastle United,0-2,0,2,1,1,2,-2,A
1973-10-27,1973,West Ham United,Derby County,0-0,0,0,1,1,0,0,D
1973-11-03,1973,Arsenal,Liverpool,0-2,0,2,1,1,2,-2,A
1973-11-03,1973,Coventry City,Ipswich Town,0-1,0,1,1,1,1,-1,A
1973-11-03,1973,Derby County,Queens Park Rangers,1-2,1,2,1,1,3,-1,A
1973-11-03,1973,Everton,Tottenham Hotspur,1-1,1,1,1,1,2,0,D
1973-11-03,1973,Leeds United,West Ham United,4-1,4,1,1,1,5,3,H
1973-11-03,1973,Manchester United,Chelsea,2-2,2,2,1,1,4,0,D
1973-11-03,1973,Newcastle United,Stoke City,2-1,2,1,1,1,3,1,H
1973-11-03,1973,Norwich City,Leicester City,1-0,1,0,1,1,1,1,H
1973-11-03,1973,Sheffield United,Birmingham City,1-1,1,1,1,1,2,0,D
1973-11-03,1973,Southampton,Burnley,2-2,2,2,1,1,4,0,D
1973-11-03,1973,Wolverhampton Wanderers,Manchester City,0-0,0,0,1,1,0,0,D
1973-11-10,1973,Birmingham City,Southampton,1-1,1,1,1,1,2,0,D
1973-11-10,1973,Burnley,Leeds United,0-0,0,0,1,1,0,0,D
1973-11-10,1973,Chelsea,Everton,3-1,3,1,1,1,4,2,H
1973-11-10,1973,Ipswich Town,Derby County,3-0,3,0,1,1,3,3,H
1973-11-10,1973,Leicester City,Newcastle United,1-0,1,0,1,1,1,1,H
1973-11-10,1973,Liverpool,Wolverhampton Wanderers,1-0,1,0,1,1,1,1,H
1973-11-10,1973,Manchester City,Arsenal,1-2,1,2,1,1,3,-1,A
1973-11-10,1973,Queens Park Rangers,Coventry City,3-0,3,0,1,1,3,3,H
1973-11-10,1973,Stoke City,Norwich City,2-0,2,0,1,1,2,2,H
1973-11-10,1973,Tottenham Hotspur,Manchester United,2-1,2,1,1,1,3,1,H
1973-11-10,1973,West Ham United,Sheffield United,2-2,2,2,1,1,4,0,D
1973-11-17,1973,Arsenal,Chelsea,0-0,0,0,1,1,0,0,D
1973-11-17,1973,Leeds United,Coventry City,3-0,3,0,1,1,3,3,H
1973-11-17,1973,Leicester City,Burnley,2-0,2,0,1,1,2,2,H
1973-11-17,1973,Liverpool,Ipswich Town,4-2,4,2,1,1,6,2,H
1973-11-17,1973,Manchester City,Queens Park Rangers,1-0,1,0,1,1,1,1,H
1973-11-17,1973,Newcastle United,Manchester United,3-2,3,2,1,1,5,1,H
1973-11-17,1973,Norwich City,Everton,1-3,1,3,1,1,4,-2,A
1973-11-17,1973,Sheffield United,Derby County,3-0,3,0,1,1,3,3,H
1973-11-17,1973,Southampton,Tottenham Hotspur,1-1,1,1,1,1,2,0,D
1973-11-17,1973,Stoke City,Birmingham City,5-2,5,2,1,1,7,3,H
1973-11-17,1973,Wolverhampton Wanderers,West Ham United,0-0,0,0,1,1,0,0,D
1973-11-24,1973,Birmingham City,Leicester City,3-0,3,0,1,1,3,3,H
1973-11-24,1973,Burnley,Stoke City,1-0,1,0,1,1,1,1,H
1973-11-24,1973,Chelsea,Southampton,4-0,4,0,1,1,4,4,H
1973-11-24,1973,Coventry City,Sheffield United,3-1,3,1,1,1,4,2,H
1973-11-24,1973,Derby County,Leeds United,0-0,0,0,1,1,0,0,D
1973-11-24,1973,Everton,Newcastle United,1-1,1,1,1,1,2,0,D
1973-11-24,1973,Ipswich Town,Manchester City,2-1,2,1,1,1,3,1,H
1973-11-24,1973,Manchester United,Norwich City,0-0,0,0,1,1,0,0,D
1973-11-24,1973,Queens Park Rangers,Liverpool,2-2,2,2,1,1,4,0,D
1973-11-24,1973,Tottenham Hotspur,Wolverhampton Wanderers,1-3,1,3,1,1,4,-2,A
1973-11-24,1973,West Ham United,Arsenal,1-3,1,3,1,1,4,-2,A
1973-12-01,1973,Arsenal,Coventry City,2-2,2,2,1,1,4,0,D
1973-12-01,1973,Leeds United,Queens Park Rangers,2-2,2,2,1,1,4,0,D
1973-12-01,1973,Leicester City,Tottenham Hotspur,3-0,3,0,1,1,3,3,H
1973-12-01,1973,Liverpool,West Ham United,1-0,1,0,1,1,1,1,H
1973-12-01,1973,Southampton,Everton,2-0,2,0,1,1,2,2,H
1973-12-04,1973,Arsenal,Wolverhampton Wanderers,2-2,2,2,1,1,4,0,D
1973-12-08,1973,Birmingham City,Newcastle United,1-0,1,0,1,1,1,1,H
1973-12-08,1973,Burnley,Norwich City,1-0,1,0,1,1,1,1,H
1973-12-08,1973,Chelsea,Leicester City,3-2,3,2,1,1,5,1,H
1973-12-08,1973,Coventry City,Wolverhampton Wanderers,1-0,1,0,1,1,1,1,H
1973-12-08,1973,Derby County,Arsenal,1-1,1,1,1,1,2,0,D
1973-12-08,1973,Everton,Liverpool,0-1,0,1,1,1,1,-1,A
1973-12-08,1973,Ipswich Town,Leeds United,0-3,0,3,1,1,3,-3,A
1973-12-08,1973,Manchester United,Southampton,0-0,0,0,1,1,0,0,D
1973-12-08,1973,Queens Park Rangers,Sheffield United,0-0,0,0,1,1,0,0,D
1973-12-08,1973,Tottenham Hotspur,Stoke City,2-1,2,1,1,1,3,1,H
1973-12-08,1973,West Ham United,Manchester City,2-1,2,1,1,1,3,1,H
1973-12-15,1973,Birmingham City,West Ham United,3-1,3,1,1,1,4,2,H
1973-12-15,1973,Burnley,Arsenal,2-1,2,1,1,1,3,1,H
1973-12-15,1973,Chelsea,Leeds United,1-2,1,2,1,1,3,-1,A
1973-12-15,1973,Everton,Sheffield United,1-1,1,1,1,1,2,0,D
1973-12-15,1973,Leicester City,Queens Park Rangers,2-0,2,0,1,1,2,2,H
1973-12-15,1973,Manchester United,Coventry City,2-3,2,3,1,1,5,-1,A
1973-12-15,1973,Newcastle United,Derby County,0-2,0,2,1,1,2,-2,A
1973-12-15,1973,Norwich City,Liverpool,1-1,1,1,1,1,2,0,D
1973-12-15,1973,Southampton,Ipswich Town,2-0,2,0,1,1,2,2,H
1973-12-15,1973,Stoke City,Wolverhampton Wanderers,2-3,2,3,1,1,5,-1,A
1973-12-15,1973,Tottenham Hotspur,Manchester City,0-2,0,2,1,1,2,-2,A
1973-12-22,1973,Arsenal,Everton,1-0,1,0,1,1,1,1,H
1973-12-22,1973,Coventry City,Leicester City,1-2,1,2,1,1,3,-1,A
1973-12-22,1973,Derby County,Tottenham Hotspur,2-0,2,0,1,1,2,2,H
1973-12-22,1973,Ipswich Town,Birmingham City,3-0,3,0,1,1,3,3,H
1973-12-22,1973,Leeds United,Norwich City,1-0,1,0,1,1,1,1,H
1973-12-22,1973,Liverpool,Manchester United,2-0,2,0,1,1,2,2,H
1973-12-22,1973,Manchester City,Burnley,2-0,2,0,1,1,2,2,H
1973-12-22,1973,Queens Park Rangers,Newcastle United,3-2,3,2,1,1,5,1,H
1973-12-22,1973,Sheffield United,Southampton,4-2,4,2,1,1,6,2,H
1973-12-22,1973,West Ham United,Stoke City,0-2,0,2,1,1,2,-2,A
1973-12-22,1973,Wolverhampton Wanderers,Chelsea,2-0,2,0,1,1,2,2,H
1973-12-26,1973,Birmingham City,Coventry City,1-0,1,0,1,1,1,1,H
1973-12-26,1973,Burnley,Liverpool,2-1,2,1,1,1,3,1,H
1973-12-26,1973,Chelsea,West Ham United,2-4,2,4,1,1,6,-2,A
1973-12-26,1973,Everton,Manchester City,2-0,2,0,1,1,2,2,H
1973-12-26,1973,Leicester City,Wolverhampton Wanderers,2-2,2,2,1,1,4,0,D
1973-12-26,1973,Manchester United,Sheffield United,1-2,1,2,1,1,3,-1,A
1973-12-26,1973,Newcastle United,Leeds United,0-1,0,1,1,1,1,-1,A
1973-12-26,1973,Norwich City,Ipswich Town,1-2,1,2,1,1,3,-1,A
1973-12-26,1973,Southampton,Arsenal,1-1,1,1,1,1,2,0,D
1973-12-26,1973,Stoke City,Derby County,0-0,0,0,1,1,0,0,D
1973-12-26,1973,Tottenham Hotspur,Queens Park Rangers,0-0,0,0,1,1,0,0,D
1973-12-29,1973,Birmingham City,Leeds United,1-1,1,1,1,1,2,0,D
1973-12-29,1973,Burnley,Wolverhampton Wanderers,1-1,1,1,1,1,2,0,D
1973-12-29,1973,Chelsea,Liverpool,0-1,0,1,1,1,1,-1,A
1973-12-29,1973,Everton,Derby County,2-1,2,1,1,1,3,1,H
1973-12-29,1973,Leicester City,Arsenal,2-0,2,0,1,1,2,2,H
1973-12-29,1973,Manchester United,Ipswich Town,2-0,2,0,1,1,2,2,H
1973-12-29,1973,Newcastle United,Sheffield United,1-0,1,0,1,1,1,1,H
1973-12-29,1973,Norwich City,Manchester City,1-1,1,1,1,1,2,0,D
1973-12-29,1973,Southampton,Coventry City,1-1,1,1,1,1,2,0,D
1973-12-29,1973,Stoke City,Queens Park Rangers,4-1,4,1,1,1,5,3,H
1973-12-29,1973,Tottenham Hotspur,West Ham United,2-0,2,0,1,1,2,2,H
1974-01-01,1973,Arsenal,Newcastle United,0-1,0,1,1,1,1,-1,A
1974-01-01,1973,Coventry City,Burnley,1-1,1,1,1,1,2,0,D
1974-01-01,1973,Derby County,Birmingham City,1-1,1,1,1,1,2,0,D
1974-01-01,1973,Ipswich Town,Everton,3-0,3,0,1,1,3,3,H
1974-01-01,1973,Leeds United,Tottenham Hotspur,1-1,1,1,1,1,2,0,D
1974-01-01,1973,Liverpool,Leicester City,1-1,1,1,1,1,2,0,D
1974-01-01,1973,Manchester City,Stoke City,0-0,0,0,1,1,0,0,D
1974-01-01,1973,Queens Park Rangers,Manchester United,3-0,3,0,1,1,3,3,H
1974-01-01,1973,Sheffield United,Chelsea,1-2,1,2,1,1,3,-1,A
1974-01-01,1973,West Ham United,Norwich City,4-2,4,2,1,1,6,2,H
1974-01-01,1973,Wolverhampton Wanderers,Southampton,2-1,2,1,1,1,3,1,H
1974-01-12,1973,Arsenal,Norwich City,2-0,2,0,1,1,2,2,H
1974-01-12,1973,Coventry City,Chelsea,2-2,2,2,1,1,4,0,D
1974-01-12,1973,Derby County,Burnley,5-1,5,1,1,1,6,4,H
1974-01-12,1973,Ipswich Town,Stoke City,1-1,1,1,1,1,2,0,D
1974-01-12,1973,Leeds United,Southampton,2-1,2,1,1,1,3,1,H
1974-01-12,1973,Liverpool,Birmingham City,3-2,3,2,1,1,5,1,H
1974-01-12,1973,Manchester City,Leicester City,2-0,2,0,1,1,2,2,H
1974-01-12,1973,Queens Park Rangers,Everton,1-0,1,0,1,1,1,1,H
1974-01-12,1973,Sheffield United,Tottenham Hotspur,2-2,2,2,1,1,4,0,D
1974-01-12,1973,West Ham United,Manchester United,2-1,2,1,1,1,3,1,H
1974-01-12,1973,Wolverhampton Wanderers,Newcastle United,1-0,1,0,1,1,1,1,H
1974-01-19,1973,Birmingham City,Manchester City,1-1,1,1,1,1,2,0,D
1974-01-19,1973,Burnley,Sheffield United,1-2,1,2,1,1,3,-1,A
1974-01-19,1973,Chelsea,Derby County,1-1,1,1,1,1,2,0,D
1974-01-19,1973,Everton,Leeds United,0-0,0,0,1,1,0,0,D
1974-01-19,1973,Leicester City,Ipswich Town,5-0,5,0,1,1,5,5,H
1974-01-19,1973,Manchester United,Arsenal,1-1,1,1,1,1,2,0,D
1974-01-19,1973,Newcastle United,West Ham United,1-1,1,1,1,1,2,0,D
1974-01-19,1973,Norwich City,Wolverhampton Wanderers,1-1,1,1,1,1,2,0,D
1974-01-19,1973,Southampton,Queens Park Rangers,2-2,2,2,1,1,4,0,D
1974-01-19,1973,Stoke City,Liverpool,1-1,1,1,1,1,2,0,D
1974-01-19,1973,Tottenham Hotspur,Coventry City,2-1,2,1,1,1,3,1,H
1974-01-27,1973,Stoke City,Chelsea,1-0,1,0,1,1,1,1,H
1974-02-02,1973,Arsenal,Burnley,1-1,1,1,1,1,2,0,D
1974-02-02,1973,Coventry City,Manchester United,1-0,1,0,1,1,1,1,H
1974-02-02,1973,Derby County,Newcastle United,1-0,1,0,1,1,1,1,H
1974-02-02,1973,Ipswich Town,Southampton,7-0,7,0,1,1,7,7,H
1974-02-02,1973,Leeds United,Chelsea,1-1,1,1,1,1,2,0,D
1974-02-02,1973,Liverpool,Norwich City,1-0,1,0,1,1,1,1,H
1974-02-02,1973,Manchester City,Tottenham Hotspur,0-0,0,0,1,1,0,0,D
1974-02-02,1973,Queens Park Rangers,Leicester City,0-0,0,0,1,1,0,0,D
1974-02-02,1973,Sheffield United,Everton,1-1,1,1,1,1,2,0,D
1974-02-02,1973,West Ham United,Birmingham City,0-0,0,0,1,1,0,0,D
1974-02-02,1973,Wolverhampton Wanderers,Stoke City,1-1,1,1,1,1,2,0,D
1974-02-05,1973,Ipswich Town,West Ham United,1-3,1,3,1,1,4,-2,A
1974-02-05,1973,Leeds United,Arsenal,3-1,3,1,1,1,4,2,H
1974-02-05,1973,Liverpool,Coventry City,2-1,2,1,1,1,3,1,H
1974-02-05,1973,Queens Park Rangers,Norwich City,1-2,1,2,1,1,3,-1,A
1974-02-05,1973,Sheffield United,Wolverhampton Wanderers,1-0,1,0,1,1,1,1,H
1974-02-05,1973,Southampton,Newcastle United,3-1,3,1,1,1,4,2,H
1974-02-06,1973,Manchester City,Derby County,1-0,1,0,1,1,1,1,H
1974-02-06,1973,Tottenham Hotspur,Birmingham City,4-2,4,2,1,1,6,2,H
1974-02-09,1973,Burnley,Ipswich Town,0-1,0,1,1,1,1,-1,A
1974-02-09,1973,Chelsea,Manchester City,1-0,1,0,1,1,1,1,H
1974-02-09,1973,Everton,Wolverhampton Wanderers,2-1,2,1,1,1,3,1,H
1974-02-09,1973,Leicester City,West Ham United,0-1,0,1,1,1,1,-1,A
1974-02-09,1973,Manchester United,Leeds United,0-2,0,2,1,1,2,-2,A
1974-02-09,1973,Newcastle United,Coventry City,5-1,5,1,1,1,6,4,H
1974-02-09,1973,Norwich City,Sheffield United,2-1,2,1,1,1,3,1,H
1974-02-16,1973,Arsenal,Tottenham Hotspur,0-1,0,1,1,1,1,-1,A
1974-02-16,1973,Derby County,Manchester United,2-2,2,2,1,1,4,0,D
1974-02-16,1973,Sheffield United,Stoke City,0-0,0,0,1,1,0,0,D
1974-02-16,1973,West Ham United,Everton,4-3,4,3,1,1,7,1,H
1974-02-16,1973,Wolverhampton Wanderers,Birmingham City,1-0,1,0,1,1,1,1,H
1974-02-23,1973,Birmingham City,Arsenal,3-1,3,1,1,1,4,2,H
1974-02-23,1973,Burnley,West Ham United,1-1,1,1,1,1,2,0,D
1974-02-23,1973,Chelsea,Queens Park Rangers,3-3,3,3,1,1,6,0,D
1974-02-23,1973,Everton,Coventry City,1-0,1,0,1,1,1,1,H
1974-02-23,1973,Leicester City,Sheffield United,1-1,1,1,1,1,2,0,D
1974-02-23,1973,Manchester United,Wolverhampton Wanderers,0-0,0,0,1,1,0,0,D
1974-02-23,1973,Newcastle United,Liverpool,0-0,0,0,1,1,0,0,D
1974-02-23,1973,Norwich City,Derby County,2-4,2,4,1,1,6,-2,A
1974-02-23,1973,Southampton,Manchester City,0-2,0,2,1,1,2,-2,A
1974-02-23,1973,Stoke City,Leeds United,3-2,3,2,1,1,5,1,H
1974-02-23,1973,Tottenham Hotspur,Ipswich Town,1-1,1,1,1,1,2,0,D
1974-02-26,1973,Coventry City,Norwich City,1-0,1,0,1,1,1,1,H
1974-02-26,1973,Ipswich Town,Chelsea,1-1,1,1,1,1,2,0,D
1974-02-26,1973,Leeds United,Leicester City,1-1,1,1,1,1,2,0,D
1974-02-26,1973,Liverpool,Southampton,1-0,1,0,1,1,1,1,H
1974-02-27,1973,Queens Park Rangers,Burnley,2-1,2,1,1,1,3,1,H
1974-03-02,1973,Arsenal,Southampton,1-0,1,0,1,1,1,1,H
1974-03-02,1973,Coventry City,Birmingham City,0-1,0,1,1,1,1,-1,A
1974-03-02,1973,Derby County,Stoke City,1-1,1,1,1,1,2,0,D
1974-03-02,1973,Ipswich Town,Norwich City,1-1,1,1,1,1,2,0,D
1974-03-02,1973,Leeds United,Newcastle United,1-1,1,1,1,1,2,0,D
1974-03-02,1973,Leicester City,Everton,2-1,2,1,1,1,3,1,H
1974-03-02,1973,Liverpool,Burnley,1-0,1,0,1,1,1,1,H
1974-03-02,1973,Queens Park Rangers,Tottenham Hotspur,3-1,3,1,1,1,4,2,H
1974-03-02,1973,Sheffield United,Manchester United,0-1,0,1,1,1,1,-1,A
1974-03-02,1973,West Ham United,Chelsea,3-0,3,0,1,1,3,3,H
1974-03-05,1973,Southampton,Derby County,1-1,1,1,1,1,2,0,D
1974-03-09,1973,Coventry City,Stoke City,2-0,2,0,1,1,2,2,H
1974-03-09,1973,Derby County,West Ham United,1-1,1,1,1,1,2,0,D
1974-03-09,1973,Everton,Birmingham City,4-1,4,1,1,1,5,3,H
1974-03-09,1973,Leeds United,Manchester City,1-0,1,0,1,1,1,1,H
1974-03-09,1973,Norwich City,Chelsea,2-2,2,2,1,1,4,0,D
1974-03-09,1973,Wolverhampton Wanderers,Ipswich Town,3-1,3,1,1,1,4,2,H
1974-03-12,1973,Sheffield United,Ipswich Town,0-3,0,3,1,1,3,-3,A
1974-03-13,1973,Chelsea,Burnley,3-0,3,0,1,1,3,3,H
1974-03-13,1973,Manchester City,Manchester United,0-0,0,0,1,1,0,0,D
1974-03-16,1973,Birmingham City,Manchester United,1-0,1,0,1,1,1,1,H
1974-03-16,1973,Burnley,Everton,3-1,3,1,1,1,4,2,H
1974-03-16,1973,Chelsea,Newcastle United,1-0,1,0,1,1,1,1,H
1974-03-16,1973,Ipswich Town,Arsenal,2-2,2,2,1,1,4,0,D
1974-03-16,1973,Leicester City,Derby County,0-1,0,1,1,1,1,-1,A
1974-03-16,1973,Liverpool,Leeds United,1-0,1,0,1,1,1,1,H
1974-03-16,1973,Manchester City,Sheffield United,0-1,0,1,1,1,1,-1,A
1974-03-16,1973,Queens Park Rangers,Wolverhampton Wanderers,0-0,0,0,1,1,0,0,D
1974-03-16,1973,Stoke City,Southampton,4-1,4,1,1,1,5,3,H
1974-03-16,1973,Tottenham Hotspur,Norwich City,0-0,0,0,1,1,0,0,D
1974-03-16,1973,West Ham United,Coventry City,2-3,2,3,1,1,5,-1,A
1974-03-18,1973,Southampton,Leicester City,1-0,1,0,1,1,1,1,H
1974-03-20,1973,Norwich City,Birmingham City,2-1,2,1,1,1,3,1,H
1974-03-23,1973,Arsenal,Manchester City,2-0,2,0,1,1,2,2,H
1974-03-23,1973,Coventry City,Queens Park Rangers,0-1,0,1,1,1,1,-1,A
1974-03-23,1973,Derby County,Ipswich Town,2-0,2,0,1,1,2,2,H
1974-03-23,1973,Everton,Chelsea,1-1,1,1,1,1,2,0,D
1974-03-23,1973,Leeds United,Burnley,1-4,1,4,1,1,5,-3,A
1974-03-23,1973,Manchester United,Tottenham Hotspur,0-1,0,1,1,1,1,-1,A
1974-03-23,1973,Newcastle United,Leicester City,1-1,1,1,1,1,2,0,D
1974-03-23,1973,Norwich City,Stoke City,4-0,4,0,1,1,4,4,H
1974-03-23,1973,Sheffield United,West Ham United,1-0,1,0,1,1,1,1,H
1974-03-23,1973,Southampton,Birmingham City,0-2,0,2,1,1,2,-2,A
1974-03-23,1973,Wolverhampton Wanderers,Liverpool,0-1,0,1,1,1,1,-1,A
1974-03-27,1973,Manchester City,Newcastle United,2-1,2,1,1,1,3,1,H
1974-03-30,1973,Birmingham City,Sheffield United,1-0,1,0,1,1,1,1,H
1974-03-30,1973,Chelsea,Manchester United,1-3,1,3,1,1,4,-2,A
1974-03-30,1973,Ipswich Town,Coventry City,3-0,3,0,1,1,3,3,H
1974-03-30,1973,Manchester City,Wolverhampton Wanderers,1-1,1,1,1,1,2,0,D
1974-03-30,1973,Queens Park Rangers,Derby County,0-0,0,0,1,1,0,0,D
1974-03-30,1973,Stoke City,Arsenal,0-0,0,0,1,1,0,0,D
1974-03-30,1973,Tottenham Hotspur,Everton,0-2,0,2,1,1,2,-2,A
1974-03-30,1973,West Ham United,Leeds United,3-1,3,1,1,1,4,2,H
1974-04-02,1973,Manchester City,Everton,1-1,1,1,1,1,2,0,D
1974-04-03,1973,Manchester United,Burnley,3-3,3,3,1,1,6,0,D
1974-04-03,1973,Stoke City,Newcastle United,2-1,2,1,1,1,3,1,H
1974-04-03,1973,Tottenham Hotspur,Chelsea,1-2,1,2,1,1,3,-1,A
1974-04-06,1973,Arsenal,West Ham United,0-0,0,0,1,1,0,0,D
1974-04-06,1973,Leeds United,Derby County,2-0,2,0,1,1,2,2,H
1974-04-06,1973,Leicester City,Birmingham City,3-3,3,3,1,1,6,0,D
1974-04-06,1973,Liverpool,Queens Park Rangers,2-1,2,1,1,1,3,1,H
1974-04-06,1973,Manchester City,Ipswich Town,1-3,1,3,1,1,4,-2,A
1974-04-06,1973,Newcastle United,Everton,2-1,2,1,1,1,3,1,H
1974-04-06,1973,Norwich City,Manchester United,0-2,0,2,1,1,2,-2,A
1974-04-06,1973,Sheffield United,Coventry City,0-1,0,1,1,1,1,-1,A
1974-04-06,1973,Southampton,Chelsea,0-0,0,0,1,1,0,0,D
1974-04-06,1973,Stoke City,Burnley,4-0,4,0,1,1,4,4,H
1974-04-06,1973,Wolverhampton Wanderers,Tottenham Hotspur,1-1,1,1,1,1,2,0,D
1974-04-08,1973,Sheffield United,Liverpool,1-0,1,0,1,1,1,1,H
1974-04-09,1973,Queens Park Rangers,Manchester City,3-0,3,0,1,1,3,3,H
1974-04-09,1973,Wolverhampton Wanderers,Derby County,4-0,4,0,1,1,4,4,H
1974-04-10,1973,Newcastle United,Burnley,1-2,1,2,1,1,3,-1,A
1974-04-12,1973,Burnley,Birmingham City,2-1,2,1,1,1,3,1,H
1974-04-12,1973,Manchester City,Liverpool,1-1,1,1,1,1,2,0,D
1974-04-12,1973,Queens Park Rangers,Ipswich Town,0-1,0,1,1,1,1,-1,A
1974-04-12,1973,West Ham United,Southampton,4-1,4,1,1,1,5,3,H
1974-04-13,1973,Birmingham City,Stoke City,0-0,0,0,1,1,0,0,D
1974-04-13,1973,Burnley,Leicester City,0-0,0,0,1,1,0,0,D
1974-04-13,1973,Chelsea,Arsenal,1-3,1,3,1,1,4,-2,A
1974-04-13,1973,Coventry City,Leeds United,0-0,0,0,1,1,0,0,D
1974-04-13,1973,Derby County,Sheffield United,4-1,4,1,1,1,5,3,H
1974-04-13,1973,Everton,Norwich City,4-1,4,1,1,1,5,3,H
1974-04-13,1973,Ipswich Town,Liverpool,1-1,1,1,1,1,2,0,D
1974-04-13,1973,Manchester United,Newcastle United,1-0,1,0,1,1,1,1,H
1974-04-13,1973,Tottenham Hotspur,Southampton,3-1,3,1,1,1,4,2,H
1974-04-13,1973,West Ham United,Wolverhampton Wanderers,0-0,0,0,1,1,0,0,D
1974-04-15,1973,Chelsea,Tottenham Hotspur,0-0,0,0,1,1,0,0,D
1974-04-15,1973,Derby County,Coventry City,1-0,1,0,1,1,1,1,H
1974-04-15,1973,Ipswich Town,Queens Park Rangers,1-0,1,0,1,1,1,1,H
1974-04-15,1973,Leeds United,Sheffield United,0-0,0,0,1,1,0,0,D
1974-04-15,1973,Manchester United,Everton,3-0,3,0,1,1,3,3,H
1974-04-15,1973,Newcastle United,Norwich City,0-0,0,0,1,1,0,0,D
1974-04-15,1973,Southampton,West Ham United,1-1,1,1,1,1,2,0,D
1974-04-15,1973,Stoke City,Leicester City,1-0,1,0,1,1,1,1,H
1974-04-15,1973,Wolverhampton Wanderers,Arsenal,3-1,3,1,1,1,4,2,H
1974-04-16,1973,Birmingham City,Burnley,2-2,2,2,1,1,4,0,D
1974-04-16,1973,Leicester City,Stoke City,1-1,1,1,1,1,2,0,D
1974-04-16,1973,Liverpool,Manchester City,4-0,4,0,1,1,4,4,H
1974-04-16,1973,Sheffield United,Leeds United,0-2,0,2,1,1,2,-2,A
1974-04-17,1973,Norwich City,Newcastle United,1-1,1,1,1,1,2,0,D
1974-04-20,1973,Arsenal,Derby County,2-0,2,0,1,1,2,2,H
1974-04-20,1973,Leeds United,Ipswich Town,3-2,3,2,1,1,5,1,H
1974-04-20,1973,Leicester City,Chelsea,3-0,3,0,1,1,3,3,H
1974-04-20,1973,Liverpool,Everton,0-0,0,0,1,1,0,0,D
1974-04-20,1973,Manchester City,West Ham United,2-1,2,1,1,1,3,1,H
1974-04-20,1973,Newcastle United,Birmingham City,1-1,1,1,1,1,2,0,D
1974-04-20,1973,Norwich City,Burnley,1-0,1,0,1,1,1,1,H
1974-04-20,1973,Sheffield United,Queens Park Rangers,1-1,1,1,1,1,2,0,D
1974-04-20,1973,Southampton,Manchester United,1-1,1,1,1,1,2,0,D
1974-04-20,1973,Stoke City,Tottenham Hotspur,1-0,1,0,1,1,1,1,H
1974-04-20,1973,Wolverhampton Wanderers,Coventry City,1-1,1,1,1,1,2,0,D
1974-04-22,1973,Burnley,Southampton,3-0,3,0,1,1,3,3,H
1974-04-23,1973,Birmingham City,Queens Park Rangers,4-0,4,0,1,1,4,4,H
1974-04-23,1973,Everton,Manchester United,1-0,1,0,1,1,1,1,H
1974-04-23,1973,Wolverhampton Wanderers,Leicester City,1-0,1,0,1,1,1,1,H
1974-04-24,1973,Liverpool,Arsenal,0-1,0,1,1,1,1,-1,A
1974-04-27,1973,Birmingham City,Norwich City,2-1,2,1,1,1,3,1,H
1974-04-27,1973,Burnley,Newcastle United,1-1,1,1,1,1,2,0,D
1974-04-27,1973,Chelsea,Stoke City,0-1,0,1,1,1,1,-1,A
1974-04-27,1973,Coventry City,Arsenal,3-3,3,3,1,1,6,0,D
1974-04-27,1973,Derby County,Wolverhampton Wanderers,2-0,2,0,1,1,2,2,H
1974-04-27,1973,Everton,Southampton,0-3,0,3,1,1,3,-3,A
1974-04-27,1973,Ipswich Town,Sheffield United,0-1,0,1,1,1,1,-1,A
1974-04-27,1973,Manchester United,Manchester City,0-1,0,1,1,1,1,-1,A
1974-04-27,1973,Queens Park Rangers,Leeds United,0-1,0,1,1,1,1,-1,A
1974-04-27,1973,Tottenham Hotspur,Leicester City,1-0,1,0,1,1,1,1,H
1974-04-27,1973,West Ham United,Liverpool,2-2,2,2,1,1,4,0,D
1974-04-29,1973,Leicester City,Norwich City,3-0,3,0,1,1,3,3,H
1974-04-29,1973,Stoke City,Manchester United,1-0,1,0,1,1,1,1,H
1974-04-30,1973,Arsenal,Queens Park Rangers,1-1,1,1,1,1,2,0,D
1974-05-08,1973,Tottenham Hotspur,Liverpool,1-1,1,1,1,1,2,0,D
1974-05-11,1973,Newcastle United,Tottenham Hotspur,0-2,0,2,1,1,2,-2,A
1974-08-17,1974,Birmingham City,Middlesbrough,0-3,0,3,1,1,3,-3,A
1974-08-17,1974,Burnley,Wolverhampton Wanderers,1-2,1,2,1,1,3,-1,A
1974-08-17,1974,Chelsea,Carlisle United,0-2,0,2,1,1,2,-2,A
1974-08-17,1974,Everton,Derby County,0-0,0,0,1,1,0,0,D
1974-08-17,1974,Leicester City,Arsenal,0-1,0,1,1,1,1,-1,A
1974-08-17,1974,Luton Town,Liverpool,1-2,1,2,1,1,3,-1,A
1974-08-17,1974,Manchester City,West Ham United,4-0,4,0,1,1,4,4,H
1974-08-17,1974,Newcastle United,Coventry City,3-2,3,2,1,1,5,1,H
1974-08-17,1974,Sheffield United,Queens Park Rangers,1-1,1,1,1,1,2,0,D
1974-08-17,1974,Stoke City,Leeds United,3-0,3,0,1,1,3,3,H
1974-08-17,1974,Tottenham Hotspur,Ipswich Town,0-1,0,1,1,1,1,-1,A
1974-08-19,1974,West Ham United,Luton Town,2-0,2,0,1,1,2,2,H
1974-08-20,1974,Arsenal,Ipswich Town,0-1,0,1,1,1,1,-1,A
1974-08-20,1974,Birmingham City,Leicester City,3-4,3,4,1,1,7,-1,A
1974-08-20,1974,Everton,Stoke City,2-1,2,1,1,1,3,1,H
1974-08-20,1974,Middlesbrough,Carlisle United,0-2,0,2,1,1,2,-2,A
1974-08-20,1974,Wolverhampton Wanderers,Liverpool,0-0,0,0,1,1,0,0,D
1974-08-21,1974,Chelsea,Burnley,3-3,3,3,1,1,6,0,D
1974-08-21,1974,Derby County,Coventry City,1-1,1,1,1,1,2,0,D
1974-08-21,1974,Leeds United,Queens Park Rangers,0-1,0,1,1,1,1,-1,A
1974-08-21,1974,Manchester City,Tottenham Hotspur,1-0,1,0,1,1,1,1,H
1974-08-21,1974,Newcastle United,Sheffield United,2-2,2,2,1,1,4,0,D
1974-08-24,1974,Arsenal,Manchester City,4-0,4,0,1,1,4,4,H
1974-08-24,1974,Carlisle United,Tottenham Hotspur,1-0,1,0,1,1,1,1,H
1974-08-24,1974,Coventry City,Chelsea,1-3,1,3,1,1,4,-2,A
1974-08-24,1974,Derby County,Sheffield United,2-0,2,0,1,1,2,2,H
1974-08-24,1974,Ipswich Town,Burnley,2-0,2,0,1,1,2,2,H
1974-08-24,1974,Leeds United,Birmingham City,1-0,1,0,1,1,1,1,H
1974-08-24,1974,Liverpool,Leicester City,2-1,2,1,1,1,3,1,H
1974-08-24,1974,Middlesbrough,Luton Town,1-1,1,1,1,1,2,0,D
1974-08-24,1974,Queens Park Rangers,Stoke City,0-1,0,1,1,1,1,-1,A
1974-08-24,1974,West Ham United,Everton,2-3,2,3,1,1,5,-1,A
1974-08-24,1974,Wolverhampton Wanderers,Newcastle United,4-2,4,2,1,1,6,2,H
1974-08-27,1974,Burnley,Chelsea,1-2,1,2,1,1,3,-1,A
1974-08-27,1974,Carlisle United,Middlesbrough,0-1,0,1,1,1,1,-1,A
1974-08-27,1974,Coventry City,Derby County,1-1,1,1,1,1,2,0,D
1974-08-27,1974,Ipswich Town,Arsenal,3-0,3,0,1,1,3,3,H
1974-08-27,1974,Liverpool,Wolverhampton Wanderers,2-0,2,0,1,1,2,2,H
1974-08-27,1974,Queens Park Rangers,Leeds United,1-1,1,1,1,1,2,0,D
1974-08-27,1974,Sheffield United,Newcastle United,2-1,2,1,1,1,3,1,H
1974-08-28,1974,Leicester City,Birmingham City,1-1,1,1,1,1,2,0,D
1974-08-28,1974,Luton Town,West Ham United,0-0,0,0,1,1,0,0,D
1974-08-28,1974,Stoke City,Everton,1-1,1,1,1,1,2,0,D
1974-08-28,1974,Tottenham Hotspur,Manchester City,1-2,1,2,1,1,3,-1,A
1974-08-31,1974,Birmingham City,Wolverhampton Wanderers,1-1,1,1,1,1,2,0,D
1974-08-31,1974,Burnley,Coventry City,3-0,3,0,1,1,3,3,H
1974-08-31,1974,Chelsea,Liverpool,0-3,0,3,1,1,3,-3,A
1974-08-31,1974,Everton,Arsenal,2-1,2,1,1,1,3,1,H
1974-08-31,1974,Leicester City,Carlisle United,1-1,1,1,1,1,2,0,D
1974-08-31,1974,Luton Town,Queens Park Rangers,1-1,1,1,1,1,2,0,D
1974-08-31,1974,Manchester City,Leeds United,2-1,2,1,1,1,3,1,H
1974-08-31,1974,Newcastle United,West Ham United,2-0,2,0,1,1,2,2,H
1974-08-31,1974,Sheffield United,Ipswich Town,3-1,3,1,1,1,4,2,H
1974-08-31,1974,Stoke City,Middlesbrough,1-1,1,1,1,1,2,0,D
1974-08-31,1974,Tottenham Hotspur,Derby County,2-0,2,0,1,1,2,2,H
1974-09-07,1974,Arsenal,Burnley,0-1,0,1,1,1,1,-1,A
1974-09-07,1974,Carlisle United,Stoke City,0-2,0,2,1,1,2,-2,A
1974-09-07,1974,Coventry City,Manchester City,2-2,2,2,1,1,4,0,D
1974-09-07,1974,Derby County,Newcastle United,2-2,2,2,1,1,4,0,D
1974-09-07,1974,Ipswich Town,Everton,1-0,1,0,1,1,1,1,H
1974-09-07,1974,Leeds United,Luton Town,1-1,1,1,1,1,2,0,D
1974-09-07,1974,Liverpool,Tottenham Hotspur,5-2,5,2,1,1,7,3,H
1974-09-07,1974,Middlesbrough,Chelsea,1-1,1,1,1,1,2,0,D
1974-09-07,1974,Queens Park Rangers,Birmingham City,0-1,0,1,1,1,1,-1,A
1974-09-07,1974,West Ham United,Sheffield United,1-2,1,2,1,1,3,-1,A
1974-09-07,1974,Wolverhampton Wanderers,Leicester City,1-1,1,1,1,1,2,0,D
1974-09-14,1974,Birmingham City,Derby County,3-2,3,2,1,1,5,1,H
1974-09-14,1974,Burnley,Leeds United,2-1,2,1,1,1,3,1,H
1974-09-14,1974,Chelsea,Arsenal,0-0,0,0,1,1,0,0,D
1974-09-14,1974,Everton,Wolverhampton Wanderers,0-0,0,0,1,1,0,0,D
1974-09-14,1974,Leicester City,Queens Park Rangers,3-1,3,1,1,1,4,2,H
1974-09-14,1974,Luton Town,Ipswich Town,1-4,1,4,1,1,5,-3,A
1974-09-14,1974,Manchester City,Liverpool,2-0,2,0,1,1,2,2,H
1974-09-14,1974,Newcastle United,Carlisle United,1-0,1,0,1,1,1,1,H
1974-09-14,1974,Sheffield United,Middlesbrough,1-0,1,0,1,1,1,1,H
1974-09-14,1974,Stoke City,Coventry City,2-0,2,0,1,1,2,2,H
1974-09-14,1974,Tottenham Hotspur,West Ham United,2-1,2,1,1,1,3,1,H
1974-09-21,1974,Arsenal,Luton Town,2-2,2,2,1,1,4,0,D
1974-09-21,1974,Carlisle United,Birmingham City,1-0,1,0,1,1,1,1,H
1974-09-21,1974,Coventry City,Everton,1-1,1,1,1,1,2,0,D
1974-09-21,1974,Derby County,Burnley,3-2,3,2,1,1,5,1,H
1974-09-21,1974,Ipswich Town,Chelsea,2-0,2,0,1,1,2,2,H
1974-09-21,1974,Leeds United,Sheffield United,5-1,5,1,1,1,6,4,H
1974-09-21,1974,Liverpool,Stoke City,3-0,3,0,1,1,3,3,H
1974-09-21,1974,Middlesbrough,Manchester City,3-0,3,0,1,1,3,3,H
1974-09-21,1974,Queens Park Rangers,Newcastle United,1-2,1,2,1,1,3,-1,A
1974-09-21,1974,West Ham United,Leicester City,6-2,6,2,1,1,8,4,H
1974-09-21,1974,Wolverhampton Wanderers,Tottenham Hotspur,2-3,2,3,1,1,5,-1,A
1974-09-24,1974,Carlisle United,Manchester City,0-0,0,0,1,1,0,0,D
1974-09-24,1974,Coventry City,Luton Town,2-1,2,1,1,1,3,1,H
1974-09-24,1974,Ipswich Town,Stoke City,3-1,3,1,1,1,4,2,H
1974-09-24,1974,Liverpool,Burnley,0-1,0,1,1,1,1,-1,A
1974-09-24,1974,Queens Park Rangers,Everton,2-2,2,2,1,1,4,0,D
1974-09-24,1974,Wolverhampton Wanderers,Sheffield United,1-1,1,1,1,1,2,0,D
1974-09-25,1974,Derby County,Chelsea,4-1,4,1,1,1,5,3,H
1974-09-25,1974,West Ham United,Birmingham City,3-0,3,0,1,1,3,3,H
1974-09-28,1974,Birmingham City,Arsenal,3-1,3,1,1,1,4,2,H
1974-09-28,1974,Burnley,West Ham United,3-5,3,5,1,1,8,-2,A
1974-09-28,1974,Chelsea,Wolverhampton Wanderers,0-1,0,1,1,1,1,-1,A
1974-09-28,1974,Everton,Leeds United,3-2,3,2,1,1,5,1,H
1974-09-28,1974,Leicester City,Coventry City,0-1,0,1,1,1,1,-1,A
1974-09-28,1974,Luton Town,Carlisle United,3-1,3,1,1,1,4,2,H
1974-09-28,1974,Manchester City,Queens Park Rangers,1-0,1,0,1,1,1,1,H
1974-09-28,1974,Newcastle United,Ipswich Town,1-0,1,0,1,1,1,1,H
1974-09-28,1974,Sheffield United,Liverpool,1-0,1,0,1,1,1,1,H
1974-09-28,1974,Stoke City,Derby County,1-1,1,1,1,1,2,0,D
1974-09-28,1974,Tottenham Hotspur,Middlesbrough,1-2,1,2,1,1,3,-1,A
1974-10-05,1974,Birmingham City,Coventry City,1-2,1,2,1,1,3,-1,A
1974-10-05,1974,Carlisle United,Liverpool,0-1,0,1,1,1,1,-1,A
1974-10-05,1974,Everton,Newcastle United,1-1,1,1,1,1,2,0,D
1974-10-05,1974,Leeds United,Arsenal,2-0,2,0,1,1,2,2,H
1974-10-05,1974,Leicester City,Luton Town,0-0,0,0,1,1,0,0,D
1974-10-05,1974,Manchester City,Chelsea,1-1,1,1,1,1,2,0,D
1974-10-05,1974,Middlesbrough,Wolverhampton Wanderers,2-1,2,1,1,1,3,1,H
1974-10-05,1974,Queens Park Rangers,Ipswich Town,1-0,1,0,1,1,1,1,H
1974-10-05,1974,Stoke City,Sheffield United,3-2,3,2,1,1,5,1,H
1974-10-05,1974,Tottenham Hotspur,Burnley,2-3,2,3,1,1,5,-1,A
1974-10-05,1974,West Ham United,Derby County,2-2,2,2,1,1,4,0,D
1974-10-12,1974,Arsenal,Queens Park Rangers,2-2,2,2,1,1,4,0,D
1974-10-12,1974,Burnley,Manchester City,2-1,2,1,1,1,3,1,H
1974-10-12,1974,Chelsea,Tottenham Hotspur,1-0,1,0,1,1,1,1,H
1974-10-12,1974,Coventry City,West Ham United,1-1,1,1,1,1,2,0,D
1974-10-12,1974,Derby County,Leicester City,1-0,1,0,1,1,1,1,H
1974-10-12,1974,Ipswich Town,Leeds United,0-0,0,0,1,1,0,0,D
1974-10-12,1974,Liverpool,Middlesbrough,2-0,2,0,1,1,2,2,H
1974-10-12,1974,Luton Town,Birmingham City,1-3,1,3,1,1,4,-2,A
1974-10-12,1974,Newcastle United,Stoke City,2-2,2,2,1,1,4,0,D
1974-10-12,1974,Sheffield United,Everton,2-2,2,2,1,1,4,0,D
1974-10-12,1974,Wolverhampton Wanderers,Carlisle United,2-0,2,0,1,1,2,2,H
1974-10-15,1974,Birmingham City,Leeds United,1-0,1,0,1,1,1,1,H
1974-10-15,1974,Burnley,Ipswich Town,1-0,1,0,1,1,1,1,H
1974-10-15,1974,Everton,West Ham United,1-1,1,1,1,1,2,0,D
1974-10-15,1974,Sheffield United,Derby County,1-2,1,2,1,1,3,-1,A
1974-10-16,1974,Luton Town,Middlesbrough,0-1,0,1,1,1,1,-1,A
1974-10-16,1974,Manchester City,Arsenal,2-1,2,1,1,1,3,1,H
1974-10-16,1974,Newcastle United,Wolverhampton Wanderers,0-0,0,0,1,1,0,0,D
1974-10-16,1974,Tottenham Hotspur,Carlisle United,1-1,1,1,1,1,2,0,D
1974-10-19,1974,Birmingham City,Newcastle United,3-0,3,0,1,1,3,3,H
1974-10-19,1974,Carlisle United,Derby County,3-0,3,0,1,1,3,3,H
1974-10-19,1974,Everton,Chelsea,1-1,1,1,1,1,2,0,D
1974-10-19,1974,Leeds United,Wolverhampton Wanderers,2-0,2,0,1,1,2,2,H
1974-10-19,1974,Leicester City,Sheffield United,3-0,3,0,1,1,3,3,H
1974-10-19,1974,Manchester City,Luton Town,1-0,1,0,1,1,1,1,H
1974-10-19,1974,Middlesbrough,Coventry City,4-4,4,4,1,1,8,0,D
1974-10-19,1974,Queens Park Rangers,Liverpool,0-1,0,1,1,1,1,-1,A
1974-10-19,1974,Stoke City,Burnley,2-0,2,0,1,1,2,2,H
1974-10-19,1974,Tottenham Hotspur,Arsenal,2-0,2,0,1,1,2,2,H
1974-10-19,1974,West Ham United,Ipswich Town,1-0,1,0,1,1,1,1,H
1974-10-26,1974,Arsenal,West Ham United,3-0,3,0,1,1,3,3,H
1974-10-26,1974,Burnley,Everton,1-1,1,1,1,1,2,0,D
1974-10-26,1974,Chelsea,Stoke City,3-3,3,3,1,1,6,0,D
1974-10-26,1974,Coventry City,Carlisle United,2-1,2,1,1,1,3,1,H
1974-10-26,1974,Derby County,Middlesbrough,2-3,2,3,1,1,5,-1,A
1974-10-26,1974,Ipswich Town,Manchester City,1-1,1,1,1,1,2,0,D
1974-10-26,1974,Liverpool,Leeds United,1-0,1,0,1,1,1,1,H
1974-10-26,1974,Luton Town,Tottenham Hotspur,1-1,1,1,1,1,2,0,D
1974-10-26,1974,Newcastle United,Leicester City,0-1,0,1,1,1,1,-1,A
1974-10-26,1974,Sheffield United,Birmingham City,3-2,3,2,1,1,5,1,H
1974-10-26,1974,Wolverhampton Wanderers,Queens Park Rangers,1-2,1,2,1,1,3,-1,A
1974-11-02,1974,Arsenal,Wolverhampton Wanderers,0-0,0,0,1,1,0,0,D
1974-11-02,1974,Birmingham City,Chelsea,2-0,2,0,1,1,2,2,H
1974-11-02,1974,Everton,Manchester City,2-0,2,0,1,1,2,2,H
1974-11-02,1974,Ipswich Town,Liverpool,1-0,1,0,1,1,1,1,H
1974-11-02,1974,Leeds United,Derby County,0-1,0,1,1,1,1,-1,A
1974-11-02,1974,Leicester City,Burnley,1-0,1,0,1,1,1,1,H
1974-11-02,1974,Newcastle United,Luton Town,1-0,1,0,1,1,1,1,H
1974-11-02,1974,Queens Park Rangers,Coventry City,2-0,2,0,1,1,2,2,H
1974-11-02,1974,Sheffield United,Carlisle United,2-1,2,1,1,1,3,1,H
1974-11-02,1974,Stoke City,Tottenham Hotspur,2-2,2,2,1,1,4,0,D
1974-11-02,1974,West Ham United,Middlesbrough,3-0,3,0,1,1,3,3,H
1974-11-09,1974,Burnley,Birmingham City,2-2,2,2,1,1,4,0,D
1974-11-09,1974,Carlisle United,West Ham United,0-1,0,1,1,1,1,-1,A
1974-11-09,1974,Chelsea,Leicester City,0-0,0,0,1,1,0,0,D
1974-11-09,1974,Coventry City,Leeds United,1-3,1,3,1,1,4,-2,A
1974-11-09,1974,Derby County,Queens Park Rangers,5-2,5,2,1,1,7,3,H
1974-11-09,1974,Liverpool,Arsenal,1-3,1,3,1,1,4,-2,A
1974-11-09,1974,Luton Town,Sheffield United,0-1,0,1,1,1,1,-1,A
1974-11-09,1974,Manchester City,Stoke City,1-0,1,0,1,1,1,1,H
1974-11-09,1974,Middlesbrough,Newcastle United,0-0,0,0,1,1,0,0,D
1974-11-09,1974,Tottenham Hotspur,Everton,1-1,1,1,1,1,2,0,D
1974-11-09,1974,Wolverhampton Wanderers,Ipswich Town,2-1,2,1,1,1,3,1,H
1974-11-13,1974,Chelsea,Coventry City,3-3,3,3,1,1,6,0,D
1974-11-16,1974,Arsenal,Derby County,3-1,3,1,1,1,4,2,H
1974-11-16,1974,Birmingham City,Manchester City,4-0,4,0,1,1,4,4,H
1974-11-16,1974,Everton,Liverpool,0-0,0,0,1,1,0,0,D
1974-11-16,1974,Ipswich Town,Coventry City,4-0,4,0,1,1,4,4,H
1974-11-16,1974,Leeds United,Middlesbrough,2-2,2,2,1,1,4,0,D
1974-11-16,1974,Leicester City,Tottenham Hotspur,1-2,1,2,1,1,3,-1,A
1974-11-16,1974,Newcastle United,Chelsea,5-0,5,0,1,1,5,5,H
1974-11-16,1974,Queens Park Rangers,Carlisle United,2-1,2,1,1,1,3,1,H
1974-11-16,1974,Sheffield United,Burnley,2-2,2,2,1,1,4,0,D
1974-11-16,1974,Stoke City,Luton Town,4-2,4,2,1,1,6,2,H
1974-11-16,1974,West Ham United,Wolverhampton Wanderers,5-2,5,2,1,1,7,3,H
1974-11-23,1974,Burnley,Newcastle United,4-1,4,1,1,1,5,3,H
1974-11-23,1974,Carlisle United,Leeds United,1-2,1,2,1,1,3,-1,A
1974-11-23,1974,Coventry City,Arsenal,3-0,3,0,1,1,3,3,H
1974-11-23,1974,Derby County,Ipswich Town,2-0,2,0,1,1,2,2,H
1974-11-23,1974,Liverpool,West Ham United,1-1,1,1,1,1,2,0,D
1974-11-23,1974,Manchester City,Leicester City,4-1,4,1,1,1,5,3,H
1974-11-23,1974,Middlesbrough,Queens Park Rangers,1-3,1,3,1,1,4,-2,A
1974-11-23,1974,Tottenham Hotspur,Birmingham City,0-0,0,0,1,1,0,0,D
1974-11-23,1974,Wolverhampton Wanderers,Stoke City,2-2,2,2,1,1,4,0,D
1974-11-27,1974,Stoke City,Queens Park Rangers,1-0,1,0,1,1,1,1,H
1974-11-30,1974,Arsenal,Middlesbrough,2-0,2,0,1,1,2,2,H
1974-11-30,1974,Coventry City,Liverpool,1-1,1,1,1,1,2,0,D
1974-11-30,1974,Everton,Birmingham City,4-1,4,1,1,1,5,3,H
1974-11-30,1974,Ipswich Town,Carlisle United,3-1,3,1,1,1,4,2,H
1974-11-30,1974,Leeds United,Chelsea,2-0,2,0,1,1,2,2,H
1974-11-30,1974,Luton Town,Burnley,2-3,2,3,1,1,5,-1,A
1974-11-30,1974,Newcastle United,Manchester City,2-1,2,1,1,1,3,1,H
1974-11-30,1974,Queens Park Rangers,West Ham United,0-2,0,2,1,1,2,-2,A
1974-11-30,1974,Sheffield United,Tottenham Hotspur,0-1,0,1,1,1,1,-1,A
1974-11-30,1974,Stoke City,Leicester City,1-0,1,0,1,1,1,1,H
1974-12-04,1974,Leeds United,Tottenham Hotspur,2-1,2,1,1,1,3,1,H
1974-12-07,1974,Birmingham City,Stoke City,0-3,0,3,1,1,3,-3,A
1974-12-07,1974,Burnley,Queens Park Rangers,3-0,3,0,1,1,3,3,H
1974-12-07,1974,Carlisle United,Arsenal,2-1,2,1,1,1,3,1,H
1974-12-07,1974,Chelsea,Luton Town,2-0,2,0,1,1,2,2,H
1974-12-07,1974,Leicester City,Everton,0-2,0,2,1,1,2,-2,A
1974-12-07,1974,Liverpool,Derby County,2-2,2,2,1,1,4,0,D
1974-12-07,1974,Manchester City,Sheffield United,3-2,3,2,1,1,5,1,H
1974-12-07,1974,Middlesbrough,Ipswich Town,3-0,3,0,1,1,3,3,H
1974-12-07,1974,Tottenham Hotspur,Newcastle United,3-0,3,0,1,1,3,3,H
1974-12-07,1974,West Ham United,Leeds United,2-1,2,1,1,1,3,1,H
1974-12-07,1974,Wolverhampton Wanderers,Coventry City,2-0,2,0,1,1,2,2,H
1974-12-10,1974,Middlesbrough,Leicester City,3-0,3,0,1,1,3,3,H
1974-12-14,1974,Arsenal,Leicester City,0-0,0,0,1,1,0,0,D
1974-12-14,1974,Carlisle United,Chelsea,1-2,1,2,1,1,3,-1,A
1974-12-14,1974,Coventry City,Newcastle United,2-0,2,0,1,1,2,2,H
1974-12-14,1974,Derby County,Everton,0-1,0,1,1,1,1,-1,A
1974-12-14,1974,Ipswich Town,Tottenham Hotspur,4-0,4,0,1,1,4,4,H
1974-12-14,1974,Leeds United,Stoke City,3-1,3,1,1,1,4,2,H
1974-12-14,1974,Liverpool,Luton Town,2-0,2,0,1,1,2,2,H
1974-12-14,1974,Middlesbrough,Birmingham City,3-0,3,0,1,1,3,3,H
1974-12-14,1974,Queens Park Rangers,Sheffield United,1-0,1,0,1,1,1,1,H
1974-12-14,1974,West Ham United,Manchester City,0-0,0,0,1,1,0,0,D
1974-12-14,1974,Wolverhampton Wanderers,Burnley,4-2,4,2,1,1,6,2,H
1974-12-20,1974,Leicester City,Ipswich Town,0-1,0,1,1,1,1,-1,A
1974-12-20,1974,Sheffield United,Coventry City,1-0,1,0,1,1,1,1,H
1974-12-21,1974,Birmingham City,Liverpool,3-1,3,1,1,1,4,2,H
1974-12-21,1974,Burnley,Middlesbrough,1-1,1,1,1,1,2,0,D
1974-12-21,1974,Chelsea,West Ham United,1-1,1,1,1,1,2,0,D
1974-12-21,1974,Everton,Carlisle United,2-3,2,3,1,1,5,-1,A
1974-12-21,1974,Luton Town,Derby County,1-0,1,0,1,1,1,1,H
1974-12-21,1974,Manchester City,Wolverhampton Wanderers,0-0,0,0,1,1,0,0,D
1974-12-21,1974,Newcastle United,Leeds United,3-0,3,0,1,1,3,3,H
1974-12-21,1974,Stoke City,Arsenal,0-2,0,2,1,1,2,-2,A
1974-12-21,1974,Tottenham Hotspur,Queens Park Rangers,1-2,1,2,1,1,3,-1,A
1974-12-26,1974,Arsenal,Chelsea,1-2,1,2,1,1,3,-1,A
1974-12-26,1974,Carlisle United,Newcastle United,1-2,1,2,1,1,3,-1,A
1974-12-26,1974,Coventry City,Stoke City,2-0,2,0,1,1,2,2,H
1974-12-26,1974,Derby County,Birmingham City,2-1,2,1,1,1,3,1,H
1974-12-26,1974,Ipswich Town,Luton Town,0-1,0,1,1,1,1,-1,A
1974-12-26,1974,Leeds United,Burnley,2-2,2,2,1,1,4,0,D
1974-12-26,1974,Liverpool,Manchester City,4-1,4,1,1,1,5,3,H
1974-12-26,1974,Middlesbrough,Sheffield United,1-0,1,0,1,1,1,1,H
1974-12-26,1974,Queens Park Rangers,Leicester City,4-2,4,2,1,1,6,2,H
1974-12-26,1974,West Ham United,Tottenham Hotspur,1-1,1,1,1,1,2,0,D
1974-12-26,1974,Wolverhampton Wanderers,Everton,2-0,2,0,1,1,2,2,H
1974-12-28,1974,Birmingham City,Ipswich Town,0-1,0,1,1,1,1,-1,A
1974-12-28,1974,Burnley,Carlisle United,2-1,2,1,1,1,3,1,H
1974-12-28,1974,Chelsea,Queens Park Rangers,0-3,0,3,1,1,3,-3,A
1974-12-28,1974,Everton,Middlesbrough,1-1,1,1,1,1,2,0,D
1974-12-28,1974,Leicester City,Leeds United,0-2,0,2,1,1,2,-2,A
1974-12-28,1974,Luton Town,Wolverhampton Wanderers,3-2,3,2,1,1,5,1,H
1974-12-28,1974,Manchester City,Derby County,1-2,1,2,1,1,3,-1,A
1974-12-28,1974,Sheffield United,Arsenal,1-1,1,1,1,1,2,0,D
1974-12-28,1974,Stoke City,West Ham United,2-1,2,1,1,1,3,1,H
1974-12-28,1974,Tottenham Hotspur,Coventry City,1-1,1,1,1,1,2,0,D
1975-01-11,1974,Arsenal,Carlisle United,2-1,2,1,1,1,3,1,H
1975-01-11,1974,Coventry City,Wolverhampton Wanderers,2-1,2,1,1,1,3,1,H
1975-01-11,1974,Derby County,Liverpool,2-0,2,0,1,1,2,2,H
1975-01-11,1974,Everton,Leicester City,3-0,3,0,1,1,3,3,H
1975-01-11,1974,Ipswich Town,Middlesbrough,2-0,2,0,1,1,2,2,H
1975-01-11,1974,Leeds United,West Ham United,2-1,2,1,1,1,3,1,H
1975-01-11,1974,Luton Town,Chelsea,1-1,1,1,1,1,2,0,D
1975-01-11,1974,Newcastle United,Tottenham Hotspur,2-5,2,5,1,1,7,-3,A
1975-01-11,1974,Queens Park Rangers,Burnley,0-1,0,1,1,1,1,-1,A
1975-01-11,1974,Sheffield United,Manchester City,1-1,1,1,1,1,2,0,D
1975-01-11,1974,Stoke City,Birmingham City,0-0,0,0,1,1,0,0,D
1975-01-18,1974,Birmingham City,Everton,0-3,0,3,1,1,3,-3,A
1975-01-18,1974,Burnley,Luton Town,1-0,1,0,1,1,1,1,H
1975-01-18,1974,Carlisle United,Ipswich Town,2-1,2,1,1,1,3,1,H
1975-01-18,1974,Chelsea,Leeds United,0-2,0,2,1,1,2,-2,A
1975-01-18,1974,Leicester City,Stoke City,1-1,1,1,1,1,2,0,D
1975-01-18,1974,Liverpool,Coventry City,2-1,2,1,1,1,3,1,H
1975-01-18,1974,Manchester City,Newcastle United,5-1,5,1,1,1,6,4,H
1975-01-18,1974,Middlesbrough,Arsenal,0-0,0,0,1,1,0,0,D
1975-01-18,1974,Tottenham Hotspur,Sheffield United,1-3,1,3,1,1,4,-2,A
1975-01-18,1974,West Ham United,Queens Park Rangers,2-2,2,2,1,1,4,0,D
1975-01-18,1974,Wolverhampton Wanderers,Derby County,0-1,0,1,1,1,1,-1,A
1975-02-01,1974,Arsenal,Liverpool,2-0,2,0,1,1,2,2,H
1975-02-01,1974,Birmingham City,Burnley,1-1,1,1,1,1,2,0,D
1975-02-01,1974,Everton,Tottenham Hotspur,1-0,1,0,1,1,1,1,H
1975-02-01,1974,Ipswich Town,Wolverhampton Wanderers,2-0,2,0,1,1,2,2,H
1975-02-01,1974,Leeds United,Coventry City,0-0,0,0,1,1,0,0,D
1975-02-01,1974,Leicester City,Chelsea,1-1,1,1,1,1,2,0,D
1975-02-01,1974,Newcastle United,Middlesbrough,2-1,2,1,1,1,3,1,H
1975-02-01,1974,Queens Park Rangers,Derby County,4-1,4,1,1,1,5,3,H
1975-02-01,1974,Sheffield United,Luton Town,1-1,1,1,1,1,2,0,D
1975-02-01,1974,Stoke City,Manchester City,4-0,4,0,1,1,4,4,H
1975-02-01,1974,West Ham United,Carlisle United,2-0,2,0,1,1,2,2,H
1975-02-08,1974,Burnley,Leicester City,2-0,2,0,1,1,2,2,H
1975-02-08,1974,Carlisle United,Sheffield United,0-1,0,1,1,1,1,-1,A
1975-02-08,1974,Chelsea,Birmingham City,2-1,2,1,1,1,3,1,H
1975-02-08,1974,Coventry City,Queens Park Rangers,1-1,1,1,1,1,2,0,D
1975-02-08,1974,Derby County,Leeds United,0-0,0,0,1,1,0,0,D
1975-02-08,1974,Liverpool,Ipswich Town,5-2,5,2,1,1,7,3,H
1975-02-08,1974,Luton Town,Newcastle United,1-0,1,0,1,1,1,1,H
1975-02-08,1974,Manchester City,Everton,2-1,2,1,1,1,3,1,H
1975-02-08,1974,Middlesbrough,West Ham United,0-0,0,0,1,1,0,0,D
1975-02-08,1974,Tottenham Hotspur,Stoke City,0-2,0,2,1,1,2,-2,A
1975-02-08,1974,Wolverhampton Wanderers,Arsenal,1-0,1,0,1,1,1,1,H
1975-02-12,1974,Newcastle United,Liverpool,4-1,4,1,1,1,5,3,H
1975-02-15,1974,Coventry City,Tottenham Hotspur,1-1,1,1,1,1,2,0,D
1975-02-15,1974,Newcastle United,Burnley,3-0,3,0,1,1,3,3,H
1975-02-15,1974,Sheffield United,Chelsea,2-1,2,1,1,1,3,1,H
1975-02-15,1974,Stoke City,Wolverhampton Wanderers,2-2,2,2,1,1,4,0,D
1975-02-18,1974,Birmingham City,Tottenham Hotspur,1-0,1,0,1,1,1,1,H
1975-02-19,1974,West Ham United,Liverpool,0-0,0,0,1,1,0,0,D
1975-02-22,1974,Burnley,Sheffield United,2-1,2,1,1,1,3,1,H
1975-02-22,1974,Carlisle United,Queens Park Rangers,1-2,1,2,1,1,3,-1,A
1975-02-22,1974,Chelsea,Newcastle United,3-2,3,2,1,1,5,1,H
1975-02-22,1974,Coventry City,Ipswich Town,3-1,3,1,1,1,4,2,H
1975-02-22,1974,Derby County,Arsenal,2-1,2,1,1,1,3,1,H
1975-02-22,1974,Liverpool,Everton,0-0,0,0,1,1,0,0,D
1975-02-22,1974,Luton Town,Stoke City,0-0,0,0,1,1,0,0,D
1975-02-22,1974,Manchester City,Birmingham City,3-1,3,1,1,1,4,2,H
1975-02-22,1974,Middlesbrough,Leeds United,0-1,0,1,1,1,1,-1,A
1975-02-22,1974,Tottenham Hotspur,Leicester City,0-3,0,3,1,1,3,-3,A
1975-02-22,1974,Wolverhampton Wanderers,West Ham United,3-1,3,1,1,1,4,2,H
1975-02-25,1974,Everton,Luton Town,3-1,3,1,1,1,4,2,H
1975-02-25,1974,Ipswich Town,Derby County,3-0,3,0,1,1,3,3,H
1975-02-25,1974,Leeds United,Carlisle United,3-1,3,1,1,1,4,2,H
1975-02-25,1974,Queens Park Rangers,Middlesbrough,0-0,0,0,1,1,0,0,D
1975-02-28,1974,West Ham United,Newcastle United,0-1,0,1,1,1,1,-1,A
1975-03-01,1974,Arsenal,Everton,0-2,0,2,1,1,2,-2,A
1975-03-01,1974,Carlisle United,Leicester City,0-1,0,1,1,1,1,-1,A
1975-03-01,1974,Coventry City,Burnley,0-3,0,3,1,1,3,-3,A
1975-03-01,1974,Derby County,Tottenham Hotspur,3-1,3,1,1,1,4,2,H
1975-03-01,1974,Ipswich Town,Sheffield United,0-1,0,1,1,1,1,-1,A
1975-03-01,1974,Leeds United,Manchester City,2-2,2,2,1,1,4,0,D
1975-03-01,1974,Liverpool,Chelsea,2-2,2,2,1,1,4,0,D
1975-03-01,1974,Middlesbrough,Stoke City,2-0,2,0,1,1,2,2,H
1975-03-01,1974,Queens Park Rangers,Luton Town,2-1,2,1,1,1,3,1,H
1975-03-01,1974,Wolverhampton Wanderers,Birmingham City,0-1,0,1,1,1,1,-1,A
1975-03-08,1974,Burnley,Liverpool,1-1,1,1,1,1,2,0,D
1975-03-08,1974,Chelsea,Derby County,1-2,1,2,1,1,3,-1,A
1975-03-08,1974,Everton,Queens Park Rangers,2-1,2,1,1,1,3,1,H
1975-03-08,1974,Leicester City,Manchester City,1-0,1,0,1,1,1,1,H
1975-03-08,1974,Luton Town,Coventry City,1-3,1,3,1,1,4,-2,A
1975-03-08,1974,Sheffield United,Wolverhampton Wanderers,1-0,1,0,1,1,1,1,H
1975-03-15,1974,Arsenal,Birmingham City,1-1,1,1,1,1,2,0,D
1975-03-15,1974,Carlisle United,Luton Town,1-2,1,2,1,1,3,-1,A
1975-03-15,1974,Coventry City,Leicester City,2-2,2,2,1,1,4,0,D
1975-03-15,1974,Derby County,Stoke City,1-2,1,2,1,1,3,-1,A
1975-03-15,1974,Ipswich Town,Newcastle United,5-4,5,4,1,1,9,1,H
1975-03-15,1974,Leeds United,Everton,0-0,0,0,1,1,0,0,D
1975-03-15,1974,Liverpool,Sheffield United,0-0,0,0,1,1,0,0,D
1975-03-15,1974,Middlesbrough,Tottenham Hotspur,3-0,3,0,1,1,3,3,H
1975-03-15,1974,Queens Park Rangers,Manchester City,2-0,2,0,1,1,2,2,H
1975-03-15,1974,West Ham United,Burnley,2-1,2,1,1,1,3,1,H
1975-03-15,1974,Wolverhampton Wanderers,Chelsea,7-1,7,1,1,1,8,6,H
1975-03-18,1974,Arsenal,Newcastle United,3-0,3,0,1,1,3,3,H
1975-03-18,1974,Birmingham City,West Ham United,1-1,1,1,1,1,2,0,D
1975-03-18,1974,Middlesbrough,Everton,2-0,2,0,1,1,2,2,H
1975-03-18,1974,Queens Park Rangers,Chelsea,1-0,1,0,1,1,1,1,H
1975-03-18,1974,Stoke City,Ipswich Town,1-2,1,2,1,1,3,-1,A
1975-03-19,1974,Leicester City,Liverpool,1-1,1,1,1,1,2,0,D
1975-03-19,1974,Manchester City,Carlisle United,1-2,1,2,1,1,3,-1,A
1975-03-22,1974,Birmingham City,Queens Park Rangers,4-1,4,1,1,1,5,3,H
1975-03-22,1974,Burnley,Arsenal,3-3,3,3,1,1,6,0,D
1975-03-22,1974,Chelsea,Middlesbrough,1-2,1,2,1,1,3,-1,A
1975-03-22,1974,Everton,Ipswich Town,1-1,1,1,1,1,2,0,D
1975-03-22,1974,Leicester City,Wolverhampton Wanderers,3-2,3,2,1,1,5,1,H
1975-03-22,1974,Luton Town,Leeds United,2-1,2,1,1,1,3,1,H
1975-03-22,1974,Manchester City,Coventry City,1-0,1,0,1,1,1,1,H
1975-03-22,1974,Newcastle United,Derby County,0-2,0,2,1,1,2,-2,A
1975-03-22,1974,Sheffield United,West Ham United,3-2,3,2,1,1,5,1,H
1975-03-22,1974,Stoke City,Carlisle United,5-2,5,2,1,1,7,3,H
1975-03-22,1974,Tottenham Hotspur,Liverpool,0-2,0,2,1,1,2,-2,A
1975-03-25,1974,Birmingham City,Carlisle United,2-0,2,0,1,1,2,2,H
1975-03-25,1974,Liverpool,Newcastle United,4-0,4,0,1,1,4,4,H
1975-03-25,1974,Luton Town,Arsenal,2-0,2,0,1,1,2,2,H
1975-03-28,1974,Coventry City,Sheffield United,2-2,2,2,1,1,4,0,D
1975-03-28,1974,Manchester City,Middlesbrough,2-1,2,1,1,1,3,1,H
1975-03-28,1974,Tottenham Hotspur,Wolverhampton Wanderers,3-0,3,0,1,1,3,3,H
1975-03-28,1974,West Ham United,Stoke City,2-2,2,2,1,1,4,0,D
1975-03-29,1974,Arsenal,Stoke City,1-1,1,1,1,1,2,0,D
1975-03-29,1974,Carlisle United,Everton,3-0,3,0,1,1,3,3,H
1975-03-29,1974,Derby County,Luton Town,5-0,5,0,1,1,5,5,H
1975-03-29,1974,Ipswich Town,Leicester City,2-1,2,1,1,1,3,1,H
1975-03-29,1974,Leeds United,Newcastle United,1-1,1,1,1,1,2,0,D
1975-03-29,1974,Liverpool,Birmingham City,1-0,1,0,1,1,1,1,H
1975-03-29,1974,Middlesbrough,Burnley,2-0,2,0,1,1,2,2,H
1975-03-29,1974,Queens Park Rangers,Tottenham Hotspur,0-1,0,1,1,1,1,-1,A
1975-03-29,1974,West Ham United,Chelsea,0-1,0,1,1,1,1,-1,A
1975-03-29,1974,Wolverhampton Wanderers,Manchester City,1-0,1,0,1,1,1,1,H
1975-03-31,1974,Arsenal,Sheffield United,1-0,1,0,1,1,1,1,H
1975-03-31,1974,Burnley,Derby County,2-5,2,5,1,1,7,-3,A
1975-03-31,1974,Chelsea,Ipswich Town,0-0,0,0,1,1,0,0,D
1975-03-31,1974,Everton,Coventry City,1-0,1,0,1,1,1,1,H
1975-03-31,1974,Leeds United,Leicester City,2-2,2,2,1,1,4,0,D
1975-03-31,1974,Newcastle United,Queens Park Rangers,2-2,2,2,1,1,4,0,D
1975-03-31,1974,Stoke City,Liverpool,2-0,2,0,1,1,2,2,H
1975-03-31,1974,Wolverhampton Wanderers,Luton Town,5-2,5,2,1,1,7,3,H
1975-04-01,1974,Carlisle United,Burnley,4-2,4,2,1,1,6,2,H
1975-04-01,1974,Derby County,Manchester City,2-1,2,1,1,1,3,1,H
1975-04-01,1974,Ipswich Town,Birmingham City,3-2,3,2,1,1,5,1,H
1975-04-01,1974,Leicester City,West Ham United,3-0,3,0,1,1,3,3,H
1975-04-01,1974,Sheffield United,Leeds United,1-1,1,1,1,1,2,0,D
1975-04-04,1974,Everton,Burnley,1-1,1,1,1,1,2,0,D
1975-04-05,1974,Carlisle United,Coventry City,0-0,0,0,1,1,0,0,D
1975-04-05,1974,Leeds United,Liverpool,0-2,0,2,1,1,2,-2,A
1975-04-05,1974,Leicester City,Newcastle United,4-0,4,0,1,1,4,4,H
1975-04-05,1974,Middlesbrough,Derby County,1-1,1,1,1,1,2,0,D
1975-04-05,1974,Queens Park Rangers,Wolverhampton Wanderers,2-0,2,0,1,1,2,2,H
1975-04-05,1974,Stoke City,Chelsea,3-0,3,0,1,1,3,3,H
1975-04-05,1974,Tottenham Hotspur,Luton Town,2-1,2,1,1,1,3,1,H
1975-04-08,1974,Arsenal,Coventry City,2-0,2,0,1,1,2,2,H
1975-04-09,1974,Derby County,Wolverhampton Wanderers,1-0,1,0,1,1,1,1,H
1975-04-09,1974,Leicester City,Middlesbrough,1-0,1,0,1,1,1,1,H
1975-04-09,1974,Luton Town,Everton,2-1,2,1,1,1,3,1,H
1975-04-12,1974,Arsenal,Leeds United,1-2,1,2,1,1,3,-1,A
1975-04-12,1974,Burnley,Tottenham Hotspur,3-2,3,2,1,1,5,1,H
1975-04-12,1974,Chelsea,Manchester City,0-1,0,1,1,1,1,-1,A
1975-04-12,1974,Coventry City,Birmingham City,1-0,1,0,1,1,1,1,H
1975-04-12,1974,Derby County,West Ham United,1-0,1,0,1,1,1,1,H
1975-04-12,1974,Ipswich Town,Queens Park Rangers,2-1,2,1,1,1,3,1,H
1975-04-12,1974,Liverpool,Carlisle United,2-0,2,0,1,1,2,2,H
1975-04-12,1974,Luton Town,Leicester City,3-0,3,0,1,1,3,3,H
1975-04-12,1974,Newcastle United,Everton,0-1,0,1,1,1,1,-1,A
1975-04-12,1974,Sheffield United,Stoke City,2-0,2,0,1,1,2,2,H
1975-04-12,1974,Wolverhampton Wanderers,Middlesbrough,2-0,2,0,1,1,2,2,H
1975-04-19,1974,Birmingham City,Luton Town,1-4,1,4,1,1,5,-3,A
1975-04-19,1974,Carlisle United,Wolverhampton Wanderers,1-0,1,0,1,1,1,1,H
1975-04-19,1974,Everton,Sheffield United,2-3,2,3,1,1,5,-1,A
1975-04-19,1974,Leeds United,Ipswich Town,2-1,2,1,1,1,3,1,H
1975-04-19,1974,Leicester City,Derby County,0-0,0,0,1,1,0,0,D
1975-04-19,1974,Manchester City,Burnley,2-0,2,0,1,1,2,2,H
1975-04-19,1974,Middlesbrough,Liverpool,1-0,1,0,1,1,1,1,H
1975-04-19,1974,Queens Park Rangers,Arsenal,0-0,0,0,1,1,0,0,D
1975-04-19,1974,Stoke City,Newcastle United,0-0,0,0,1,1,0,0,D
1975-04-19,1974,Tottenham Hotspur,Chelsea,2-0,2,0,1,1,2,2,H
1975-04-19,1974,West Ham United,Coventry City,1-2,1,2,1,1,3,-1,A
1975-04-23,1974,Chelsea,Sheffield United,1-1,1,1,1,1,2,0,D
1975-04-23,1974,Manchester City,Ipswich Town,1-1,1,1,1,1,2,0,D
1975-04-23,1974,Newcastle United,Arsenal,3-1,3,1,1,1,4,2,H
1975-04-26,1974,Arsenal,Tottenham Hotspur,1-0,1,0,1,1,1,1,H
1975-04-26,1974,Burnley,Stoke City,0-0,0,0,1,1,0,0,D
1975-04-26,1974,Chelsea,Everton,1-1,1,1,1,1,2,0,D
1975-04-26,1974,Coventry City,Middlesbrough,0-2,0,2,1,1,2,-2,A
1975-04-26,1974,Derby County,Carlisle United,0-0,0,0,1,1,0,0,D
1975-04-26,1974,Ipswich Town,West Ham United,4-1,4,1,1,1,5,3,H
1975-04-26,1974,Liverpool,Queens Park Rangers,3-1,3,1,1,1,4,2,H
1975-04-26,1974,Luton Town,Manchester City,1-1,1,1,1,1,2,0,D
1975-04-26,1974,Newcastle United,Birmingham City,1-2,1,2,1,1,3,-1,A
1975-04-26,1974,Sheffield United,Leicester City,4-0,4,0,1,1,4,4,H
1975-04-26,1974,Wolverhampton Wanderers,Leeds United,1-1,1,1,1,1,2,0,D
1975-04-28,1974,Tottenham Hotspur,Leeds United,4-2,4,2,1,1,6,2,H
1975-04-28,1974,West Ham United,Arsenal,1-0,1,0,1,1,1,1,H
1975-04-29,1974,Birmingham City,Sheffield United,0-0,0,0,1,1,0,0,D
1975-08-16,1975,Aston Villa,Leeds United,1-2,1,2,1,1,3,-1,A
1975-08-16,1975,Burnley,Arsenal,0-0,0,0,1,1,0,0,D
1975-08-16,1975,Everton,Coventry City,1-4,1,4,1,1,5,-3,A
1975-08-16,1975,Ipswich Town,Newcastle United,0-3,0,3,1,1,3,-3,A
1975-08-16,1975,Leicester City,Birmingham City,3-3,3,3,1,1,6,0,D
1975-08-16,1975,Manchester City,Norwich City,3-0,3,0,1,1,3,3,H
1975-08-16,1975,Queens Park Rangers,Liverpool,2-0,2,0,1,1,2,2,H
1975-08-16,1975,Sheffield United,Derby County,1-1,1,1,1,1,2,0,D
1975-08-16,1975,Stoke City,West Ham United,1-2,1,2,1,1,3,-1,A
1975-08-16,1975,Tottenham Hotspur,Middlesbrough,1-0,1,0,1,1,1,1,H
1975-08-16,1975,Wolverhampton Wanderers,Manchester United,0-2,0,2,1,1,2,-2,A
1975-08-19,1975,Birmingham City,Manchester United,0-2,0,2,1,1,2,-2,A
1975-08-19,1975,Burnley,Everton,1-1,1,1,1,1,2,0,D
1975-08-19,1975,Coventry City,Derby County,1-1,1,1,1,1,2,0,D
1975-08-19,1975,Liverpool,West Ham United,2-2,2,2,1,1,4,0,D
1975-08-19,1975,Queens Park Rangers,Aston Villa,1-1,1,1,1,1,2,0,D
1975-08-19,1975,Sheffield United,Arsenal,1-3,1,3,1,1,4,-2,A
1975-08-20,1975,Manchester City,Leicester City,1-1,1,1,1,1,2,0,D
1975-08-20,1975,Newcastle United,Middlesbrough,1-1,1,1,1,1,2,0,D
1975-08-20,1975,Norwich City,Leeds United,1-1,1,1,1,1,2,0,D
1975-08-20,1975,Stoke City,Wolverhampton Wanderers,2-2,2,2,1,1,4,0,D
1975-08-20,1975,Tottenham Hotspur,Ipswich Town,1-1,1,1,1,1,2,0,D
1975-08-23,1975,Arsenal,Stoke City,0-1,0,1,1,1,1,-1,A
1975-08-23,1975,Birmingham City,Everton,0-1,0,1,1,1,1,-1,A
1975-08-23,1975,Coventry City,Manchester City,2-0,2,0,1,1,2,2,H
1975-08-23,1975,Derby County,Queens Park Rangers,1-5,1,5,1,1,6,-4,A
1975-08-23,1975,Leeds United,Ipswich Town,1-0,1,0,1,1,1,1,H
1975-08-23,1975,Liverpool,Tottenham Hotspur,3-2,3,2,1,1,5,1,H
1975-08-23,1975,Manchester United,Sheffield United,5-1,5,1,1,1,6,4,H
1975-08-23,1975,Middlesbrough,Wolverhampton Wanderers,1-0,1,0,1,1,1,1,H
1975-08-23,1975,Newcastle United,Leicester City,3-0,3,0,1,1,3,3,H
1975-08-23,1975,Norwich City,Aston Villa,5-3,5,3,1,1,8,2,H
1975-08-23,1975,West Ham United,Burnley,3-2,3,2,1,1,5,1,H
1975-08-25,1975,West Ham United,Tottenham Hotspur,1-0,1,0,1,1,1,1,H
1975-08-26,1975,Arsenal,Norwich City,2-1,2,1,1,1,3,1,H
1975-08-26,1975,Everton,Sheffield United,3-0,3,0,1,1,3,3,H
1975-08-26,1975,Ipswich Town,Burnley,0-0,0,0,1,1,0,0,D
1975-08-26,1975,Leeds United,Liverpool,0-3,0,3,1,1,3,-3,A
1975-08-26,1975,Middlesbrough,Birmingham City,2-0,2,0,1,1,2,2,H
1975-08-26,1975,Wolverhampton Wanderers,Queens Park Rangers,2-2,2,2,1,1,4,0,D
1975-08-27,1975,Aston Villa,Manchester City,1-0,1,0,1,1,1,1,H
1975-08-27,1975,Derby County,Newcastle United,3-2,3,2,1,1,5,1,H
1975-08-27,1975,Leicester City,Stoke City,1-1,1,1,1,1,2,0,D
1975-08-27,1975,Manchester United,Coventry City,1-1,1,1,1,1,2,0,D
1975-08-30,1975,Aston Villa,Coventry City,1-0,1,0,1,1,1,1,H
1975-08-30,1975,Burnley,Middlesbrough,4-1,4,1,1,1,5,3,H
1975-08-30,1975,Everton,Derby County,2-0,2,0,1,1,2,2,H
1975-08-30,1975,Ipswich Town,Birmingham City,4-2,4,2,1,1,6,2,H
1975-08-30,1975,Leicester City,Liverpool,1-1,1,1,1,1,2,0,D
1975-08-30,1975,Manchester City,Newcastle United,4-0,4,0,1,1,4,4,H
1975-08-30,1975,Queens Park Rangers,West Ham United,1-1,1,1,1,1,2,0,D
1975-08-30,1975,Sheffield United,Leeds United,0-2,0,2,1,1,2,-2,A
1975-08-30,1975,Stoke City,Manchester United,0-1,0,1,1,1,1,-1,A
1975-08-30,1975,Tottenham Hotspur,Norwich City,2-2,2,2,1,1,4,0,D
1975-08-30,1975,Wolverhampton Wanderers,Arsenal,0-0,0,0,1,1,0,0,D
1975-09-06,1975,Arsenal,Leicester City,1-1,1,1,1,1,2,0,D
1975-09-06,1975,Birmingham City,Queens Park Rangers,1-1,1,1,1,1,2,0,D
1975-09-06,1975,Coventry City,Ipswich Town,0-0,0,0,1,1,0,0,D
1975-09-06,1975,Derby County,Burnley,3-0,3,0,1,1,3,3,H
1975-09-06,1975,Leeds United,Wolverhampton Wanderers,3-0,3,0,1,1,3,3,H
1975-09-06,1975,Liverpool,Sheffield United,1-0,1,0,1,1,1,1,H
1975-09-06,1975,Manchester United,Tottenham Hotspur,3-2,3,2,1,1,5,1,H
1975-09-06,1975,Middlesbrough,Stoke City,3-0,3,0,1,1,3,3,H
1975-09-06,1975,Newcastle United,Aston Villa,3-0,3,0,1,1,3,3,H
1975-09-06,1975,Norwich City,Everton,4-2,4,2,1,1,6,2,H
1975-09-06,1975,West Ham United,Manchester City,1-0,1,0,1,1,1,1,H
1975-09-13,1975,Aston Villa,Arsenal,2-0,2,0,1,1,2,2,H
1975-09-13,1975,Burnley,Norwich City,4-4,4,4,1,1,8,0,D
1975-09-13,1975,Everton,Newcastle United,3-0,3,0,1,1,3,3,H
1975-09-13,1975,Ipswich Town,Liverpool,2-0,2,0,1,1,2,2,H
1975-09-13,1975,Leicester City,West Ham United,3-3,3,3,1,1,6,0,D
1975-09-13,1975,Manchester City,Middlesbrough,4-0,4,0,1,1,4,4,H
1975-09-13,1975,Queens Park Rangers,Manchester United,1-0,1,0,1,1,1,1,H
1975-09-13,1975,Sheffield United,Coventry City,0-1,0,1,1,1,1,-1,A
1975-09-13,1975,Stoke City,Leeds United,3-2,3,2,1,1,5,1,H
1975-09-13,1975,Tottenham Hotspur,Derby County,2-3,2,3,1,1,5,-1,A
1975-09-13,1975,Wolverhampton Wanderers,Birmingham City,2-0,2,0,1,1,2,2,H
1975-09-20,1975,Arsenal,Everton,2-2,2,2,1,1,4,0,D
1975-09-20,1975,Birmingham City,Burnley,4-0,4,0,1,1,4,4,H
1975-09-20,1975,Coventry City,Stoke City,0-3,0,3,1,1,3,-3,A
1975-09-20,1975,Derby County,Manchester City,1-0,1,0,1,1,1,1,H
1975-09-20,1975,Leeds United,Tottenham Hotspur,1-1,1,1,1,1,2,0,D
1975-09-20,1975,Liverpool,Aston Villa,3-0,3,0,1,1,3,3,H
1975-09-20,1975,Manchester United,Ipswich Town,1-0,1,0,1,1,1,1,H
1975-09-20,1975,Middlesbrough,Queens Park Rangers,0-0,0,0,1,1,0,0,D
1975-09-20,1975,Newcastle United,Wolverhampton Wanderers,5-1,5,1,1,1,6,4,H
1975-09-20,1975,Norwich City,Leicester City,2-0,2,0,1,1,2,2,H
1975-09-20,1975,West Ham United,Sheffield United,2-0,2,0,1,1,2,2,H
1975-09-23,1975,Birmingham City,Newcastle United,3-2,3,2,1,1,5,1,H
1975-09-23,1975,Coventry City,Middlesbrough,0-1,0,1,1,1,1,-1,A
1975-09-23,1975,Ipswich Town,Norwich City,2-0,2,0,1,1,2,2,H
1975-09-23,1975,Queens Park Rangers,Leicester City,1-0,1,0,1,1,1,1,H
1975-09-23,1975,Sheffield United,Burnley,2-1,2,1,1,1,3,1,H
1975-09-23,1975,Wolverhampton Wanderers,Aston Villa,0-0,0,0,1,1,0,0,D
1975-09-24,1975,Derby County,Manchester United,2-1,2,1,1,1,3,1,H
1975-09-24,1975,Manchester City,Stoke City,1-0,1,0,1,1,1,1,H
1975-09-27,1975,Aston Villa,Birmingham City,2-1,2,1,1,1,3,1,H
1975-09-27,1975,Burnley,Leeds United,0-1,0,1,1,1,1,-1,A
1975-09-27,1975,Everton,Liverpool,0-0,0,0,1,1,0,0,D
1975-09-27,1975,Ipswich Town,Middlesbrough,0-3,0,3,1,1,3,-3,A
1975-09-27,1975,Leicester City,Coventry City,0-3,0,3,1,1,3,-3,A
1975-09-27,1975,Manchester City,Manchester United,2-2,2,2,1,1,4,0,D
1975-09-27,1975,Queens Park Rangers,Newcastle United,1-0,1,0,1,1,1,1,H
1975-09-27,1975,Sheffield United,Norwich City,0-1,0,1,1,1,1,-1,A
1975-09-27,1975,Stoke City,Derby County,1-0,1,0,1,1,1,1,H
1975-09-27,1975,Tottenham Hotspur,Arsenal,0-0,0,0,1,1,0,0,D
1975-09-27,1975,Wolverhampton Wanderers,West Ham United,0-1,0,1,1,1,1,-1,A
1975-10-04,1975,Arsenal,Manchester City,2-3,2,3,1,1,5,-1,A
1975-10-04,1975,Birmingham City,Sheffield United,2-0,2,0,1,1,2,2,H
1975-10-04,1975,Coventry City,Burnley,1-2,1,2,1,1,3,-1,A
1975-10-04,1975,Derby County,Ipswich Town,1-0,1,0,1,1,1,1,H
1975-10-04,1975,Leeds United,Queens Park Rangers,2-1,2,1,1,1,3,1,H
1975-10-04,1975,Liverpool,Wolverhampton Wanderers,2-0,2,0,1,1,2,2,H
1975-10-04,1975,Manchester United,Leicester City,0-0,0,0,1,1,0,0,D
1975-10-04,1975,Middlesbrough,Aston Villa,0-0,0,0,1,1,0,0,D
1975-10-04,1975,Newcastle United,Tottenham Hotspur,2-2,2,2,1,1,4,0,D
1975-10-04,1975,Norwich City,Stoke City,0-1,0,1,1,1,1,-1,A
1975-10-04,1975,West Ham United,Everton,0-1,0,1,1,1,1,-1,A
1975-10-11,1975,Arsenal,Coventry City,5-0,5,0,1,1,5,5,H
1975-10-11,1975,Aston Villa,Tottenham Hotspur,1-1,1,1,1,1,2,0,D
1975-10-11,1975,Leeds United,Manchester United,1-2,1,2,1,1,3,-1,A
1975-10-11,1975,Leicester City,Middlesbrough,0-0,0,0,1,1,0,0,D
1975-10-11,1975,Liverpool,Birmingham City,3-1,3,1,1,1,4,2,H
1975-10-11,1975,Manchester City,Burnley,0-0,0,0,1,1,0,0,D
1975-10-11,1975,Norwich City,Derby County,0-0,0,0,1,1,0,0,D
1975-10-11,1975,Queens Park Rangers,Everton,5-0,5,0,1,1,5,5,H
1975-10-11,1975,Stoke City,Ipswich Town,0-1,0,1,1,1,1,-1,A
1975-10-11,1975,West Ham United,Newcastle United,2-1,2,1,1,1,3,1,H
1975-10-11,1975,Wolverhampton Wanderers,Sheffield United,5-1,5,1,1,1,6,4,H
1975-10-18,1975,Birmingham City,Leeds United,2-2,2,2,1,1,4,0,D
1975-10-18,1975,Burnley,Queens Park Rangers,1-0,1,0,1,1,1,1,H
1975-10-18,1975,Coventry City,Liverpool,0-0,0,0,1,1,0,0,D
1975-10-18,1975,Derby County,Wolverhampton Wanderers,3-2,3,2,1,1,5,1,H
1975-10-18,1975,Everton,Aston Villa,2-1,2,1,1,1,3,1,H
1975-10-18,1975,Ipswich Town,Leicester City,1-1,1,1,1,1,2,0,D
1975-10-18,1975,Manchester United,Arsenal,3-1,3,1,1,1,4,2,H
1975-10-18,1975,Middlesbrough,West Ham United,3-0,3,0,1,1,3,3,H
1975-10-18,1975,Newcastle United,Norwich City,5-2,5,2,1,1,7,3,H
1975-10-18,1975,Sheffield United,Stoke City,0-2,0,2,1,1,2,-2,A
1975-10-18,1975,Tottenham Hotspur,Manchester City,2-2,2,2,1,1,4,0,D
1975-10-25,1975,Arsenal,Middlesbrough,2-1,2,1,1,1,3,1,H
1975-10-25,1975,Aston Villa,Burnley,1-1,1,1,1,1,2,0,D
1975-10-25,1975,Leeds United,Coventry City,2-0,2,0,1,1,2,2,H
1975-10-25,1975,Leicester City,Tottenham Hotspur,2-3,2,3,1,1,5,-1,A
1975-10-25,1975,Liverpool,Derby County,1-1,1,1,1,1,2,0,D
1975-10-25,1975,Manchester City,Ipswich Town,1-1,1,1,1,1,2,0,D
1975-10-25,1975,Norwich City,Birmingham City,1-0,1,0,1,1,1,1,H
1975-10-25,1975,Queens Park Rangers,Sheffield United,1-0,1,0,1,1,1,1,H
1975-10-25,1975,Stoke City,Newcastle United,1-1,1,1,1,1,2,0,D
1975-10-25,1975,West Ham United,Manchester United,2-1,2,1,1,1,3,1,H
1975-10-25,1975,Wolverhampton Wanderers,Everton,1-2,1,2,1,1,3,-1,A
1975-11-01,1975,Birmingham City,West Ham United,1-5,1,5,1,1,6,-4,A
1975-11-01,1975,Burnley,Stoke City,0-1,0,1,1,1,1,-1,A
1975-11-01,1975,Coventry City,Queens Park Rangers,1-1,1,1,1,1,2,0,D
1975-11-01,1975,Derby County,Leeds United,3-2,3,2,1,1,5,1,H
1975-11-01,1975,Everton,Leicester City,1-1,1,1,1,1,2,0,D
1975-11-01,1975,Ipswich Town,Aston Villa,3-0,3,0,1,1,3,3,H
1975-11-01,1975,Manchester United,Norwich City,1-0,1,0,1,1,1,1,H
1975-11-01,1975,Middlesbrough,Liverpool,0-1,0,1,1,1,1,-1,A
1975-11-01,1975,Newcastle United,Arsenal,2-0,2,0,1,1,2,2,H
1975-11-01,1975,Sheffield United,Manchester City,2-2,2,2,1,1,4,0,D
1975-11-01,1975,Tottenham Hotspur,Wolverhampton Wanderers,2-1,2,1,1,1,3,1,H
1975-11-08,1975,Arsenal,Derby County,0-1,0,1,1,1,1,-1,A
1975-11-08,1975,Aston Villa,Sheffield United,5-1,5,1,1,1,6,4,H
1975-11-08,1975,Leeds United,Newcastle United,3-0,3,0,1,1,3,3,H
1975-11-08,1975,Leicester City,Burnley,3-2,3,2,1,1,5,1,H
1975-11-08,1975,Liverpool,Manchester United,3-1,3,1,1,1,4,2,H
1975-11-08,1975,Manchester City,Birmingham City,2-0,2,0,1,1,2,2,H
1975-11-08,1975,Norwich City,Middlesbrough,0-1,0,1,1,1,1,-1,A
1975-11-08,1975,Queens Park Rangers,Tottenham Hotspur,0-0,0,0,1,1,0,0,D
1975-11-08,1975,Stoke City,Everton,3-2,3,2,1,1,5,1,H
1975-11-08,1975,West Ham United,Coventry City,1-1,1,1,1,1,2,0,D
1975-11-08,1975,Wolverhampton Wanderers,Ipswich Town,1-0,1,0,1,1,1,1,H
1975-11-15,1975,Birmingham City,Arsenal,3-1,3,1,1,1,4,2,H
1975-11-15,1975,Burnley,Wolverhampton Wanderers,1-5,1,5,1,1,6,-4,A
1975-11-15,1975,Coventry City,Norwich City,1-0,1,0,1,1,1,1,H
1975-11-15,1975,Derby County,West Ham United,2-1,2,1,1,1,3,1,H
1975-11-15,1975,Everton,Manchester City,1-1,1,1,1,1,2,0,D
1975-11-15,1975,Ipswich Town,Queens Park Rangers,1-1,1,1,1,1,2,0,D
1975-11-15,1975,Manchester United,Aston Villa,2-0,2,0,1,1,2,2,H
1975-11-15,1975,Middlesbrough,Leeds United,0-0,0,0,1,1,0,0,D
1975-11-15,1975,Newcastle United,Liverpool,1-2,1,2,1,1,3,-1,A
1975-11-15,1975,Sheffield United,Leicester City,1-2,1,2,1,1,3,-1,A
1975-11-15,1975,Tottenham Hotspur,Stoke City,1-1,1,1,1,1,2,0,D
1975-11-22,1975,Arsenal,Manchester United,3-1,3,1,1,1,4,2,H
1975-11-22,1975,Aston Villa,Everton,3-1,3,1,1,1,4,2,H
1975-11-22,1975,Leeds United,Birmingham City,3-0,3,0,1,1,3,3,H
1975-11-22,1975,Leicester City,Ipswich Town,0-0,0,0,1,1,0,0,D
1975-11-22,1975,Liverpool,Coventry City,1-1,1,1,1,1,2,0,D
1975-11-22,1975,Manchester City,Tottenham Hotspur,2-1,2,1,1,1,3,1,H
1975-11-22,1975,Norwich City,Newcastle United,1-2,1,2,1,1,3,-1,A
1975-11-22,1975,Queens Park Rangers,Burnley,1-0,1,0,1,1,1,1,H
1975-11-22,1975,Stoke City,Sheffield United,2-1,2,1,1,1,3,1,H
1975-11-22,1975,West Ham United,Middlesbrough,2-1,2,1,1,1,3,1,H
1975-11-22,1975,Wolverhampton Wanderers,Derby County,0-0,0,0,1,1,0,0,D
1975-11-29,1975,Aston Villa,Leicester City,1-1,1,1,1,1,2,0,D
1975-11-29,1975,Coventry City,Birmingham City,3-2,3,2,1,1,5,1,H
1975-11-29,1975,Derby County,Middlesbrough,3-2,3,2,1,1,5,1,H
1975-11-29,1975,Ipswich Town,Sheffield United,1-1,1,1,1,1,2,0,D
1975-11-29,1975,Leeds United,Everton,5-2,5,2,1,1,7,3,H
1975-11-29,1975,Liverpool,Norwich City,1-3,1,3,1,1,4,-2,A
1975-11-29,1975,Manchester United,Newcastle United,1-0,1,0,1,1,1,1,H
1975-11-29,1975,Queens Park Rangers,Stoke City,3-2,3,2,1,1,5,1,H
1975-11-29,1975,Tottenham Hotspur,Burnley,2-1,2,1,1,1,3,1,H
1975-11-29,1975,West Ham United,Arsenal,1-0,1,0,1,1,1,1,H
1975-11-29,1975,Wolverhampton Wanderers,Manchester City,0-4,0,4,1,1,4,-4,A
1975-12-02,1975,Liverpool,Arsenal,2-2,2,2,1,1,4,0,D
1975-12-06,1975,Arsenal,Leeds United,1-2,1,2,1,1,3,-1,A
1975-12-06,1975,Birmingham City,Derby County,2-1,2,1,1,1,3,1,H
1975-12-06,1975,Burnley,Liverpool,0-0,0,0,1,1,0,0,D
1975-12-06,1975,Everton,Ipswich Town,3-3,3,3,1,1,6,0,D
1975-12-06,1975,Leicester City,Wolverhampton Wanderers,2-0,2,0,1,1,2,2,H
1975-12-06,1975,Manchester City,Queens Park Rangers,0-0,0,0,1,1,0,0,D
1975-12-06,1975,Middlesbrough,Manchester United,0-0,0,0,1,1,0,0,D
1975-12-06,1975,Newcastle United,Coventry City,4-0,4,0,1,1,4,4,H
1975-12-06,1975,Norwich City,West Ham United,1-0,1,0,1,1,1,1,H
1975-12-06,1975,Sheffield United,Tottenham Hotspur,1-2,1,2,1,1,3,-1,A
1975-12-06,1975,Stoke City,Aston Villa,1-1,1,1,1,1,2,0,D
1975-12-10,1975,Tottenham Hotspur,Everton,2-2,2,2,1,1,4,0,D
1975-12-13,1975,Aston Villa,Norwich City,3-2,3,2,1,1,5,1,H
1975-12-13,1975,Burnley,West Ham United,2-0,2,0,1,1,2,2,H
1975-12-13,1975,Everton,Birmingham City,5-2,5,2,1,1,7,3,H
1975-12-13,1975,Ipswich Town,Leeds United,2-1,2,1,1,1,3,1,H
1975-12-13,1975,Leicester City,Newcastle United,1-0,1,0,1,1,1,1,H
1975-12-13,1975,Manchester City,Coventry City,4-2,4,2,1,1,6,2,H
1975-12-13,1975,Queens Park Rangers,Derby County,1-1,1,1,1,1,2,0,D
1975-12-13,1975,Sheffield United,Manchester United,1-4,1,4,1,1,5,-3,A
1975-12-13,1975,Stoke City,Arsenal,2-1,2,1,1,1,3,1,H
1975-12-13,1975,Tottenham Hotspur,Liverpool,0-4,0,4,1,1,4,-4,A
1975-12-13,1975,Wolverhampton Wanderers,Middlesbrough,1-2,1,2,1,1,3,-1,A
1975-12-19,1975,Coventry City,Everton,1-2,1,2,1,1,3,-1,A
1975-12-20,1975,Arsenal,Burnley,1-0,1,0,1,1,1,1,H
1975-12-20,1975,Birmingham City,Leicester City,2-1,2,1,1,1,3,1,H
1975-12-20,1975,Derby County,Sheffield United,3-2,3,2,1,1,5,1,H
1975-12-20,1975,Leeds United,Aston Villa,1-0,1,0,1,1,1,1,H
1975-12-20,1975,Liverpool,Queens Park Rangers,2-0,2,0,1,1,2,2,H
1975-12-20,1975,Manchester United,Wolverhampton Wanderers,1-0,1,0,1,1,1,1,H
1975-12-20,1975,Middlesbrough,Tottenham Hotspur,1-0,1,0,1,1,1,1,H
1975-12-20,1975,Newcastle United,Ipswich Town,1-1,1,1,1,1,2,0,D
1975-12-20,1975,Norwich City,Manchester City,2-2,2,2,1,1,4,0,D
1975-12-20,1975,West Ham United,Stoke City,3-1,3,1,1,1,4,2,H
1975-12-23,1975,Everton,Manchester United,1-1,1,1,1,1,2,0,D
1975-12-26,1975,Aston Villa,West Ham United,4-1,4,1,1,1,5,3,H
1975-12-26,1975,Burnley,Newcastle United,0-1,0,1,1,1,1,-1,A
1975-12-26,1975,Ipswich Town,Arsenal,2-0,2,0,1,1,2,2,H
1975-12-26,1975,Leicester City,Derby County,2-1,2,1,1,1,3,1,H
1975-12-26,1975,Manchester City,Leeds United,0-1,0,1,1,1,1,-1,A
1975-12-26,1975,Queens Park Rangers,Norwich City,2-0,2,0,1,1,2,2,H
1975-12-26,1975,Sheffield United,Middlesbrough,1-1,1,1,1,1,2,0,D
1975-12-26,1975,Stoke City,Liverpool,1-1,1,1,1,1,2,0,D
1975-12-26,1975,Tottenham Hotspur,Birmingham City,1-3,1,3,1,1,4,-2,A
1975-12-26,1975,Wolverhampton Wanderers,Coventry City,0-1,0,1,1,1,1,-1,A
1975-12-27,1975,Arsenal,Queens Park Rangers,2-0,2,0,1,1,2,2,H
1975-12-27,1975,Birmingham City,Stoke City,1-1,1,1,1,1,2,0,D
1975-12-27,1975,Coventry City,Tottenham Hotspur,2-2,2,2,1,1,4,0,D
1975-12-27,1975,Derby County,Aston Villa,2-0,2,0,1,1,2,2,H
1975-12-27,1975,Leeds United,Leicester City,4-0,4,0,1,1,4,4,H
1975-12-27,1975,Liverpool,Manchester City,1-0,1,0,1,1,1,1,H
1975-12-27,1975,Manchester United,Burnley,2-1,2,1,1,1,3,1,H
1975-12-27,1975,Middlesbrough,Everton,1-1,1,1,1,1,2,0,D
1975-12-27,1975,Newcastle United,Sheffield United,1-1,1,1,1,1,2,0,D
1975-12-27,1975,Norwich City,Wolverhampton Wanderers,1-1,1,1,1,1,2,0,D
1975-12-27,1975,West Ham United,Ipswich Town,1-2,1,2,1,1,3,-1,A
1976-01-10,1975,Arsenal,Aston Villa,0-0,0,0,1,1,0,0,D
1976-01-10,1975,Birmingham City,Wolverhampton Wanderers,0-1,0,1,1,1,1,-1,A
1976-01-10,1975,Coventry City,Sheffield United,1-0,1,0,1,1,1,1,H
1976-01-10,1975,Derby County,Tottenham Hotspur,2-3,2,3,1,1,5,-1,A
1976-01-10,1975,Leeds United,Stoke City,2-0,2,0,1,1,2,2,H
1976-01-10,1975,Liverpool,Ipswich Town,3-3,3,3,1,1,6,0,D
1976-01-10,1975,Manchester United,Queens Park Rangers,2-1,2,1,1,1,3,1,H
1976-01-10,1975,Middlesbrough,Manchester City,1-0,1,0,1,1,1,1,H
1976-01-10,1975,Newcastle United,Everton,5-0,5,0,1,1,5,5,H
1976-01-10,1975,Norwich City,Burnley,3-1,3,1,1,1,4,2,H
1976-01-10,1975,West Ham United,Leicester City,1-1,1,1,1,1,2,0,D
1976-01-17,1975,Aston Villa,Newcastle United,1-1,1,1,1,1,2,0,D
1976-01-17,1975,Burnley,Derby County,1-2,1,2,1,1,3,-1,A
1976-01-17,1975,Everton,Norwich City,1-1,1,1,1,1,2,0,D
1976-01-17,1975,Ipswich Town,Coventry City,1-1,1,1,1,1,2,0,D
1976-01-17,1975,Leicester City,Arsenal,2-1,2,1,1,1,3,1,H
1976-01-17,1975,Manchester City,West Ham United,3-0,3,0,1,1,3,3,H
1976-01-17,1975,Queens Park Rangers,Birmingham City,2-1,2,1,1,1,3,1,H
1976-01-17,1975,Sheffield United,Liverpool,0-0,0,0,1,1,0,0,D
1976-01-17,1975,Stoke City,Middlesbrough,1-0,1,0,1,1,1,1,H
1976-01-17,1975,Tottenham Hotspur,Manchester United,1-1,1,1,1,1,2,0,D
1976-01-17,1975,Wolverhampton Wanderers,Leeds United,1-1,1,1,1,1,2,0,D
1976-01-24,1975,West Ham United,Queens Park Rangers,1-0,1,0,1,1,1,1,H
1976-01-31,1975,Arsenal,Sheffield United,1-0,1,0,1,1,1,1,H
1976-01-31,1975,Aston Villa,Queens Park Rangers,0-2,0,2,1,1,2,-2,A
1976-01-31,1975,Derby County,Coventry City,2-0,2,0,1,1,2,2,H
1976-01-31,1975,Everton,Burnley,2-3,2,3,1,1,5,-1,A
1976-01-31,1975,Ipswich Town,Tottenham Hotspur,1-2,1,2,1,1,3,-1,A
1976-01-31,1975,Leeds United,Norwich City,0-3,0,3,1,1,3,-3,A
1976-01-31,1975,Leicester City,Manchester City,1-0,1,0,1,1,1,1,H
1976-01-31,1975,Manchester United,Birmingham City,3-1,3,1,1,1,4,2,H
1976-01-31,1975,Middlesbrough,Newcastle United,3-3,3,3,1,1,6,0,D
1976-01-31,1975,West Ham United,Liverpool,0-4,0,4,1,1,4,-4,A
1976-01-31,1975,Wolverhampton Wanderers,Stoke City,2-1,2,1,1,1,3,1,H
1976-02-07,1975,Birmingham City,Middlesbrough,2-1,2,1,1,1,3,1,H
1976-02-07,1975,Burnley,Ipswich Town,0-1,0,1,1,1,1,-1,A
1976-02-07,1975,Coventry City,Manchester United,1-1,1,1,1,1,2,0,D
1976-02-07,1975,Liverpool,Leeds United,2-0,2,0,1,1,2,2,H
1976-02-07,1975,Manchester City,Aston Villa,2-1,2,1,1,1,3,1,H
1976-02-07,1975,Newcastle United,Derby County,4-3,4,3,1,1,7,1,H
1976-02-07,1975,Norwich City,Arsenal,3-1,3,1,1,1,4,2,H
1976-02-07,1975,Queens Park Rangers,Wolverhampton Wanderers,4-2,4,2,1,1,6,2,H
1976-02-07,1975,Sheffield United,Everton,0-0,0,0,1,1,0,0,D
1976-02-07,1975,Stoke City,Leicester City,1-2,1,2,1,1,3,-1,A
1976-02-07,1975,Tottenham Hotspur,West Ham United,1-1,1,1,1,1,2,0,D
1976-02-14,1975,Birmingham City,Manchester City,2-1,2,1,1,1,3,1,H
1976-02-14,1975,Coventry City,West Ham United,2-0,2,0,1,1,2,2,H
1976-02-14,1975,Middlesbrough,Burnley,1-1,1,1,1,1,2,0,D
1976-02-14,1975,Sheffield United,Aston Villa,2-1,2,1,1,1,3,1,H
1976-02-14,1975,Tottenham Hotspur,Queens Park Rangers,0-3,0,3,1,1,3,-3,A
1976-02-17,1975,Burnley,Leicester City,1-0,1,0,1,1,1,1,H
1976-02-17,1975,Ipswich Town,Wolverhampton Wanderers,3-0,3,0,1,1,3,3,H
1976-02-18,1975,Derby County,Arsenal,2-0,2,0,1,1,2,2,H
1976-02-18,1975,Manchester United,Liverpool,0-0,0,0,1,1,0,0,D
1976-02-21,1975,Arsenal,Birmingham City,1-0,1,0,1,1,1,1,H
1976-02-21,1975,Aston Villa,Manchester United,2-1,2,1,1,1,3,1,H
1976-02-21,1975,Leeds United,Middlesbrough,0-2,0,2,1,1,2,-2,A
1976-02-21,1975,Leicester City,Sheffield United,1-1,1,1,1,1,2,0,D
1976-02-21,1975,Liverpool,Newcastle United,2-0,2,0,1,1,2,2,H
1976-02-21,1975,Manchester City,Everton,3-0,3,0,1,1,3,3,H
1976-02-21,1975,Norwich City,Coventry City,0-3,0,3,1,1,3,-3,A
1976-02-21,1975,Queens Park Rangers,Ipswich Town,3-1,3,1,1,1,4,2,H
1976-02-21,1975,Stoke City,Tottenham Hotspur,1-2,1,2,1,1,3,-1,A
1976-02-21,1975,West Ham United,Derby County,1-2,1,2,1,1,3,-1,A
1976-02-21,1975,Wolverhampton Wanderers,Burnley,3-2,3,2,1,1,5,1,H
1976-02-23,1975,West Ham United,Leeds United,1-1,1,1,1,1,2,0,D
1976-02-24,1975,Arsenal,Liverpool,1-0,1,0,1,1,1,1,H
1976-02-24,1975,Aston Villa,Wolverhampton Wanderers,1-1,1,1,1,1,2,0,D
1976-02-24,1975,Burnley,Sheffield United,3-1,3,1,1,1,4,2,H
1976-02-24,1975,Everton,Tottenham Hotspur,1-0,1,0,1,1,1,1,H
1976-02-24,1975,Middlesbrough,Coventry City,2-0,2,0,1,1,2,2,H
1976-02-25,1975,Leicester City,Queens Park Rangers,0-1,0,1,1,1,1,-1,A
1976-02-25,1975,Manchester United,Derby County,1-1,1,1,1,1,2,0,D
1976-02-28,1975,Birmingham City,Norwich City,1-1,1,1,1,1,2,0,D
1976-02-28,1975,Burnley,Aston Villa,2-2,2,2,1,1,4,0,D
1976-02-28,1975,Coventry City,Leeds United,0-1,0,1,1,1,1,-1,A
1976-02-28,1975,Derby County,Liverpool,1-1,1,1,1,1,2,0,D
1976-02-28,1975,Everton,Wolverhampton Wanderers,3-0,3,0,1,1,3,3,H
1976-02-28,1975,Manchester United,West Ham United,4-0,4,0,1,1,4,4,H
1976-02-28,1975,Middlesbrough,Arsenal,0-1,0,1,1,1,1,-1,A
1976-02-28,1975,Sheffield United,Queens Park Rangers,0-0,0,0,1,1,0,0,D
1976-02-28,1975,Tottenham Hotspur,Leicester City,1-1,1,1,1,1,2,0,D
1976-03-02,1975,Leeds United,Derby County,1-1,1,1,1,1,2,0,D
1976-03-03,1975,Newcastle United,Stoke City,0-1,0,1,1,1,1,-1,A
1976-03-06,1975,Aston Villa,Ipswich Town,0-0,0,0,1,1,0,0,D
1976-03-06,1975,Leicester City,Everton,1-0,1,0,1,1,1,1,H
1976-03-06,1975,Liverpool,Middlesbrough,0-2,0,2,1,1,2,-2,A
1976-03-06,1975,Manchester City,Sheffield United,4-0,4,0,1,1,4,4,H
1976-03-06,1975,Norwich City,Tottenham Hotspur,3-1,3,1,1,1,4,2,H
1976-03-06,1975,Queens Park Rangers,Coventry City,4-1,4,1,1,1,5,3,H
1976-03-06,1975,Stoke City,Burnley,4-1,4,1,1,1,5,3,H
1976-03-06,1975,West Ham United,Birmingham City,1-2,1,2,1,1,3,-1,A
1976-03-09,1975,Leeds United,West Ham United,1-1,1,1,1,1,2,0,D
1976-03-13,1975,Birmingham City,Liverpool,0-1,0,1,1,1,1,-1,A
1976-03-13,1975,Burnley,Manchester City,0-0,0,0,1,1,0,0,D
1976-03-13,1975,Coventry City,Arsenal,1-1,1,1,1,1,2,0,D
1976-03-13,1975,Derby County,Norwich City,3-1,3,1,1,1,4,2,H
1976-03-13,1975,Everton,Queens Park Rangers,0-2,0,2,1,1,2,-2,A
1976-03-13,1975,Ipswich Town,Stoke City,1-1,1,1,1,1,2,0,D
1976-03-13,1975,Manchester United,Leeds United,3-2,3,2,1,1,5,1,H
1976-03-13,1975,Middlesbrough,Leicester City,0-1,0,1,1,1,1,-1,A
1976-03-13,1975,Newcastle United,West Ham United,2-1,2,1,1,1,3,1,H
1976-03-13,1975,Sheffield United,Wolverhampton Wanderers,1-4,1,4,1,1,5,-3,A
1976-03-13,1975,Tottenham Hotspur,Aston Villa,5-2,5,2,1,1,7,3,H
1976-03-16,1975,Arsenal,Newcastle United,0-0,0,0,1,1,0,0,D
1976-03-16,1975,Wolverhampton Wanderers,Tottenham Hotspur,0-1,0,1,1,1,1,-1,A
1976-03-17,1975,Norwich City,Manchester United,1-1,1,1,1,1,2,0,D
1976-03-20,1975,Arsenal,West Ham United,6-1,6,1,1,1,7,5,H
1976-03-20,1975,Birmingham City,Coventry City,1-1,1,1,1,1,2,0,D
1976-03-20,1975,Burnley,Tottenham Hotspur,1-2,1,2,1,1,3,-1,A
1976-03-20,1975,Everton,Leeds United,1-3,1,3,1,1,4,-2,A
1976-03-20,1975,Leicester City,Aston Villa,2-2,2,2,1,1,4,0,D
1976-03-20,1975,Manchester City,Wolverhampton Wanderers,3-2,3,2,1,1,5,1,H
1976-03-20,1975,Middlesbrough,Derby County,0-2,0,2,1,1,2,-2,A
1976-03-20,1975,Newcastle United,Manchester United,3-4,3,4,1,1,7,-1,A
1976-03-20,1975,Norwich City,Liverpool,0-1,0,1,1,1,1,-1,A
1976-03-20,1975,Sheffield United,Ipswich Town,1-2,1,2,1,1,3,-1,A
1976-03-20,1975,Stoke City,Queens Park Rangers,0-1,0,1,1,1,1,-1,A
1976-03-24,1975,Derby County,Stoke City,1-1,1,1,1,1,2,0,D
1976-03-27,1975,Aston Villa,Stoke City,0-0,0,0,1,1,0,0,D
1976-03-27,1975,Coventry City,Newcastle United,1-1,1,1,1,1,2,0,D
1976-03-27,1975,Derby County,Birmingham City,4-2,4,2,1,1,6,2,H
1976-03-27,1975,Ipswich Town,Everton,1-0,1,0,1,1,1,1,H
1976-03-27,1975,Leeds United,Arsenal,3-0,3,0,1,1,3,3,H
1976-03-27,1975,Liverpool,Burnley,2-0,2,0,1,1,2,2,H
1976-03-27,1975,Manchester United,Middlesbrough,3-0,3,0,1,1,3,3,H
1976-03-27,1975,Queens Park Rangers,Manchester City,1-0,1,0,1,1,1,1,H
1976-03-27,1975,Tottenham Hotspur,Sheffield United,5-0,5,0,1,1,5,5,H
1976-03-27,1975,West Ham United,Norwich City,0-1,0,1,1,1,1,-1,A
1976-03-27,1975,Wolverhampton Wanderers,Leicester City,2-2,2,2,1,1,4,0,D
1976-03-31,1975,Newcastle United,Leeds United,2-3,2,3,1,1,5,-1,A
1976-03-31,1975,Norwich City,Ipswich Town,1-0,1,0,1,1,1,1,H
1976-04-02,1975,Stoke City,Manchester City,0-0,0,0,1,1,0,0,D
1976-04-03,1975,Arsenal,Tottenham Hotspur,0-2,0,2,1,1,2,-2,A
1976-04-03,1975,Birmingham City,Aston Villa,3-2,3,2,1,1,5,1,H
1976-04-03,1975,Coventry City,Leicester City,0-2,0,2,1,1,2,-2,A
1976-04-03,1975,Leeds United,Burnley,2-1,2,1,1,1,3,1,H
1976-04-03,1975,Liverpool,Everton,1-0,1,0,1,1,1,1,H
1976-04-03,1975,Middlesbrough,Ipswich Town,2-0,2,0,1,1,2,2,H
1976-04-03,1975,Newcastle United,Queens Park Rangers,1-2,1,2,1,1,3,-1,A
1976-04-03,1975,Norwich City,Sheffield United,1-3,1,3,1,1,4,-2,A
1976-04-03,1975,West Ham United,Wolverhampton Wanderers,0-0,0,0,1,1,0,0,D
1976-04-06,1975,Liverpool,Leicester City,1-0,1,0,1,1,1,1,H
1976-04-06,1975,Middlesbrough,Norwich City,0-1,0,1,1,1,1,-1,A
1976-04-07,1975,Everton,Stoke City,2-1,2,1,1,1,3,1,H
1976-04-07,1975,Ipswich Town,Manchester City,2-1,2,1,1,1,3,1,H
1976-04-07,1975,Newcastle United,Birmingham City,4-0,4,0,1,1,4,4,H
1976-04-10,1975,Aston Villa,Liverpool,0-0,0,0,1,1,0,0,D
1976-04-10,1975,Burnley,Birmingham City,1-0,1,0,1,1,1,1,H
1976-04-10,1975,Everton,Arsenal,0-0,0,0,1,1,0,0,D
1976-04-10,1975,Ipswich Town,Manchester United,3-0,3,0,1,1,3,3,H
1976-04-10,1975,Leicester City,Norwich City,0-0,0,0,1,1,0,0,D
1976-04-10,1975,Manchester City,Derby County,4-3,4,3,1,1,7,1,H
1976-04-10,1975,Queens Park Rangers,Middlesbrough,4-2,4,2,1,1,6,2,H
1976-04-10,1975,Sheffield United,West Ham United,3-2,3,2,1,1,5,1,H
1976-04-10,1975,Stoke City,Coventry City,0-1,0,1,1,1,1,-1,A
1976-04-10,1975,Tottenham Hotspur,Leeds United,0-0,0,0,1,1,0,0,D
1976-04-10,1975,Wolverhampton Wanderers,Newcastle United,5-0,5,0,1,1,5,5,H
1976-04-13,1975,Arsenal,Wolverhampton Wanderers,2-1,2,1,1,1,3,1,H
1976-04-13,1975,Birmingham City,Ipswich Town,3-0,3,0,1,1,3,3,H
1976-04-13,1975,Coventry City,Aston Villa,1-1,1,1,1,1,2,0,D
1976-04-14,1975,Leeds United,Sheffield United,0-1,0,1,1,1,1,-1,A
1976-04-14,1975,Newcastle United,Manchester City,2-1,2,1,1,1,3,1,H
1976-04-17,1975,Arsenal,Ipswich Town,1-2,1,2,1,1,3,-1,A
1976-04-17,1975,Birmingham City,Tottenham Hotspur,3-1,3,1,1,1,4,2,H
1976-04-17,1975,Coventry City,Wolverhampton Wanderers,3-1,3,1,1,1,4,2,H
1976-04-17,1975,Derby County,Leicester City,2-2,2,2,1,1,4,0,D
1976-04-17,1975,Leeds United,Manchester City,2-1,2,1,1,1,3,1,H
1976-04-17,1975,Liverpool,Stoke City,5-3,5,3,1,1,8,2,H
1976-04-17,1975,Manchester United,Everton,2-1,2,1,1,1,3,1,H
1976-04-17,1975,Middlesbrough,Sheffield United,3-0,3,0,1,1,3,3,H
1976-04-17,1975,Newcastle United,Burnley,0-1,0,1,1,1,1,-1,A
1976-04-17,1975,Norwich City,Queens Park Rangers,3-2,3,2,1,1,5,1,H
1976-04-17,1975,West Ham United,Aston Villa,2-2,2,2,1,1,4,0,D
1976-04-19,1975,Aston Villa,Derby County,1-0,1,0,1,1,1,1,H
1976-04-19,1975,Burnley,Manchester United,0-1,0,1,1,1,1,-1,A
1976-04-19,1975,Everton,Middlesbrough,3-1,3,1,1,1,4,2,H
1976-04-19,1975,Ipswich Town,West Ham United,4-0,4,0,1,1,4,4,H
1976-04-19,1975,Manchester City,Liverpool,0-3,0,3,1,1,3,-3,A
1976-04-19,1975,Queens Park Rangers,Arsenal,2-1,2,1,1,1,3,1,H
1976-04-19,1975,Sheffield United,Newcastle United,1-0,1,0,1,1,1,1,H
1976-04-19,1975,Stoke City,Birmingham City,1-0,1,0,1,1,1,1,H
1976-04-19,1975,Tottenham Hotspur,Coventry City,4-1,4,1,1,1,5,3,H
1976-04-19,1975,Wolverhampton Wanderers,Norwich City,1-0,1,0,1,1,1,1,H
1976-04-20,1975,Leicester City,Leeds United,2-1,2,1,1,1,3,1,H
1976-04-21,1975,Derby County,Everton,1-3,1,3,1,1,4,-2,A
1976-04-21,1975,Manchester United,Stoke City,0-1,0,1,1,1,1,-1,A
1976-04-24,1975,Aston Villa,Middlesbrough,2-1,2,1,1,1,3,1,H
1976-04-24,1975,Burnley,Coventry City,1-3,1,3,1,1,4,-2,A
1976-04-24,1975,Everton,West Ham United,2-0,2,0,1,1,2,2,H
1976-04-24,1975,Ipswich Town,Derby County,2-6,2,6,1,1,8,-4,A
1976-04-24,1975,Leicester City,Manchester United,2-1,2,1,1,1,3,1,H
1976-04-24,1975,Manchester City,Arsenal,3-1,3,1,1,1,4,2,H
1976-04-24,1975,Queens Park Rangers,Leeds United,2-0,2,0,1,1,2,2,H
1976-04-24,1975,Stoke City,Norwich City,0-2,0,2,1,1,2,-2,A
1976-04-24,1975,Tottenham Hotspur,Newcastle United,0-3,0,3,1,1,3,-3,A
1976-05-04,1975,Manchester United,Manchester City,2-0,2,0,1,1,2,2,H
1976-05-04,1975,Sheffield United,Birmingham City,1-1,1,1,1,1,2,0,D
1976-05-04,1975,Wolverhampton Wanderers,Liverpool,1-3,1,3,1,1,4,-2,A
1976-08-21,1976,Arsenal,Bristol City,0-1,0,1,1,1,1,-1,A
1976-08-21,1976,Aston Villa,West Ham United,4-0,4,0,1,1,4,4,H
1976-08-21,1976,Ipswich Town,Tottenham Hotspur,3-1,3,1,1,1,4,2,H
1976-08-21,1976,Leeds United,West Bromwich Albion,2-2,2,2,1,1,4,0,D
1976-08-21,1976,Leicester City,Manchester City,2-2,2,2,1,1,4,0,D
1976-08-21,1976,Liverpool,Norwich City,1-0,1,0,1,1,1,1,H
1976-08-21,1976,Manchester United,Birmingham City,2-2,2,2,1,1,4,0,D
1976-08-21,1976,Middlesbrough,Coventry City,1-0,1,0,1,1,1,1,H
1976-08-21,1976,Newcastle United,Derby County,2-2,2,2,1,1,4,0,D
1976-08-21,1976,Queens Park Rangers,Everton,0-4,0,4,1,1,4,-4,A
1976-08-21,1976,Stoke City,Sunderland,0-0,0,0,1,1,0,0,D
1976-08-23,1976,West Ham United,Queens Park Rangers,1-0,1,0,1,1,1,1,H
1976-08-24,1976,Birmingham City,Leeds United,0-0,0,0,1,1,0,0,D
1976-08-24,1976,Bristol City,Stoke City,1-1,1,1,1,1,2,0,D
1976-08-24,1976,Coventry City,Manchester United,0-2,0,2,1,1,2,-2,A
1976-08-24,1976,Everton,Ipswich Town,1-1,1,1,1,1,2,0,D
1976-08-24,1976,Sunderland,Leicester City,0-0,0,0,1,1,0,0,D
1976-08-25,1976,Derby County,Middlesbrough,0-0,0,0,1,1,0,0,D
1976-08-25,1976,Manchester City,Aston Villa,2-0,2,0,1,1,2,2,H
1976-08-25,1976,Norwich City,Arsenal,1-3,1,3,1,1,4,-2,A
1976-08-25,1976,Tottenham Hotspur,Newcastle United,0-2,0,2,1,1,2,-2,A
1976-08-25,1976,West Bromwich Albion,Liverpool,0-1,0,1,1,1,1,-1,A
1976-08-28,1976,Birmingham City,Liverpool,2-1,2,1,1,1,3,1,H
1976-08-28,1976,Coventry City,Leeds United,4-2,4,2,1,1,6,2,H
1976-08-28,1976,Derby County,Manchester United,0-0,0,0,1,1,0,0,D
1976-08-28,1976,Everton,Aston Villa,0-2,0,2,1,1,2,-2,A
1976-08-28,1976,Ipswich Town,Queens Park Rangers,2-2,2,2,1,1,4,0,D
1976-08-28,1976,Manchester City,Stoke City,0-0,0,0,1,1,0,0,D
1976-08-28,1976,Newcastle United,Bristol City,0-0,0,0,1,1,0,0,D
1976-08-28,1976,Sunderland,Arsenal,2-2,2,2,1,1,4,0,D
1976-08-28,1976,Tottenham Hotspur,Middlesbrough,0-0,0,0,1,1,0,0,D
1976-08-28,1976,West Bromwich Albion,Norwich City,2-0,2,0,1,1,2,2,H
1976-08-28,1976,West Ham United,Leicester City,0-0,0,0,1,1,0,0,D
1976-09-04,1976,Arsenal,Manchester City,0-0,0,0,1,1,0,0,D
1976-09-04,1976,Aston Villa,Ipswich Town,5-2,5,2,1,1,7,3,H
1976-09-04,1976,Bristol City,Sunderland,4-1,4,1,1,1,5,3,H
1976-09-04,1976,Leeds United,Derby County,2-0,2,0,1,1,2,2,H
1976-09-04,1976,Leicester City,Everton,1-1,1,1,1,1,2,0,D
1976-09-04,1976,Liverpool,Coventry City,3-1,3,1,1,1,4,2,H
1976-09-04,1976,Manchester United,Tottenham Hotspur,2-3,2,3,1,1,5,-1,A
1976-09-04,1976,Middlesbrough,Newcastle United,1-0,1,0,1,1,1,1,H
1976-09-04,1976,Norwich City,Birmingham City,1-0,1,0,1,1,1,1,H
1976-09-04,1976,Queens Park Rangers,West Bromwich Albion,1-0,1,0,1,1,1,1,H
1976-09-04,1976,Stoke City,West Ham United,2-1,2,1,1,1,3,1,H
1976-09-11,1976,Birmingham City,West Bromwich Albion,0-1,0,1,1,1,1,-1,A
1976-09-11,1976,Coventry City,Norwich City,2-0,2,0,1,1,2,2,H
1976-09-11,1976,Derby County,Liverpool,2-3,2,3,1,1,5,-1,A
1976-09-11,1976,Everton,Stoke City,3-0,3,0,1,1,3,3,H
1976-09-11,1976,Ipswich Town,Leicester City,0-0,0,0,1,1,0,0,D
1976-09-11,1976,Manchester City,Bristol City,2-1,2,1,1,1,3,1,H
1976-09-11,1976,Middlesbrough,Sunderland,2-1,2,1,1,1,3,1,H
1976-09-11,1976,Newcastle United,Manchester United,2-2,2,2,1,1,4,0,D
1976-09-11,1976,Queens Park Rangers,Aston Villa,2-1,2,1,1,1,3,1,H
1976-09-11,1976,Tottenham Hotspur,Leeds United,1-0,1,0,1,1,1,1,H
1976-09-11,1976,West Ham United,Arsenal,0-2,0,2,1,1,2,-2,A
1976-09-17,1976,West Bromwich Albion,Coventry City,1-1,1,1,1,1,2,0,D
1976-09-18,1976,Arsenal,Everton,3-1,3,1,1,1,4,2,H
1976-09-18,1976,Aston Villa,Birmingham City,1-2,1,2,1,1,3,-1,A
1976-09-18,1976,Bristol City,West Ham United,1-1,1,1,1,1,2,0,D
1976-09-18,1976,Leeds United,Newcastle United,2-2,2,2,1,1,4,0,D
1976-09-18,1976,Leicester City,Queens Park Rangers,2-2,2,2,1,1,4,0,D
1976-09-18,1976,Liverpool,Tottenham Hotspur,2-0,2,0,1,1,2,2,H
1976-09-18,1976,Manchester United,Middlesbrough,2-0,2,0,1,1,2,2,H
1976-09-18,1976,Norwich City,Derby County,0-0,0,0,1,1,0,0,D
1976-09-18,1976,Stoke City,Ipswich Town,2-1,2,1,1,1,3,1,H
1976-09-18,1976,Sunderland,Manchester City,0-2,0,2,1,1,2,-2,A
1976-09-25,1976,Aston Villa,Leicester City,2-0,2,0,1,1,2,2,H
1976-09-25,1976,Coventry City,Birmingham City,2-1,2,1,1,1,3,1,H
1976-09-25,1976,Derby County,West Bromwich Albion,2-2,2,2,1,1,4,0,D
1976-09-25,1976,Everton,Bristol City,2-0,2,0,1,1,2,2,H
1976-09-25,1976,Ipswich Town,Arsenal,3-1,3,1,1,1,4,2,H
1976-09-25,1976,Manchester City,Manchester United,1-3,1,3,1,1,4,-2,A
1976-09-25,1976,Middlesbrough,Leeds United,1-0,1,0,1,1,1,1,H
1976-09-25,1976,Newcastle United,Liverpool,1-0,1,0,1,1,1,1,H
1976-09-25,1976,Queens Park Rangers,Stoke City,2-0,2,0,1,1,2,2,H
1976-09-25,1976,Tottenham Hotspur,Norwich City,1-1,1,1,1,1,2,0,D
1976-09-25,1976,West Ham United,Sunderland,1-1,1,1,1,1,2,0,D
1976-09-29,1976,Leicester City,Stoke City,1-0,1,0,1,1,1,1,H
1976-10-02,1976,Arsenal,Queens Park Rangers,3-2,3,2,1,1,5,1,H
1976-10-02,1976,Birmingham City,Derby County,5-1,5,1,1,1,6,4,H
1976-10-02,1976,Bristol City,Ipswich Town,1-2,1,2,1,1,3,-1,A
1976-10-02,1976,Coventry City,Leicester City,1-1,1,1,1,1,2,0,D
1976-10-02,1976,Leeds United,Manchester United,0-2,0,2,1,1,2,-2,A
1976-10-02,1976,Liverpool,Middlesbrough,0-0,0,0,1,1,0,0,D
1976-10-02,1976,Manchester City,West Ham United,4-2,4,2,1,1,6,2,H
1976-10-02,1976,Norwich City,Newcastle United,3-2,3,2,1,1,5,1,H
1976-10-02,1976,Stoke City,Aston Villa,1-0,1,0,1,1,1,1,H
1976-10-02,1976,Sunderland,Everton,0-1,0,1,1,1,1,-1,A
1976-10-02,1976,West Bromwich Albion,Tottenham Hotspur,4-2,4,2,1,1,6,2,H
1976-10-05,1976,Everton,Manchester City,2-2,2,2,1,1,4,0,D
1976-10-05,1976,Queens Park Rangers,Norwich City,2-3,2,3,1,1,5,-1,A
1976-10-06,1976,Newcastle United,West Bromwich Albion,2-0,2,0,1,1,2,2,H
1976-10-06,1976,West Ham United,Leeds United,1-3,1,3,1,1,4,-2,A
1976-10-09,1976,Middlesbrough,Norwich City,1-0,1,0,1,1,1,1,H
1976-10-16,1976,Arsenal,Stoke City,2-0,2,0,1,1,2,2,H
1976-10-16,1976,Birmingham City,Middlesbrough,3-1,3,1,1,1,4,2,H
1976-10-16,1976,Bristol City,Leicester City,0-1,0,1,1,1,1,-1,A
1976-10-16,1976,Coventry City,Newcastle United,1-1,1,1,1,1,2,0,D
1976-10-16,1976,Derby County,Tottenham Hotspur,8-2,8,2,1,1,10,6,H
1976-10-16,1976,Liverpool,Everton,3-1,3,1,1,1,4,2,H
1976-10-16,1976,Manchester City,Queens Park Rangers,0-0,0,0,1,1,0,0,D
1976-10-16,1976,Norwich City,Leeds United,1-2,1,2,1,1,3,-1,A
1976-10-16,1976,Sunderland,Aston Villa,0-1,0,1,1,1,1,-1,A
1976-10-16,1976,West Bromwich Albion,Manchester United,4-0,4,0,1,1,4,4,H
1976-10-16,1976,West Ham United,Ipswich Town,0-2,0,2,1,1,2,-2,A
1976-10-20,1976,Aston Villa,Arsenal,5-1,5,1,1,1,6,4,H
1976-10-20,1976,Tottenham Hotspur,Birmingham City,1-0,1,0,1,1,1,1,H
1976-10-23,1976,Aston Villa,Bristol City,3-1,3,1,1,1,4,2,H
1976-10-23,1976,Everton,West Ham United,3-2,3,2,1,1,5,1,H
1976-10-23,1976,Ipswich Town,Manchester City,1-0,1,0,1,1,1,1,H
1976-10-23,1976,Leeds United,Liverpool,1-1,1,1,1,1,2,0,D
1976-10-23,1976,Leicester City,Arsenal,4-1,4,1,1,1,5,3,H
1976-10-23,1976,Manchester United,Norwich City,2-2,2,2,1,1,4,0,D
1976-10-23,1976,Middlesbrough,West Bromwich Albion,1-0,1,0,1,1,1,1,H
1976-10-23,1976,Newcastle United,Birmingham City,3-2,3,2,1,1,5,1,H
1976-10-23,1976,Queens Park Rangers,Sunderland,2-0,2,0,1,1,2,2,H
1976-10-23,1976,Stoke City,Derby County,1-0,1,0,1,1,1,1,H
1976-10-23,1976,Tottenham Hotspur,Coventry City,0-1,0,1,1,1,1,-1,A
1976-10-26,1976,Bristol City,Birmingham City,0-1,0,1,1,1,1,-1,A
1976-10-27,1976,Leicester City,Liverpool,0-1,0,1,1,1,1,-1,A
1976-10-30,1976,Birmingham City,Queens Park Rangers,2-1,2,1,1,1,3,1,H
1976-10-30,1976,Coventry City,Sunderland,1-2,1,2,1,1,3,-1,A
1976-10-30,1976,Derby County,Bristol City,2-0,2,0,1,1,2,2,H
1976-10-30,1976,Leeds United,Arsenal,2-1,2,1,1,1,3,1,H
1976-10-30,1976,Liverpool,Aston Villa,3-0,3,0,1,1,3,3,H
1976-10-30,1976,Manchester United,Ipswich Town,0-1,0,1,1,1,1,-1,A
1976-10-30,1976,Middlesbrough,Leicester City,0-1,0,1,1,1,1,-1,A
1976-10-30,1976,Newcastle United,Stoke City,1-0,1,0,1,1,1,1,H
1976-10-30,1976,Norwich City,Manchester City,0-2,0,2,1,1,2,-2,A
1976-10-30,1976,Tottenham Hotspur,Everton,3-3,3,3,1,1,6,0,D
1976-10-30,1976,West Bromwich Albion,West Ham United,3-0,3,0,1,1,3,3,H
1976-11-06,1976,Arsenal,Birmingham City,4-0,4,0,1,1,4,4,H
1976-11-06,1976,Aston Villa,Manchester United,3-2,3,2,1,1,5,1,H
1976-11-06,1976,Bristol City,Coventry City,0-0,0,0,1,1,0,0,D
1976-11-06,1976,Everton,Leeds United,0-2,0,2,1,1,2,-2,A
1976-11-06,1976,Ipswich Town,West Bromwich Albion,7-0,7,0,1,1,7,7,H
1976-11-06,1976,Leicester City,Norwich City,1-1,1,1,1,1,2,0,D
1976-11-06,1976,Manchester City,Newcastle United,0-0,0,0,1,1,0,0,D
1976-11-06,1976,Queens Park Rangers,Derby County,1-1,1,1,1,1,2,0,D
1976-11-06,1976,Stoke City,Middlesbrough,3-1,3,1,1,1,4,2,H
1976-11-06,1976,Sunderland,Liverpool,0-1,0,1,1,1,1,-1,A
1976-11-06,1976,West Ham United,Tottenham Hotspur,5-3,5,3,1,1,8,2,H
1976-11-09,1976,Coventry City,Queens Park Rangers,2-0,2,0,1,1,2,2,H
1976-11-09,1976,Liverpool,Leicester City,5-1,5,1,1,1,6,4,H
1976-11-10,1976,Leeds United,Stoke City,1-1,1,1,1,1,2,0,D
1976-11-10,1976,Manchester United,Sunderland,3-3,3,3,1,1,6,0,D
1976-11-10,1976,Norwich City,West Ham United,1-0,1,0,1,1,1,1,H
1976-11-10,1976,West Bromwich Albion,Aston Villa,1-1,1,1,1,1,2,0,D
1976-11-13,1976,Tottenham Hotspur,Bristol City,0-1,0,1,1,1,1,-1,A
1976-11-20,1976,Arsenal,Liverpool,1-1,1,1,1,1,2,0,D
1976-11-20,1976,Aston Villa,Coventry City,2-2,2,2,1,1,4,0,D
1976-11-20,1976,Bristol City,Norwich City,3-1,3,1,1,1,4,2,H
1976-11-20,1976,Everton,Derby County,2-0,2,0,1,1,2,2,H
1976-11-20,1976,Ipswich Town,Leeds United,1-1,1,1,1,1,2,0,D
1976-11-20,1976,Leicester City,Manchester United,1-1,1,1,1,1,2,0,D
1976-11-20,1976,Manchester City,West Bromwich Albion,1-0,1,0,1,1,1,1,H
1976-11-20,1976,Queens Park Rangers,Middlesbrough,3-0,3,0,1,1,3,3,H
1976-11-20,1976,Stoke City,Birmingham City,1-0,1,0,1,1,1,1,H
1976-11-20,1976,Sunderland,Tottenham Hotspur,2-1,2,1,1,1,3,1,H
1976-11-20,1976,West Ham United,Newcastle United,1-2,1,2,1,1,3,-1,A
1976-11-23,1976,Ipswich Town,Sunderland,3-1,3,1,1,1,4,2,H
1976-11-24,1976,Newcastle United,Everton,4-1,4,1,1,1,5,3,H
1976-11-27,1976,Birmingham City,Manchester City,0-0,0,0,1,1,0,0,D
1976-11-27,1976,Coventry City,Arsenal,1-2,1,2,1,1,3,-1,A
1976-11-27,1976,Derby County,Sunderland,1-0,1,0,1,1,1,1,H
1976-11-27,1976,Leeds United,Leicester City,2-2,2,2,1,1,4,0,D
1976-11-27,1976,Liverpool,Bristol City,2-1,2,1,1,1,3,1,H
1976-11-27,1976,Manchester United,West Ham United,0-2,0,2,1,1,2,-2,A
1976-11-27,1976,Middlesbrough,Ipswich Town,0-2,0,2,1,1,2,-2,A
1976-11-27,1976,Newcastle United,Queens Park Rangers,2-0,2,0,1,1,2,2,H
1976-11-27,1976,Norwich City,Aston Villa,1-1,1,1,1,1,2,0,D
1976-11-27,1976,Tottenham Hotspur,Stoke City,2-0,2,0,1,1,2,2,H
1976-11-27,1976,West Bromwich Albion,Everton,3-0,3,0,1,1,3,3,H
1976-12-04,1976,Arsenal,Newcastle United,5-3,5,3,1,1,8,2,H
1976-12-04,1976,Ipswich Town,Liverpool,1-0,1,0,1,1,1,1,H
1976-12-04,1976,Leicester City,Birmingham City,2-6,2,6,1,1,8,-4,A
1976-12-04,1976,Manchester City,Derby County,3-2,3,2,1,1,5,1,H
1976-12-04,1976,West Ham United,Middlesbrough,0-1,0,1,1,1,1,-1,A
1976-12-07,1976,Birmingham City,Ipswich Town,2-4,2,4,1,1,6,-2,A
1976-12-07,1976,Middlesbrough,Manchester City,0-0,0,0,1,1,0,0,D
1976-12-11,1976,Birmingham City,Sunderland,2-0,2,0,1,1,2,2,H
1976-12-11,1976,Coventry City,Everton,4-2,4,2,1,1,6,2,H
1976-12-11,1976,Leeds United,Aston Villa,1-3,1,3,1,1,4,-2,A
1976-12-11,1976,Liverpool,Queens Park Rangers,3-1,3,1,1,1,4,2,H
1976-12-11,1976,Tottenham Hotspur,Manchester City,2-2,2,2,1,1,4,0,D
1976-12-11,1976,West Bromwich Albion,Leicester City,2-2,2,2,1,1,4,0,D
1976-12-15,1976,Aston Villa,Liverpool,5-1,5,1,1,1,6,4,H
1976-12-15,1976,Derby County,Arsenal,0-0,0,0,1,1,0,0,D
1976-12-18,1976,Arsenal,Manchester United,3-1,3,1,1,1,4,2,H
1976-12-18,1976,Aston Villa,Newcastle United,2-1,2,1,1,1,3,1,H
1976-12-18,1976,Bristol City,Middlesbrough,1-2,1,2,1,1,3,-1,A
1976-12-18,1976,Everton,Birmingham City,2-2,2,2,1,1,4,0,D
1976-12-18,1976,Ipswich Town,Derby County,0-0,0,0,1,1,0,0,D
1976-12-18,1976,Leicester City,Tottenham Hotspur,2-1,2,1,1,1,3,1,H
1976-12-18,1976,Manchester City,Coventry City,2-0,2,0,1,1,2,2,H
1976-12-18,1976,Stoke City,West Bromwich Albion,0-2,0,2,1,1,2,-2,A
1976-12-18,1976,Sunderland,Norwich City,0-1,0,1,1,1,1,-1,A
1976-12-18,1976,West Ham United,Liverpool,2-0,2,0,1,1,2,2,H
1976-12-27,1976,Birmingham City,West Ham United,0-0,0,0,1,1,0,0,D
1976-12-27,1976,Coventry City,Ipswich Town,1-1,1,1,1,1,2,0,D
1976-12-27,1976,Derby County,Leicester City,1-0,1,0,1,1,1,1,H
1976-12-27,1976,Leeds United,Manchester City,0-2,0,2,1,1,2,-2,A
1976-12-27,1976,Liverpool,Stoke City,4-0,4,0,1,1,4,4,H
1976-12-27,1976,Manchester United,Everton,4-0,4,0,1,1,4,4,H
1976-12-27,1976,Middlesbrough,Aston Villa,3-2,3,2,1,1,5,1,H
1976-12-27,1976,Newcastle United,Sunderland,2-0,2,0,1,1,2,2,H
1976-12-27,1976,Norwich City,Queens Park Rangers,2-0,2,0,1,1,2,2,H
1976-12-27,1976,Tottenham Hotspur,Arsenal,2-2,2,2,1,1,4,0,D
1976-12-27,1976,West Bromwich Albion,Bristol City,1-1,1,1,1,1,2,0,D
1976-12-29,1976,Everton,Middlesbrough,2-2,2,2,1,1,4,0,D
1976-12-29,1976,Manchester City,Liverpool,1-1,1,1,1,1,2,0,D
1976-12-29,1976,Sunderland,Leeds United,0-1,0,1,1,1,1,-1,A
1977-01-01,1976,Liverpool,Sunderland,2-0,2,0,1,1,2,2,H
1977-01-01,1976,Manchester United,Aston Villa,2-0,2,0,1,1,2,2,H
1977-01-01,1976,Middlesbrough,Stoke City,0-0,0,0,1,1,0,0,D
1977-01-01,1976,Norwich City,Leicester City,3-2,3,2,1,1,5,1,H
1977-01-01,1976,Tottenham Hotspur,West Ham United,2-1,2,1,1,1,3,1,H
1977-01-03,1976,Arsenal,Leeds United,1-1,1,1,1,1,2,0,D
1977-01-03,1976,Ipswich Town,Manchester United,2-1,2,1,1,1,3,1,H
1977-01-03,1976,Sunderland,Coventry City,0-1,0,1,1,1,1,-1,A
1977-01-03,1976,West Ham United,West Bromwich Albion,0-0,0,0,1,1,0,0,D
1977-01-11,1976,Queens Park Rangers,Tottenham Hotspur,2-1,2,1,1,1,3,1,H
1977-01-15,1976,Arsenal,Norwich City,1-0,1,0,1,1,1,1,H
1977-01-15,1976,Ipswich Town,Everton,2-0,2,0,1,1,2,2,H
1977-01-15,1976,Leicester City,Sunderland,2-0,2,0,1,1,2,2,H
1977-01-15,1976,Liverpool,West Bromwich Albion,1-1,1,1,1,1,2,0,D
1977-01-15,1976,Manchester United,Coventry City,2-0,2,0,1,1,2,2,H
1977-01-15,1976,Middlesbrough,Derby County,2-0,2,0,1,1,2,2,H
1977-01-18,1976,Birmingham City,Arsenal,3-3,3,3,1,1,6,0,D
1977-01-19,1976,Manchester United,Bristol City,2-1,2,1,1,1,3,1,H
1977-01-22,1976,Birmingham City,Manchester United,2-3,2,3,1,1,5,-1,A
1977-01-22,1976,Bristol City,Arsenal,2-0,2,0,1,1,2,2,H
1977-01-22,1976,Coventry City,Middlesbrough,1-1,1,1,1,1,2,0,D
1977-01-22,1976,Derby County,Newcastle United,4-2,4,2,1,1,6,2,H
1977-01-22,1976,Everton,Queens Park Rangers,1-3,1,3,1,1,4,-2,A
1977-01-22,1976,Manchester City,Leicester City,5-0,5,0,1,1,5,5,H
1977-01-22,1976,Norwich City,Liverpool,2-1,2,1,1,1,3,1,H
1977-01-22,1976,Sunderland,Stoke City,0-0,0,0,1,1,0,0,D
1977-01-22,1976,Tottenham Hotspur,Ipswich Town,1-0,1,0,1,1,1,1,H
1977-01-22,1976,West Bromwich Albion,Leeds United,1-2,1,2,1,1,3,-1,A
1977-01-22,1976,West Ham United,Aston Villa,0-1,0,1,1,1,1,-1,A
1977-01-29,1976,Norwich City,Stoke City,1-1,1,1,1,1,2,0,D
1977-02-02,1976,Leeds United,Birmingham City,1-0,1,0,1,1,1,1,H
1977-02-05,1976,Arsenal,Sunderland,0-0,0,0,1,1,0,0,D
1977-02-05,1976,Aston Villa,Everton,2-0,2,0,1,1,2,2,H
1977-02-05,1976,Bristol City,Newcastle United,1-1,1,1,1,1,2,0,D
1977-02-05,1976,Leeds United,Coventry City,1-2,1,2,1,1,3,-1,A
1977-02-05,1976,Leicester City,West Ham United,2-0,2,0,1,1,2,2,H
1977-02-05,1976,Liverpool,Birmingham City,4-1,4,1,1,1,5,3,H
1977-02-05,1976,Manchester United,Derby County,3-1,3,1,1,1,4,2,H
1977-02-05,1976,Middlesbrough,Tottenham Hotspur,2-0,2,0,1,1,2,2,H
1977-02-05,1976,Norwich City,West Bromwich Albion,1-0,1,0,1,1,1,1,H
1977-02-05,1976,Stoke City,Manchester City,0-2,0,2,1,1,2,-2,A
1977-02-11,1976,Sunderland,Bristol City,1-0,1,0,1,1,1,1,H
1977-02-12,1976,Birmingham City,Norwich City,3-2,3,2,1,1,5,1,H
1977-02-12,1976,Derby County,Leeds United,0-1,0,1,1,1,1,-1,A
1977-02-12,1976,Everton,Leicester City,1-2,1,2,1,1,3,-1,A
1977-02-12,1976,Ipswich Town,Aston Villa,1-0,1,0,1,1,1,1,H
1977-02-12,1976,Manchester City,Arsenal,1-0,1,0,1,1,1,1,H
1977-02-12,1976,Tottenham Hotspur,Manchester United,1-3,1,3,1,1,4,-2,A
1977-02-12,1976,West Bromwich Albion,Queens Park Rangers,1-1,1,1,1,1,2,0,D
1977-02-12,1976,West Ham United,Stoke City,1-0,1,0,1,1,1,1,H
1977-02-15,1976,Ipswich Town,Norwich City,5-0,5,0,1,1,5,5,H
1977-02-15,1976,Middlesbrough,Arsenal,3-0,3,0,1,1,3,3,H
1977-02-16,1976,Manchester United,Liverpool,0-0,0,0,1,1,0,0,D
1977-02-16,1976,Newcastle United,Manchester City,2-2,2,2,1,1,4,0,D
1977-02-16,1976,Stoke City,Coventry City,2-0,2,0,1,1,2,2,H
1977-02-19,1976,Arsenal,West Ham United,2-3,2,3,1,1,5,-1,A
1977-02-19,1976,Bristol City,Manchester City,1-0,1,0,1,1,1,1,H
1977-02-19,1976,Leeds United,Tottenham Hotspur,2-1,2,1,1,1,3,1,H
1977-02-19,1976,Leicester City,Ipswich Town,1-0,1,0,1,1,1,1,H
1977-02-19,1976,Liverpool,Derby County,3-1,3,1,1,1,4,2,H
1977-02-19,1976,Manchester United,Newcastle United,3-1,3,1,1,1,4,2,H
1977-02-19,1976,Norwich City,Coventry City,3-0,3,0,1,1,3,3,H
1977-02-19,1976,Stoke City,Everton,0-1,0,1,1,1,1,-1,A
1977-02-19,1976,Sunderland,Middlesbrough,4-0,4,0,1,1,4,4,H
1977-02-22,1976,Sunderland,West Bromwich Albion,6-1,6,1,1,1,7,5,H
1977-02-26,1976,Ipswich Town,Stoke City,0-1,0,1,1,1,1,-1,A
1977-02-26,1976,Newcastle United,Tottenham Hotspur,2-0,2,0,1,1,2,2,H
1977-02-26,1976,Queens Park Rangers,Leicester City,3-2,3,2,1,1,5,1,H
1977-02-26,1976,West Ham United,Bristol City,2-0,2,0,1,1,2,2,H
1977-02-28,1976,West Bromwich Albion,Birmingham City,2-1,2,1,1,1,3,1,H
1977-03-01,1976,Everton,Arsenal,2-1,2,1,1,1,3,1,H
1977-03-01,1976,Manchester City,Norwich City,2-0,2,0,1,1,2,2,H
1977-03-02,1976,Aston Villa,Derby County,4-0,4,0,1,1,4,4,H
1977-03-02,1976,Newcastle United,Leeds United,3-0,3,0,1,1,3,3,H
1977-03-05,1976,Arsenal,Ipswich Town,1-4,1,4,1,1,5,-3,A
1977-03-05,1976,Birmingham City,Coventry City,3-1,3,1,1,1,4,2,H
1977-03-05,1976,Bristol City,Everton,1-2,1,2,1,1,3,-1,A
1977-03-05,1976,Leeds United,Middlesbrough,2-1,2,1,1,1,3,1,H
1977-03-05,1976,Leicester City,Aston Villa,1-1,1,1,1,1,2,0,D
1977-03-05,1976,Liverpool,Newcastle United,1-0,1,0,1,1,1,1,H
1977-03-05,1976,Manchester United,Manchester City,3-1,3,1,1,1,4,2,H
1977-03-05,1976,Norwich City,Tottenham Hotspur,1-3,1,3,1,1,4,-2,A
1977-03-05,1976,Stoke City,Queens Park Rangers,1-0,1,0,1,1,1,1,H
1977-03-05,1976,Sunderland,West Ham United,6-0,6,0,1,1,6,6,H
1977-03-05,1976,West Bromwich Albion,Derby County,1-0,1,0,1,1,1,1,H
1977-03-08,1976,Arsenal,West Bromwich Albion,1-2,1,2,1,1,3,-1,A
1977-03-08,1976,Queens Park Rangers,Leeds United,0-0,0,0,1,1,0,0,D
1977-03-09,1976,Derby County,Coventry City,1-1,1,1,1,1,2,0,D
1977-03-09,1976,Manchester City,Sunderland,1-0,1,0,1,1,1,1,H
1977-03-09,1976,Newcastle United,Ipswich Town,1-1,1,1,1,1,2,0,D
1977-03-09,1976,Norwich City,Middlesbrough,1-0,1,0,1,1,1,1,H
1977-03-09,1976,Tottenham Hotspur,Liverpool,1-0,1,0,1,1,1,1,H
1977-03-12,1976,Derby County,Birmingham City,0-0,0,0,1,1,0,0,D
1977-03-12,1976,Ipswich Town,Bristol City,1-0,1,0,1,1,1,1,H
1977-03-12,1976,Leicester City,Coventry City,3-1,3,1,1,1,4,2,H
1977-03-12,1976,Manchester United,Leeds United,1-0,1,0,1,1,1,1,H
1977-03-12,1976,Middlesbrough,Liverpool,0-1,0,1,1,1,1,-1,A
1977-03-12,1976,Newcastle United,Norwich City,5-1,5,1,1,1,6,4,H
1977-03-12,1976,Queens Park Rangers,Arsenal,2-1,2,1,1,1,3,1,H
1977-03-12,1976,Tottenham Hotspur,West Bromwich Albion,0-2,0,2,1,1,2,-2,A
1977-03-12,1976,West Ham United,Manchester City,1-0,1,0,1,1,1,1,H
1977-03-15,1976,Bristol City,Derby County,2-2,2,2,1,1,4,0,D
1977-03-15,1976,Leicester City,Middlesbrough,3-3,3,3,1,1,6,0,D
1977-03-15,1976,Stoke City,Newcastle United,0-0,0,0,1,1,0,0,D
1977-03-16,1976,West Bromwich Albion,Ipswich Town,4-0,4,0,1,1,4,4,H
1977-03-19,1976,Birmingham City,Tottenham Hotspur,1-2,1,2,1,1,3,-1,A
1977-03-19,1976,Bristol City,Queens Park Rangers,1-0,1,0,1,1,1,1,H
1977-03-19,1976,Stoke City,Leicester City,0-1,0,1,1,1,1,-1,A
1977-03-19,1976,Sunderland,Ipswich Town,1-0,1,0,1,1,1,1,H
1977-03-19,1976,West Bromwich Albion,Newcastle United,1-1,1,1,1,1,2,0,D
1977-03-22,1976,Everton,Liverpool,0-0,0,0,1,1,0,0,D
1977-03-22,1976,Ipswich Town,West Ham United,4-1,4,1,1,1,5,3,H
1977-03-22,1976,Middlesbrough,Birmingham City,2-2,2,2,1,1,4,0,D
1977-03-22,1976,Queens Park Rangers,Manchester City,0-0,0,0,1,1,0,0,D
1977-03-23,1976,Aston Villa,Sunderland,4-1,4,1,1,1,5,3,H
1977-03-23,1976,Leeds United,Norwich City,3-2,3,2,1,1,5,1,H
1977-03-23,1976,Manchester United,West Bromwich Albion,2-2,2,2,1,1,4,0,D
1977-03-23,1976,Newcastle United,Coventry City,1-0,1,0,1,1,1,1,H
1977-03-23,1976,Stoke City,Arsenal,1-1,1,1,1,1,2,0,D
1977-03-23,1976,Tottenham Hotspur,Derby County,0-0,0,0,1,1,0,0,D
1977-03-26,1976,Everton,Tottenham Hotspur,4-0,4,0,1,1,4,4,H
1977-03-26,1976,Leicester City,Bristol City,0-0,0,0,1,1,0,0,D
1977-03-26,1976,Newcastle United,Middlesbrough,1-0,1,0,1,1,1,1,H
1977-04-02,1976,Arsenal,Leicester City,3-0,3,0,1,1,3,3,H
1977-04-02,1976,Birmingham City,Newcastle United,1-2,1,2,1,1,3,-1,A
1977-04-02,1976,Bristol City,Aston Villa,0-0,0,0,1,1,0,0,D
1977-04-02,1976,Coventry City,Tottenham Hotspur,1-1,1,1,1,1,2,0,D
1977-04-02,1976,Derby County,Stoke City,2-0,2,0,1,1,2,2,H
1977-04-02,1976,Liverpool,Leeds United,3-1,3,1,1,1,4,2,H
1977-04-02,1976,Manchester City,Ipswich Town,2-1,2,1,1,1,3,1,H
1977-04-02,1976,Norwich City,Manchester United,2-1,2,1,1,1,3,1,H
1977-04-02,1976,Sunderland,Queens Park Rangers,1-0,1,0,1,1,1,1,H
1977-04-02,1976,West Bromwich Albion,Middlesbrough,2-1,2,1,1,1,3,1,H
1977-04-02,1976,West Ham United,Everton,2-2,2,2,1,1,4,0,D
1977-04-04,1976,Queens Park Rangers,West Ham United,1-1,1,1,1,1,2,0,D
1977-04-05,1976,Aston Villa,Middlesbrough,1-0,1,0,1,1,1,1,H
1977-04-05,1976,Bristol City,West Bromwich Albion,1-2,1,2,1,1,3,-1,A
1977-04-05,1976,Everton,Manchester United,1-2,1,2,1,1,3,-1,A
1977-04-05,1976,Ipswich Town,Coventry City,2-1,2,1,1,1,3,1,H
1977-04-06,1976,Derby County,Norwich City,2-2,2,2,1,1,4,0,D
1977-04-08,1976,Manchester City,Leeds United,2-1,2,1,1,1,3,1,H
1977-04-08,1976,Sunderland,Newcastle United,2-2,2,2,1,1,4,0,D
1977-04-08,1976,West Ham United,Birmingham City,2-2,2,2,1,1,4,0,D
1977-04-09,1976,Birmingham City,Bristol City,3-0,3,0,1,1,3,3,H
1977-04-09,1976,Coventry City,West Ham United,1-1,1,1,1,1,2,0,D
1977-04-09,1976,Derby County,Aston Villa,2-1,2,1,1,1,3,1,H
1977-04-09,1976,Leeds United,Sunderland,1-1,1,1,1,1,2,0,D
1977-04-09,1976,Liverpool,Manchester City,2-1,2,1,1,1,3,1,H
1977-04-09,1976,Manchester United,Stoke City,3-0,3,0,1,1,3,3,H
1977-04-09,1976,Middlesbrough,Everton,2-2,2,2,1,1,4,0,D
1977-04-09,1976,Newcastle United,Leicester City,0-0,0,0,1,1,0,0,D
1977-04-09,1976,Norwich City,Ipswich Town,0-1,0,1,1,1,1,-1,A
1977-04-09,1976,Tottenham Hotspur,Queens Park Rangers,3-0,3,0,1,1,3,3,H
1977-04-09,1976,West Bromwich Albion,Arsenal,0-2,0,2,1,1,2,-2,A
1977-04-11,1976,Arsenal,Tottenham Hotspur,1-0,1,0,1,1,1,1,H
1977-04-11,1976,Ipswich Town,Birmingham City,1-0,1,0,1,1,1,1,H
1977-04-11,1976,Manchester City,Middlesbrough,1-0,1,0,1,1,1,1,H
1977-04-11,1976,Queens Park Rangers,Coventry City,1-1,1,1,1,1,2,0,D
1977-04-11,1976,Stoke City,Liverpool,0-0,0,0,1,1,0,0,D
1977-04-11,1976,Sunderland,Manchester United,2-1,2,1,1,1,3,1,H
1977-04-11,1976,West Ham United,Norwich City,1-0,1,0,1,1,1,1,H
1977-04-12,1976,Bristol City,Tottenham Hotspur,1-0,1,0,1,1,1,1,H
1977-04-12,1976,Leicester City,Derby County,1-1,1,1,1,1,2,0,D
1977-04-12,1976,Stoke City,Leeds United,2-1,2,1,1,1,3,1,H
1977-04-16,1976,Birmingham City,Stoke City,2-0,2,0,1,1,2,2,H
1977-04-16,1976,Coventry City,Aston Villa,2-3,2,3,1,1,5,-1,A
1977-04-16,1976,Derby County,Everton,2-3,2,3,1,1,5,-1,A
1977-04-16,1976,Leeds United,Ipswich Town,2-1,2,1,1,1,3,1,H
1977-04-16,1976,Liverpool,Arsenal,2-0,2,0,1,1,2,2,H
1977-04-16,1976,Manchester United,Leicester City,1-1,1,1,1,1,2,0,D
1977-04-16,1976,Middlesbrough,Queens Park Rangers,0-2,0,2,1,1,2,-2,A
1977-04-16,1976,Newcastle United,West Ham United,3-0,3,0,1,1,3,3,H
1977-04-16,1976,Norwich City,Bristol City,2-1,2,1,1,1,3,1,H
1977-04-16,1976,Tottenham Hotspur,Sunderland,1-1,1,1,1,1,2,0,D
1977-04-16,1976,West Bromwich Albion,Manchester City,0-2,0,2,1,1,2,-2,A
1977-04-19,1976,Coventry City,West Bromwich Albion,1-1,1,1,1,1,2,0,D
1977-04-19,1976,Everton,Norwich City,3-1,3,1,1,1,4,2,H
1977-04-19,1976,Manchester City,Birmingham City,2-1,2,1,1,1,3,1,H
1977-04-19,1976,Queens Park Rangers,Manchester United,4-0,4,0,1,1,4,4,H
1977-04-20,1976,Aston Villa,Tottenham Hotspur,2-1,2,1,1,1,3,1,H
1977-04-20,1976,Derby County,West Ham United,1-1,1,1,1,1,2,0,D
1977-04-20,1976,Stoke City,Bristol City,2-2,2,2,1,1,4,0,D
1977-04-23,1976,Arsenal,Coventry City,2-0,2,0,1,1,2,2,H
1977-04-23,1976,Aston Villa,Norwich City,1-0,1,0,1,1,1,1,H
1977-04-23,1976,Ipswich Town,Middlesbrough,0-1,0,1,1,1,1,-1,A
1977-04-23,1976,Queens Park Rangers,Newcastle United,1-2,1,2,1,1,3,-1,A
1977-04-23,1976,Stoke City,Tottenham Hotspur,0-0,0,0,1,1,0,0,D
1977-04-23,1976,Sunderland,Derby County,1-1,1,1,1,1,2,0,D
1977-04-25,1976,Arsenal,Aston Villa,3-0,3,0,1,1,3,3,H
1977-04-25,1976,Coventry City,Derby County,2-0,2,0,1,1,2,2,H
1977-04-26,1976,Leeds United,West Ham United,1-1,1,1,1,1,2,0,D
1977-04-26,1976,Middlesbrough,Manchester United,3-0,3,0,1,1,3,3,H
1977-04-26,1976,Queens Park Rangers,Bristol City,0-1,0,1,1,1,1,-1,A
1977-04-29,1976,Middlesbrough,West Ham United,1-1,1,1,1,1,2,0,D
1977-04-30,1976,Birmingham City,Leicester City,1-1,1,1,1,1,2,0,D
1977-04-30,1976,Coventry City,Stoke City,5-2,5,2,1,1,7,3,H
1977-04-30,1976,Derby County,Manchester City,4-0,4,0,1,1,4,4,H
1977-04-30,1976,Leeds United,Bristol City,2-0,2,0,1,1,2,2,H
1977-04-30,1976,Liverpool,Ipswich Town,2-1,2,1,1,1,3,1,H
1977-04-30,1976,Manchester United,Queens Park Rangers,1-0,1,0,1,1,1,1,H
1977-04-30,1976,Newcastle United,Arsenal,0-2,0,2,1,1,2,-2,A
1977-04-30,1976,Norwich City,Everton,2-1,2,1,1,1,3,1,H
1977-04-30,1976,Tottenham Hotspur,Aston Villa,3-1,3,1,1,1,4,2,H
1977-04-30,1976,West Bromwich Albion,Sunderland,2-3,2,3,1,1,5,-1,A
1977-05-03,1976,Arsenal,Derby County,0-0,0,0,1,1,0,0,D
1977-05-03,1976,Liverpool,Manchester United,1-0,1,0,1,1,1,1,H
1977-05-04,1976,Aston Villa,Manchester City,1-1,1,1,1,1,2,0,D
1977-05-04,1976,Leeds United,Everton,0-0,0,0,1,1,0,0,D
1977-05-04,1976,Leicester City,Newcastle United,1-0,1,0,1,1,1,1,H
1977-05-04,1976,West Ham United,Coventry City,2-0,2,0,1,1,2,2,H
1977-05-07,1976,Arsenal,Middlesbrough,1-1,1,1,1,1,2,0,D
1977-05-07,1976,Aston Villa,Leeds United,2-1,2,1,1,1,3,1,H
1977-05-07,1976,Bristol City,Manchester United,1-1,1,1,1,1,2,0,D
1977-05-07,1976,Everton,Coventry City,1-1,1,1,1,1,2,0,D
1977-05-07,1976,Ipswich Town,Newcastle United,2-0,2,0,1,1,2,2,H
1977-05-07,1976,Leicester City,West Bromwich Albion,0-5,0,5,1,1,5,-5,A
1977-05-07,1976,Manchester City,Tottenham Hotspur,5-0,5,0,1,1,5,5,H
1977-05-07,1976,Queens Park Rangers,Liverpool,1-1,1,1,1,1,2,0,D
1977-05-07,1976,Stoke City,Norwich City,0-0,0,0,1,1,0,0,D
1977-05-07,1976,Sunderland,Birmingham City,1-0,1,0,1,1,1,1,H
1977-05-07,1976,West Ham United,Derby County,2-2,2,2,1,1,4,0,D
1977-05-10,1976,Birmingham City,Aston Villa,2-1,2,1,1,1,3,1,H
1977-05-10,1976,Bristol City,Leeds United,1-0,1,0,1,1,1,1,H
1977-05-10,1976,Coventry City,Liverpool,0-0,0,0,1,1,0,0,D
1977-05-10,1976,Manchester City,Everton,1-1,1,1,1,1,2,0,D
1977-05-11,1976,Derby County,Queens Park Rangers,2-0,2,0,1,1,2,2,H
1977-05-11,1976,Stoke City,Manchester United,3-3,3,3,1,1,6,0,D
1977-05-14,1976,Birmingham City,Everton,1-1,1,1,1,1,2,0,D
1977-05-14,1976,Coventry City,Manchester City,0-1,0,1,1,1,1,-1,A
1977-05-14,1976,Derby County,Ipswich Town,0-0,0,0,1,1,0,0,D
1977-05-14,1976,Leeds United,Queens Park Rangers,0-1,0,1,1,1,1,-1,A
1977-05-14,1976,Liverpool,West Ham United,0-0,0,0,1,1,0,0,D
1977-05-14,1976,Manchester United,Arsenal,3-2,3,2,1,1,5,1,H
1977-05-14,1976,Middlesbrough,Bristol City,0-0,0,0,1,1,0,0,D
1977-05-14,1976,Newcastle United,Aston Villa,3-2,3,2,1,1,5,1,H
1977-05-14,1976,Norwich City,Sunderland,2-2,2,2,1,1,4,0,D
1977-05-14,1976,Tottenham Hotspur,Leicester City,2-0,2,0,1,1,2,2,H
1977-05-14,1976,West Bromwich Albion,Stoke City,3-1,3,1,1,1,4,2,H
1977-05-16,1976,Aston Villa,Stoke City,1-0,1,0,1,1,1,1,H
1977-05-16,1976,Bristol City,Liverpool,2-1,2,1,1,1,3,1,H
1977-05-16,1976,Everton,West Bromwich Albion,1-1,1,1,1,1,2,0,D
1977-05-16,1976,Leicester City,Leeds United,0-1,0,1,1,1,1,-1,A
1977-05-16,1976,Queens Park Rangers,Ipswich Town,1-0,1,0,1,1,1,1,H
1977-05-16,1976,West Ham United,Manchester United,4-2,4,2,1,1,6,2,H
1977-05-19,1976,Coventry City,Bristol City,2-2,2,2,1,1,4,0,D
1977-05-19,1976,Everton,Sunderland,2-0,2,0,1,1,2,2,H
1977-05-20,1976,Aston Villa,Queens Park Rangers,1-1,1,1,1,1,2,0,D
1977-05-23,1976,Aston Villa,West Bromwich Albion,4-0,4,0,1,1,4,4,H
1977-05-23,1976,Queens Park Rangers,Birmingham City,2-2,2,2,1,1,4,0,D
1977-05-24,1976,Everton,Newcastle United,2-0,2,0,1,1,2,2,H
1977-08-20,1977,Birmingham City,Manchester United,1-4,1,4,1,1,5,-3,A
1977-08-20,1977,Bristol City,Wolverhampton Wanderers,2-3,2,3,1,1,5,-1,A
1977-08-20,1977,Coventry City,Derby County,3-1,3,1,1,1,4,2,H
1977-08-20,1977,Everton,Nottingham Forest,1-3,1,3,1,1,4,-2,A
1977-08-20,1977,Ipswich Town,Arsenal,1-0,1,0,1,1,1,1,H
1977-08-20,1977,Manchester City,Leicester City,0-0,0,0,1,1,0,0,D
1977-08-20,1977,Middlesbrough,Liverpool,1-1,1,1,1,1,2,0,D
1977-08-20,1977,Newcastle United,Leeds United,3-2,3,2,1,1,5,1,H
1977-08-20,1977,Queens Park Rangers,Aston Villa,1-2,1,2,1,1,3,-1,A
1977-08-20,1977,West Bromwich Albion,Chelsea,3-0,3,0,1,1,3,3,H
1977-08-20,1977,West Ham United,Norwich City,1-3,1,3,1,1,4,-2,A
1977-08-23,1977,Arsenal,Everton,1-0,1,0,1,1,1,1,H
1977-08-23,1977,Liverpool,Newcastle United,2-0,2,0,1,1,2,2,H
1977-08-23,1977,Nottingham Forest,Bristol City,1-0,1,0,1,1,1,1,H
1977-08-23,1977,Wolverhampton Wanderers,Queens Park Rangers,1-0,1,0,1,1,1,1,H
1977-08-24,1977,Aston Villa,Manchester City,1-4,1,4,1,1,5,-3,A
1977-08-24,1977,Chelsea,Birmingham City,2-0,2,0,1,1,2,2,H
1977-08-24,1977,Derby County,Ipswich Town,0-0,0,0,1,1,0,0,D
1977-08-24,1977,Leeds United,West Bromwich Albion,2-2,2,2,1,1,4,0,D
1977-08-24,1977,Leicester City,West Ham United,1-0,1,0,1,1,1,1,H
1977-08-24,1977,Manchester United,Coventry City,2-1,2,1,1,1,3,1,H
1977-08-24,1977,Norwich City,Middlesbrough,1-1,1,1,1,1,2,0,D
1977-08-27,1977,Aston Villa,Everton,1-2,1,2,1,1,3,-1,A
1977-08-27,1977,Chelsea,Coventry City,1-2,1,2,1,1,3,-1,A
1977-08-27,1977,Leeds United,Birmingham City,1-0,1,0,1,1,1,1,H
1977-08-27,1977,Leicester City,Bristol City,0-0,0,0,1,1,0,0,D
1977-08-27,1977,Liverpool,West Bromwich Albion,3-0,3,0,1,1,3,3,H
1977-08-27,1977,Manchester United,Ipswich Town,0-0,0,0,1,1,0,0,D
1977-08-27,1977,Middlesbrough,Newcastle United,2-0,2,0,1,1,2,2,H
1977-08-27,1977,Norwich City,Queens Park Rangers,1-1,1,1,1,1,2,0,D
1977-08-27,1977,Nottingham Forest,Derby County,3-0,3,0,1,1,3,3,H
1977-08-27,1977,West Ham United,Manchester City,0-1,0,1,1,1,1,-1,A
1977-08-27,1977,Wolverhampton Wanderers,Arsenal,1-1,1,1,1,1,2,0,D
1977-09-03,1977,Arsenal,Nottingham Forest,3-0,3,0,1,1,3,3,H
1977-09-03,1977,Birmingham City,Liverpool,0-1,0,1,1,1,1,-1,A
1977-09-03,1977,Bristol City,Aston Villa,1-1,1,1,1,1,2,0,D
1977-09-03,1977,Coventry City,Leeds United,2-2,2,2,1,1,4,0,D
1977-09-03,1977,Derby County,Manchester United,0-1,0,1,1,1,1,-1,A
1977-09-03,1977,Everton,Wolverhampton Wanderers,0-0,0,0,1,1,0,0,D
1977-09-03,1977,Ipswich Town,Chelsea,1-0,1,0,1,1,1,1,H
1977-09-03,1977,Manchester City,Norwich City,4-0,4,0,1,1,4,4,H
1977-09-03,1977,Newcastle United,West Ham United,2-3,2,3,1,1,5,-1,A
1977-09-03,1977,Queens Park Rangers,Leicester City,3-0,3,0,1,1,3,3,H
1977-09-03,1977,West Bromwich Albion,Middlesbrough,2-1,2,1,1,1,3,1,H
1977-09-10,1977,Aston Villa,Arsenal,1-0,1,0,1,1,1,1,H
1977-09-10,1977,Chelsea,Derby County,1-1,1,1,1,1,2,0,D
1977-09-10,1977,Leeds United,Ipswich Town,2-1,2,1,1,1,3,1,H
1977-09-10,1977,Leicester City,Everton,1-5,1,5,1,1,6,-4,A
1977-09-10,1977,Liverpool,Coventry City,2-0,2,0,1,1,2,2,H
1977-09-10,1977,Manchester City,Manchester United,3-1,3,1,1,1,4,2,H
1977-09-10,1977,Middlesbrough,Birmingham City,1-2,1,2,1,1,3,-1,A
1977-09-10,1977,Newcastle United,West Bromwich Albion,0-3,0,3,1,1,3,-3,A
1977-09-10,1977,Norwich City,Bristol City,1-0,1,0,1,1,1,1,H
1977-09-10,1977,West Ham United,Queens Park Rangers,2-2,2,2,1,1,4,0,D
1977-09-10,1977,Wolverhampton Wanderers,Nottingham Forest,2-3,2,3,1,1,5,-1,A
1977-09-17,1977,Arsenal,Leicester City,2-1,2,1,1,1,3,1,H
1977-09-17,1977,Birmingham City,Newcastle United,3-0,3,0,1,1,3,3,H
1977-09-17,1977,Bristol City,West Ham United,3-2,3,2,1,1,5,1,H
1977-09-17,1977,Coventry City,Middlesbrough,2-1,2,1,1,1,3,1,H
1977-09-17,1977,Derby County,Leeds United,2-2,2,2,1,1,4,0,D
1977-09-17,1977,Everton,Norwich City,3-0,3,0,1,1,3,3,H
1977-09-17,1977,Ipswich Town,Liverpool,1-1,1,1,1,1,2,0,D
1977-09-17,1977,Manchester United,Chelsea,0-1,0,1,1,1,1,-1,A
1977-09-17,1977,Nottingham Forest,Aston Villa,2-0,2,0,1,1,2,2,H
1977-09-17,1977,Queens Park Rangers,Manchester City,1-1,1,1,1,1,2,0,D
1977-09-17,1977,West Bromwich Albion,Wolverhampton Wanderers,2-2,2,2,1,1,4,0,D
1977-09-23,1977,Aston Villa,Wolverhampton Wanderers,2-0,2,0,1,1,2,2,H
1977-09-24,1977,Leeds United,Manchester United,1-1,1,1,1,1,2,0,D
1977-09-24,1977,Leicester City,Nottingham Forest,0-3,0,3,1,1,3,-3,A
1977-09-24,1977,Liverpool,Derby County,1-0,1,0,1,1,1,1,H
1977-09-24,1977,Manchester City,Bristol City,2-0,2,0,1,1,2,2,H
1977-09-24,1977,Middlesbrough,Ipswich Town,1-1,1,1,1,1,2,0,D
1977-09-24,1977,Newcastle United,Coventry City,1-2,1,2,1,1,3,-1,A
1977-09-24,1977,Norwich City,Arsenal,1-0,1,0,1,1,1,1,H
1977-09-24,1977,Queens Park Rangers,Chelsea,1-1,1,1,1,1,2,0,D
1977-09-24,1977,West Bromwich Albion,Birmingham City,3-1,3,1,1,1,4,2,H
1977-09-24,1977,West Ham United,Everton,1-1,1,1,1,1,2,0,D
1977-10-01,1977,Arsenal,West Ham United,3-0,3,0,1,1,3,3,H
1977-10-01,1977,Aston Villa,Birmingham City,0-1,0,1,1,1,1,-1,A
1977-10-01,1977,Bristol City,Queens Park Rangers,2-2,2,2,1,1,4,0,D
1977-10-01,1977,Chelsea,Leeds United,1-2,1,2,1,1,3,-1,A
1977-10-01,1977,Coventry City,West Bromwich Albion,1-2,1,2,1,1,3,-1,A
1977-10-01,1977,Derby County,Middlesbrough,4-1,4,1,1,1,5,3,H
1977-10-01,1977,Everton,Manchester City,1-1,1,1,1,1,2,0,D
1977-10-01,1977,Ipswich Town,Newcastle United,2-1,2,1,1,1,3,1,H
1977-10-01,1977,Manchester United,Liverpool,2-0,2,0,1,1,2,2,H
1977-10-01,1977,Nottingham Forest,Norwich City,1-1,1,1,1,1,2,0,D
1977-10-01,1977,Wolverhampton Wanderers,Leicester City,3-0,3,0,1,1,3,3,H
1977-10-03,1977,West Ham United,Middlesbrough,0-2,0,2,1,1,2,-2,A
1977-10-04,1977,Arsenal,Liverpool,0-0,0,0,1,1,0,0,D
1977-10-04,1977,Birmingham City,Queens Park Rangers,2-1,2,1,1,1,3,1,H
1977-10-04,1977,Coventry City,Manchester City,4-2,4,2,1,1,6,2,H
1977-10-04,1977,Everton,West Bromwich Albion,3-1,3,1,1,1,4,2,H
1977-10-04,1977,Nottingham Forest,Ipswich Town,4-0,4,0,1,1,4,4,H
1977-10-04,1977,Wolverhampton Wanderers,Derby County,1-2,1,2,1,1,3,-1,A
1977-10-05,1977,Chelsea,Leicester City,0-0,0,0,1,1,0,0,D
1977-10-05,1977,Leeds United,Aston Villa,1-1,1,1,1,1,2,0,D
1977-10-05,1977,Norwich City,Newcastle United,2-1,2,1,1,1,3,1,H
1977-10-08,1977,Birmingham City,Coventry City,1-1,1,1,1,1,2,0,D
1977-10-08,1977,Bristol City,Leeds United,3-2,3,2,1,1,5,1,H
1977-10-08,1977,Leicester City,Aston Villa,0-2,0,2,1,1,2,-2,A
1977-10-08,1977,Liverpool,Chelsea,2-0,2,0,1,1,2,2,H
1977-10-08,1977,Manchester City,Arsenal,2-1,2,1,1,1,3,1,H
1977-10-08,1977,Middlesbrough,Manchester United,2-1,2,1,1,1,3,1,H
1977-10-08,1977,Newcastle United,Derby County,1-2,1,2,1,1,3,-1,A
1977-10-08,1977,Norwich City,Wolverhampton Wanderers,2-1,2,1,1,1,3,1,H
1977-10-08,1977,Queens Park Rangers,Everton,1-5,1,5,1,1,6,-4,A
1977-10-08,1977,West Bromwich Albion,Ipswich Town,1-0,1,0,1,1,1,1,H
1977-10-08,1977,West Ham United,Nottingham Forest,0-0,0,0,1,1,0,0,D
1977-10-15,1977,Arsenal,Queens Park Rangers,1-0,1,0,1,1,1,1,H
1977-10-15,1977,Aston Villa,Norwich City,3-0,3,0,1,1,3,3,H
1977-10-15,1977,Chelsea,Middlesbrough,0-0,0,0,1,1,0,0,D
1977-10-15,1977,Derby County,West Bromwich Albion,1-1,1,1,1,1,2,0,D
1977-10-15,1977,Everton,Bristol City,1-0,1,0,1,1,1,1,H
1977-10-15,1977,Ipswich Town,Birmingham City,5-2,5,2,1,1,7,3,H
1977-10-15,1977,Leeds United,Liverpool,1-2,1,2,1,1,3,-1,A
1977-10-15,1977,Leicester City,Coventry City,1-2,1,2,1,1,3,-1,A
1977-10-15,1977,Manchester United,Newcastle United,3-2,3,2,1,1,5,1,H
1977-10-15,1977,Nottingham Forest,Manchester City,2-1,2,1,1,1,3,1,H
1977-10-15,1977,Wolverhampton Wanderers,West Ham United,2-2,2,2,1,1,4,0,D
1977-10-22,1977,Birmingham City,Derby County,3-1,3,1,1,1,4,2,H
1977-10-22,1977,Bristol City,Arsenal,0-2,0,2,1,1,2,-2,A
1977-10-22,1977,Coventry City,Ipswich Town,1-1,1,1,1,1,2,0,D
1977-10-22,1977,Liverpool,Everton,0-0,0,0,1,1,0,0,D
1977-10-22,1977,Manchester City,Wolverhampton Wanderers,0-2,0,2,1,1,2,-2,A
1977-10-22,1977,Middlesbrough,Leeds United,2-1,2,1,1,1,3,1,H
1977-10-22,1977,Newcastle United,Chelsea,1-0,1,0,1,1,1,1,H
1977-10-22,1977,Norwich City,Leicester City,2-0,2,0,1,1,2,2,H
1977-10-22,1977,Queens Park Rangers,Nottingham Forest,0-2,0,2,1,1,2,-2,A
1977-10-22,1977,West Bromwich Albion,Manchester United,4-0,4,0,1,1,4,4,H
1977-10-22,1977,West Ham United,Aston Villa,2-2,2,2,1,1,4,0,D
1977-10-29,1977,Arsenal,Birmingham City,1-1,1,1,1,1,2,0,D
1977-10-29,1977,Aston Villa,Manchester United,2-1,2,1,1,1,3,1,H
1977-10-29,1977,Chelsea,Bristol City,1-0,1,0,1,1,1,1,H
1977-10-29,1977,Derby County,Norwich City,2-2,2,2,1,1,4,0,D
1977-10-29,1977,Everton,Newcastle United,4-4,4,4,1,1,8,0,D
1977-10-29,1977,Ipswich Town,West Ham United,0-2,0,2,1,1,2,-2,A
1977-10-29,1977,Leicester City,Leeds United,0-0,0,0,1,1,0,0,D
1977-10-29,1977,Manchester City,Liverpool,3-1,3,1,1,1,4,2,H
1977-10-29,1977,Nottingham Forest,Middlesbrough,4-0,4,0,1,1,4,4,H
1977-10-29,1977,Queens Park Rangers,West Bromwich Albion,2-1,2,1,1,1,3,1,H
1977-10-29,1977,Wolverhampton Wanderers,Coventry City,1-3,1,3,1,1,4,-2,A
1977-11-05,1977,Birmingham City,Wolverhampton Wanderers,2-1,2,1,1,1,3,1,H
1977-11-05,1977,Chelsea,Nottingham Forest,1-0,1,0,1,1,1,1,H
1977-11-05,1977,Coventry City,West Ham United,1-0,1,0,1,1,1,1,H
1977-11-05,1977,Derby County,Everton,0-1,0,1,1,1,1,-1,A
1977-11-05,1977,Ipswich Town,Manchester City,1-0,1,0,1,1,1,1,H
1977-11-05,1977,Leeds United,Norwich City,2-2,2,2,1,1,4,0,D
1977-11-05,1977,Liverpool,Aston Villa,1-2,1,2,1,1,3,-1,A
1977-11-05,1977,Manchester United,Arsenal,1-2,1,2,1,1,3,-1,A
1977-11-05,1977,Middlesbrough,Queens Park Rangers,1-1,1,1,1,1,2,0,D
1977-11-05,1977,Newcastle United,Bristol City,1-1,1,1,1,1,2,0,D
1977-11-05,1977,West Bromwich Albion,Leicester City,2-0,2,0,1,1,2,2,H
1977-11-12,1977,Arsenal,Coventry City,1-1,1,1,1,1,2,0,D
1977-11-12,1977,Aston Villa,Middlesbrough,0-1,0,1,1,1,1,-1,A
1977-11-12,1977,Bristol City,Derby County,3-1,3,1,1,1,4,2,H
1977-11-12,1977,Everton,Birmingham City,2-1,2,1,1,1,3,1,H
1977-11-12,1977,Leicester City,Ipswich Town,2-1,2,1,1,1,3,1,H
1977-11-12,1977,Manchester City,Leeds United,2-3,2,3,1,1,5,-1,A
1977-11-12,1977,Norwich City,Chelsea,0-0,0,0,1,1,0,0,D
1977-11-12,1977,Nottingham Forest,Manchester United,2-1,2,1,1,1,3,1,H
1977-11-12,1977,Queens Park Rangers,Liverpool,2-0,2,0,1,1,2,2,H
1977-11-12,1977,West Ham United,West Bromwich Albion,3-3,3,3,1,1,6,0,D
1977-11-12,1977,Wolverhampton Wanderers,Newcastle United,1-0,1,0,1,1,1,1,H
1977-11-19,1977,Birmingham City,Leicester City,1-1,1,1,1,1,2,0,D
1977-11-19,1977,Chelsea,Aston Villa,0-0,0,0,1,1,0,0,D
1977-11-19,1977,Coventry City,Queens Park Rangers,4-1,4,1,1,1,5,3,H
1977-11-19,1977,Derby County,West Ham United,2-1,2,1,1,1,3,1,H
1977-11-19,1977,Ipswich Town,Everton,3-3,3,3,1,1,6,0,D
1977-11-19,1977,Leeds United,Nottingham Forest,1-0,1,0,1,1,1,1,H
1977-11-19,1977,Liverpool,Bristol City,1-1,1,1,1,1,2,0,D
1977-11-19,1977,Manchester United,Norwich City,1-0,1,0,1,1,1,1,H
1977-11-19,1977,Middlesbrough,Wolverhampton Wanderers,0-0,0,0,1,1,0,0,D
1977-11-19,1977,Newcastle United,Arsenal,1-2,1,2,1,1,3,-1,A
1977-11-19,1977,West Bromwich Albion,Manchester City,0-0,0,0,1,1,0,0,D
1977-11-26,1977,Arsenal,Derby County,1-3,1,3,1,1,4,-2,A
1977-11-26,1977,Bristol City,Middlesbrough,4-1,4,1,1,1,5,3,H
1977-11-26,1977,Everton,Coventry City,6-0,6,0,1,1,6,6,H
1977-11-26,1977,Leicester City,Liverpool,0-4,0,4,1,1,4,-4,A
1977-11-26,1977,Manchester City,Chelsea,6-2,6,2,1,1,8,4,H
1977-11-26,1977,Norwich City,Birmingham City,1-0,1,0,1,1,1,1,H
1977-11-26,1977,Nottingham Forest,West Bromwich Albion,0-0,0,0,1,1,0,0,D
1977-11-26,1977,Queens Park Rangers,Manchester United,2-2,2,2,1,1,4,0,D
1977-11-26,1977,West Ham United,Leeds United,0-1,0,1,1,1,1,-1,A
1977-11-26,1977,Wolverhampton Wanderers,Ipswich Town,0-0,0,0,1,1,0,0,D
1977-12-03,1977,Birmingham City,Nottingham Forest,0-2,0,2,1,1,2,-2,A
1977-12-03,1977,Chelsea,Everton,0-1,0,1,1,1,1,-1,A
1977-12-03,1977,Coventry City,Bristol City,1-1,1,1,1,1,2,0,D
1977-12-03,1977,Derby County,Manchester City,2-1,2,1,1,1,3,1,H
1977-12-03,1977,Ipswich Town,Aston Villa,2-0,2,0,1,1,2,2,H
1977-12-03,1977,Leeds United,Queens Park Rangers,3-0,3,0,1,1,3,3,H
1977-12-03,1977,Liverpool,West Ham United,2-0,2,0,1,1,2,2,H
1977-12-03,1977,Manchester United,Wolverhampton Wanderers,3-1,3,1,1,1,4,2,H
1977-12-03,1977,Middlesbrough,Arsenal,0-1,0,1,1,1,1,-1,A
1977-12-03,1977,Newcastle United,Leicester City,2-0,2,0,1,1,2,2,H
1977-12-03,1977,West Bromwich Albion,Norwich City,0-0,0,0,1,1,0,0,D
1977-12-10,1977,Arsenal,Leeds United,1-1,1,1,1,1,2,0,D
1977-12-10,1977,Aston Villa,West Bromwich Albion,3-0,3,0,1,1,3,3,H
1977-12-10,1977,Bristol City,Ipswich Town,2-0,2,0,1,1,2,2,H
1977-12-10,1977,Everton,Middlesbrough,3-0,3,0,1,1,3,3,H
1977-12-10,1977,Leicester City,Derby County,1-1,1,1,1,1,2,0,D
1977-12-10,1977,Manchester City,Birmingham City,3-0,3,0,1,1,3,3,H
1977-12-10,1977,Norwich City,Liverpool,2-1,2,1,1,1,3,1,H
1977-12-10,1977,Nottingham Forest,Coventry City,2-1,2,1,1,1,3,1,H
1977-12-10,1977,Queens Park Rangers,Newcastle United,0-1,0,1,1,1,1,-1,A
1977-12-10,1977,West Ham United,Manchester United,2-1,2,1,1,1,3,1,H
1977-12-10,1977,Wolverhampton Wanderers,Chelsea,1-3,1,3,1,1,4,-2,A
1977-12-17,1977,Birmingham City,Everton,0-0,0,0,1,1,0,0,D
1977-12-17,1977,Chelsea,Norwich City,1-1,1,1,1,1,2,0,D
1977-12-17,1977,Coventry City,Arsenal,1-2,1,2,1,1,3,-1,A
1977-12-17,1977,Derby County,Bristol City,1-0,1,0,1,1,1,1,H
1977-12-17,1977,Ipswich Town,Leicester City,1-0,1,0,1,1,1,1,H
1977-12-17,1977,Leeds United,Manchester City,2-0,2,0,1,1,2,2,H
1977-12-17,1977,Liverpool,Queens Park Rangers,1-0,1,0,1,1,1,1,H
1977-12-17,1977,Manchester United,Nottingham Forest,0-4,0,4,1,1,4,-4,A
1977-12-17,1977,Middlesbrough,Aston Villa,1-0,1,0,1,1,1,1,H
1977-12-17,1977,Newcastle United,Wolverhampton Wanderers,4-0,4,0,1,1,4,4,H
1977-12-17,1977,West Bromwich Albion,West Ham United,1-0,1,0,1,1,1,1,H
1977-12-26,1977,Arsenal,Chelsea,3-0,3,0,1,1,3,3,H
1977-12-26,1977,Aston Villa,Coventry City,1-1,1,1,1,1,2,0,D
1977-12-26,1977,Bristol City,West Bromwich Albion,3-1,3,1,1,1,4,2,H
1977-12-26,1977,Everton,Manchester United,2-6,2,6,1,1,8,-4,A
1977-12-26,1977,Leicester City,Middlesbrough,0-0,0,0,1,1,0,0,D
1977-12-26,1977,Manchester City,Newcastle United,4-0,4,0,1,1,4,4,H
1977-12-26,1977,Norwich City,Ipswich Town,1-0,1,0,1,1,1,1,H
1977-12-26,1977,Nottingham Forest,Liverpool,1-1,1,1,1,1,2,0,D
1977-12-26,1977,Queens Park Rangers,Derby County,0-0,0,0,1,1,0,0,D
1977-12-26,1977,West Ham United,Birmingham City,1-0,1,0,1,1,1,1,H
1977-12-26,1977,Wolverhampton Wanderers,Leeds United,3-1,3,1,1,1,4,2,H
1977-12-27,1977,Birmingham City,Bristol City,3-0,3,0,1,1,3,3,H
1977-12-27,1977,Chelsea,West Ham United,2-1,2,1,1,1,3,1,H
1977-12-27,1977,Coventry City,Norwich City,5-4,5,4,1,1,9,1,H
1977-12-27,1977,Derby County,Aston Villa,0-3,0,3,1,1,3,-3,A
1977-12-27,1977,Ipswich Town,Queens Park Rangers,3-2,3,2,1,1,5,1,H
1977-12-27,1977,Leeds United,Everton,3-1,3,1,1,1,4,2,H
1977-12-27,1977,Liverpool,Wolverhampton Wanderers,1-0,1,0,1,1,1,1,H
1977-12-27,1977,Manchester United,Leicester City,3-1,3,1,1,1,4,2,H
1977-12-27,1977,Middlesbrough,Manchester City,0-2,0,2,1,1,2,-2,A
1977-12-27,1977,West Bromwich Albion,Arsenal,1-3,1,3,1,1,4,-2,A
1977-12-28,1977,Newcastle United,Nottingham Forest,0-2,0,2,1,1,2,-2,A
1977-12-31,1977,Birmingham City,Chelsea,4-5,4,5,1,1,9,-1,A
1977-12-31,1977,Bristol City,Nottingham Forest,1-3,1,3,1,1,4,-2,A
1977-12-31,1977,Coventry City,Manchester United,3-0,3,0,1,1,3,3,H
1977-12-31,1977,Everton,Arsenal,2-0,2,0,1,1,2,2,H
1977-12-31,1977,Ipswich Town,Derby County,1-2,1,2,1,1,3,-1,A
1977-12-31,1977,Manchester City,Aston Villa,2-0,2,0,1,1,2,2,H
1977-12-31,1977,Middlesbrough,Norwich City,2-2,2,2,1,1,4,0,D
1977-12-31,1977,Newcastle United,Liverpool,0-2,0,2,1,1,2,-2,A
1977-12-31,1977,Queens Park Rangers,Wolverhampton Wanderers,1-3,1,3,1,1,4,-2,A
1977-12-31,1977,West Bromwich Albion,Leeds United,1-0,1,0,1,1,1,1,H
1977-12-31,1977,West Ham United,Leicester City,3-2,3,2,1,1,5,1,H
1978-01-02,1977,Arsenal,Ipswich Town,1-0,1,0,1,1,1,1,H
1978-01-02,1977,Aston Villa,Queens Park Rangers,1-1,1,1,1,1,2,0,D
1978-01-02,1977,Chelsea,West Bromwich Albion,2-2,2,2,1,1,4,0,D
1978-01-02,1977,Derby County,Coventry City,4-2,4,2,1,1,6,2,H
1978-01-02,1977,Leeds United,Newcastle United,0-2,0,2,1,1,2,-2,A
1978-01-02,1977,Leicester City,Manchester City,0-1,0,1,1,1,1,-1,A
1978-01-02,1977,Liverpool,Middlesbrough,2-0,2,0,1,1,2,2,H
1978-01-02,1977,Manchester United,Birmingham City,1-2,1,2,1,1,3,-1,A
1978-01-02,1977,Norwich City,West Ham United,2-2,2,2,1,1,4,0,D
1978-01-02,1977,Nottingham Forest,Everton,1-1,1,1,1,1,2,0,D
1978-01-02,1977,Wolverhampton Wanderers,Bristol City,0-0,0,0,1,1,0,0,D
1978-01-14,1977,Arsenal,Wolverhampton Wanderers,3-1,3,1,1,1,4,2,H
1978-01-14,1977,Birmingham City,Leeds United,2-3,2,3,1,1,5,-1,A
1978-01-14,1977,Bristol City,Leicester City,0-0,0,0,1,1,0,0,D
1978-01-14,1977,Coventry City,Chelsea,5-1,5,1,1,1,6,4,H
1978-01-14,1977,Derby County,Nottingham Forest,0-0,0,0,1,1,0,0,D
1978-01-14,1977,Everton,Aston Villa,1-0,1,0,1,1,1,1,H
1978-01-14,1977,Ipswich Town,Manchester United,1-2,1,2,1,1,3,-1,A
1978-01-14,1977,Manchester City,West Ham United,3-2,3,2,1,1,5,1,H
1978-01-14,1977,Newcastle United,Middlesbrough,2-4,2,4,1,1,6,-2,A
1978-01-14,1977,Queens Park Rangers,Norwich City,2-1,2,1,1,1,3,1,H
1978-01-14,1977,West Bromwich Albion,Liverpool,0-1,0,1,1,1,1,-1,A
1978-01-21,1977,Chelsea,Ipswich Town,5-3,5,3,1,1,8,2,H
1978-01-21,1977,Leeds United,Coventry City,2-0,2,0,1,1,2,2,H
1978-01-21,1977,Leicester City,Queens Park Rangers,0-0,0,0,1,1,0,0,D
1978-01-21,1977,Liverpool,Birmingham City,2-3,2,3,1,1,5,-1,A
1978-01-21,1977,Manchester United,Derby County,4-0,4,0,1,1,4,4,H
1978-01-21,1977,Middlesbrough,West Bromwich Albion,1-0,1,0,1,1,1,1,H
1978-01-21,1977,Norwich City,Manchester City,1-3,1,3,1,1,4,-2,A
1978-01-21,1977,Nottingham Forest,Arsenal,2-0,2,0,1,1,2,2,H
1978-01-21,1977,West Ham United,Newcastle United,1-0,1,0,1,1,1,1,H
1978-01-21,1977,Wolverhampton Wanderers,Everton,3-1,3,1,1,1,4,2,H
1978-01-28,1977,Aston Villa,Bristol City,1-0,1,0,1,1,1,1,H
1978-02-04,1977,Arsenal,Aston Villa,0-1,0,1,1,1,1,-1,A
1978-02-04,1977,Birmingham City,Middlesbrough,1-2,1,2,1,1,3,-1,A
1978-02-04,1977,Bristol City,Norwich City,3-0,3,0,1,1,3,3,H
1978-02-04,1977,Coventry City,Liverpool,1-0,1,0,1,1,1,1,H
1978-02-04,1977,Everton,Leicester City,2-0,2,0,1,1,2,2,H
1978-02-04,1977,Ipswich Town,Leeds United,0-1,0,1,1,1,1,-1,A
1978-02-04,1977,Nottingham Forest,Wolverhampton Wanderers,2-0,2,0,1,1,2,2,H
1978-02-08,1977,Manchester United,Bristol City,1-1,1,1,1,1,2,0,D
1978-02-11,1977,Chelsea,Manchester United,2-2,2,2,1,1,4,0,D
1978-02-11,1977,Leicester City,Arsenal,1-1,1,1,1,1,2,0,D
1978-02-11,1977,Manchester City,Queens Park Rangers,2-1,2,1,1,1,3,1,H
1978-02-11,1977,West Ham United,Bristol City,1-2,1,2,1,1,3,-1,A
1978-02-17,1977,Bristol City,Manchester City,2-2,2,2,1,1,4,0,D
1978-02-18,1977,Everton,West Ham United,2-1,2,1,1,1,3,1,H
1978-02-25,1977,Birmingham City,Aston Villa,1-0,1,0,1,1,1,1,H
1978-02-25,1977,Leeds United,Chelsea,2-0,2,0,1,1,2,2,H
1978-02-25,1977,Leicester City,Wolverhampton Wanderers,1-0,1,0,1,1,1,1,H
1978-02-25,1977,Liverpool,Manchester United,3-1,3,1,1,1,4,2,H
1978-02-25,1977,Manchester City,Everton,1-0,1,0,1,1,1,1,H
1978-02-25,1977,Middlesbrough,Derby County,3-1,3,1,1,1,4,2,H
1978-02-25,1977,Newcastle United,Ipswich Town,0-1,0,1,1,1,1,-1,A
1978-02-25,1977,Norwich City,Nottingham Forest,3-3,3,3,1,1,6,0,D
1978-02-25,1977,Queens Park Rangers,Bristol City,2-2,2,2,1,1,4,0,D
1978-02-25,1977,West Bromwich Albion,Coventry City,3-3,3,3,1,1,6,0,D
1978-02-25,1977,West Ham United,Arsenal,2-2,2,2,1,1,4,0,D
1978-02-28,1977,Arsenal,Norwich City,0-0,0,0,1,1,0,0,D
1978-02-28,1977,Birmingham City,West Bromwich Albion,1-2,1,2,1,1,3,-1,A
1978-03-01,1977,Manchester United,Leeds United,0-1,0,1,1,1,1,-1,A
1978-03-04,1977,Arsenal,Manchester City,3-0,3,0,1,1,3,3,H
1978-03-04,1977,Aston Villa,Leicester City,0-0,0,0,1,1,0,0,D
1978-03-04,1977,Chelsea,Liverpool,3-1,3,1,1,1,4,2,H
1978-03-04,1977,Coventry City,Birmingham City,4-0,4,0,1,1,4,4,H
1978-03-04,1977,Derby County,Newcastle United,1-1,1,1,1,1,2,0,D
1978-03-04,1977,Everton,Queens Park Rangers,3-3,3,3,1,1,6,0,D
1978-03-04,1977,Ipswich Town,West Bromwich Albion,2-2,2,2,1,1,4,0,D
1978-03-04,1977,Leeds United,Bristol City,0-2,0,2,1,1,2,-2,A
1978-03-04,1977,Manchester United,Middlesbrough,0-0,0,0,1,1,0,0,D
1978-03-04,1977,Nottingham Forest,West Ham United,2-0,2,0,1,1,2,2,H
1978-03-04,1977,Wolverhampton Wanderers,Norwich City,3-3,3,3,1,1,6,0,D
1978-03-08,1977,Derby County,Liverpool,4-2,4,2,1,1,6,2,H
1978-03-11,1977,Bristol City,Everton,0-1,0,1,1,1,1,-1,A
1978-03-11,1977,Coventry City,Leicester City,1-0,1,0,1,1,1,1,H
1978-03-11,1977,Derby County,Chelsea,1-1,1,1,1,1,2,0,D
1978-03-11,1977,Liverpool,Leeds United,1-0,1,0,1,1,1,1,H
1978-03-11,1977,Newcastle United,Manchester United,2-2,2,2,1,1,4,0,D
1978-03-11,1977,Norwich City,Aston Villa,2-1,2,1,1,1,3,1,H
1978-03-11,1977,West Ham United,Wolverhampton Wanderers,1-2,1,2,1,1,3,-1,A
1978-03-14,1977,Nottingham Forest,Leicester City,1-0,1,0,1,1,1,1,H
1978-03-14,1977,Queens Park Rangers,West Ham United,1-0,1,0,1,1,1,1,H
1978-03-14,1977,Wolverhampton Wanderers,West Bromwich Albion,1-1,1,1,1,1,2,0,D
1978-03-15,1977,Manchester United,Manchester City,2-2,2,2,1,1,4,0,D
1978-03-15,1977,Newcastle United,Birmingham City,1-1,1,1,1,1,2,0,D
1978-03-15,1977,Norwich City,Everton,0-0,0,0,1,1,0,0,D
1978-03-18,1977,Arsenal,Bristol City,4-1,4,1,1,1,5,3,H
1978-03-18,1977,Aston Villa,West Ham United,4-1,4,1,1,1,5,3,H
1978-03-18,1977,Chelsea,Newcastle United,2-2,2,2,1,1,4,0,D
1978-03-18,1977,Derby County,Birmingham City,1-3,1,3,1,1,4,-2,A
1978-03-18,1977,Ipswich Town,Coventry City,1-1,1,1,1,1,2,0,D
1978-03-18,1977,Leeds United,Middlesbrough,5-0,5,0,1,1,5,5,H
1978-03-18,1977,Leicester City,Norwich City,2-2,2,2,1,1,4,0,D
1978-03-18,1977,Manchester United,West Bromwich Albion,1-1,1,1,1,1,2,0,D
1978-03-18,1977,Wolverhampton Wanderers,Manchester City,1-1,1,1,1,1,2,0,D
1978-03-21,1977,Birmingham City,Arsenal,1-1,1,1,1,1,2,0,D
1978-03-21,1977,Bristol City,Chelsea,3-0,3,0,1,1,3,3,H
1978-03-21,1977,Coventry City,Aston Villa,2-3,2,3,1,1,5,-1,A
1978-03-21,1977,Ipswich Town,Middlesbrough,1-1,1,1,1,1,2,0,D
1978-03-22,1977,West Bromwich Albion,Queens Park Rangers,2-0,2,0,1,1,2,2,H
1978-03-24,1977,Newcastle United,Everton,0-2,0,2,1,1,2,-2,A
1978-03-24,1977,West Ham United,Ipswich Town,3-0,3,0,1,1,3,3,H
1978-03-25,1977,Arsenal,West Bromwich Albion,4-0,4,0,1,1,4,4,H
1978-03-25,1977,Aston Villa,Derby County,0-0,0,0,1,1,0,0,D
1978-03-25,1977,Bristol City,Birmingham City,0-1,0,1,1,1,1,-1,A
1978-03-25,1977,Everton,Leeds United,2-0,2,0,1,1,2,2,H
1978-03-25,1977,Leicester City,Manchester United,2-3,2,3,1,1,5,-1,A
1978-03-25,1977,Manchester City,Middlesbrough,2-2,2,2,1,1,4,0,D
1978-03-25,1977,Norwich City,Coventry City,1-2,1,2,1,1,3,-1,A
1978-03-25,1977,Nottingham Forest,Newcastle United,2-0,2,0,1,1,2,2,H
1978-03-25,1977,Queens Park Rangers,Ipswich Town,3-3,3,3,1,1,6,0,D
1978-03-25,1977,West Ham United,Chelsea,3-1,3,1,1,1,4,2,H
1978-03-25,1977,Wolverhampton Wanderers,Liverpool,1-3,1,3,1,1,4,-2,A
1978-03-27,1977,Chelsea,Arsenal,0-0,0,0,1,1,0,0,D
1978-03-27,1977,Derby County,Queens Park Rangers,2-0,2,0,1,1,2,2,H
1978-03-27,1977,Ipswich Town,Norwich City,4-0,4,0,1,1,4,4,H
1978-03-27,1977,Leeds United,Wolverhampton Wanderers,2-1,2,1,1,1,3,1,H
1978-03-27,1977,Manchester United,Everton,1-2,1,2,1,1,3,-1,A
1978-03-27,1977,Middlesbrough,Leicester City,0-1,0,1,1,1,1,-1,A
1978-03-27,1977,West Bromwich Albion,Bristol City,2-1,2,1,1,1,3,1,H
1978-03-28,1977,Birmingham City,West Ham United,3-0,3,0,1,1,3,3,H
1978-03-28,1977,Coventry City,Wolverhampton Wanderers,4-0,4,0,1,1,4,4,H
1978-03-28,1977,Leeds United,Leicester City,5-1,5,1,1,1,6,4,H
1978-03-29,1977,Manchester United,Aston Villa,1-1,1,1,1,1,2,0,D
1978-03-29,1977,Middlesbrough,Nottingham Forest,2-2,2,2,1,1,4,0,D
1978-03-29,1977,Newcastle United,Manchester City,2-2,2,2,1,1,4,0,D
1978-03-29,1977,Norwich City,Derby County,0-0,0,0,1,1,0,0,D
1978-04-01,1977,Arsenal,Manchester United,3-1,3,1,1,1,4,2,H
1978-04-01,1977,Aston Villa,Liverpool,0-3,0,3,1,1,3,-3,A
1978-04-01,1977,Bristol City,Newcastle United,3-1,3,1,1,1,4,2,H
1978-04-01,1977,Everton,Derby County,2-1,2,1,1,1,3,1,H
1978-04-01,1977,Leicester City,West Bromwich Albion,0-1,0,1,1,1,1,-1,A
1978-04-01,1977,Manchester City,Ipswich Town,2-1,2,1,1,1,3,1,H
1978-04-01,1977,Norwich City,Leeds United,3-0,3,0,1,1,3,3,H
1978-04-01,1977,Nottingham Forest,Chelsea,3-1,3,1,1,1,4,2,H
1978-04-01,1977,Queens Park Rangers,Middlesbrough,1-0,1,0,1,1,1,1,H
1978-04-01,1977,West Ham United,Coventry City,2-1,2,1,1,1,3,1,H
1978-04-01,1977,Wolverhampton Wanderers,Birmingham City,0-1,0,1,1,1,1,-1,A
1978-04-04,1977,Coventry City,Newcastle United,0-0,0,0,1,1,0,0,D
1978-04-04,1977,Middlesbrough,Chelsea,2-0,2,0,1,1,2,2,H
1978-04-05,1977,Aston Villa,Nottingham Forest,0-1,0,1,1,1,1,-1,A
1978-04-05,1977,Everton,Liverpool,0-1,0,1,1,1,1,-1,A
1978-04-08,1977,Birmingham City,Norwich City,2-1,2,1,1,1,3,1,H
1978-04-08,1977,Coventry City,Everton,3-2,3,2,1,1,5,1,H
1978-04-08,1977,Derby County,Wolverhampton Wanderers,3-1,3,1,1,1,4,2,H
1978-04-08,1977,Leeds United,West Ham United,1-2,1,2,1,1,3,-1,A
1978-04-08,1977,Liverpool,Leicester City,3-2,3,2,1,1,5,1,H
1978-04-08,1977,Manchester United,Queens Park Rangers,3-1,3,1,1,1,4,2,H
1978-04-08,1977,Middlesbrough,Bristol City,2-0,2,0,1,1,2,2,H
1978-04-08,1977,Newcastle United,Aston Villa,1-1,1,1,1,1,2,0,D
1978-04-11,1977,Birmingham City,Ipswich Town,0-0,0,0,1,1,0,0,D
1978-04-11,1977,Manchester City,Nottingham Forest,0-0,0,0,1,1,0,0,D
1978-04-11,1977,Middlesbrough,Coventry City,1-1,1,1,1,1,2,0,D
1978-04-11,1977,Queens Park Rangers,Arsenal,2-1,2,1,1,1,3,1,H
1978-04-12,1977,Leeds United,Derby County,2-0,2,0,1,1,2,2,H
1978-04-12,1977,West Bromwich Albion,Newcastle United,2-0,2,0,1,1,2,2,H
1978-04-15,1977,Arsenal,Newcastle United,2-1,2,1,1,1,3,1,H
1978-04-15,1977,Aston Villa,Chelsea,2-0,2,0,1,1,2,2,H
1978-04-15,1977,Bristol City,Liverpool,1-1,1,1,1,1,2,0,D
1978-04-15,1977,Everton,Ipswich Town,1-0,1,0,1,1,1,1,H
1978-04-15,1977,Leicester City,Birmingham City,1-4,1,4,1,1,5,-3,A
1978-04-15,1977,Manchester City,West Bromwich Albion,1-3,1,3,1,1,4,-2,A
1978-04-15,1977,Norwich City,Manchester United,1-3,1,3,1,1,4,-2,A
1978-04-15,1977,Nottingham Forest,Leeds United,1-1,1,1,1,1,2,0,D
1978-04-15,1977,Queens Park Rangers,Coventry City,2-1,2,1,1,1,3,1,H
1978-04-15,1977,West Ham United,Derby County,3-0,3,0,1,1,3,3,H
1978-04-15,1977,Wolverhampton Wanderers,Middlesbrough,0-0,0,0,1,1,0,0,D
1978-04-17,1977,Aston Villa,Newcastle United,2-0,2,0,1,1,2,2,H
1978-04-18,1977,Liverpool,Ipswich Town,2-2,2,2,1,1,4,0,D
1978-04-18,1977,Nottingham Forest,Queens Park Rangers,1-0,1,0,1,1,1,1,H
1978-04-18,1977,West Bromwich Albion,Derby County,1-0,1,0,1,1,1,1,H
1978-04-22,1977,Birmingham City,Manchester City,1-4,1,4,1,1,5,-3,A
1978-04-22,1977,Chelsea,Wolverhampton Wanderers,1-1,1,1,1,1,2,0,D
1978-04-22,1977,Coventry City,Nottingham Forest,0-0,0,0,1,1,0,0,D
1978-04-22,1977,Derby County,Leicester City,4-1,4,1,1,1,5,3,H
1978-04-22,1977,Ipswich Town,Bristol City,1-0,1,0,1,1,1,1,H
1978-04-22,1977,Leeds United,Arsenal,1-3,1,3,1,1,4,-2,A
1978-04-22,1977,Liverpool,Norwich City,3-0,3,0,1,1,3,3,H
1978-04-22,1977,Manchester United,West Ham United,3-0,3,0,1,1,3,3,H
1978-04-22,1977,Middlesbrough,Everton,0-0,0,0,1,1,0,0,D
1978-04-22,1977,Newcastle United,Queens Park Rangers,0-3,0,3,1,1,3,-3,A
1978-04-22,1977,West Bromwich Albion,Aston Villa,0-3,0,3,1,1,3,-3,A
1978-04-25,1977,Bristol City,Manchester United,0-1,0,1,1,1,1,-1,A
1978-04-25,1977,Ipswich Town,Nottingham Forest,0-2,0,2,1,1,2,-2,A
1978-04-25,1977,Liverpool,Arsenal,1-0,1,0,1,1,1,1,H
1978-04-25,1977,Manchester City,Coventry City,3-1,3,1,1,1,4,2,H
1978-04-25,1977,Middlesbrough,West Ham United,1-2,1,2,1,1,3,-1,A
1978-04-25,1977,Queens Park Rangers,Birmingham City,0-0,0,0,1,1,0,0,D
1978-04-25,1977,West Bromwich Albion,Everton,3-1,3,1,1,1,4,2,H
1978-04-26,1977,Aston Villa,Leeds United,3-1,3,1,1,1,4,2,H
1978-04-26,1977,Leicester City,Chelsea,0-2,0,2,1,1,2,-2,A
1978-04-26,1977,Newcastle United,Norwich City,2-2,2,2,1,1,4,0,D
1978-04-29,1977,Arsenal,Middlesbrough,1-0,1,0,1,1,1,1,H
1978-04-29,1977,Aston Villa,Ipswich Town,6-1,6,1,1,1,7,5,H
1978-04-29,1977,Bristol City,Coventry City,1-1,1,1,1,1,2,0,D
1978-04-29,1977,Everton,Chelsea,6-0,6,0,1,1,6,6,H
1978-04-29,1977,Leicester City,Newcastle United,3-0,3,0,1,1,3,3,H
1978-04-29,1977,Manchester City,Derby County,1-1,1,1,1,1,2,0,D
1978-04-29,1977,Norwich City,West Bromwich Albion,1-1,1,1,1,1,2,0,D
1978-04-29,1977,Nottingham Forest,Birmingham City,0-0,0,0,1,1,0,0,D
1978-04-29,1977,Queens Park Rangers,Leeds United,0-0,0,0,1,1,0,0,D
1978-04-29,1977,West Ham United,Liverpool,0-2,0,2,1,1,2,-2,A
1978-04-29,1977,Wolverhampton Wanderers,Manchester United,2-1,2,1,1,1,3,1,H
1978-05-01,1977,Liverpool,Manchester City,4-0,4,0,1,1,4,4,H
1978-05-02,1977,Chelsea,Queens Park Rangers,3-1,3,1,1,1,4,2,H
1978-05-02,1977,West Bromwich Albion,Nottingham Forest,2-2,2,2,1,1,4,0,D
1978-05-02,1977,Wolverhampton Wanderers,Aston Villa,3-1,3,1,1,1,4,2,H
1978-05-04,1977,Liverpool,Nottingham Forest,0-0,0,0,1,1,0,0,D
1978-05-05,1977,Chelsea,Manchester City,0-0,0,0,1,1,0,0,D
1978-05-09,1977,Derby County,Arsenal,3-0,3,0,1,1,3,3,H
1978-05-09,1977,Ipswich Town,Wolverhampton Wanderers,1-2,1,2,1,1,3,-1,A
1978-08-19,1978,Arsenal,Leeds United,2-2,2,2,1,1,4,0,D
1978-08-19,1978,Aston Villa,Wolverhampton Wanderers,1-0,1,0,1,1,1,1,H
1978-08-19,1978,Bolton Wanderers,Bristol City,1-2,1,2,1,1,3,-1,A
1978-08-19,1978,Chelsea,Everton,0-1,0,1,1,1,1,-1,A
1978-08-19,1978,Derby County,Manchester City,1-1,1,1,1,1,2,0,D
1978-08-19,1978,Liverpool,Queens Park Rangers,2-1,2,1,1,1,3,1,H
1978-08-19,1978,Manchester United,Birmingham City,1-0,1,0,1,1,1,1,H
1978-08-19,1978,Middlesbrough,Coventry City,1-2,1,2,1,1,3,-1,A
1978-08-19,1978,Norwich City,Southampton,3-1,3,1,1,1,4,2,H
1978-08-19,1978,Nottingham Forest,Tottenham Hotspur,1-1,1,1,1,1,2,0,D
1978-08-19,1978,West Bromwich Albion,Ipswich Town,2-1,2,1,1,1,3,1,H
1978-08-22,1978,Birmingham City,Middlesbrough,1-3,1,3,1,1,4,-2,A
1978-08-22,1978,Bristol City,Norwich City,1-1,1,1,1,1,2,0,D
1978-08-22,1978,Coventry City,Nottingham Forest,0-0,0,0,1,1,0,0,D
1978-08-22,1978,Everton,Derby County,2-1,2,1,1,1,3,1,H
1978-08-22,1978,Ipswich Town,Liverpool,0-3,0,3,1,1,3,-3,A
1978-08-22,1978,Manchester City,Arsenal,1-1,1,1,1,1,2,0,D
1978-08-22,1978,Queens Park Rangers,West Bromwich Albion,0-1,0,1,1,1,1,-1,A
1978-08-22,1978,Southampton,Bolton Wanderers,2-2,2,2,1,1,4,0,D
1978-08-22,1978,Wolverhampton Wanderers,Chelsea,0-1,0,1,1,1,1,-1,A
1978-08-23,1978,Leeds United,Manchester United,2-3,2,3,1,1,5,-1,A
1978-08-23,1978,Tottenham Hotspur,Aston Villa,1-4,1,4,1,1,5,-3,A
1978-08-26,1978,Birmingham City,Derby County,1-1,1,1,1,1,2,0,D
1978-08-26,1978,Bristol City,Aston Villa,1-0,1,0,1,1,1,1,H
1978-08-26,1978,Coventry City,Norwich City,4-1,4,1,1,1,5,3,H
1978-08-26,1978,Everton,Arsenal,1-0,1,0,1,1,1,1,H
1978-08-26,1978,Ipswich Town,Manchester United,3-0,3,0,1,1,3,3,H
1978-08-26,1978,Leeds United,Wolverhampton Wanderers,3-0,3,0,1,1,3,3,H
1978-08-26,1978,Manchester City,Liverpool,1-4,1,4,1,1,5,-3,A
1978-08-26,1978,Queens Park Rangers,Nottingham Forest,0-0,0,0,1,1,0,0,D
1978-08-26,1978,Southampton,Middlesbrough,2-1,2,1,1,1,3,1,H
1978-08-26,1978,Tottenham Hotspur,Chelsea,2-2,2,2,1,1,4,0,D
1978-08-26,1978,West Bromwich Albion,Bolton Wanderers,4-0,4,0,1,1,4,4,H
1978-09-02,1978,Arsenal,Queens Park Rangers,5-1,5,1,1,1,6,4,H
1978-09-02,1978,Aston Villa,Southampton,1-1,1,1,1,1,2,0,D
1978-09-02,1978,Bolton Wanderers,Birmingham City,2-2,2,2,1,1,4,0,D
1978-09-02,1978,Chelsea,Leeds United,0-3,0,3,1,1,3,-3,A
1978-09-02,1978,Derby County,Coventry City,0-2,0,2,1,1,2,-2,A
1978-09-02,1978,Liverpool,Tottenham Hotspur,7-0,7,0,1,1,7,7,H
1978-09-02,1978,Manchester United,Everton,1-1,1,1,1,1,2,0,D
1978-09-02,1978,Middlesbrough,Ipswich Town,0-0,0,0,1,1,0,0,D
1978-09-02,1978,Norwich City,Manchester City,1-1,1,1,1,1,2,0,D
1978-09-02,1978,Nottingham Forest,West Bromwich Albion,0-0,0,0,1,1,0,0,D
1978-09-02,1978,Wolverhampton Wanderers,Bristol City,2-0,2,0,1,1,2,2,H
1978-09-09,1978,Birmingham City,Liverpool,0-3,0,3,1,1,3,-3,A
1978-09-09,1978,Bolton Wanderers,Derby County,2-1,2,1,1,1,3,1,H
1978-09-09,1978,Coventry City,Chelsea,3-2,3,2,1,1,5,1,H
1978-09-09,1978,Everton,Middlesbrough,2-0,2,0,1,1,2,2,H
1978-09-09,1978,Ipswich Town,Aston Villa,0-2,0,2,1,1,2,-2,A
1978-09-09,1978,Manchester City,Leeds United,3-0,3,0,1,1,3,3,H
1978-09-09,1978,Nottingham Forest,Arsenal,2-1,2,1,1,1,3,1,H
1978-09-09,1978,Queens Park Rangers,Manchester United,1-1,1,1,1,1,2,0,D
1978-09-09,1978,Southampton,Wolverhampton Wanderers,3-2,3,2,1,1,5,1,H
1978-09-09,1978,Tottenham Hotspur,Bristol City,1-0,1,0,1,1,1,1,H
1978-09-09,1978,West Bromwich Albion,Norwich City,2-2,2,2,1,1,4,0,D
1978-09-16,1978,Arsenal,Bolton Wanderers,1-0,1,0,1,1,1,1,H
1978-09-16,1978,Aston Villa,Everton,1-1,1,1,1,1,2,0,D
1978-09-16,1978,Bristol City,Southampton,3-1,3,1,1,1,4,2,H
1978-09-16,1978,Chelsea,Manchester City,1-4,1,4,1,1,5,-3,A
1978-09-16,1978,Derby County,West Bromwich Albion,3-2,3,2,1,1,5,1,H
1978-09-16,1978,Leeds United,Tottenham Hotspur,1-2,1,2,1,1,3,-1,A
1978-09-16,1978,Liverpool,Coventry City,1-0,1,0,1,1,1,1,H
1978-09-16,1978,Manchester United,Nottingham Forest,1-1,1,1,1,1,2,0,D
1978-09-16,1978,Middlesbrough,Queens Park Rangers,0-2,0,2,1,1,2,-2,A
1978-09-16,1978,Norwich City,Birmingham City,4-0,4,0,1,1,4,4,H
1978-09-16,1978,Wolverhampton Wanderers,Ipswich Town,1-3,1,3,1,1,4,-2,A
1978-09-23,1978,Arsenal,Manchester United,1-1,1,1,1,1,2,0,D
1978-09-23,1978,Birmingham City,Chelsea,1-1,1,1,1,1,2,0,D
1978-09-23,1978,Bolton Wanderers,Norwich City,3-2,3,2,1,1,5,1,H
1978-09-23,1978,Coventry City,Leeds United,0-0,0,0,1,1,0,0,D
1978-09-23,1978,Derby County,Southampton,2-1,2,1,1,1,3,1,H
1978-09-23,1978,Everton,Wolverhampton Wanderers,2-0,2,0,1,1,2,2,H
1978-09-23,1978,Ipswich Town,Bristol City,0-1,0,1,1,1,1,-1,A
1978-09-23,1978,Manchester City,Tottenham Hotspur,2-0,2,0,1,1,2,2,H
1978-09-23,1978,Nottingham Forest,Middlesbrough,2-2,2,2,1,1,4,0,D
1978-09-23,1978,Queens Park Rangers,Aston Villa,1-0,1,0,1,1,1,1,H
1978-09-23,1978,West Bromwich Albion,Liverpool,1-1,1,1,1,1,2,0,D
1978-09-30,1978,Aston Villa,Nottingham Forest,1-2,1,2,1,1,3,-1,A
1978-09-30,1978,Bristol City,Everton,2-2,2,2,1,1,4,0,D
1978-09-30,1978,Chelsea,West Bromwich Albion,1-3,1,3,1,1,4,-2,A
1978-09-30,1978,Leeds United,Birmingham City,3-0,3,0,1,1,3,3,H
1978-09-30,1978,Liverpool,Bolton Wanderers,3-0,3,0,1,1,3,3,H
1978-09-30,1978,Manchester United,Manchester City,1-0,1,0,1,1,1,1,H
1978-09-30,1978,Middlesbrough,Arsenal,2-3,2,3,1,1,5,-1,A
1978-09-30,1978,Norwich City,Derby County,3-0,3,0,1,1,3,3,H
1978-09-30,1978,Southampton,Ipswich Town,1-2,1,2,1,1,3,-1,A
1978-09-30,1978,Tottenham Hotspur,Coventry City,1-1,1,1,1,1,2,0,D
1978-09-30,1978,Wolverhampton Wanderers,Queens Park Rangers,1-0,1,0,1,1,1,1,H
1978-10-07,1978,Arsenal,Aston Villa,1-1,1,1,1,1,2,0,D
1978-10-07,1978,Birmingham City,Manchester City,1-2,1,2,1,1,3,-1,A
1978-10-07,1978,Bolton Wanderers,Leeds United,3-1,3,1,1,1,4,2,H
1978-10-07,1978,Coventry City,Ipswich Town,2-2,2,2,1,1,4,0,D
1978-10-07,1978,Derby County,Chelsea,1-0,1,0,1,1,1,1,H
1978-10-07,1978,Everton,Southampton,0-0,0,0,1,1,0,0,D
1978-10-07,1978,Manchester United,Middlesbrough,3-2,3,2,1,1,5,1,H
1978-10-07,1978,Norwich City,Liverpool,1-4,1,4,1,1,5,-3,A
1978-10-07,1978,Nottingham Forest,Wolverhampton Wanderers,3-1,3,1,1,1,4,2,H
1978-10-07,1978,Queens Park Rangers,Bristol City,1-0,1,0,1,1,1,1,H
1978-10-07,1978,West Bromwich Albion,Tottenham Hotspur,0-1,0,1,1,1,1,-1,A
1978-10-14,1978,Aston Villa,Manchester United,2-2,2,2,1,1,4,0,D
1978-10-14,1978,Bristol City,Nottingham Forest,1-3,1,3,1,1,4,-2,A
1978-10-14,1978,Chelsea,Bolton Wanderers,4-3,4,3,1,1,7,1,H
1978-10-14,1978,Ipswich Town,Everton,0-1,0,1,1,1,1,-1,A
1978-10-14,1978,Leeds United,West Bromwich Albion,1-3,1,3,1,1,4,-2,A
1978-10-14,1978,Liverpool,Derby County,5-0,5,0,1,1,5,5,H
1978-10-14,1978,Manchester City,Coventry City,2-0,2,0,1,1,2,2,H
1978-10-14,1978,Middlesbrough,Norwich City,2-0,2,0,1,1,2,2,H
1978-10-14,1978,Southampton,Queens Park Rangers,1-1,1,1,1,1,2,0,D
1978-10-14,1978,Tottenham Hotspur,Birmingham City,1-0,1,0,1,1,1,1,H
1978-10-14,1978,Wolverhampton Wanderers,Arsenal,1-0,1,0,1,1,1,1,H
1978-10-21,1978,Arsenal,Southampton,1-0,1,0,1,1,1,1,H
1978-10-21,1978,Birmingham City,Aston Villa,0-1,0,1,1,1,1,-1,A
1978-10-21,1978,Bolton Wanderers,Manchester City,2-2,2,2,1,1,4,0,D
1978-10-21,1978,Derby County,Tottenham Hotspur,2-2,2,2,1,1,4,0,D
1978-10-21,1978,Liverpool,Chelsea,2-0,2,0,1,1,2,2,H
1978-10-21,1978,Manchester United,Bristol City,1-3,1,3,1,1,4,-2,A
1978-10-21,1978,Middlesbrough,Wolverhampton Wanderers,2-0,2,0,1,1,2,2,H
1978-10-21,1978,Norwich City,Leeds United,2-2,2,2,1,1,4,0,D
1978-10-21,1978,Nottingham Forest,Ipswich Town,1-0,1,0,1,1,1,1,H
1978-10-21,1978,Queens Park Rangers,Everton,1-1,1,1,1,1,2,0,D
1978-10-21,1978,West Bromwich Albion,Coventry City,7-1,7,1,1,1,8,6,H
1978-10-27,1978,Aston Villa,Middlesbrough,0-2,0,2,1,1,2,-2,A
1978-10-28,1978,Bristol City,Arsenal,1-3,1,3,1,1,4,-2,A
1978-10-28,1978,Chelsea,Norwich City,3-3,3,3,1,1,6,0,D
1978-10-28,1978,Coventry City,Birmingham City,2-1,2,1,1,1,3,1,H
1978-10-28,1978,Everton,Liverpool,1-0,1,0,1,1,1,1,H
1978-10-28,1978,Ipswich Town,Queens Park Rangers,2-1,2,1,1,1,3,1,H
1978-10-28,1978,Leeds United,Derby County,4-0,4,0,1,1,4,4,H
1978-10-28,1978,Manchester City,West Bromwich Albion,2-2,2,2,1,1,4,0,D
1978-10-28,1978,Southampton,Nottingham Forest,0-0,0,0,1,1,0,0,D
1978-10-28,1978,Tottenham Hotspur,Bolton Wanderers,2-0,2,0,1,1,2,2,H
1978-10-28,1978,Wolverhampton Wanderers,Manchester United,2-4,2,4,1,1,6,-2,A
1978-11-04,1978,Arsenal,Ipswich Town,4-1,4,1,1,1,5,3,H
1978-11-04,1978,Aston Villa,Manchester City,1-1,1,1,1,1,2,0,D
1978-11-04,1978,Bolton Wanderers,Coventry City,0-0,0,0,1,1,0,0,D
1978-11-04,1978,Derby County,Wolverhampton Wanderers,4-1,4,1,1,1,5,3,H
1978-11-04,1978,Liverpool,Leeds United,1-1,1,1,1,1,2,0,D
1978-11-04,1978,Manchester United,Southampton,1-1,1,1,1,1,2,0,D
1978-11-04,1978,Middlesbrough,Bristol City,0-0,0,0,1,1,0,0,D
1978-11-04,1978,Norwich City,Tottenham Hotspur,2-2,2,2,1,1,4,0,D
1978-11-04,1978,Nottingham Forest,Everton,0-0,0,0,1,1,0,0,D
1978-11-04,1978,Queens Park Rangers,Chelsea,0-0,0,0,1,1,0,0,D
1978-11-04,1978,West Bromwich Albion,Birmingham City,1-0,1,0,1,1,1,1,H
1978-11-11,1978,Birmingham City,Manchester United,5-1,5,1,1,1,6,4,H
1978-11-11,1978,Bristol City,Bolton Wanderers,4-1,4,1,1,1,5,3,H
1978-11-11,1978,Coventry City,Middlesbrough,2-1,2,1,1,1,3,1,H
1978-11-11,1978,Everton,Chelsea,3-2,3,2,1,1,5,1,H
1978-11-11,1978,Ipswich Town,West Bromwich Albion,0-1,0,1,1,1,1,-1,A
1978-11-11,1978,Leeds United,Arsenal,0-1,0,1,1,1,1,-1,A
1978-11-11,1978,Manchester City,Derby County,1-2,1,2,1,1,3,-1,A
1978-11-11,1978,Queens Park Rangers,Liverpool,1-3,1,3,1,1,4,-2,A
1978-11-11,1978,Southampton,Norwich City,2-2,2,2,1,1,4,0,D
1978-11-11,1978,Tottenham Hotspur,Nottingham Forest,1-3,1,3,1,1,4,-2,A
1978-11-11,1978,Wolverhampton Wanderers,Aston Villa,0-4,0,4,1,1,4,-4,A
1978-11-18,1978,Arsenal,Everton,2-2,2,2,1,1,4,0,D
1978-11-18,1978,Aston Villa,Bristol City,2-0,2,0,1,1,2,2,H
1978-11-18,1978,Bolton Wanderers,West Bromwich Albion,0-1,0,1,1,1,1,-1,A
1978-11-18,1978,Chelsea,Tottenham Hotspur,1-3,1,3,1,1,4,-2,A
1978-11-18,1978,Derby County,Birmingham City,2-1,2,1,1,1,3,1,H
1978-11-18,1978,Liverpool,Manchester City,1-0,1,0,1,1,1,1,H
1978-11-18,1978,Manchester United,Ipswich Town,2-0,2,0,1,1,2,2,H
1978-11-18,1978,Middlesbrough,Southampton,2-0,2,0,1,1,2,2,H
1978-11-18,1978,Norwich City,Coventry City,1-0,1,0,1,1,1,1,H
1978-11-18,1978,Nottingham Forest,Queens Park Rangers,0-0,0,0,1,1,0,0,D
1978-11-18,1978,Wolverhampton Wanderers,Leeds United,1-1,1,1,1,1,2,0,D
1978-11-21,1978,Birmingham City,Bolton Wanderers,3-0,3,0,1,1,3,3,H
1978-11-21,1978,Bristol City,Wolverhampton Wanderers,0-1,0,1,1,1,1,-1,A
1978-11-21,1978,Coventry City,Derby County,4-2,4,2,1,1,6,2,H
1978-11-21,1978,Everton,Manchester United,3-0,3,0,1,1,3,3,H
1978-11-21,1978,Ipswich Town,Middlesbrough,2-1,2,1,1,1,3,1,H
1978-11-21,1978,Southampton,Aston Villa,2-0,2,0,1,1,2,2,H
1978-11-22,1978,Leeds United,Chelsea,2-1,2,1,1,1,3,1,H
1978-11-22,1978,Tottenham Hotspur,Liverpool,0-0,0,0,1,1,0,0,D
1978-11-25,1978,Birmingham City,Bristol City,1-1,1,1,1,1,2,0,D
1978-11-25,1978,Bolton Wanderers,Nottingham Forest,0-1,0,1,1,1,1,-1,A
1978-11-25,1978,Chelsea,Manchester United,0-1,0,1,1,1,1,-1,A
1978-11-25,1978,Coventry City,Arsenal,1-1,1,1,1,1,2,0,D
1978-11-25,1978,Derby County,Queens Park Rangers,2-1,2,1,1,1,3,1,H
1978-11-25,1978,Leeds United,Southampton,4-0,4,0,1,1,4,4,H
1978-11-25,1978,Liverpool,Middlesbrough,2-0,2,0,1,1,2,2,H
1978-11-25,1978,Manchester City,Ipswich Town,1-2,1,2,1,1,3,-1,A
1978-11-25,1978,Norwich City,Everton,0-1,0,1,1,1,1,-1,A
1978-11-25,1978,Tottenham Hotspur,Wolverhampton Wanderers,1-0,1,0,1,1,1,1,H
1978-11-25,1978,West Bromwich Albion,Aston Villa,1-1,1,1,1,1,2,0,D
1978-12-02,1978,Arsenal,Liverpool,1-0,1,0,1,1,1,1,H
1978-12-02,1978,Bristol City,Derby County,1-0,1,0,1,1,1,1,H
1978-12-02,1978,Ipswich Town,Leeds United,2-3,2,3,1,1,5,-1,A
1978-12-02,1978,Queens Park Rangers,Bolton Wanderers,1-3,1,3,1,1,4,-2,A
1978-12-02,1978,Southampton,Birmingham City,1-0,1,0,1,1,1,1,H
1978-12-09,1978,Birmingham City,Everton,1-3,1,3,1,1,4,-2,A
1978-12-09,1978,Bolton Wanderers,Wolverhampton Wanderers,3-1,3,1,1,1,4,2,H
1978-12-09,1978,Chelsea,Aston Villa,0-1,0,1,1,1,1,-1,A
1978-12-09,1978,Coventry City,Queens Park Rangers,1-0,1,0,1,1,1,1,H
1978-12-09,1978,Derby County,Manchester United,1-3,1,3,1,1,4,-2,A
1978-12-09,1978,Leeds United,Bristol City,1-1,1,1,1,1,2,0,D
1978-12-09,1978,Liverpool,Nottingham Forest,2-0,2,0,1,1,2,2,H
1978-12-09,1978,Manchester City,Southampton,1-2,1,2,1,1,3,-1,A
1978-12-09,1978,Norwich City,Arsenal,0-0,0,0,1,1,0,0,D
1978-12-09,1978,Tottenham Hotspur,Ipswich Town,1-0,1,0,1,1,1,1,H
1978-12-09,1978,West Bromwich Albion,Middlesbrough,2-0,2,0,1,1,2,2,H
1978-12-16,1978,Arsenal,Derby County,2-0,2,0,1,1,2,2,H
1978-12-16,1978,Aston Villa,Norwich City,1-1,1,1,1,1,2,0,D
1978-12-16,1978,Bristol City,Liverpool,1-0,1,0,1,1,1,1,H
1978-12-16,1978,Everton,Leeds United,1-1,1,1,1,1,2,0,D
1978-12-16,1978,Ipswich Town,Bolton Wanderers,3-0,3,0,1,1,3,3,H
1978-12-16,1978,Manchester United,Tottenham Hotspur,2-0,2,0,1,1,2,2,H
1978-12-16,1978,Middlesbrough,Chelsea,7-2,7,2,1,1,9,5,H
1978-12-16,1978,Nottingham Forest,Birmingham City,1-0,1,0,1,1,1,1,H
1978-12-16,1978,Queens Park Rangers,Manchester City,2-1,2,1,1,1,3,1,H
1978-12-16,1978,Southampton,Coventry City,4-0,4,0,1,1,4,4,H
1978-12-16,1978,Wolverhampton Wanderers,West Bromwich Albion,0-3,0,3,1,1,3,-3,A
1978-12-22,1978,Bolton Wanderers,Manchester United,3-0,3,0,1,1,3,3,H
1978-12-23,1978,Chelsea,Bristol City,0-0,0,0,1,1,0,0,D
1978-12-23,1978,Coventry City,Everton,3-2,3,2,1,1,5,1,H
1978-12-23,1978,Derby County,Aston Villa,0-0,0,0,1,1,0,0,D
1978-12-23,1978,Leeds United,Middlesbrough,3-1,3,1,1,1,4,2,H
1978-12-23,1978,Manchester City,Nottingham Forest,0-0,0,0,1,1,0,0,D
1978-12-23,1978,Tottenham Hotspur,Arsenal,0-5,0,5,1,1,5,-5,A
1978-12-26,1978,Arsenal,West Bromwich Albion,1-2,1,2,1,1,3,-1,A
1978-12-26,1978,Aston Villa,Leeds United,2-2,2,2,1,1,4,0,D
1978-12-26,1978,Bristol City,Coventry City,5-0,5,0,1,1,5,5,H
1978-12-26,1978,Everton,Manchester City,1-0,1,0,1,1,1,1,H
1978-12-26,1978,Ipswich Town,Norwich City,1-1,1,1,1,1,2,0,D
1978-12-26,1978,Manchester United,Liverpool,0-3,0,3,1,1,3,-3,A
1978-12-26,1978,Middlesbrough,Bolton Wanderers,1-1,1,1,1,1,2,0,D
1978-12-26,1978,Nottingham Forest,Derby County,1-1,1,1,1,1,2,0,D
1978-12-26,1978,Queens Park Rangers,Tottenham Hotspur,2-2,2,2,1,1,4,0,D
1978-12-26,1978,Southampton,Chelsea,0-0,0,0,1,1,0,0,D
1978-12-26,1978,Wolverhampton Wanderers,Birmingham City,2-1,2,1,1,1,3,1,H
1978-12-30,1978,Arsenal,Birmingham City,3-1,3,1,1,1,4,2,H
1978-12-30,1978,Bristol City,Manchester City,1-1,1,1,1,1,2,0,D
1978-12-30,1978,Everton,Tottenham Hotspur,1-1,1,1,1,1,2,0,D
1978-12-30,1978,Ipswich Town,Chelsea,5-1,5,1,1,1,6,4,H
1978-12-30,1978,Manchester United,West Bromwich Albion,3-5,3,5,1,1,8,-2,A
1978-12-30,1978,Queens Park Rangers,Leeds United,1-4,1,4,1,1,5,-3,A
1978-12-30,1978,Wolverhampton Wanderers,Coventry City,1-1,1,1,1,1,2,0,D
1979-01-01,1978,West Bromwich Albion,Bristol City,3-1,3,1,1,1,4,2,H
1979-01-13,1978,Arsenal,Nottingham Forest,2-1,2,1,1,1,3,1,H
1979-01-13,1978,Bristol City,Tottenham Hotspur,0-0,0,0,1,1,0,0,D
1979-01-13,1978,Leeds United,Manchester City,1-1,1,1,1,1,2,0,D
1979-01-13,1978,Norwich City,West Bromwich Albion,1-1,1,1,1,1,2,0,D
1979-01-17,1978,Wolverhampton Wanderers,Southampton,2-0,2,0,1,1,2,2,H
1979-01-20,1978,Ipswich Town,Wolverhampton Wanderers,3-1,3,1,1,1,4,2,H
1979-01-20,1978,Manchester City,Chelsea,2-3,2,3,1,1,5,-1,A
1979-01-20,1978,Queens Park Rangers,Middlesbrough,1-1,1,1,1,1,2,0,D
1979-01-20,1978,Tottenham Hotspur,Leeds United,1-2,1,2,1,1,3,-1,A
1979-01-31,1978,Everton,Aston Villa,1-1,1,1,1,1,2,0,D
1979-01-31,1978,Norwich City,Queens Park Rangers,1-1,1,1,1,1,2,0,D
1979-02-03,1978,Bristol City,Ipswich Town,3-1,3,1,1,1,4,2,H
1979-02-03,1978,Chelsea,Birmingham City,2-1,2,1,1,1,3,1,H
1979-02-03,1978,Leeds United,Coventry City,1-0,1,0,1,1,1,1,H
1979-02-03,1978,Liverpool,West Bromwich Albion,2-1,2,1,1,1,3,1,H
1979-02-03,1978,Manchester United,Arsenal,0-2,0,2,1,1,2,-2,A
1979-02-03,1978,Middlesbrough,Nottingham Forest,1-3,1,3,1,1,4,-2,A
1979-02-03,1978,Norwich City,Bolton Wanderers,0-0,0,0,1,1,0,0,D
1979-02-03,1978,Southampton,Derby County,1-2,1,2,1,1,3,-1,A
1979-02-03,1978,Tottenham Hotspur,Manchester City,0-3,0,3,1,1,3,-3,A
1979-02-03,1978,Wolverhampton Wanderers,Everton,1-0,1,0,1,1,1,1,H
1979-02-10,1978,Arsenal,Middlesbrough,0-0,0,0,1,1,0,0,D
1979-02-10,1978,Birmingham City,Leeds United,0-1,0,1,1,1,1,-1,A
1979-02-10,1978,Coventry City,Tottenham Hotspur,1-3,1,3,1,1,4,-2,A
1979-02-10,1978,Derby County,Norwich City,1-1,1,1,1,1,2,0,D
1979-02-10,1978,Everton,Bristol City,4-1,4,1,1,1,5,3,H
1979-02-10,1978,Ipswich Town,Southampton,0-0,0,0,1,1,0,0,D
1979-02-10,1978,Manchester City,Manchester United,0-3,0,3,1,1,3,-3,A
1979-02-10,1978,Queens Park Rangers,Wolverhampton Wanderers,3-3,3,3,1,1,6,0,D
1979-02-13,1978,Liverpool,Birmingham City,1-0,1,0,1,1,1,1,H
1979-02-13,1978,Queens Park Rangers,Arsenal,1-2,1,2,1,1,3,-1,A
1979-02-17,1978,Southampton,Everton,3-0,3,0,1,1,3,3,H
1979-02-20,1978,Southampton,Bristol City,2-0,2,0,1,1,2,2,H
1979-02-21,1978,Chelsea,Coventry City,1-3,1,3,1,1,4,-2,A
1979-02-21,1978,Liverpool,Norwich City,6-0,6,0,1,1,6,6,H
1979-02-24,1978,Arsenal,Wolverhampton Wanderers,0-1,0,1,1,1,1,-1,A
1979-02-24,1978,Birmingham City,Tottenham Hotspur,1-0,1,0,1,1,1,1,H
1979-02-24,1978,Bolton Wanderers,Chelsea,2-1,2,1,1,1,3,1,H
1979-02-24,1978,Coventry City,Manchester City,0-3,0,3,1,1,3,-3,A
1979-02-24,1978,Derby County,Liverpool,0-2,0,2,1,1,2,-2,A
1979-02-24,1978,Everton,Ipswich Town,0-1,0,1,1,1,1,-1,A
1979-02-24,1978,Manchester United,Aston Villa,1-1,1,1,1,1,2,0,D
1979-02-24,1978,Norwich City,Middlesbrough,1-0,1,0,1,1,1,1,H
1979-02-24,1978,Nottingham Forest,Bristol City,2-0,2,0,1,1,2,2,H
1979-02-24,1978,Queens Park Rangers,Southampton,0-1,0,1,1,1,1,-1,A
1979-02-24,1978,West Bromwich Albion,Leeds United,1-2,1,2,1,1,3,-1,A
1979-02-27,1978,Manchester City,Norwich City,2-2,2,2,1,1,4,0,D
1979-02-28,1978,Derby County,Ipswich Town,0-1,0,1,1,1,1,-1,A
1979-02-28,1978,Manchester United,Queens Park Rangers,2-0,2,0,1,1,2,2,H
1979-03-03,1978,Aston Villa,Birmingham City,1-0,1,0,1,1,1,1,H
1979-03-03,1978,Bristol City,Manchester United,1-2,1,2,1,1,3,-1,A
1979-03-03,1978,Chelsea,Liverpool,0-0,0,0,1,1,0,0,D
1979-03-03,1978,Coventry City,West Bromwich Albion,1-3,1,3,1,1,4,-2,A
1979-03-03,1978,Everton,Queens Park Rangers,2-1,2,1,1,1,3,1,H
1979-03-03,1978,Ipswich Town,Nottingham Forest,1-1,1,1,1,1,2,0,D
1979-03-03,1978,Leeds United,Norwich City,2-2,2,2,1,1,4,0,D
1979-03-03,1978,Manchester City,Bolton Wanderers,2-1,2,1,1,1,3,1,H
1979-03-03,1978,Southampton,Arsenal,2-0,2,0,1,1,2,2,H
1979-03-03,1978,Tottenham Hotspur,Derby County,2-0,2,0,1,1,2,2,H
1979-03-03,1978,Wolverhampton Wanderers,Middlesbrough,1-3,1,3,1,1,4,-2,A
1979-03-06,1978,Birmingham City,Queens Park Rangers,3-1,3,1,1,1,4,2,H
1979-03-06,1978,Coventry City,Liverpool,0-0,0,0,1,1,0,0,D
1979-03-06,1978,Middlesbrough,Everton,1-2,1,2,1,1,3,-1,A
1979-03-07,1978,Aston Villa,Bolton Wanderers,3-0,3,0,1,1,3,3,H
1979-03-07,1978,Norwich City,Wolverhampton Wanderers,0-0,0,0,1,1,0,0,D
1979-03-10,1978,Arsenal,Bristol City,2-0,2,0,1,1,2,2,H
1979-03-10,1978,Birmingham City,Coventry City,0-0,0,0,1,1,0,0,D
1979-03-10,1978,Derby County,Leeds United,0-1,0,1,1,1,1,-1,A
1979-03-10,1978,Everton,Nottingham Forest,1-1,1,1,1,1,2,0,D
1979-03-10,1978,Middlesbrough,Aston Villa,2-0,2,0,1,1,2,2,H
1979-03-10,1978,Norwich City,Chelsea,2-0,2,0,1,1,2,2,H
1979-03-13,1978,Ipswich Town,Coventry City,1-1,1,1,1,1,2,0,D
1979-03-13,1978,Liverpool,Everton,1-1,1,1,1,1,2,0,D
1979-03-13,1978,Middlesbrough,Derby County,3-1,3,1,1,1,4,2,H
1979-03-14,1978,Nottingham Forest,Norwich City,2-1,2,1,1,1,3,1,H
1979-03-14,1978,West Bromwich Albion,Chelsea,1-0,1,0,1,1,1,1,H
1979-03-17,1978,Bristol City,Middlesbrough,1-1,1,1,1,1,2,0,D
1979-03-17,1978,Chelsea,Queens Park Rangers,1-3,1,3,1,1,4,-2,A
1979-03-17,1978,Coventry City,Bolton Wanderers,2-2,2,2,1,1,4,0,D
1979-03-17,1978,Ipswich Town,Arsenal,2-0,2,0,1,1,2,2,H
1979-03-17,1978,Tottenham Hotspur,Norwich City,0-0,0,0,1,1,0,0,D
1979-03-20,1978,Aston Villa,Queens Park Rangers,3-1,3,1,1,1,4,2,H
1979-03-20,1978,Coventry City,Manchester United,4-3,4,3,1,1,7,1,H
1979-03-20,1978,Liverpool,Wolverhampton Wanderers,2-0,2,0,1,1,2,2,H
1979-03-21,1978,Derby County,Bolton Wanderers,3-0,3,0,1,1,3,3,H
1979-03-24,1978,Arsenal,Manchester City,1-1,1,1,1,1,2,0,D
1979-03-24,1978,Aston Villa,Tottenham Hotspur,2-3,2,3,1,1,5,-1,A
1979-03-24,1978,Bolton Wanderers,Southampton,2-0,2,0,1,1,2,2,H
1979-03-24,1978,Chelsea,Wolverhampton Wanderers,1-2,1,2,1,1,3,-1,A
1979-03-24,1978,Derby County,Everton,0-0,0,0,1,1,0,0,D
1979-03-24,1978,Liverpool,Ipswich Town,2-0,2,0,1,1,2,2,H
1979-03-24,1978,Manchester United,Leeds United,4-1,4,1,1,1,5,3,H
1979-03-24,1978,Middlesbrough,Birmingham City,2-1,2,1,1,1,3,1,H
1979-03-24,1978,Norwich City,Bristol City,3-0,3,0,1,1,3,3,H
1979-03-24,1978,Nottingham Forest,Coventry City,3-0,3,0,1,1,3,3,H
1979-03-24,1978,West Bromwich Albion,Queens Park Rangers,2-1,2,1,1,1,3,1,H
1979-03-26,1978,Bolton Wanderers,Arsenal,4-2,4,2,1,1,6,2,H
1979-03-26,1978,West Bromwich Albion,Derby County,2-1,2,1,1,1,3,1,H
1979-03-27,1978,Birmingham City,Norwich City,1-0,1,0,1,1,1,1,H
1979-03-27,1978,Middlesbrough,Manchester United,2-2,2,2,1,1,4,0,D
1979-03-27,1978,Wolverhampton Wanderers,Manchester City,1-1,1,1,1,1,2,0,D
1979-03-28,1978,Aston Villa,Coventry City,1-1,1,1,1,1,2,0,D
1979-03-28,1978,Nottingham Forest,Chelsea,6-0,6,0,1,1,6,6,H
1979-03-28,1978,Tottenham Hotspur,Southampton,0-0,0,0,1,1,0,0,D
1979-03-30,1978,Everton,Norwich City,2-2,2,2,1,1,4,0,D
1979-03-31,1978,Bristol City,Birmingham City,2-1,2,1,1,1,3,1,H
1979-03-31,1978,Ipswich Town,Manchester City,2-1,2,1,1,1,3,1,H
1979-03-31,1978,Middlesbrough,Tottenham Hotspur,1-0,1,0,1,1,1,1,H
1979-03-31,1978,Nottingham Forest,Bolton Wanderers,1-1,1,1,1,1,2,0,D
1979-03-31,1978,Queens Park Rangers,Derby County,2-2,2,2,1,1,4,0,D
1979-03-31,1978,Southampton,Leeds United,2-2,2,2,1,1,4,0,D
1979-04-03,1978,Arsenal,Coventry City,1-1,1,1,1,1,2,0,D
1979-04-03,1978,Birmingham City,Ipswich Town,1-1,1,1,1,1,2,0,D
1979-04-03,1978,Bolton Wanderers,Everton,3-1,3,1,1,1,4,2,H
1979-04-03,1978,Bristol City,Queens Park Rangers,2-0,2,0,1,1,2,2,H
1979-04-03,1978,Wolverhampton Wanderers,Tottenham Hotspur,3-2,3,2,1,1,5,1,H
1979-04-04,1978,Chelsea,Derby County,1-1,1,1,1,1,2,0,D
1979-04-04,1978,Nottingham Forest,Aston Villa,4-0,4,0,1,1,4,4,H
1979-04-04,1978,West Bromwich Albion,Manchester City,4-0,4,0,1,1,4,4,H
1979-04-07,1978,Birmingham City,Southampton,2-2,2,2,1,1,4,0,D
1979-04-07,1978,Bolton Wanderers,Queens Park Rangers,2-1,2,1,1,1,3,1,H
1979-04-07,1978,Chelsea,Nottingham Forest,1-3,1,3,1,1,4,-2,A
1979-04-07,1978,Coventry City,Aston Villa,1-1,1,1,1,1,2,0,D
1979-04-07,1978,Derby County,Bristol City,0-1,0,1,1,1,1,-1,A
1979-04-07,1978,Leeds United,Ipswich Town,1-1,1,1,1,1,2,0,D
1979-04-07,1978,Liverpool,Arsenal,3-0,3,0,1,1,3,3,H
1979-04-07,1978,Manchester City,Wolverhampton Wanderers,3-1,3,1,1,1,4,2,H
1979-04-07,1978,Norwich City,Manchester United,2-2,2,2,1,1,4,0,D
1979-04-07,1978,Tottenham Hotspur,Middlesbrough,1-2,1,2,1,1,3,-1,A
1979-04-07,1978,West Bromwich Albion,Everton,1-0,1,0,1,1,1,1,H
1979-04-10,1978,Arsenal,Tottenham Hotspur,1-0,1,0,1,1,1,1,H
1979-04-10,1978,Bristol City,Chelsea,3-1,3,1,1,1,4,2,H
1979-04-10,1978,Everton,Coventry City,3-3,3,3,1,1,6,0,D
1979-04-10,1978,Middlesbrough,Leeds United,1-0,1,0,1,1,1,1,H
1979-04-10,1978,Wolverhampton Wanderers,Liverpool,0-1,0,1,1,1,1,-1,A
1979-04-11,1978,Aston Villa,Derby County,3-3,3,3,1,1,6,0,D
1979-04-11,1978,Manchester United,Bolton Wanderers,1-2,1,2,1,1,3,-1,A
1979-04-13,1978,Queens Park Rangers,Norwich City,0-0,0,0,1,1,0,0,D
1979-04-13,1978,Southampton,West Bromwich Albion,1-1,1,1,1,1,2,0,D
1979-04-14,1978,Birmingham City,Wolverhampton Wanderers,1-1,1,1,1,1,2,0,D
1979-04-14,1978,Bolton Wanderers,Middlesbrough,0-0,0,0,1,1,0,0,D
1979-04-14,1978,Chelsea,Southampton,1-2,1,2,1,1,3,-1,A
1979-04-14,1978,Coventry City,Bristol City,3-2,3,2,1,1,5,1,H
1979-04-14,1978,Derby County,Nottingham Forest,1-2,1,2,1,1,3,-1,A
1979-04-14,1978,Leeds United,Aston Villa,1-0,1,0,1,1,1,1,H
1979-04-14,1978,Liverpool,Manchester United,2-0,2,0,1,1,2,2,H
1979-04-14,1978,Manchester City,Everton,0-0,0,0,1,1,0,0,D
1979-04-14,1978,Norwich City,Ipswich Town,0-1,0,1,1,1,1,-1,A
1979-04-14,1978,Tottenham Hotspur,Queens Park Rangers,1-1,1,1,1,1,2,0,D
1979-04-14,1978,West Bromwich Albion,Arsenal,1-1,1,1,1,1,2,0,D
1979-04-16,1978,Arsenal,Chelsea,5-2,5,2,1,1,7,3,H
1979-04-16,1978,Aston Villa,Liverpool,3-1,3,1,1,1,4,2,H
1979-04-16,1978,Everton,Bolton Wanderers,1-0,1,0,1,1,1,1,H
1979-04-16,1978,Ipswich Town,Derby County,2-1,2,1,1,1,3,1,H
1979-04-16,1978,Manchester United,Coventry City,0-0,0,0,1,1,0,0,D
1979-04-16,1978,Nottingham Forest,Leeds United,0-0,0,0,1,1,0,0,D
1979-04-16,1978,Southampton,Tottenham Hotspur,3-3,3,3,1,1,6,0,D
1979-04-16,1978,Wolverhampton Wanderers,Norwich City,1-0,1,0,1,1,1,1,H
1979-04-17,1978,Bristol City,West Bromwich Albion,1-0,1,0,1,1,1,1,H
1979-04-17,1978,Ipswich Town,Birmingham City,3-0,3,0,1,1,3,3,H
1979-04-17,1978,Middlesbrough,Manchester City,2-0,2,0,1,1,2,2,H
1979-04-18,1978,Nottingham Forest,Manchester United,1-1,1,1,1,1,2,0,D
1979-04-21,1978,Birmingham City,Nottingham Forest,0-2,0,2,1,1,2,-2,A
1979-04-21,1978,Bolton Wanderers,Ipswich Town,2-3,2,3,1,1,5,-1,A
1979-04-21,1978,Chelsea,Middlesbrough,2-1,2,1,1,1,3,1,H
1979-04-21,1978,Coventry City,Southampton,4-0,4,0,1,1,4,4,H
1979-04-21,1978,Derby County,Arsenal,2-0,2,0,1,1,2,2,H
1979-04-21,1978,Leeds United,Everton,1-0,1,0,1,1,1,1,H
1979-04-21,1978,Liverpool,Bristol City,1-0,1,0,1,1,1,1,H
1979-04-21,1978,Manchester City,Queens Park Rangers,3-1,3,1,1,1,4,2,H
1979-04-21,1978,Norwich City,Aston Villa,1-2,1,2,1,1,3,-1,A
1979-04-21,1978,Tottenham Hotspur,Manchester United,1-1,1,1,1,1,2,0,D
1979-04-21,1978,West Bromwich Albion,Wolverhampton Wanderers,1-1,1,1,1,1,2,0,D
1979-04-24,1978,Birmingham City,West Bromwich Albion,1-1,1,1,1,1,2,0,D
1979-04-24,1978,Manchester City,Middlesbrough,1-0,1,0,1,1,1,1,H
1979-04-24,1978,Southampton,Liverpool,1-1,1,1,1,1,2,0,D
1979-04-24,1978,Wolverhampton Wanderers,Derby County,4-0,4,0,1,1,4,4,H
1979-04-25,1978,Aston Villa,Arsenal,5-1,5,1,1,1,6,4,H
1979-04-25,1978,Leeds United,Bolton Wanderers,5-1,5,1,1,1,6,4,H
1979-04-25,1978,Manchester United,Norwich City,1-0,1,0,1,1,1,1,H
1979-04-28,1978,Arsenal,Norwich City,1-1,1,1,1,1,2,0,D
1979-04-28,1978,Aston Villa,Chelsea,2-1,2,1,1,1,3,1,H
1979-04-28,1978,Bristol City,Leeds United,0-0,0,0,1,1,0,0,D
1979-04-28,1978,Everton,Birmingham City,1-0,1,0,1,1,1,1,H
1979-04-28,1978,Ipswich Town,Tottenham Hotspur,2-1,2,1,1,1,3,1,H
1979-04-28,1978,Manchester United,Derby County,0-0,0,0,1,1,0,0,D
1979-04-28,1978,Middlesbrough,West Bromwich Albion,1-1,1,1,1,1,2,0,D
1979-04-28,1978,Nottingham Forest,Liverpool,0-0,0,0,1,1,0,0,D
1979-04-28,1978,Queens Park Rangers,Coventry City,5-1,5,1,1,1,6,4,H
1979-04-28,1978,Southampton,Manchester City,1-0,1,0,1,1,1,1,H
1979-04-28,1978,Wolverhampton Wanderers,Bolton Wanderers,1-1,1,1,1,1,2,0,D
1979-04-30,1978,Southampton,Manchester United,1-1,1,1,1,1,2,0,D
1979-04-30,1978,Wolverhampton Wanderers,Nottingham Forest,1-0,1,0,1,1,1,1,H
1979-05-01,1978,Bolton Wanderers,Liverpool,1-4,1,4,1,1,5,-3,A
1979-05-01,1978,Everton,West Bromwich Albion,0-2,0,2,1,1,2,-2,A
1979-05-01,1978,Manchester City,Birmingham City,3-1,3,1,1,1,4,2,H
1979-05-02,1978,Aston Villa,Ipswich Town,2-2,2,2,1,1,4,0,D
1979-05-02,1978,Nottingham Forest,Southampton,1-0,1,0,1,1,1,1,H
1979-05-04,1978,Leeds United,Queens Park Rangers,4-3,4,3,1,1,7,1,H
1979-05-05,1978,Birmingham City,Arsenal,0-0,0,0,1,1,0,0,D
1979-05-05,1978,Bolton Wanderers,Aston Villa,0-0,0,0,1,1,0,0,D
1979-05-05,1978,Chelsea,Ipswich Town,2-3,2,3,1,1,5,-1,A
1979-05-05,1978,Coventry City,Wolverhampton Wanderers,3-0,3,0,1,1,3,3,H
1979-05-05,1978,Derby County,Middlesbrough,0-3,0,3,1,1,3,-3,A
1979-05-05,1978,Liverpool,Southampton,2-0,2,0,1,1,2,2,H
1979-05-05,1978,Manchester City,Bristol City,2-0,2,0,1,1,2,2,H
1979-05-05,1978,Norwich City,Nottingham Forest,1-1,1,1,1,1,2,0,D
1979-05-05,1978,Tottenham Hotspur,Everton,1-1,1,1,1,1,2,0,D
1979-05-05,1978,West Bromwich Albion,Manchester United,1-0,1,0,1,1,1,1,H
1979-05-07,1978,Manchester United,Wolverhampton Wanderers,3-2,3,2,1,1,5,1,H
1979-05-07,1978,Queens Park Rangers,Birmingham City,1-3,1,3,1,1,4,-2,A
1979-05-08,1978,Bolton Wanderers,Tottenham Hotspur,1-3,1,3,1,1,4,-2,A
1979-05-08,1978,Liverpool,Aston Villa,3-0,3,0,1,1,3,3,H
1979-05-08,1978,West Bromwich Albion,Southampton,1-0,1,0,1,1,1,1,H
1979-05-09,1978,Nottingham Forest,Manchester City,3-1,3,1,1,1,4,2,H
1979-05-11,1978,Aston Villa,West Bromwich Albion,0-1,0,1,1,1,1,-1,A
1979-05-11,1978,Middlesbrough,Liverpool,0-1,0,1,1,1,1,-1,A
1979-05-11,1978,Queens Park Rangers,Ipswich Town,0-4,0,4,1,1,4,-4,A
1979-05-14,1978,Chelsea,Arsenal,1-1,1,1,1,1,2,0,D
1979-05-14,1978,Tottenham Hotspur,West Bromwich Albion,1-0,1,0,1,1,1,1,H
1979-05-15,1978,Leeds United,Nottingham Forest,1-2,1,2,1,1,3,-1,A
1979-05-15,1978,Manchester City,Aston Villa,2-3,2,3,1,1,5,-1,A
1979-05-16,1978,Manchester United,Chelsea,1-1,1,1,1,1,2,0,D
1979-05-17,1978,Leeds United,Liverpool,0-3,0,3,1,1,3,-3,A
1979-05-18,1978,West Bromwich Albion,Nottingham Forest,0-1,0,1,1,1,1,-1,A
1979-08-18,1979,Bolton Wanderers,Aston Villa,1-1,1,1,1,1,2,0,D
1979-08-18,1979,Brighton & Hove Albion,Arsenal,0-4,0,4,1,1,4,-4,A
1979-08-18,1979,Bristol City,Leeds United,2-2,2,2,1,1,4,0,D
1979-08-18,1979,Everton,Norwich City,2-4,2,4,1,1,6,-2,A
1979-08-18,1979,Ipswich Town,Nottingham Forest,0-1,0,1,1,1,1,-1,A
1979-08-18,1979,Manchester City,Crystal Palace,0-0,0,0,1,1,0,0,D
1979-08-18,1979,Southampton,Manchester United,1-1,1,1,1,1,2,0,D
1979-08-18,1979,Stoke City,Coventry City,3-2,3,2,1,1,5,1,H
1979-08-18,1979,Tottenham Hotspur,Middlesbrough,1-3,1,3,1,1,4,-2,A
1979-08-18,1979,West Bromwich Albion,Derby County,0-0,0,0,1,1,0,0,D
1979-08-21,1979,Arsenal,Ipswich Town,0-2,0,2,1,1,2,-2,A
1979-08-21,1979,Coventry City,Bristol City,3-1,3,1,1,1,4,2,H
1979-08-21,1979,Crystal Palace,Southampton,0-0,0,0,1,1,0,0,D
1979-08-21,1979,Liverpool,Bolton Wanderers,0-0,0,0,1,1,0,0,D
1979-08-21,1979,Middlesbrough,Manchester City,3-0,3,0,1,1,3,3,H
1979-08-22,1979,Aston Villa,Brighton & Hove Albion,2-1,2,1,1,1,3,1,H
1979-08-22,1979,Derby County,Wolverhampton Wanderers,0-1,0,1,1,1,1,-1,A
1979-08-22,1979,Leeds United,Everton,2-0,2,0,1,1,2,2,H
1979-08-22,1979,Manchester United,West Bromwich Albion,2-0,2,0,1,1,2,2,H
1979-08-22,1979,Norwich City,Tottenham Hotspur,4-0,4,0,1,1,4,4,H
1979-08-22,1979,Nottingham Forest,Stoke City,1-0,1,0,1,1,1,1,H
1979-08-25,1979,Arsenal,Manchester United,0-0,0,0,1,1,0,0,D
1979-08-25,1979,Aston Villa,Bristol City,0-2,0,2,1,1,2,-2,A
1979-08-25,1979,Bolton Wanderers,Southampton,2-1,2,1,1,1,3,1,H
1979-08-25,1979,Derby County,Everton,0-1,0,1,1,1,1,-1,A
1979-08-25,1979,Liverpool,West Bromwich Albion,3-1,3,1,1,1,4,2,H
1979-08-25,1979,Manchester City,Brighton & Hove Albion,3-2,3,2,1,1,5,1,H
1979-08-25,1979,Middlesbrough,Crystal Palace,1-1,1,1,1,1,2,0,D
1979-08-25,1979,Norwich City,Leeds United,2-1,2,1,1,1,3,1,H
1979-08-25,1979,Nottingham Forest,Coventry City,4-1,4,1,1,1,5,3,H
1979-08-25,1979,Stoke City,Tottenham Hotspur,3-1,3,1,1,1,4,2,H
1979-08-25,1979,Wolverhampton Wanderers,Ipswich Town,3-0,3,0,1,1,3,3,H
1979-09-01,1979,Brighton & Hove Albion,Bolton Wanderers,3-1,3,1,1,1,4,2,H
1979-09-01,1979,Bristol City,Wolverhampton Wanderers,2-0,2,0,1,1,2,2,H
1979-09-01,1979,Coventry City,Norwich City,2-0,2,0,1,1,2,2,H
1979-09-01,1979,Crystal Palace,Derby County,4-0,4,0,1,1,4,4,H
1979-09-01,1979,Everton,Aston Villa,1-1,1,1,1,1,2,0,D
1979-09-01,1979,Ipswich Town,Stoke City,3-1,3,1,1,1,4,2,H
1979-09-01,1979,Leeds United,Arsenal,1-1,1,1,1,1,2,0,D
1979-09-01,1979,Manchester United,Middlesbrough,2-1,2,1,1,1,3,1,H
1979-09-01,1979,Southampton,Liverpool,3-2,3,2,1,1,5,1,H
1979-09-01,1979,Tottenham Hotspur,Manchester City,2-1,2,1,1,1,3,1,H
1979-09-01,1979,West Bromwich Albion,Nottingham Forest,1-5,1,5,1,1,6,-4,A
1979-09-08,1979,Aston Villa,Manchester United,0-3,0,3,1,1,3,-3,A
1979-09-08,1979,Bolton Wanderers,West Bromwich Albion,0-0,0,0,1,1,0,0,D
1979-09-08,1979,Derby County,Arsenal,3-2,3,2,1,1,5,1,H
1979-09-08,1979,Ipswich Town,Bristol City,1-0,1,0,1,1,1,1,H
1979-09-08,1979,Liverpool,Coventry City,4-0,4,0,1,1,4,4,H
1979-09-08,1979,Manchester City,Southampton,0-1,0,1,1,1,1,-1,A
1979-09-08,1979,Middlesbrough,Norwich City,1-0,1,0,1,1,1,1,H
1979-09-08,1979,Nottingham Forest,Leeds United,0-0,0,0,1,1,0,0,D
1979-09-08,1979,Stoke City,Everton,2-3,2,3,1,1,5,-1,A
1979-09-08,1979,Tottenham Hotspur,Brighton & Hove Albion,2-1,2,1,1,1,3,1,H
1979-09-08,1979,Wolverhampton Wanderers,Crystal Palace,1-1,1,1,1,1,2,0,D
1979-09-15,1979,Arsenal,Middlesbrough,2-0,2,0,1,1,2,2,H
1979-09-15,1979,Brighton & Hove Albion,Ipswich Town,2-0,2,0,1,1,2,2,H
1979-09-15,1979,Bristol City,Stoke City,0-0,0,0,1,1,0,0,D
1979-09-15,1979,Coventry City,Bolton Wanderers,3-1,3,1,1,1,4,2,H
1979-09-15,1979,Crystal Palace,Aston Villa,2-0,2,0,1,1,2,2,H
1979-09-15,1979,Everton,Wolverhampton Wanderers,2-3,2,3,1,1,5,-1,A
1979-09-15,1979,Leeds United,Liverpool,1-1,1,1,1,1,2,0,D
1979-09-15,1979,Manchester United,Derby County,1-0,1,0,1,1,1,1,H
1979-09-15,1979,Norwich City,Nottingham Forest,3-1,3,1,1,1,4,2,H
1979-09-15,1979,Southampton,Tottenham Hotspur,5-2,5,2,1,1,7,3,H
1979-09-15,1979,West Bromwich Albion,Manchester City,4-0,4,0,1,1,4,4,H
1979-09-22,1979,Aston Villa,Arsenal,0-0,0,0,1,1,0,0,D
1979-09-22,1979,Bolton Wanderers,Leeds United,1-1,1,1,1,1,2,0,D
1979-09-22,1979,Brighton & Hove Albion,Southampton,0-0,0,0,1,1,0,0,D
1979-09-22,1979,Bristol City,Nottingham Forest,1-1,1,1,1,1,2,0,D
1979-09-22,1979,Derby County,Middlesbrough,1-0,1,0,1,1,1,1,H
1979-09-22,1979,Ipswich Town,Everton,1-1,1,1,1,1,2,0,D
1979-09-22,1979,Liverpool,Norwich City,0-0,0,0,1,1,0,0,D
1979-09-22,1979,Manchester City,Coventry City,3-0,3,0,1,1,3,3,H
1979-09-22,1979,Stoke City,Crystal Palace,1-2,1,2,1,1,3,-1,A
1979-09-22,1979,Tottenham Hotspur,West Bromwich Albion,1-1,1,1,1,1,2,0,D
1979-09-22,1979,Wolverhampton Wanderers,Manchester United,3-1,3,1,1,1,4,2,H
1979-09-29,1979,Arsenal,Wolverhampton Wanderers,2-3,2,3,1,1,5,-1,A
1979-09-29,1979,Coventry City,Tottenham Hotspur,1-1,1,1,1,1,2,0,D
1979-09-29,1979,Crystal Palace,Ipswich Town,4-1,4,1,1,1,5,3,H
1979-09-29,1979,Everton,Bristol City,0-0,0,0,1,1,0,0,D
1979-09-29,1979,Leeds United,Manchester City,1-2,1,2,1,1,3,-1,A
1979-09-29,1979,Manchester United,Stoke City,4-0,4,0,1,1,4,4,H
1979-09-29,1979,Middlesbrough,Aston Villa,0-0,0,0,1,1,0,0,D
1979-09-29,1979,Norwich City,Bolton Wanderers,2-1,2,1,1,1,3,1,H
1979-09-29,1979,Nottingham Forest,Liverpool,1-0,1,0,1,1,1,1,H
1979-09-29,1979,Southampton,Derby County,4-0,4,0,1,1,4,4,H
1979-09-29,1979,West Bromwich Albion,Brighton & Hove Albion,2-2,2,2,1,1,4,0,D
1979-10-06,1979,Arsenal,Manchester City,0-0,0,0,1,1,0,0,D
1979-10-06,1979,Aston Villa,Southampton,3-0,3,0,1,1,3,3,H
1979-10-06,1979,Coventry City,Everton,2-1,2,1,1,1,3,1,H
1979-10-06,1979,Crystal Palace,Tottenham Hotspur,1-1,1,1,1,1,2,0,D
1979-10-06,1979,Derby County,Bolton Wanderers,4-0,4,0,1,1,4,4,H
1979-10-06,1979,Leeds United,Ipswich Town,2-1,2,1,1,1,3,1,H
1979-10-06,1979,Liverpool,Bristol City,4-0,4,0,1,1,4,4,H
1979-10-06,1979,Manchester United,Brighton & Hove Albion,2-0,2,0,1,1,2,2,H
1979-10-06,1979,Middlesbrough,West Bromwich Albion,2-1,2,1,1,1,3,1,H
1979-10-06,1979,Norwich City,Stoke City,2-2,2,2,1,1,4,0,D
1979-10-06,1979,Nottingham Forest,Wolverhampton Wanderers,3-2,3,2,1,1,5,1,H
1979-10-09,1979,Bolton Wanderers,Liverpool,1-1,1,1,1,1,2,0,D
1979-10-09,1979,Bristol City,Coventry City,1-0,1,0,1,1,1,1,H
1979-10-09,1979,Ipswich Town,Arsenal,1-2,1,2,1,1,3,-1,A
1979-10-09,1979,Southampton,Crystal Palace,4-1,4,1,1,1,5,3,H
1979-10-09,1979,Wolverhampton Wanderers,Derby County,0-0,0,0,1,1,0,0,D
1979-10-10,1979,Manchester City,Middlesbrough,1-0,1,0,1,1,1,1,H
1979-10-10,1979,Stoke City,Nottingham Forest,1-1,1,1,1,1,2,0,D
1979-10-10,1979,Tottenham Hotspur,Norwich City,3-2,3,2,1,1,5,1,H
1979-10-10,1979,West Bromwich Albion,Manchester United,2-0,2,0,1,1,2,2,H
1979-10-13,1979,Aston Villa,West Bromwich Albion,0-0,0,0,1,1,0,0,D
1979-10-13,1979,Bolton Wanderers,Arsenal,0-0,0,0,1,1,0,0,D
1979-10-13,1979,Brighton & Hove Albion,Leeds United,0-0,0,0,1,1,0,0,D
1979-10-13,1979,Bristol City,Manchester United,1-1,1,1,1,1,2,0,D
1979-10-13,1979,Everton,Crystal Palace,3-1,3,1,1,1,4,2,H
1979-10-13,1979,Ipswich Town,Liverpool,1-2,1,2,1,1,3,-1,A
1979-10-13,1979,Manchester City,Nottingham Forest,1-0,1,0,1,1,1,1,H
1979-10-13,1979,Southampton,Coventry City,2-3,2,3,1,1,5,-1,A
1979-10-13,1979,Stoke City,Middlesbrough,0-0,0,0,1,1,0,0,D
1979-10-13,1979,Tottenham Hotspur,Derby County,1-0,1,0,1,1,1,1,H
1979-10-13,1979,Wolverhampton Wanderers,Norwich City,1-0,1,0,1,1,1,1,H
1979-10-20,1979,Arsenal,Stoke City,0-0,0,0,1,1,0,0,D
1979-10-20,1979,Coventry City,Brighton & Hove Albion,2-1,2,1,1,1,3,1,H
1979-10-20,1979,Crystal Palace,Bristol City,1-1,1,1,1,1,2,0,D
1979-10-20,1979,Derby County,Aston Villa,1-3,1,3,1,1,4,-2,A
1979-10-20,1979,Leeds United,Tottenham Hotspur,1-2,1,2,1,1,3,-1,A
1979-10-20,1979,Liverpool,Everton,2-2,2,2,1,1,4,0,D
1979-10-20,1979,Manchester United,Ipswich Town,1-0,1,0,1,1,1,1,H
1979-10-20,1979,Middlesbrough,Wolverhampton Wanderers,1-0,1,0,1,1,1,1,H
1979-10-20,1979,Norwich City,Manchester City,2-2,2,2,1,1,4,0,D
1979-10-20,1979,Nottingham Forest,Bolton Wanderers,5-2,5,2,1,1,7,3,H
1979-10-20,1979,West Bromwich Albion,Southampton,4-0,4,0,1,1,4,4,H
1979-10-27,1979,Bolton Wanderers,Crystal Palace,1-1,1,1,1,1,2,0,D
1979-10-27,1979,Brighton & Hove Albion,Norwich City,2-4,2,4,1,1,6,-2,A
1979-10-27,1979,Bristol City,Arsenal,0-1,0,1,1,1,1,-1,A
1979-10-27,1979,Everton,Manchester United,0-0,0,0,1,1,0,0,D
1979-10-27,1979,Ipswich Town,Middlesbrough,1-0,1,0,1,1,1,1,H
1979-10-27,1979,Manchester City,Liverpool,0-4,0,4,1,1,4,-4,A
1979-10-27,1979,Southampton,Leeds United,1-2,1,2,1,1,3,-1,A
1979-10-27,1979,Stoke City,Derby County,3-2,3,2,1,1,5,1,H
1979-10-27,1979,Tottenham Hotspur,Nottingham Forest,1-0,1,0,1,1,1,1,H
1979-10-27,1979,West Bromwich Albion,Coventry City,4-1,4,1,1,1,5,3,H
1979-10-27,1979,Wolverhampton Wanderers,Aston Villa,1-1,1,1,1,1,2,0,D
1979-11-03,1979,Arsenal,Brighton & Hove Albion,3-0,3,0,1,1,3,3,H
1979-11-03,1979,Aston Villa,Bolton Wanderers,3-1,3,1,1,1,4,2,H
1979-11-03,1979,Coventry City,Stoke City,1-3,1,3,1,1,4,-2,A
1979-11-03,1979,Crystal Palace,Manchester City,2-0,2,0,1,1,2,2,H
1979-11-03,1979,Derby County,West Bromwich Albion,2-1,2,1,1,1,3,1,H
1979-11-03,1979,Leeds United,Bristol City,1-3,1,3,1,1,4,-2,A
1979-11-03,1979,Liverpool,Wolverhampton Wanderers,3-0,3,0,1,1,3,3,H
1979-11-03,1979,Manchester United,Southampton,1-0,1,0,1,1,1,1,H
1979-11-03,1979,Middlesbrough,Tottenham Hotspur,0-0,0,0,1,1,0,0,D
1979-11-03,1979,Norwich City,Everton,0-0,0,0,1,1,0,0,D
1979-11-03,1979,Nottingham Forest,Ipswich Town,2-0,2,0,1,1,2,2,H
1979-11-10,1979,Brighton & Hove Albion,Liverpool,1-4,1,4,1,1,5,-3,A
1979-11-10,1979,Bristol City,Derby County,0-2,0,2,1,1,2,-2,A
1979-11-10,1979,Coventry City,Leeds United,3-0,3,0,1,1,3,3,H
1979-11-10,1979,Crystal Palace,Arsenal,1-0,1,0,1,1,1,1,H
1979-11-10,1979,Everton,Middlesbrough,0-2,0,2,1,1,2,-2,A
1979-11-10,1979,Ipswich Town,Aston Villa,0-0,0,0,1,1,0,0,D
1979-11-10,1979,Manchester City,Manchester United,2-0,2,0,1,1,2,2,H
1979-11-10,1979,Southampton,Nottingham Forest,4-1,4,1,1,1,5,3,H
1979-11-10,1979,Stoke City,Wolverhampton Wanderers,0-1,0,1,1,1,1,-1,A
1979-11-10,1979,Tottenham Hotspur,Bolton Wanderers,2-0,2,0,1,1,2,2,H
1979-11-10,1979,West Bromwich Albion,Norwich City,2-1,2,1,1,1,3,1,H
1979-11-13,1979,Everton,Leeds United,5-1,5,1,1,1,6,4,H
1979-11-17,1979,Arsenal,Everton,2-0,2,0,1,1,2,2,H
1979-11-17,1979,Aston Villa,Stoke City,2-1,2,1,1,1,3,1,H
1979-11-17,1979,Bolton Wanderers,Manchester City,0-1,0,1,1,1,1,-1,A
1979-11-17,1979,Derby County,Ipswich Town,0-1,0,1,1,1,1,-1,A
1979-11-17,1979,Leeds United,West Bromwich Albion,1-0,1,0,1,1,1,1,H
1979-11-17,1979,Liverpool,Tottenham Hotspur,2-1,2,1,1,1,3,1,H
1979-11-17,1979,Manchester United,Crystal Palace,1-1,1,1,1,1,2,0,D
1979-11-17,1979,Middlesbrough,Bristol City,1-0,1,0,1,1,1,1,H
1979-11-17,1979,Norwich City,Southampton,2-1,2,1,1,1,3,1,H
1979-11-17,1979,Nottingham Forest,Brighton & Hove Albion,0-1,0,1,1,1,1,-1,A
1979-11-17,1979,Wolverhampton Wanderers,Coventry City,0-3,0,3,1,1,3,-3,A
1979-11-24,1979,Arsenal,Liverpool,0-0,0,0,1,1,0,0,D
1979-11-24,1979,Aston Villa,Leeds United,0-0,0,0,1,1,0,0,D
1979-11-24,1979,Bristol City,Manchester City,1-0,1,0,1,1,1,1,H
1979-11-24,1979,Crystal Palace,Coventry City,0-0,0,0,1,1,0,0,D
1979-11-24,1979,Derby County,Nottingham Forest,4-1,4,1,1,1,5,3,H
1979-11-24,1979,Everton,Tottenham Hotspur,1-1,1,1,1,1,2,0,D
1979-11-24,1979,Ipswich Town,Southampton,3-1,3,1,1,1,4,2,H
1979-11-24,1979,Manchester United,Norwich City,5-0,5,0,1,1,5,5,H
1979-11-24,1979,Middlesbrough,Brighton & Hove Albion,1-1,1,1,1,1,2,0,D
1979-11-24,1979,Stoke City,Bolton Wanderers,1-0,1,0,1,1,1,1,H
1979-11-24,1979,Wolverhampton Wanderers,West Bromwich Albion,0-0,0,0,1,1,0,0,D
1979-12-01,1979,Bolton Wanderers,Bristol City,1-1,1,1,1,1,2,0,D
1979-12-01,1979,Brighton & Hove Albion,Derby County,2-0,2,0,1,1,2,2,H
1979-12-01,1979,Coventry City,Ipswich Town,4-1,4,1,1,1,5,3,H
1979-12-01,1979,Leeds United,Crystal Palace,1-0,1,0,1,1,1,1,H
1979-12-01,1979,Liverpool,Middlesbrough,4-0,4,0,1,1,4,4,H
1979-12-01,1979,Manchester City,Wolverhampton Wanderers,2-3,2,3,1,1,5,-1,A
1979-12-01,1979,Norwich City,Aston Villa,1-1,1,1,1,1,2,0,D
1979-12-01,1979,Nottingham Forest,Arsenal,1-1,1,1,1,1,2,0,D
1979-12-01,1979,Southampton,Stoke City,3-1,3,1,1,1,4,2,H
1979-12-01,1979,Tottenham Hotspur,Manchester United,1-2,1,2,1,1,3,-1,A
1979-12-01,1979,West Bromwich Albion,Everton,1-1,1,1,1,1,2,0,D
1979-12-08,1979,Arsenal,Coventry City,3-1,3,1,1,1,4,2,H
1979-12-08,1979,Aston Villa,Liverpool,1-3,1,3,1,1,4,-2,A
1979-12-08,1979,Bristol City,Tottenham Hotspur,1-3,1,3,1,1,4,-2,A
1979-12-08,1979,Crystal Palace,Nottingham Forest,1-0,1,0,1,1,1,1,H
1979-12-08,1979,Derby County,Norwich City,0-0,0,0,1,1,0,0,D
1979-12-08,1979,Everton,Brighton & Hove Albion,2-0,2,0,1,1,2,2,H
1979-12-08,1979,Ipswich Town,Manchester City,4-0,4,0,1,1,4,4,H
1979-12-08,1979,Manchester United,Leeds United,1-1,1,1,1,1,2,0,D
1979-12-08,1979,Middlesbrough,Southampton,0-1,0,1,1,1,1,-1,A
1979-12-08,1979,Stoke City,West Bromwich Albion,3-2,3,2,1,1,5,1,H
1979-12-08,1979,Wolverhampton Wanderers,Bolton Wanderers,3-1,3,1,1,1,4,2,H
1979-12-15,1979,Bolton Wanderers,Ipswich Town,0-1,0,1,1,1,1,-1,A
1979-12-15,1979,Brighton & Hove Albion,Stoke City,0-0,0,0,1,1,0,0,D
1979-12-15,1979,Coventry City,Manchester United,1-2,1,2,1,1,3,-1,A
1979-12-15,1979,Leeds United,Wolverhampton Wanderers,3-0,3,0,1,1,3,3,H
1979-12-15,1979,Liverpool,Crystal Palace,3-0,3,0,1,1,3,3,H
1979-12-15,1979,Manchester City,Derby County,3-0,3,0,1,1,3,3,H
1979-12-15,1979,Norwich City,Bristol City,2-0,2,0,1,1,2,2,H
1979-12-15,1979,Southampton,Everton,1-0,1,0,1,1,1,1,H
1979-12-15,1979,Tottenham Hotspur,Aston Villa,1-2,1,2,1,1,3,-1,A
1979-12-15,1979,West Bromwich Albion,Arsenal,2-2,2,2,1,1,4,0,D
1979-12-19,1979,Aston Villa,Coventry City,3-0,3,0,1,1,3,3,H
1979-12-21,1979,Arsenal,Norwich City,1-1,1,1,1,1,2,0,D
1979-12-21,1979,Bristol City,Southampton,0-1,0,1,1,1,1,-1,A
1979-12-21,1979,Ipswich Town,Tottenham Hotspur,3-1,3,1,1,1,4,2,H
1979-12-21,1979,Middlesbrough,Bolton Wanderers,3-1,3,1,1,1,4,2,H
1979-12-21,1979,Stoke City,Leeds United,0-2,0,2,1,1,2,-2,A
1979-12-21,1979,Wolverhampton Wanderers,Brighton & Hove Albion,1-3,1,3,1,1,4,-2,A
1979-12-22,1979,Derby County,Liverpool,1-3,1,3,1,1,4,-2,A
1979-12-22,1979,Everton,Manchester City,1-2,1,2,1,1,3,-1,A
1979-12-22,1979,Manchester United,Nottingham Forest,3-0,3,0,1,1,3,3,H
1979-12-26,1979,Arsenal,Tottenham Hotspur,1-0,1,0,1,1,1,1,H
1979-12-26,1979,Bolton Wanderers,Everton,1-1,1,1,1,1,2,0,D
1979-12-26,1979,Brighton & Hove Albion,Crystal Palace,3-0,3,0,1,1,3,3,H
1979-12-26,1979,Derby County,Coventry City,1-2,1,2,1,1,3,-1,A
1979-12-26,1979,Liverpool,Manchester United,2-0,2,0,1,1,2,2,H
1979-12-26,1979,Manchester City,Stoke City,1-1,1,1,1,1,2,0,D
1979-12-26,1979,Middlesbrough,Leeds United,3-1,3,1,1,1,4,2,H
1979-12-26,1979,Norwich City,Ipswich Town,3-3,3,3,1,1,6,0,D
1979-12-26,1979,Nottingham Forest,Aston Villa,2-1,2,1,1,1,3,1,H
1979-12-26,1979,West Bromwich Albion,Bristol City,3-0,3,0,1,1,3,3,H
1979-12-26,1979,Wolverhampton Wanderers,Southampton,0-0,0,0,1,1,0,0,D
1979-12-29,1979,Brighton & Hove Albion,Manchester City,4-1,4,1,1,1,5,3,H
1979-12-29,1979,Bristol City,Aston Villa,1-3,1,3,1,1,4,-2,A
1979-12-29,1979,Coventry City,Nottingham Forest,0-3,0,3,1,1,3,-3,A
1979-12-29,1979,Crystal Palace,Middlesbrough,1-2,1,2,1,1,3,-1,A
1979-12-29,1979,Everton,Derby County,1-1,1,1,1,1,2,0,D
1979-12-29,1979,Ipswich Town,Wolverhampton Wanderers,1-0,1,0,1,1,1,1,H
1979-12-29,1979,Leeds United,Norwich City,2-2,2,2,1,1,4,0,D
1979-12-29,1979,Manchester United,Arsenal,3-0,3,0,1,1,3,3,H
1979-12-29,1979,Southampton,Bolton Wanderers,2-0,2,0,1,1,2,2,H
1979-12-29,1979,Tottenham Hotspur,Stoke City,1-0,1,0,1,1,1,1,H
1979-12-29,1979,West Bromwich Albion,Liverpool,0-2,0,2,1,1,2,-2,A
1980-01-01,1979,Bristol City,Brighton & Hove Albion,2-2,2,2,1,1,4,0,D
1980-01-01,1979,Coventry City,Middlesbrough,2-0,2,0,1,1,2,2,H
1980-01-01,1979,Crystal Palace,Norwich City,0-0,0,0,1,1,0,0,D
1980-01-01,1979,Everton,Nottingham Forest,1-0,1,0,1,1,1,1,H
1980-01-01,1979,Ipswich Town,West Bromwich Albion,4-0,4,0,1,1,4,4,H
1980-01-01,1979,Leeds United,Derby County,1-0,1,0,1,1,1,1,H
1980-01-01,1979,Southampton,Arsenal,0-1,0,1,1,1,1,-1,A
1980-01-12,1979,Arsenal,Leeds United,0-1,0,1,1,1,1,-1,A
1980-01-12,1979,Aston Villa,Everton,2-1,2,1,1,1,3,1,H
1980-01-12,1979,Bolton Wanderers,Brighton & Hove Albion,0-2,0,2,1,1,2,-2,A
1980-01-12,1979,Derby County,Crystal Palace,1-2,1,2,1,1,3,-1,A
1980-01-12,1979,Liverpool,Southampton,1-1,1,1,1,1,2,0,D
1980-01-12,1979,Manchester City,Tottenham Hotspur,1-1,1,1,1,1,2,0,D
1980-01-12,1979,Middlesbrough,Manchester United,1-1,1,1,1,1,2,0,D
1980-01-12,1979,Norwich City,Coventry City,1-0,1,0,1,1,1,1,H
1980-01-12,1979,Nottingham Forest,West Bromwich Albion,3-1,3,1,1,1,4,2,H
1980-01-12,1979,Stoke City,Ipswich Town,0-1,0,1,1,1,1,-1,A
1980-01-12,1979,Wolverhampton Wanderers,Bristol City,3-0,3,0,1,1,3,3,H
1980-01-19,1979,Arsenal,Derby County,2-0,2,0,1,1,2,2,H
1980-01-19,1979,Brighton & Hove Albion,Tottenham Hotspur,0-2,0,2,1,1,2,-2,A
1980-01-19,1979,Bristol City,Ipswich Town,0-3,0,3,1,1,3,-3,A
1980-01-19,1979,Coventry City,Liverpool,1-0,1,0,1,1,1,1,H
1980-01-19,1979,Crystal Palace,Wolverhampton Wanderers,1-0,1,0,1,1,1,1,H
1980-01-19,1979,Leeds United,Nottingham Forest,1-2,1,2,1,1,3,-1,A
1980-01-19,1979,Southampton,Manchester City,4-1,4,1,1,1,5,3,H
1980-01-26,1979,Crystal Palace,West Bromwich Albion,2-2,2,2,1,1,4,0,D
1980-02-02,1979,Aston Villa,Crystal Palace,2-0,2,0,1,1,2,2,H
1980-02-02,1979,Derby County,Manchester United,1-3,1,3,1,1,4,-2,A
1980-02-02,1979,Ipswich Town,Brighton & Hove Albion,1-1,1,1,1,1,2,0,D
1980-02-02,1979,Manchester City,West Bromwich Albion,1-3,1,3,1,1,4,-2,A
1980-02-02,1979,Stoke City,Bristol City,1-0,1,0,1,1,1,1,H
1980-02-02,1979,Tottenham Hotspur,Southampton,0-0,0,0,1,1,0,0,D
1980-02-02,1979,Wolverhampton Wanderers,Everton,0-0,0,0,1,1,0,0,D
1980-02-09,1979,Arsenal,Aston Villa,3-1,3,1,1,1,4,2,H
1980-02-09,1979,Coventry City,Manchester City,0-0,0,0,1,1,0,0,D
1980-02-09,1979,Crystal Palace,Stoke City,0-1,0,1,1,1,1,-1,A
1980-02-09,1979,Everton,Ipswich Town,0-4,0,4,1,1,4,-4,A
1980-02-09,1979,Leeds United,Bolton Wanderers,2-2,2,2,1,1,4,0,D
1980-02-09,1979,Manchester United,Wolverhampton Wanderers,0-1,0,1,1,1,1,-1,A
1980-02-09,1979,Middlesbrough,Derby County,3-0,3,0,1,1,3,3,H
1980-02-09,1979,Norwich City,Liverpool,3-5,3,5,1,1,8,-2,A
1980-02-09,1979,Nottingham Forest,Bristol City,0-0,0,0,1,1,0,0,D
1980-02-09,1979,Southampton,Brighton & Hove Albion,5-1,5,1,1,1,6,4,H
1980-02-09,1979,West Bromwich Albion,Tottenham Hotspur,2-1,2,1,1,1,3,1,H
1980-02-16,1979,Brighton & Hove Albion,West Bromwich Albion,0-0,0,0,1,1,0,0,D
1980-02-16,1979,Derby County,Southampton,2-2,2,2,1,1,4,0,D
1980-02-16,1979,Manchester City,Leeds United,1-1,1,1,1,1,2,0,D
1980-02-16,1979,Nottingham Forest,Middlesbrough,2-2,2,2,1,1,4,0,D
1980-02-16,1979,Stoke City,Manchester United,1-1,1,1,1,1,2,0,D
1980-02-19,1979,Bristol City,Everton,2-1,2,1,1,1,3,1,H
1980-02-19,1979,Ipswich Town,Crystal Palace,3-0,3,0,1,1,3,3,H
1980-02-19,1979,Liverpool,Nottingham Forest,2-0,2,0,1,1,2,2,H
1980-02-23,1979,Arsenal,Bolton Wanderers,2-0,2,0,1,1,2,2,H
1980-02-23,1979,Coventry City,Southampton,3-0,3,0,1,1,3,3,H
1980-02-23,1979,Crystal Palace,Everton,1-1,1,1,1,1,2,0,D
1980-02-23,1979,Derby County,Tottenham Hotspur,2-1,2,1,1,1,3,1,H
1980-02-23,1979,Leeds United,Brighton & Hove Albion,1-1,1,1,1,1,2,0,D
1980-02-23,1979,Liverpool,Ipswich Town,1-1,1,1,1,1,2,0,D
1980-02-23,1979,Manchester United,Bristol City,4-0,4,0,1,1,4,4,H
1980-02-23,1979,Middlesbrough,Stoke City,1-3,1,3,1,1,4,-2,A
1980-02-23,1979,Norwich City,Wolverhampton Wanderers,0-4,0,4,1,1,4,-4,A
1980-02-23,1979,Nottingham Forest,Manchester City,4-0,4,0,1,1,4,4,H
1980-02-23,1979,West Bromwich Albion,Aston Villa,1-2,1,2,1,1,3,-1,A
1980-02-26,1979,Wolverhampton Wanderers,Liverpool,1-0,1,0,1,1,1,1,H
1980-02-27,1979,Aston Villa,Manchester City,2-2,2,2,1,1,4,0,D
1980-02-27,1979,Manchester United,Bolton Wanderers,2-0,2,0,1,1,2,2,H
1980-02-27,1979,Norwich City,Middlesbrough,0-0,0,0,1,1,0,0,D
1980-02-27,1979,Tottenham Hotspur,Coventry City,4-3,4,3,1,1,7,1,H
1980-03-01,1979,Aston Villa,Derby County,1-0,1,0,1,1,1,1,H
1980-03-01,1979,Bolton Wanderers,Nottingham Forest,1-0,1,0,1,1,1,1,H
1980-03-01,1979,Brighton & Hove Albion,Coventry City,1-1,1,1,1,1,2,0,D
1980-03-01,1979,Bristol City,Crystal Palace,0-2,0,2,1,1,2,-2,A
1980-03-01,1979,Everton,Liverpool,1-2,1,2,1,1,3,-1,A
1980-03-01,1979,Ipswich Town,Manchester United,6-0,6,0,1,1,6,6,H
1980-03-01,1979,Manchester City,Norwich City,0-0,0,0,1,1,0,0,D
1980-03-01,1979,Southampton,West Bromwich Albion,1-1,1,1,1,1,2,0,D
1980-03-01,1979,Stoke City,Arsenal,2-3,2,3,1,1,5,-1,A
1980-03-01,1979,Tottenham Hotspur,Leeds United,2-1,2,1,1,1,3,1,H
1980-03-01,1979,Wolverhampton Wanderers,Middlesbrough,0-2,0,2,1,1,2,-2,A
1980-03-03,1979,Brighton & Hove Albion,Aston Villa,1-1,1,1,1,1,2,0,D
1980-03-08,1979,Coventry City,West Bromwich Albion,0-2,0,2,1,1,2,-2,A
1980-03-08,1979,Crystal Palace,Bolton Wanderers,3-1,3,1,1,1,4,2,H
1980-03-08,1979,Derby County,Stoke City,2-2,2,2,1,1,4,0,D
1980-03-08,1979,Leeds United,Southampton,2-0,2,0,1,1,2,2,H
1980-03-08,1979,Norwich City,Brighton & Hove Albion,2-2,2,2,1,1,4,0,D
1980-03-10,1979,Aston Villa,Wolverhampton Wanderers,1-3,1,3,1,1,4,-2,A
1980-03-11,1979,Arsenal,Bristol City,0-0,0,0,1,1,0,0,D
1980-03-11,1979,Bolton Wanderers,Norwich City,1-0,1,0,1,1,1,1,H
1980-03-11,1979,Liverpool,Manchester City,2-0,2,0,1,1,2,2,H
1980-03-11,1979,Middlesbrough,Ipswich Town,1-1,1,1,1,1,2,0,D
1980-03-11,1979,Nottingham Forest,Tottenham Hotspur,4-0,4,0,1,1,4,4,H
1980-03-12,1979,Manchester United,Everton,0-0,0,0,1,1,0,0,D
1980-03-14,1979,Ipswich Town,Leeds United,1-0,1,0,1,1,1,1,H
1980-03-14,1979,West Bromwich Albion,Middlesbrough,0-0,0,0,1,1,0,0,D
1980-03-15,1979,Bolton Wanderers,Derby County,1-2,1,2,1,1,3,-1,A
1980-03-15,1979,Brighton & Hove Albion,Manchester United,0-0,0,0,1,1,0,0,D
1980-03-15,1979,Bristol City,Liverpool,1-3,1,3,1,1,4,-2,A
1980-03-15,1979,Everton,Coventry City,1-1,1,1,1,1,2,0,D
1980-03-15,1979,Manchester City,Arsenal,0-3,0,3,1,1,3,-3,A
1980-03-15,1979,Southampton,Aston Villa,2-0,2,0,1,1,2,2,H
1980-03-15,1979,Stoke City,Norwich City,2-1,2,1,1,1,3,1,H
1980-03-15,1979,Tottenham Hotspur,Crystal Palace,0-0,0,0,1,1,0,0,D
1980-03-18,1979,Everton,Stoke City,2-0,2,0,1,1,2,2,H
1980-03-18,1979,West Bromwich Albion,Bolton Wanderers,4-4,4,4,1,1,8,0,D
1980-03-19,1979,Aston Villa,Middlesbrough,0-2,0,2,1,1,2,-2,A
1980-03-19,1979,Liverpool,Leeds United,3-0,3,0,1,1,3,3,H
1980-03-22,1979,Arsenal,Crystal Palace,1-1,1,1,1,1,2,0,D
1980-03-22,1979,Aston Villa,Ipswich Town,1-1,1,1,1,1,2,0,D
1980-03-22,1979,Bolton Wanderers,Tottenham Hotspur,2-1,2,1,1,1,3,1,H
1980-03-22,1979,Derby County,Bristol City,3-3,3,3,1,1,6,0,D
1980-03-22,1979,Leeds United,Coventry City,0-0,0,0,1,1,0,0,D
1980-03-22,1979,Liverpool,Brighton & Hove Albion,1-0,1,0,1,1,1,1,H
1980-03-22,1979,Manchester United,Manchester City,1-0,1,0,1,1,1,1,H
1980-03-22,1979,Middlesbrough,Everton,2-1,2,1,1,1,3,1,H
1980-03-22,1979,Norwich City,West Bromwich Albion,1-1,1,1,1,1,2,0,D
1980-03-22,1979,Nottingham Forest,Southampton,2-0,2,0,1,1,2,2,H
1980-03-22,1979,Wolverhampton Wanderers,Stoke City,3-0,3,0,1,1,3,3,H
1980-03-26,1979,Aston Villa,Norwich City,2-0,2,0,1,1,2,2,H
1980-03-28,1979,Everton,Arsenal,0-1,0,1,1,1,1,-1,A
1980-03-29,1979,Brighton & Hove Albion,Nottingham Forest,1-0,1,0,1,1,1,1,H
1980-03-29,1979,Coventry City,Wolverhampton Wanderers,1-3,1,3,1,1,4,-2,A
1980-03-29,1979,Crystal Palace,Manchester United,0-2,0,2,1,1,2,-2,A
1980-03-29,1979,Ipswich Town,Derby County,1-1,1,1,1,1,2,0,D
1980-03-29,1979,Manchester City,Bolton Wanderers,2-2,2,2,1,1,4,0,D
1980-03-29,1979,Southampton,Norwich City,2-0,2,0,1,1,2,2,H
1980-03-29,1979,Stoke City,Aston Villa,2-0,2,0,1,1,2,2,H
1980-03-29,1979,Tottenham Hotspur,Liverpool,2-0,2,0,1,1,2,2,H
1980-03-29,1979,West Bromwich Albion,Leeds United,2-1,2,1,1,1,3,1,H
1980-04-01,1979,Liverpool,Stoke City,1-0,1,0,1,1,1,1,H
1980-04-01,1979,West Bromwich Albion,Crystal Palace,3-0,3,0,1,1,3,3,H
1980-04-02,1979,Leeds United,Middlesbrough,2-0,2,0,1,1,2,2,H
1980-04-02,1979,Manchester City,Everton,1-1,1,1,1,1,2,0,D
1980-04-02,1979,Norwich City,Arsenal,2-1,2,1,1,1,3,1,H
1980-04-02,1979,Nottingham Forest,Manchester United,2-0,2,0,1,1,2,2,H
1980-04-02,1979,Tottenham Hotspur,Ipswich Town,0-2,0,2,1,1,2,-2,A
1980-04-05,1979,Arsenal,Southampton,1-1,1,1,1,1,2,0,D
1980-04-05,1979,Aston Villa,Nottingham Forest,3-2,3,2,1,1,5,1,H
1980-04-05,1979,Bristol City,West Bromwich Albion,0-0,0,0,1,1,0,0,D
1980-04-05,1979,Crystal Palace,Brighton & Hove Albion,1-1,1,1,1,1,2,0,D
1980-04-05,1979,Derby County,Leeds United,2-0,2,0,1,1,2,2,H
1980-04-05,1979,Everton,Bolton Wanderers,3-1,3,1,1,1,4,2,H
1980-04-05,1979,Ipswich Town,Norwich City,4-2,4,2,1,1,6,2,H
1980-04-05,1979,Manchester United,Liverpool,2-1,2,1,1,1,3,1,H
1980-04-05,1979,Middlesbrough,Coventry City,1-2,1,2,1,1,3,-1,A
1980-04-05,1979,Stoke City,Manchester City,0-0,0,0,1,1,0,0,D
1980-04-05,1979,Wolverhampton Wanderers,Tottenham Hotspur,1-2,1,2,1,1,3,-1,A
1980-04-07,1979,Bolton Wanderers,Manchester United,1-3,1,3,1,1,4,-2,A
1980-04-07,1979,Brighton & Hove Albion,Bristol City,0-1,0,1,1,1,1,-1,A
1980-04-07,1979,Coventry City,Derby County,2-1,2,1,1,1,3,1,H
1980-04-07,1979,Manchester City,Aston Villa,1-1,1,1,1,1,2,0,D
1980-04-07,1979,Norwich City,Crystal Palace,2-1,2,1,1,1,3,1,H
1980-04-07,1979,Southampton,Wolverhampton Wanderers,0-3,0,3,1,1,3,-3,A
1980-04-07,1979,Tottenham Hotspur,Arsenal,1-2,1,2,1,1,3,-1,A
1980-04-07,1979,West Bromwich Albion,Ipswich Town,0-0,0,0,1,1,0,0,D
1980-04-08,1979,Bolton Wanderers,Middlesbrough,2-2,2,2,1,1,4,0,D
1980-04-08,1979,Brighton & Hove Albion,Wolverhampton Wanderers,3-0,3,0,1,1,3,3,H
1980-04-08,1979,Leeds United,Stoke City,3-0,3,0,1,1,3,3,H
1980-04-08,1979,Liverpool,Derby County,3-0,3,0,1,1,3,3,H
1980-04-12,1979,Bristol City,Bolton Wanderers,2-1,2,1,1,1,3,1,H
1980-04-12,1979,Crystal Palace,Leeds United,1-0,1,0,1,1,1,1,H
1980-04-12,1979,Derby County,Brighton & Hove Albion,3-0,3,0,1,1,3,3,H
1980-04-12,1979,Ipswich Town,Coventry City,3-0,3,0,1,1,3,3,H
1980-04-12,1979,Manchester United,Tottenham Hotspur,4-1,4,1,1,1,5,3,H
1980-04-12,1979,Stoke City,Southampton,1-2,1,2,1,1,3,-1,A
1980-04-12,1979,Wolverhampton Wanderers,Manchester City,1-2,1,2,1,1,3,-1,A
1980-04-15,1979,Bolton Wanderers,Coventry City,1-1,1,1,1,1,2,0,D
1980-04-19,1979,Bolton Wanderers,Stoke City,2-1,2,1,1,1,3,1,H
1980-04-19,1979,Brighton & Hove Albion,Middlesbrough,2-1,2,1,1,1,3,1,H
1980-04-19,1979,Coventry City,Crystal Palace,2-1,2,1,1,1,3,1,H
1980-04-19,1979,Leeds United,Aston Villa,0-0,0,0,1,1,0,0,D
1980-04-19,1979,Liverpool,Arsenal,1-1,1,1,1,1,2,0,D
1980-04-19,1979,Manchester City,Bristol City,3-1,3,1,1,1,4,2,H
1980-04-19,1979,Norwich City,Manchester United,0-2,0,2,1,1,2,-2,A
1980-04-19,1979,Nottingham Forest,Derby County,1-0,1,0,1,1,1,1,H
1980-04-19,1979,Southampton,Ipswich Town,0-1,0,1,1,1,1,-1,A
1980-04-19,1979,Tottenham Hotspur,Everton,3-0,3,0,1,1,3,3,H
1980-04-19,1979,West Bromwich Albion,Wolverhampton Wanderers,0-0,0,0,1,1,0,0,D
1980-04-22,1979,Bristol City,Middlesbrough,3-1,3,1,1,1,4,2,H
1980-04-23,1979,Manchester United,Aston Villa,2-1,2,1,1,1,3,1,H
1980-04-23,1979,Stoke City,Liverpool,0-2,0,2,1,1,2,-2,A
1980-04-23,1979,Tottenham Hotspur,Wolverhampton Wanderers,2-2,2,2,1,1,4,0,D
1980-04-26,1979,Arsenal,West Bromwich Albion,1-1,1,1,1,1,2,0,D
1980-04-26,1979,Aston Villa,Tottenham Hotspur,1-0,1,0,1,1,1,1,H
1980-04-26,1979,Bristol City,Norwich City,2-3,2,3,1,1,5,-1,A
1980-04-26,1979,Crystal Palace,Liverpool,0-0,0,0,1,1,0,0,D
1980-04-26,1979,Derby County,Manchester City,3-1,3,1,1,1,4,2,H
1980-04-26,1979,Everton,Southampton,2-0,2,0,1,1,2,2,H
1980-04-26,1979,Ipswich Town,Bolton Wanderers,1-0,1,0,1,1,1,1,H
1980-04-26,1979,Manchester United,Coventry City,2-1,2,1,1,1,3,1,H
1980-04-26,1979,Middlesbrough,Nottingham Forest,0-0,0,0,1,1,0,0,D
1980-04-26,1979,Stoke City,Brighton & Hove Albion,1-0,1,0,1,1,1,1,H
1980-04-26,1979,Wolverhampton Wanderers,Leeds United,3-1,3,1,1,1,4,2,H
1980-04-28,1979,Everton,West Bromwich Albion,0-0,0,0,1,1,0,0,D
1980-04-29,1979,Coventry City,Aston Villa,1-2,1,2,1,1,3,-1,A
1980-04-29,1979,Southampton,Bristol City,5-2,5,2,1,1,7,3,H
1980-04-30,1979,Nottingham Forest,Norwich City,2-0,2,0,1,1,2,2,H
1980-05-03,1979,Bolton Wanderers,Wolverhampton Wanderers,0-0,0,0,1,1,0,0,D
1980-05-03,1979,Brighton & Hove Albion,Everton,0-0,0,0,1,1,0,0,D
1980-05-03,1979,Coventry City,Arsenal,0-1,0,1,1,1,1,-1,A
1980-05-03,1979,Leeds United,Manchester United,2-0,2,0,1,1,2,2,H
1980-05-03,1979,Liverpool,Aston Villa,4-1,4,1,1,1,5,3,H
1980-05-03,1979,Manchester City,Ipswich Town,2-1,2,1,1,1,3,1,H
1980-05-03,1979,Norwich City,Derby County,4-2,4,2,1,1,6,2,H
1980-05-03,1979,Nottingham Forest,Crystal Palace,4-0,4,0,1,1,4,4,H
1980-05-03,1979,Southampton,Middlesbrough,4-1,4,1,1,1,5,3,H
1980-05-03,1979,Tottenham Hotspur,Bristol City,0-0,0,0,1,1,0,0,D
1980-05-03,1979,West Bromwich Albion,Stoke City,0-1,0,1,1,1,1,-1,A
1980-05-05,1979,Arsenal,Nottingham Forest,0-0,0,0,1,1,0,0,D
1980-05-06,1979,Middlesbrough,Liverpool,1-0,1,0,1,1,1,1,H
1980-05-09,1979,Nottingham Forest,Everton,1-0,1,0,1,1,1,1,H
1980-05-12,1979,Wolverhampton Wanderers,Nottingham Forest,3-1,3,1,1,1,4,2,H
1980-05-16,1979,Wolverhampton Wanderers,Arsenal,1-2,1,2,1,1,3,-1,A
1980-05-19,1979,Middlesbrough,Arsenal,5-0,5,0,1,1,5,5,H
1980-08-16,1980,Birmingham City,Coventry City,3-1,3,1,1,1,4,2,H
1980-08-16,1980,Brighton & Hove Albion,Wolverhampton Wanderers,2-0,2,0,1,1,2,2,H
1980-08-16,1980,Leeds United,Aston Villa,1-2,1,2,1,1,3,-1,A
1980-08-16,1980,Leicester City,Ipswich Town,0-1,0,1,1,1,1,-1,A
1980-08-16,1980,Liverpool,Crystal Palace,3-0,3,0,1,1,3,3,H
1980-08-16,1980,Manchester United,Middlesbrough,3-0,3,0,1,1,3,3,H
1980-08-16,1980,Norwich City,Stoke City,5-1,5,1,1,1,6,4,H
1980-08-16,1980,Southampton,Manchester City,2-0,2,0,1,1,2,2,H
1980-08-16,1980,Sunderland,Everton,3-1,3,1,1,1,4,2,H
1980-08-16,1980,Tottenham Hotspur,Nottingham Forest,2-0,2,0,1,1,2,2,H
1980-08-16,1980,West Bromwich Albion,Arsenal,0-1,0,1,1,1,1,-1,A
1980-08-19,1980,Arsenal,Southampton,1-1,1,1,1,1,2,0,D
1980-08-19,1980,Coventry City,Liverpool,0-0,0,0,1,1,0,0,D
1980-08-19,1980,Crystal Palace,Tottenham Hotspur,3-4,3,4,1,1,7,-1,A
1980-08-19,1980,Everton,Leicester City,1-0,1,0,1,1,1,1,H
1980-08-19,1980,Ipswich Town,Brighton & Hove Albion,2-0,2,0,1,1,2,2,H
1980-08-19,1980,Middlesbrough,Leeds United,3-0,3,0,1,1,3,3,H
1980-08-19,1980,Wolverhampton Wanderers,Manchester United,1-0,1,0,1,1,1,1,H
1980-08-20,1980,Aston Villa,Norwich City,1-0,1,0,1,1,1,1,H
1980-08-20,1980,Manchester City,Sunderland,0-4,0,4,1,1,4,-4,A
1980-08-20,1980,Nottingham Forest,Birmingham City,2-1,2,1,1,1,3,1,H
1980-08-20,1980,Stoke City,West Bromwich Albion,0-0,0,0,1,1,0,0,D
1980-08-23,1980,Birmingham City,Manchester United,0-0,0,0,1,1,0,0,D
1980-08-23,1980,Coventry City,Arsenal,3-1,3,1,1,1,4,2,H
1980-08-23,1980,Crystal Palace,Middlesbrough,5-2,5,2,1,1,7,3,H
1980-08-23,1980,Everton,Nottingham Forest,0-0,0,0,1,1,0,0,D
1980-08-23,1980,Leicester City,Liverpool,2-0,2,0,1,1,2,2,H
1980-08-23,1980,Manchester City,Aston Villa,2-2,2,2,1,1,4,0,D
1980-08-23,1980,Norwich City,Leeds United,2-3,2,3,1,1,5,-1,A
1980-08-23,1980,Stoke City,Ipswich Town,2-2,2,2,1,1,4,0,D
1980-08-23,1980,Sunderland,Southampton,1-2,1,2,1,1,3,-1,A
1980-08-23,1980,Tottenham Hotspur,Brighton & Hove Albion,2-2,2,2,1,1,4,0,D
1980-08-23,1980,West Bromwich Albion,Wolverhampton Wanderers,1-1,1,1,1,1,2,0,D
1980-08-30,1980,Arsenal,Tottenham Hotspur,2-0,2,0,1,1,2,2,H
1980-08-30,1980,Aston Villa,Coventry City,1-0,1,0,1,1,1,1,H
1980-08-30,1980,Brighton & Hove Albion,West Bromwich Albion,1-2,1,2,1,1,3,-1,A
1980-08-30,1980,Ipswich Town,Everton,4-0,4,0,1,1,4,4,H
1980-08-30,1980,Leeds United,Leicester City,1-2,1,2,1,1,3,-1,A
1980-08-30,1980,Liverpool,Norwich City,4-1,4,1,1,1,5,3,H
1980-08-30,1980,Manchester United,Sunderland,1-1,1,1,1,1,2,0,D
1980-08-30,1980,Middlesbrough,Manchester City,2-2,2,2,1,1,4,0,D
1980-08-30,1980,Nottingham Forest,Stoke City,5-0,5,0,1,1,5,5,H
1980-08-30,1980,Southampton,Birmingham City,3-1,3,1,1,1,4,2,H
1980-08-30,1980,Wolverhampton Wanderers,Crystal Palace,2-0,2,0,1,1,2,2,H
1980-09-06,1980,Birmingham City,Liverpool,1-1,1,1,1,1,2,0,D
1980-09-06,1980,Coventry City,Crystal Palace,3-1,3,1,1,1,4,2,H
1980-09-06,1980,Everton,Wolverhampton Wanderers,2-0,2,0,1,1,2,2,H
1980-09-06,1980,Ipswich Town,Aston Villa,1-0,1,0,1,1,1,1,H
1980-09-06,1980,Leicester City,Sunderland,0-1,0,1,1,1,1,-1,A
1980-09-06,1980,Manchester City,Arsenal,1-1,1,1,1,1,2,0,D
1980-09-06,1980,Middlesbrough,Nottingham Forest,0-0,0,0,1,1,0,0,D
1980-09-06,1980,Southampton,Brighton & Hove Albion,3-1,3,1,1,1,4,2,H
1980-09-06,1980,Stoke City,Leeds United,3-0,3,0,1,1,3,3,H
1980-09-06,1980,Tottenham Hotspur,Manchester United,0-0,0,0,1,1,0,0,D
1980-09-06,1980,West Bromwich Albion,Norwich City,3-0,3,0,1,1,3,3,H
1980-09-13,1980,Arsenal,Stoke City,2-0,2,0,1,1,2,2,H
1980-09-13,1980,Aston Villa,Everton,0-2,0,2,1,1,2,-2,A
1980-09-13,1980,Brighton & Hove Albion,Birmingham City,2-2,2,2,1,1,4,0,D
1980-09-13,1980,Crystal Palace,Ipswich Town,1-2,1,2,1,1,3,-1,A
1980-09-13,1980,Leeds United,Tottenham Hotspur,0-0,0,0,1,1,0,0,D
1980-09-13,1980,Liverpool,West Bromwich Albion,4-0,4,0,1,1,4,4,H
1980-09-13,1980,Manchester United,Leicester City,5-0,5,0,1,1,5,5,H
1980-09-13,1980,Norwich City,Southampton,1-0,1,0,1,1,1,1,H
1980-09-13,1980,Nottingham Forest,Manchester City,3-2,3,2,1,1,5,1,H
1980-09-13,1980,Sunderland,Middlesbrough,0-1,0,1,1,1,1,-1,A
1980-09-13,1980,Wolverhampton Wanderers,Coventry City,0-1,0,1,1,1,1,-1,A
1980-09-20,1980,Aston Villa,Wolverhampton Wanderers,2-1,2,1,1,1,3,1,H
1980-09-20,1980,Birmingham City,West Bromwich Albion,1-1,1,1,1,1,2,0,D
1980-09-20,1980,Brighton & Hove Albion,Norwich City,2-0,2,0,1,1,2,2,H
1980-09-20,1980,Everton,Crystal Palace,5-0,5,0,1,1,5,5,H
1980-09-20,1980,Ipswich Town,Coventry City,2-0,2,0,1,1,2,2,H
1980-09-20,1980,Leeds United,Manchester United,0-0,0,0,1,1,0,0,D
1980-09-20,1980,Manchester City,Stoke City,1-2,1,2,1,1,3,-1,A
1980-09-20,1980,Middlesbrough,Arsenal,2-1,2,1,1,1,3,1,H
1980-09-20,1980,Nottingham Forest,Leicester City,5-0,5,0,1,1,5,5,H
1980-09-20,1980,Southampton,Liverpool,2-2,2,2,1,1,4,0,D
1980-09-20,1980,Tottenham Hotspur,Sunderland,0-0,0,0,1,1,0,0,D
1980-09-27,1980,Arsenal,Nottingham Forest,1-0,1,0,1,1,1,1,H
1980-09-27,1980,Coventry City,Everton,0-5,0,5,1,1,5,-5,A
1980-09-27,1980,Crystal Palace,Aston Villa,0-1,0,1,1,1,1,-1,A
1980-09-27,1980,Leicester City,Tottenham Hotspur,2-1,2,1,1,1,3,1,H
1980-09-27,1980,Liverpool,Brighton & Hove Albion,4-1,4,1,1,1,5,3,H
1980-09-27,1980,Manchester United,Manchester City,2-2,2,2,1,1,4,0,D
1980-09-27,1980,Norwich City,Birmingham City,2-2,2,2,1,1,4,0,D
1980-09-27,1980,Stoke City,Middlesbrough,1-0,1,0,1,1,1,1,H
1980-09-27,1980,Sunderland,Leeds United,4-1,4,1,1,1,5,3,H
1980-09-27,1980,West Bromwich Albion,Southampton,2-1,2,1,1,1,3,1,H
1980-09-27,1980,Wolverhampton Wanderers,Ipswich Town,0-2,0,2,1,1,2,-2,A
1980-10-04,1980,Arsenal,Leicester City,1-0,1,0,1,1,1,1,H
1980-10-04,1980,Aston Villa,Sunderland,4-0,4,0,1,1,4,4,H
1980-10-04,1980,Coventry City,Brighton & Hove Albion,3-3,3,3,1,1,6,0,D
1980-10-04,1980,Crystal Palace,West Bromwich Albion,0-1,0,1,1,1,1,-1,A
1980-10-04,1980,Everton,Southampton,2-1,2,1,1,1,3,1,H
1980-10-04,1980,Ipswich Town,Leeds United,1-1,1,1,1,1,2,0,D
1980-10-04,1980,Manchester City,Liverpool,0-3,0,3,1,1,3,-3,A
1980-10-04,1980,Middlesbrough,Norwich City,6-1,6,1,1,1,7,5,H
1980-10-04,1980,Nottingham Forest,Manchester United,1-2,1,2,1,1,3,-1,A
1980-10-04,1980,Stoke City,Tottenham Hotspur,2-3,2,3,1,1,5,-1,A
1980-10-04,1980,Wolverhampton Wanderers,Birmingham City,1-0,1,0,1,1,1,1,H
1980-10-07,1980,Birmingham City,Arsenal,3-1,3,1,1,1,4,2,H
1980-10-07,1980,Brighton & Hove Albion,Everton,1-3,1,3,1,1,4,-2,A
1980-10-07,1980,Liverpool,Middlesbrough,4-2,4,2,1,1,6,2,H
1980-10-07,1980,Southampton,Wolverhampton Wanderers,4-2,4,2,1,1,6,2,H
1980-10-08,1980,Leeds United,Manchester City,1-0,1,0,1,1,1,1,H
1980-10-08,1980,Leicester City,Stoke City,1-1,1,1,1,1,2,0,D
1980-10-08,1980,Manchester United,Aston Villa,3-3,3,3,1,1,6,0,D
1980-10-08,1980,Sunderland,Nottingham Forest,2-2,2,2,1,1,4,0,D
1980-10-08,1980,West Bromwich Albion,Coventry City,1-0,1,0,1,1,1,1,H
1980-10-11,1980,Birmingham City,Aston Villa,1-2,1,2,1,1,3,-1,A
1980-10-11,1980,Brighton & Hove Albion,Nottingham Forest,0-1,0,1,1,1,1,-1,A
1980-10-11,1980,Leeds United,Everton,1-0,1,0,1,1,1,1,H
1980-10-11,1980,Leicester City,Coventry City,1-3,1,3,1,1,4,-2,A
1980-10-11,1980,Liverpool,Ipswich Town,1-1,1,1,1,1,2,0,D
1980-10-11,1980,Manchester United,Arsenal,0-0,0,0,1,1,0,0,D
1980-10-11,1980,Norwich City,Wolverhampton Wanderers,1-1,1,1,1,1,2,0,D
1980-10-11,1980,Southampton,Stoke City,1-2,1,2,1,1,3,-1,A
1980-10-11,1980,Sunderland,Crystal Palace,1-0,1,0,1,1,1,1,H
1980-10-11,1980,Tottenham Hotspur,Middlesbrough,3-2,3,2,1,1,5,1,H
1980-10-11,1980,West Bromwich Albion,Manchester City,3-1,3,1,1,1,4,2,H
1980-10-18,1980,Arsenal,Sunderland,2-2,2,2,1,1,4,0,D
1980-10-18,1980,Aston Villa,Tottenham Hotspur,3-0,3,0,1,1,3,3,H
1980-10-18,1980,Coventry City,Norwich City,0-1,0,1,1,1,1,-1,A
1980-10-18,1980,Crystal Palace,Leicester City,2-1,2,1,1,1,3,1,H
1980-10-18,1980,Everton,Liverpool,2-2,2,2,1,1,4,0,D
1980-10-18,1980,Ipswich Town,Manchester United,1-1,1,1,1,1,2,0,D
1980-10-18,1980,Manchester City,Birmingham City,0-1,0,1,1,1,1,-1,A
1980-10-18,1980,Middlesbrough,Southampton,1-1,1,1,1,1,2,0,D
1980-10-18,1980,Nottingham Forest,West Bromwich Albion,2-1,2,1,1,1,3,1,H
1980-10-18,1980,Stoke City,Brighton & Hove Albion,0-0,0,0,1,1,0,0,D
1980-10-18,1980,Wolverhampton Wanderers,Leeds United,2-1,2,1,1,1,3,1,H
1980-10-21,1980,Arsenal,Norwich City,3-1,3,1,1,1,4,2,H
1980-10-21,1980,Coventry City,Sunderland,2-1,2,1,1,1,3,1,H
1980-10-21,1980,Crystal Palace,Southampton,3-2,3,2,1,1,5,1,H
1980-10-21,1980,Everton,West Bromwich Albion,1-1,1,1,1,1,2,0,D
1980-10-21,1980,Middlesbrough,Leicester City,1-0,1,0,1,1,1,1,H
1980-10-22,1980,Aston Villa,Brighton & Hove Albion,4-1,4,1,1,1,5,3,H
1980-10-22,1980,Manchester City,Tottenham Hotspur,3-1,3,1,1,1,4,2,H
1980-10-22,1980,Nottingham Forest,Leeds United,2-1,2,1,1,1,3,1,H
1980-10-22,1980,Stoke City,Manchester United,1-2,1,2,1,1,3,-1,A
1980-10-25,1980,Birmingham City,Stoke City,1-1,1,1,1,1,2,0,D
1980-10-25,1980,Brighton & Hove Albion,Manchester City,1-2,1,2,1,1,3,-1,A
1980-10-25,1980,Leeds United,Crystal Palace,1-0,1,0,1,1,1,1,H
1980-10-25,1980,Leicester City,Wolverhampton Wanderers,2-0,2,0,1,1,2,2,H
1980-10-25,1980,Liverpool,Arsenal,1-1,1,1,1,1,2,0,D
1980-10-25,1980,Manchester United,Everton,2-0,2,0,1,1,2,2,H
1980-10-25,1980,Norwich City,Nottingham Forest,1-1,1,1,1,1,2,0,D
1980-10-25,1980,Southampton,Aston Villa,1-2,1,2,1,1,3,-1,A
1980-10-25,1980,Sunderland,Ipswich Town,0-2,0,2,1,1,2,-2,A
1980-10-25,1980,Tottenham Hotspur,Coventry City,4-1,4,1,1,1,5,3,H
1980-10-25,1980,West Bromwich Albion,Middlesbrough,3-0,3,0,1,1,3,3,H
1980-10-29,1980,Norwich City,Crystal Palace,1-1,1,1,1,1,2,0,D
1980-11-01,1980,Arsenal,Brighton & Hove Albion,2-0,2,0,1,1,2,2,H
1980-11-01,1980,Aston Villa,Leicester City,2-0,2,0,1,1,2,2,H
1980-11-01,1980,Coventry City,Leeds United,2-1,2,1,1,1,3,1,H
1980-11-01,1980,Crystal Palace,Manchester United,1-0,1,0,1,1,1,1,H
1980-11-01,1980,Everton,Tottenham Hotspur,2-2,2,2,1,1,4,0,D
1980-11-01,1980,Ipswich Town,West Bromwich Albion,0-0,0,0,1,1,0,0,D
1980-11-01,1980,Manchester City,Norwich City,1-0,1,0,1,1,1,1,H
1980-11-01,1980,Middlesbrough,Birmingham City,1-2,1,2,1,1,3,-1,A
1980-11-01,1980,Nottingham Forest,Southampton,2-1,2,1,1,1,3,1,H
1980-11-01,1980,Stoke City,Liverpool,2-2,2,2,1,1,4,0,D
1980-11-01,1980,Wolverhampton Wanderers,Sunderland,2-1,2,1,1,1,3,1,H
1980-11-08,1980,Birmingham City,Crystal Palace,1-0,1,0,1,1,1,1,H
1980-11-08,1980,Brighton & Hove Albion,Middlesbrough,0-1,0,1,1,1,1,-1,A
1980-11-08,1980,Leeds United,Arsenal,0-5,0,5,1,1,5,-5,A
1980-11-08,1980,Leicester City,Manchester City,1-1,1,1,1,1,2,0,D
1980-11-08,1980,Liverpool,Nottingham Forest,0-0,0,0,1,1,0,0,D
1980-11-08,1980,Manchester United,Coventry City,0-0,0,0,1,1,0,0,D
1980-11-08,1980,Norwich City,Everton,2-1,2,1,1,1,3,1,H
1980-11-08,1980,Southampton,Ipswich Town,3-3,3,3,1,1,6,0,D
1980-11-08,1980,Sunderland,Stoke City,0-0,0,0,1,1,0,0,D
1980-11-08,1980,Tottenham Hotspur,Wolverhampton Wanderers,2-2,2,2,1,1,4,0,D
1980-11-08,1980,West Bromwich Albion,Aston Villa,0-0,0,0,1,1,0,0,D
1980-11-11,1980,Birmingham City,Nottingham Forest,2-0,2,0,1,1,2,2,H
1980-11-11,1980,Brighton & Hove Albion,Ipswich Town,1-0,1,0,1,1,1,1,H
1980-11-11,1980,Liverpool,Coventry City,2-1,2,1,1,1,3,1,H
1980-11-11,1980,Southampton,Arsenal,3-1,3,1,1,1,4,2,H
1980-11-12,1980,Leeds United,Middlesbrough,2-1,2,1,1,1,3,1,H
1980-11-12,1980,Leicester City,Everton,0-1,0,1,1,1,1,-1,A
1980-11-12,1980,Manchester United,Wolverhampton Wanderers,0-0,0,0,1,1,0,0,D
1980-11-12,1980,Norwich City,Aston Villa,1-3,1,3,1,1,4,-2,A
1980-11-12,1980,Sunderland,Manchester City,2-0,2,0,1,1,2,2,H
1980-11-12,1980,Tottenham Hotspur,Crystal Palace,4-2,4,2,1,1,6,2,H
1980-11-15,1980,Arsenal,West Bromwich Albion,2-2,2,2,1,1,4,0,D
1980-11-15,1980,Aston Villa,Leeds United,1-1,1,1,1,1,2,0,D
1980-11-15,1980,Coventry City,Birmingham City,2-1,2,1,1,1,3,1,H
1980-11-15,1980,Crystal Palace,Liverpool,2-2,2,2,1,1,4,0,D
1980-11-15,1980,Everton,Sunderland,2-1,2,1,1,1,3,1,H
1980-11-15,1980,Ipswich Town,Leicester City,3-1,3,1,1,1,4,2,H
1980-11-15,1980,Manchester City,Southampton,3-0,3,0,1,1,3,3,H
1980-11-15,1980,Middlesbrough,Manchester United,1-1,1,1,1,1,2,0,D
1980-11-15,1980,Nottingham Forest,Tottenham Hotspur,0-3,0,3,1,1,3,-3,A
1980-11-15,1980,Stoke City,Norwich City,3-1,3,1,1,1,4,2,H
1980-11-15,1980,Wolverhampton Wanderers,Brighton & Hove Albion,0-2,0,2,1,1,2,-2,A
1980-11-22,1980,Arsenal,Everton,2-1,2,1,1,1,3,1,H
1980-11-22,1980,Birmingham City,Tottenham Hotspur,2-1,2,1,1,1,3,1,H
1980-11-22,1980,Brighton & Hove Albion,Manchester United,1-4,1,4,1,1,5,-3,A
1980-11-22,1980,Liverpool,Aston Villa,2-1,2,1,1,1,3,1,H
1980-11-22,1980,Manchester City,Coventry City,3-0,3,0,1,1,3,3,H
1980-11-22,1980,Middlesbrough,Wolverhampton Wanderers,2-0,2,0,1,1,2,2,H
1980-11-22,1980,Norwich City,Sunderland,1-0,1,0,1,1,1,1,H
1980-11-22,1980,Nottingham Forest,Ipswich Town,1-2,1,2,1,1,3,-1,A
1980-11-22,1980,Southampton,Leeds United,2-1,2,1,1,1,3,1,H
1980-11-22,1980,Stoke City,Crystal Palace,1-0,1,0,1,1,1,1,H
1980-11-22,1980,West Bromwich Albion,Leicester City,3-1,3,1,1,1,4,2,H
1980-11-25,1980,West Bromwich Albion,Stoke City,0-0,0,0,1,1,0,0,D
1980-11-25,1980,Wolverhampton Wanderers,Liverpool,4-1,4,1,1,1,5,3,H
1980-11-29,1980,Aston Villa,Arsenal,1-1,1,1,1,1,2,0,D
1980-11-29,1980,Coventry City,Nottingham Forest,1-1,1,1,1,1,2,0,D
1980-11-29,1980,Crystal Palace,Manchester City,2-3,2,3,1,1,5,-1,A
1980-11-29,1980,Everton,Birmingham City,1-1,1,1,1,1,2,0,D
1980-11-29,1980,Leeds United,Brighton & Hove Albion,1-0,1,0,1,1,1,1,H
1980-11-29,1980,Leicester City,Norwich City,1-2,1,2,1,1,3,-1,A
1980-11-29,1980,Manchester United,Southampton,1-1,1,1,1,1,2,0,D
1980-11-29,1980,Sunderland,Liverpool,2-4,2,4,1,1,6,-2,A
1980-11-29,1980,Tottenham Hotspur,West Bromwich Albion,2-3,2,3,1,1,5,-1,A
1980-11-29,1980,Wolverhampton Wanderers,Stoke City,1-0,1,0,1,1,1,1,H
1980-12-06,1980,Arsenal,Wolverhampton Wanderers,1-1,1,1,1,1,2,0,D
1980-12-06,1980,Birmingham City,Leicester City,1-2,1,2,1,1,3,-1,A
1980-12-06,1980,Brighton & Hove Albion,Sunderland,2-1,2,1,1,1,3,1,H
1980-12-06,1980,Liverpool,Tottenham Hotspur,2-1,2,1,1,1,3,1,H
1980-12-06,1980,Manchester City,Ipswich Town,1-1,1,1,1,1,2,0,D
1980-12-06,1980,Middlesbrough,Aston Villa,2-1,2,1,1,1,3,1,H
1980-12-06,1980,Norwich City,Manchester United,2-2,2,2,1,1,4,0,D
1980-12-06,1980,Nottingham Forest,Crystal Palace,3-0,3,0,1,1,3,3,H
1980-12-06,1980,Southampton,Coventry City,1-0,1,0,1,1,1,1,H
1980-12-06,1980,Stoke City,Everton,2-2,2,2,1,1,4,0,D
1980-12-06,1980,West Bromwich Albion,Leeds United,1-2,1,2,1,1,3,-1,A
1980-12-13,1980,Aston Villa,Birmingham City,3-0,3,0,1,1,3,3,H
1980-12-13,1980,Coventry City,West Bromwich Albion,3-0,3,0,1,1,3,3,H
1980-12-13,1980,Crystal Palace,Norwich City,4-1,4,1,1,1,5,3,H
1980-12-13,1980,Everton,Brighton & Hove Albion,4-3,4,3,1,1,7,1,H
1980-12-13,1980,Ipswich Town,Liverpool,1-1,1,1,1,1,2,0,D
1980-12-13,1980,Leeds United,Nottingham Forest,1-0,1,0,1,1,1,1,H
1980-12-13,1980,Leicester City,Middlesbrough,1-0,1,0,1,1,1,1,H
1980-12-13,1980,Manchester United,Stoke City,2-2,2,2,1,1,4,0,D
1980-12-13,1980,Sunderland,Arsenal,2-0,2,0,1,1,2,2,H
1980-12-13,1980,Tottenham Hotspur,Manchester City,2-1,2,1,1,1,3,1,H
1980-12-13,1980,Wolverhampton Wanderers,Southampton,1-1,1,1,1,1,2,0,D
1980-12-17,1980,Tottenham Hotspur,Ipswich Town,5-3,5,3,1,1,8,2,H
1980-12-20,1980,Arsenal,Manchester United,2-1,2,1,1,1,3,1,H
1980-12-20,1980,Birmingham City,Ipswich Town,1-3,1,3,1,1,4,-2,A
1980-12-20,1980,Brighton & Hove Albion,Aston Villa,1-0,1,0,1,1,1,1,H
1980-12-20,1980,Liverpool,Wolverhampton Wanderers,1-0,1,0,1,1,1,1,H
1980-12-20,1980,Manchester City,Leeds United,1-0,1,0,1,1,1,1,H
1980-12-20,1980,Middlesbrough,Tottenham Hotspur,4-1,4,1,1,1,5,3,H
1980-12-20,1980,Norwich City,Coventry City,2-0,2,0,1,1,2,2,H
1980-12-20,1980,Nottingham Forest,Sunderland,3-1,3,1,1,1,4,2,H
1980-12-20,1980,Southampton,Crystal Palace,4-2,4,2,1,1,6,2,H
1980-12-20,1980,Stoke City,Leicester City,1-0,1,0,1,1,1,1,H
1980-12-26,1980,Aston Villa,Stoke City,1-0,1,0,1,1,1,1,H
1980-12-26,1980,Coventry City,Middlesbrough,1-0,1,0,1,1,1,1,H
1980-12-26,1980,Crystal Palace,Arsenal,2-2,2,2,1,1,4,0,D
1980-12-26,1980,Everton,Manchester City,0-2,0,2,1,1,2,-2,A
1980-12-26,1980,Ipswich Town,Norwich City,2-0,2,0,1,1,2,2,H
1980-12-26,1980,Leeds United,Birmingham City,0-0,0,0,1,1,0,0,D
1980-12-26,1980,Leicester City,Brighton & Hove Albion,0-1,0,1,1,1,1,-1,A
1980-12-26,1980,Manchester United,Liverpool,0-0,0,0,1,1,0,0,D
1980-12-26,1980,Sunderland,West Bromwich Albion,0-0,0,0,1,1,0,0,D
1980-12-26,1980,Tottenham Hotspur,Southampton,4-4,4,4,1,1,8,0,D
1980-12-26,1980,Wolverhampton Wanderers,Nottingham Forest,1-4,1,4,1,1,5,-3,A
1980-12-27,1980,Arsenal,Ipswich Town,1-1,1,1,1,1,2,0,D
1980-12-27,1980,Birmingham City,Sunderland,3-2,3,2,1,1,5,1,H
1980-12-27,1980,Brighton & Hove Albion,Crystal Palace,3-2,3,2,1,1,5,1,H
1980-12-27,1980,Liverpool,Leeds United,0-0,0,0,1,1,0,0,D
1980-12-27,1980,Manchester City,Wolverhampton Wanderers,4-0,4,0,1,1,4,4,H
1980-12-27,1980,Middlesbrough,Everton,1-0,1,0,1,1,1,1,H
1980-12-27,1980,Norwich City,Tottenham Hotspur,2-2,2,2,1,1,4,0,D
1980-12-27,1980,Nottingham Forest,Aston Villa,2-2,2,2,1,1,4,0,D
1980-12-27,1980,Southampton,Leicester City,4-0,4,0,1,1,4,4,H
1980-12-27,1980,Stoke City,Coventry City,2-2,2,2,1,1,4,0,D
1980-12-27,1980,West Bromwich Albion,Manchester United,3-1,3,1,1,1,4,2,H
1981-01-10,1980,Aston Villa,Liverpool,2-0,2,0,1,1,2,2,H
1981-01-10,1980,Coventry City,Manchester City,1-1,1,1,1,1,2,0,D
1981-01-10,1980,Crystal Palace,Stoke City,1-1,1,1,1,1,2,0,D
1981-01-10,1980,Everton,Arsenal,1-2,1,2,1,1,3,-1,A
1981-01-10,1980,Ipswich Town,Nottingham Forest,2-0,2,0,1,1,2,2,H
1981-01-10,1980,Leeds United,Southampton,0-3,0,3,1,1,3,-3,A
1981-01-10,1980,Leicester City,West Bromwich Albion,0-2,0,2,1,1,2,-2,A
1981-01-10,1980,Manchester United,Brighton & Hove Albion,2-1,2,1,1,1,3,1,H
1981-01-10,1980,Sunderland,Norwich City,3-0,3,0,1,1,3,3,H
1981-01-10,1980,Tottenham Hotspur,Birmingham City,1-0,1,0,1,1,1,1,H
1981-01-10,1980,Wolverhampton Wanderers,Middlesbrough,3-0,3,0,1,1,3,3,H
1981-01-13,1980,Ipswich Town,Birmingham City,5-1,5,1,1,1,6,4,H
1981-01-17,1980,Birmingham City,Southampton,0-3,0,3,1,1,3,-3,A
1981-01-17,1980,Coventry City,Aston Villa,1-2,1,2,1,1,3,-1,A
1981-01-17,1980,Crystal Palace,Wolverhampton Wanderers,0-0,0,0,1,1,0,0,D
1981-01-17,1980,Everton,Ipswich Town,0-0,0,0,1,1,0,0,D
1981-01-17,1980,Leicester City,Leeds United,0-1,0,1,1,1,1,-1,A
1981-01-17,1980,Manchester City,Middlesbrough,3-2,3,2,1,1,5,1,H
1981-01-17,1980,Norwich City,Liverpool,0-1,0,1,1,1,1,-1,A
1981-01-17,1980,Tottenham Hotspur,Arsenal,2-0,2,0,1,1,2,2,H
1981-01-17,1980,West Bromwich Albion,Brighton & Hove Albion,2-0,2,0,1,1,2,2,H
1981-01-28,1980,Sunderland,Manchester United,2-0,2,0,1,1,2,2,H
1981-01-31,1980,Arsenal,Coventry City,2-2,2,2,1,1,4,0,D
1981-01-31,1980,Aston Villa,Manchester City,1-0,1,0,1,1,1,1,H
1981-01-31,1980,Brighton & Hove Albion,Tottenham Hotspur,0-2,0,2,1,1,2,-2,A
1981-01-31,1980,Ipswich Town,Stoke City,4-0,4,0,1,1,4,4,H
1981-01-31,1980,Leeds United,Norwich City,1-0,1,0,1,1,1,1,H
1981-01-31,1980,Liverpool,Leicester City,1-2,1,2,1,1,3,-1,A
1981-01-31,1980,Manchester United,Birmingham City,2-0,2,0,1,1,2,2,H
1981-01-31,1980,Middlesbrough,Crystal Palace,2-0,2,0,1,1,2,2,H
1981-01-31,1980,Nottingham Forest,Everton,1-0,1,0,1,1,1,1,H
1981-01-31,1980,Southampton,Sunderland,2-1,2,1,1,1,3,1,H
1981-01-31,1980,Wolverhampton Wanderers,West Bromwich Albion,2-0,2,0,1,1,2,2,H
1981-02-07,1980,Birmingham City,Brighton & Hove Albion,2-1,2,1,1,1,3,1,H
1981-02-07,1980,Coventry City,Wolverhampton Wanderers,2-2,2,2,1,1,4,0,D
1981-02-07,1980,Everton,Aston Villa,1-3,1,3,1,1,4,-2,A
1981-02-07,1980,Ipswich Town,Crystal Palace,3-2,3,2,1,1,5,1,H
1981-02-07,1980,Leicester City,Manchester United,1-0,1,0,1,1,1,1,H
1981-02-07,1980,Manchester City,Nottingham Forest,1-1,1,1,1,1,2,0,D
1981-02-07,1980,Middlesbrough,Sunderland,1-0,1,0,1,1,1,1,H
1981-02-07,1980,Southampton,Norwich City,2-1,2,1,1,1,3,1,H
1981-02-07,1980,Stoke City,Arsenal,1-1,1,1,1,1,2,0,D
1981-02-07,1980,Tottenham Hotspur,Leeds United,1-1,1,1,1,1,2,0,D
1981-02-07,1980,West Bromwich Albion,Liverpool,2-0,2,0,1,1,2,2,H
1981-02-14,1980,Leeds United,Stoke City,1-3,1,3,1,1,4,-2,A
1981-02-14,1980,Liverpool,Birmingham City,2-2,2,2,1,1,4,0,D
1981-02-14,1980,Norwich City,West Bromwich Albion,0-2,0,2,1,1,2,-2,A
1981-02-14,1980,Sunderland,Leicester City,1-0,1,0,1,1,1,1,H
1981-02-17,1980,Crystal Palace,Coventry City,0-3,0,3,1,1,3,-3,A
1981-02-17,1980,Ipswich Town,Middlesbrough,1-0,1,0,1,1,1,1,H
1981-02-17,1980,Manchester United,Tottenham Hotspur,0-0,0,0,1,1,0,0,D
1981-02-18,1980,Stoke City,Nottingham Forest,1-2,1,2,1,1,3,-1,A
1981-02-20,1980,Birmingham City,Norwich City,4-0,4,0,1,1,4,4,H
1981-02-21,1980,Aston Villa,Crystal Palace,2-1,2,1,1,1,3,1,H
1981-02-21,1980,Brighton & Hove Albion,Liverpool,2-2,2,2,1,1,4,0,D
1981-02-21,1980,Everton,Coventry City,3-0,3,0,1,1,3,3,H
1981-02-21,1980,Ipswich Town,Wolverhampton Wanderers,3-1,3,1,1,1,4,2,H
1981-02-21,1980,Leeds United,Sunderland,1-0,1,0,1,1,1,1,H
1981-02-21,1980,Manchester City,Manchester United,1-0,1,0,1,1,1,1,H
1981-02-21,1980,Middlesbrough,Stoke City,3-1,3,1,1,1,4,2,H
1981-02-21,1980,Nottingham Forest,Arsenal,3-1,3,1,1,1,4,2,H
1981-02-21,1980,Southampton,West Bromwich Albion,2-2,2,2,1,1,4,0,D
1981-02-21,1980,Tottenham Hotspur,Leicester City,1-2,1,2,1,1,3,-1,A
1981-02-24,1980,Arsenal,Manchester City,2-0,2,0,1,1,2,2,H
1981-02-24,1980,Brighton & Hove Albion,Southampton,2-0,2,0,1,1,2,2,H
1981-02-28,1980,Arsenal,Middlesbrough,2-2,2,2,1,1,4,0,D
1981-02-28,1980,Coventry City,Ipswich Town,0-4,0,4,1,1,4,-4,A
1981-02-28,1980,Crystal Palace,Everton,2-3,2,3,1,1,5,-1,A
1981-02-28,1980,Leicester City,Nottingham Forest,1-1,1,1,1,1,2,0,D
1981-02-28,1980,Liverpool,Southampton,2-0,2,0,1,1,2,2,H
1981-02-28,1980,Manchester United,Leeds United,0-1,0,1,1,1,1,-1,A
1981-02-28,1980,Norwich City,Brighton & Hove Albion,3-1,3,1,1,1,4,2,H
1981-02-28,1980,Sunderland,Tottenham Hotspur,1-1,1,1,1,1,2,0,D
1981-02-28,1980,West Bromwich Albion,Birmingham City,2-2,2,2,1,1,4,0,D
1981-02-28,1980,Wolverhampton Wanderers,Aston Villa,0-1,0,1,1,1,1,-1,A
1981-03-03,1980,Nottingham Forest,Middlesbrough,1-0,1,0,1,1,1,1,H
1981-03-07,1980,Brighton & Hove Albion,Coventry City,4-1,4,1,1,1,5,3,H
1981-03-07,1980,Leicester City,Arsenal,1-0,1,0,1,1,1,1,H
1981-03-07,1980,Southampton,Manchester United,1-0,1,0,1,1,1,1,H
1981-03-07,1980,Sunderland,Aston Villa,1-2,1,2,1,1,3,-1,A
1981-03-07,1980,West Bromwich Albion,Crystal Palace,1-0,1,0,1,1,1,1,H
1981-03-11,1980,Tottenham Hotspur,Stoke City,2-2,2,2,1,1,4,0,D
1981-03-14,1980,Aston Villa,Manchester United,3-3,3,3,1,1,6,0,D
1981-03-14,1980,Coventry City,Leicester City,4-1,4,1,1,1,5,3,H
1981-03-14,1980,Crystal Palace,Sunderland,0-1,0,1,1,1,1,-1,A
1981-03-14,1980,Everton,Leeds United,1-2,1,2,1,1,3,-1,A
1981-03-14,1980,Ipswich Town,Tottenham Hotspur,3-0,3,0,1,1,3,3,H
1981-03-14,1980,Manchester City,West Bromwich Albion,2-1,2,1,1,1,3,1,H
1981-03-14,1980,Nottingham Forest,Brighton & Hove Albion,4-1,4,1,1,1,5,3,H
1981-03-14,1980,Stoke City,Southampton,1-2,1,2,1,1,3,-1,A
1981-03-14,1980,Wolverhampton Wanderers,Norwich City,3-0,3,0,1,1,3,3,H
1981-03-17,1980,Birmingham City,Wolverhampton Wanderers,1-0,1,0,1,1,1,1,H
1981-03-17,1980,Norwich City,Middlesbrough,2-0,2,0,1,1,2,2,H
1981-03-17,1980,Southampton,Everton,3-0,3,0,1,1,3,3,H
1981-03-18,1980,Manchester United,Nottingham Forest,1-1,1,1,1,1,2,0,D
1981-03-18,1980,Stoke City,Manchester City,2-1,2,1,1,1,3,1,H
1981-03-21,1980,Birmingham City,Manchester City,2-0,2,0,1,1,2,2,H
1981-03-21,1980,Brighton & Hove Albion,Stoke City,1-1,1,1,1,1,2,0,D
1981-03-21,1980,Leeds United,Wolverhampton Wanderers,1-3,1,3,1,1,4,-2,A
1981-03-21,1980,Leicester City,Crystal Palace,1-1,1,1,1,1,2,0,D
1981-03-21,1980,Liverpool,Everton,1-0,1,0,1,1,1,1,H
1981-03-21,1980,Manchester United,Ipswich Town,2-1,2,1,1,1,3,1,H
1981-03-21,1980,Norwich City,Arsenal,1-1,1,1,1,1,2,0,D
1981-03-21,1980,Southampton,Middlesbrough,1-0,1,0,1,1,1,1,H
1981-03-21,1980,Sunderland,Coventry City,3-0,3,0,1,1,3,3,H
1981-03-21,1980,Tottenham Hotspur,Aston Villa,2-0,2,0,1,1,2,2,H
1981-03-21,1980,West Bromwich Albion,Nottingham Forest,2-1,2,1,1,1,3,1,H
1981-03-28,1980,Arsenal,Liverpool,1-0,1,0,1,1,1,1,H
1981-03-28,1980,Aston Villa,Southampton,2-1,2,1,1,1,3,1,H
1981-03-28,1980,Coventry City,Tottenham Hotspur,0-1,0,1,1,1,1,-1,A
1981-03-28,1980,Crystal Palace,Leeds United,0-1,0,1,1,1,1,-1,A
1981-03-28,1980,Everton,Manchester United,0-1,0,1,1,1,1,-1,A
1981-03-28,1980,Ipswich Town,Sunderland,4-1,4,1,1,1,5,3,H
1981-03-28,1980,Manchester City,Brighton & Hove Albion,1-1,1,1,1,1,2,0,D
1981-03-28,1980,Middlesbrough,West Bromwich Albion,2-1,2,1,1,1,3,1,H
1981-03-28,1980,Nottingham Forest,Norwich City,2-1,2,1,1,1,3,1,H
1981-03-28,1980,Stoke City,Birmingham City,0-0,0,0,1,1,0,0,D
1981-03-28,1980,Wolverhampton Wanderers,Leicester City,0-1,0,1,1,1,1,-1,A
1981-03-31,1980,Arsenal,Birmingham City,2-1,2,1,1,1,3,1,H
1981-03-31,1980,Leeds United,Ipswich Town,3-0,3,0,1,1,3,3,H
1981-03-31,1980,Manchester City,Leicester City,3-3,3,3,1,1,6,0,D
1981-03-31,1980,West Bromwich Albion,Everton,2-0,2,0,1,1,2,2,H
1981-04-03,1980,Liverpool,Stoke City,3-0,3,0,1,1,3,3,H
1981-04-04,1980,Birmingham City,Middlesbrough,2-1,2,1,1,1,3,1,H
1981-04-04,1980,Brighton & Hove Albion,Arsenal,0-1,0,1,1,1,1,-1,A
1981-04-04,1980,Leeds United,Coventry City,3-0,3,0,1,1,3,3,H
1981-04-04,1980,Leicester City,Aston Villa,2-4,2,4,1,1,6,-2,A
1981-04-04,1980,Manchester United,Crystal Palace,1-0,1,0,1,1,1,1,H
1981-04-04,1980,Norwich City,Manchester City,2-0,2,0,1,1,2,2,H
1981-04-04,1980,Southampton,Nottingham Forest,2-0,2,0,1,1,2,2,H
1981-04-04,1980,Sunderland,Wolverhampton Wanderers,0-1,0,1,1,1,1,-1,A
1981-04-04,1980,Tottenham Hotspur,Everton,2-2,2,2,1,1,4,0,D
1981-04-04,1980,West Bromwich Albion,Ipswich Town,3-1,3,1,1,1,4,2,H
1981-04-08,1980,Aston Villa,West Bromwich Albion,1-0,1,0,1,1,1,1,H
1981-04-11,1980,Arsenal,Leeds United,0-0,0,0,1,1,0,0,D
1981-04-11,1980,Coventry City,Manchester United,0-2,0,2,1,1,2,-2,A
1981-04-11,1980,Crystal Palace,Birmingham City,3-1,3,1,1,1,4,2,H
1981-04-11,1980,Everton,Norwich City,0-2,0,2,1,1,2,-2,A
1981-04-11,1980,Middlesbrough,Brighton & Hove Albion,1-0,1,0,1,1,1,1,H
1981-04-11,1980,Nottingham Forest,Liverpool,0-0,0,0,1,1,0,0,D
1981-04-11,1980,Stoke City,Sunderland,2-0,2,0,1,1,2,2,H
1981-04-14,1980,Aston Villa,Ipswich Town,1-2,1,2,1,1,3,-1,A
1981-04-14,1980,Liverpool,Manchester United,0-1,0,1,1,1,1,-1,A
1981-04-18,1980,Aston Villa,Nottingham Forest,2-0,2,0,1,1,2,2,H
1981-04-18,1980,Coventry City,Stoke City,2-2,2,2,1,1,4,0,D
1981-04-18,1980,Crystal Palace,Brighton & Hove Albion,0-3,0,3,1,1,3,-3,A
1981-04-18,1980,Everton,Middlesbrough,4-1,4,1,1,1,5,3,H
1981-04-18,1980,Ipswich Town,Arsenal,0-2,0,2,1,1,2,-2,A
1981-04-18,1980,Leeds United,Liverpool,0-0,0,0,1,1,0,0,D
1981-04-18,1980,Leicester City,Southampton,2-2,2,2,1,1,4,0,D
1981-04-18,1980,Manchester United,West Bromwich Albion,2-1,2,1,1,1,3,1,H
1981-04-18,1980,Sunderland,Birmingham City,3-0,3,0,1,1,3,3,H
1981-04-18,1980,Tottenham Hotspur,Norwich City,2-3,2,3,1,1,5,-1,A
1981-04-18,1980,Wolverhampton Wanderers,Manchester City,1-3,1,3,1,1,4,-2,A
1981-04-20,1980,Arsenal,Crystal Palace,3-2,3,2,1,1,5,1,H
1981-04-20,1980,Brighton & Hove Albion,Leicester City,2-1,2,1,1,1,3,1,H
1981-04-20,1980,Manchester City,Everton,3-1,3,1,1,1,4,2,H
1981-04-20,1980,Norwich City,Ipswich Town,1-0,1,0,1,1,1,1,H
1981-04-20,1980,Nottingham Forest,Wolverhampton Wanderers,1-0,1,0,1,1,1,1,H
1981-04-20,1980,Southampton,Tottenham Hotspur,1-1,1,1,1,1,2,0,D
1981-04-20,1980,Stoke City,Aston Villa,1-1,1,1,1,1,2,0,D
1981-04-20,1980,West Bromwich Albion,Sunderland,2-1,2,1,1,1,3,1,H
1981-04-21,1980,Birmingham City,Leeds United,0-2,0,2,1,1,2,-2,A
1981-04-21,1980,Middlesbrough,Coventry City,0-1,0,1,1,1,1,-1,A
1981-04-25,1980,Aston Villa,Middlesbrough,3-0,3,0,1,1,3,3,H
1981-04-25,1980,Coventry City,Southampton,1-0,1,0,1,1,1,1,H
1981-04-25,1980,Crystal Palace,Nottingham Forest,1-3,1,3,1,1,4,-2,A
1981-04-25,1980,Everton,Stoke City,0-1,0,1,1,1,1,-1,A
1981-04-25,1980,Ipswich Town,Manchester City,1-0,1,0,1,1,1,1,H
1981-04-25,1980,Leicester City,Birmingham City,1-0,1,0,1,1,1,1,H
1981-04-25,1980,Manchester United,Norwich City,1-0,1,0,1,1,1,1,H
1981-04-25,1980,Sunderland,Brighton & Hove Albion,1-2,1,2,1,1,3,-1,A
1981-04-25,1980,Tottenham Hotspur,Liverpool,1-1,1,1,1,1,2,0,D
1981-04-25,1980,Wolverhampton Wanderers,Arsenal,1-2,1,2,1,1,3,-1,A
1981-04-30,1980,Wolverhampton Wanderers,Tottenham Hotspur,1-0,1,0,1,1,1,1,H
1981-05-02,1980,Arsenal,Aston Villa,2-0,2,0,1,1,2,2,H
1981-05-02,1980,Birmingham City,Everton,1-1,1,1,1,1,2,0,D
1981-05-02,1980,Brighton & Hove Albion,Leeds United,2-0,2,0,1,1,2,2,H
1981-05-02,1980,Liverpool,Sunderland,0-1,0,1,1,1,1,-1,A
1981-05-02,1980,Manchester City,Crystal Palace,1-1,1,1,1,1,2,0,D
1981-05-02,1980,Middlesbrough,Ipswich Town,2-1,2,1,1,1,3,1,H
1981-05-02,1980,Norwich City,Leicester City,2-3,2,3,1,1,5,-1,A
1981-05-02,1980,Nottingham Forest,Coventry City,1-1,1,1,1,1,2,0,D
1981-05-02,1980,Stoke City,Wolverhampton Wanderers,3-2,3,2,1,1,5,1,H
1981-05-02,1980,West Bromwich Albion,Tottenham Hotspur,4-2,4,2,1,1,6,2,H
1981-05-04,1980,Wolverhampton Wanderers,Everton,0-0,0,0,1,1,0,0,D
1981-05-05,1980,Middlesbrough,Liverpool,1-2,1,2,1,1,3,-1,A
1981-05-06,1980,Leeds United,West Bromwich Albion,0-0,0,0,1,1,0,0,D
1981-05-13,1980,Ipswich Town,Southampton,2-3,2,3,1,1,5,-1,A
1981-05-19,1980,Liverpool,Manchester City,1-0,1,0,1,1,1,1,H
1981-08-29,1981,Arsenal,Stoke City,0-1,0,1,1,1,1,-1,A
1981-08-29,1981,Aston Villa,Notts County,0-1,0,1,1,1,1,-1,A
1981-08-29,1981,Coventry City,Manchester United,2-1,2,1,1,1,3,1,H
1981-08-29,1981,Everton,Birmingham City,3-1,3,1,1,1,4,2,H
1981-08-29,1981,Ipswich Town,Sunderland,3-3,3,3,1,1,6,0,D
1981-08-29,1981,Manchester City,West Bromwich Albion,2-1,2,1,1,1,3,1,H
1981-08-29,1981,Middlesbrough,Tottenham Hotspur,1-3,1,3,1,1,4,-2,A
1981-08-29,1981,Nottingham Forest,Southampton,2-1,2,1,1,1,3,1,H
1981-08-29,1981,Swansea City,Leeds United,5-1,5,1,1,1,6,4,H
1981-08-29,1981,West Ham United,Brighton & Hove Albion,1-1,1,1,1,1,2,0,D
1981-08-29,1981,Wolverhampton Wanderers,Liverpool,1-0,1,0,1,1,1,1,H
1981-08-31,1981,Manchester United,Nottingham Forest,0-0,0,0,1,1,0,0,D
1981-09-01,1981,Birmingham City,Ipswich Town,1-1,1,1,1,1,2,0,D
1981-09-01,1981,Brighton & Hove Albion,Swansea City,1-2,1,2,1,1,3,-1,A
1981-09-01,1981,Liverpool,Middlesbrough,1-1,1,1,1,1,2,0,D
1981-09-01,1981,Notts County,Manchester City,1-1,1,1,1,1,2,0,D
1981-09-01,1981,Southampton,Wolverhampton Wanderers,4-1,4,1,1,1,5,3,H
1981-09-02,1981,Leeds United,Everton,1-1,1,1,1,1,2,0,D
1981-09-02,1981,Stoke City,Coventry City,4-0,4,0,1,1,4,4,H
1981-09-02,1981,Sunderland,Aston Villa,2-1,2,1,1,1,3,1,H
1981-09-02,1981,Tottenham Hotspur,West Ham United,0-4,0,4,1,1,4,-4,A
1981-09-02,1981,West Bromwich Albion,Arsenal,0-2,0,2,1,1,2,-2,A
1981-09-05,1981,Birmingham City,Nottingham Forest,4-3,4,3,1,1,7,1,H
1981-09-05,1981,Brighton & Hove Albion,Middlesbrough,2-0,2,0,1,1,2,2,H
1981-09-05,1981,Leeds United,Wolverhampton Wanderers,3-0,3,0,1,1,3,3,H
1981-09-05,1981,Liverpool,Arsenal,2-0,2,0,1,1,2,2,H
1981-09-05,1981,Manchester United,Ipswich Town,1-2,1,2,1,1,3,-1,A
1981-09-05,1981,Notts County,Coventry City,2-1,2,1,1,1,3,1,H
1981-09-05,1981,Southampton,Everton,1-0,1,0,1,1,1,1,H
1981-09-05,1981,Stoke City,Manchester City,1-3,1,3,1,1,4,-2,A
1981-09-05,1981,Sunderland,West Ham United,0-2,0,2,1,1,2,-2,A
1981-09-05,1981,Tottenham Hotspur,Aston Villa,1-3,1,3,1,1,4,-2,A
1981-09-05,1981,West Bromwich Albion,Swansea City,4-1,4,1,1,1,5,3,H
1981-09-12,1981,Arsenal,Sunderland,1-1,1,1,1,1,2,0,D
1981-09-12,1981,Aston Villa,Manchester United,1-1,1,1,1,1,2,0,D
1981-09-12,1981,Coventry City,Leeds United,4-0,4,0,1,1,4,4,H
1981-09-12,1981,Everton,Brighton & Hove Albion,1-1,1,1,1,1,2,0,D
1981-09-12,1981,Ipswich Town,Liverpool,2-0,2,0,1,1,2,2,H
1981-09-12,1981,Manchester City,Southampton,1-1,1,1,1,1,2,0,D
1981-09-12,1981,Middlesbrough,Birmingham City,2-1,2,1,1,1,3,1,H
1981-09-12,1981,Nottingham Forest,West Bromwich Albion,0-0,0,0,1,1,0,0,D
1981-09-12,1981,Swansea City,Notts County,3-2,3,2,1,1,5,1,H
1981-09-12,1981,West Ham United,Stoke City,3-2,3,2,1,1,5,1,H
1981-09-12,1981,Wolverhampton Wanderers,Tottenham Hotspur,0-1,0,1,1,1,1,-1,A
1981-09-19,1981,Birmingham City,Manchester City,3-0,3,0,1,1,3,3,H
1981-09-19,1981,Brighton & Hove Albion,Coventry City,2-2,2,2,1,1,4,0,D
1981-09-19,1981,Leeds United,Arsenal,0-0,0,0,1,1,0,0,D
1981-09-19,1981,Liverpool,Aston Villa,0-0,0,0,1,1,0,0,D
1981-09-19,1981,Manchester United,Swansea City,1-0,1,0,1,1,1,1,H
1981-09-19,1981,Notts County,Ipswich Town,1-4,1,4,1,1,5,-3,A
1981-09-19,1981,Southampton,Middlesbrough,2-0,2,0,1,1,2,2,H
1981-09-19,1981,Stoke City,Nottingham Forest,1-2,1,2,1,1,3,-1,A
1981-09-19,1981,Sunderland,Wolverhampton Wanderers,0-0,0,0,1,1,0,0,D
1981-09-19,1981,Tottenham Hotspur,Everton,3-0,3,0,1,1,3,3,H
1981-09-19,1981,West Bromwich Albion,West Ham United,0-0,0,0,1,1,0,0,D
1981-09-22,1981,Arsenal,Birmingham City,1-0,1,0,1,1,1,1,H
1981-09-22,1981,Coventry City,Liverpool,1-2,1,2,1,1,3,-1,A
1981-09-22,1981,Everton,Notts County,3-1,3,1,1,1,4,2,H
1981-09-22,1981,Ipswich Town,West Bromwich Albion,1-0,1,0,1,1,1,1,H
1981-09-22,1981,Middlesbrough,Manchester United,0-2,0,2,1,1,2,-2,A
1981-09-22,1981,Swansea City,Tottenham Hotspur,2-1,2,1,1,1,3,1,H
1981-09-22,1981,West Ham United,Southampton,4-2,4,2,1,1,6,2,H
1981-09-22,1981,Wolverhampton Wanderers,Brighton & Hove Albion,0-1,0,1,1,1,1,-1,A
1981-09-23,1981,Aston Villa,Stoke City,2-2,2,2,1,1,4,0,D
1981-09-23,1981,Manchester City,Leeds United,4-0,4,0,1,1,4,4,H
1981-09-23,1981,Nottingham Forest,Sunderland,2-0,2,0,1,1,2,2,H
1981-09-26,1981,Arsenal,Manchester United,0-0,0,0,1,1,0,0,D
1981-09-26,1981,Aston Villa,Birmingham City,0-0,0,0,1,1,0,0,D
1981-09-26,1981,Coventry City,Southampton,4-2,4,2,1,1,6,2,H
1981-09-26,1981,Everton,West Bromwich Albion,1-0,1,0,1,1,1,1,H
1981-09-26,1981,Ipswich Town,Leeds United,2-1,2,1,1,1,3,1,H
1981-09-26,1981,Manchester City,Tottenham Hotspur,0-1,0,1,1,1,1,-1,A
1981-09-26,1981,Middlesbrough,Stoke City,3-2,3,2,1,1,5,1,H
1981-09-26,1981,Nottingham Forest,Brighton & Hove Albion,2-1,2,1,1,1,3,1,H
1981-09-26,1981,Swansea City,Sunderland,2-0,2,0,1,1,2,2,H
1981-09-26,1981,West Ham United,Liverpool,1-1,1,1,1,1,2,0,D
1981-09-26,1981,Wolverhampton Wanderers,Notts County,3-2,3,2,1,1,5,1,H
1981-09-30,1981,Manchester United,Leeds United,1-0,1,0,1,1,1,1,H
1981-10-03,1981,Birmingham City,West Ham United,2-2,2,2,1,1,4,0,D
1981-10-03,1981,Brighton & Hove Albion,Manchester City,4-1,4,1,1,1,5,3,H
1981-10-03,1981,Leeds United,Aston Villa,1-1,1,1,1,1,2,0,D
1981-10-03,1981,Liverpool,Swansea City,2-2,2,2,1,1,4,0,D
1981-10-03,1981,Manchester United,Wolverhampton Wanderers,5-0,5,0,1,1,5,5,H
1981-10-03,1981,Notts County,Arsenal,2-1,2,1,1,1,3,1,H
1981-10-03,1981,Southampton,Ipswich Town,4-3,4,3,1,1,7,1,H
1981-10-03,1981,Stoke City,Everton,3-1,3,1,1,1,4,2,H
1981-10-03,1981,Sunderland,Coventry City,0-0,0,0,1,1,0,0,D
1981-10-03,1981,Tottenham Hotspur,Nottingham Forest,3-0,3,0,1,1,3,3,H
1981-10-03,1981,West Bromwich Albion,Middlesbrough,2-0,2,0,1,1,2,2,H
1981-10-10,1981,Birmingham City,Southampton,4-0,4,0,1,1,4,4,H
1981-10-10,1981,Coventry City,Aston Villa,1-1,1,1,1,1,2,0,D
1981-10-10,1981,Ipswich Town,Wolverhampton Wanderers,1-0,1,0,1,1,1,1,H
1981-10-10,1981,Liverpool,Leeds United,3-0,3,0,1,1,3,3,H
1981-10-10,1981,Manchester City,Manchester United,0-0,0,0,1,1,0,0,D
1981-10-10,1981,Middlesbrough,Nottingham Forest,1-1,1,1,1,1,2,0,D
1981-10-10,1981,Notts County,Sunderland,2-0,2,0,1,1,2,2,H
1981-10-10,1981,Swansea City,Arsenal,2-0,2,0,1,1,2,2,H
1981-10-10,1981,Tottenham Hotspur,Stoke City,2-0,2,0,1,1,2,2,H
1981-10-10,1981,West Bromwich Albion,Brighton & Hove Albion,0-0,0,0,1,1,0,0,D
1981-10-10,1981,West Ham United,Everton,1-1,1,1,1,1,2,0,D
1981-10-17,1981,Arsenal,Manchester City,1-0,1,0,1,1,1,1,H
1981-10-17,1981,Aston Villa,West Ham United,3-2,3,2,1,1,5,1,H
1981-10-17,1981,Brighton & Hove Albion,Liverpool,3-3,3,3,1,1,6,0,D
1981-10-17,1981,Everton,Ipswich Town,2-1,2,1,1,1,3,1,H
1981-10-17,1981,Leeds United,West Bromwich Albion,3-1,3,1,1,1,4,2,H
1981-10-17,1981,Manchester United,Birmingham City,1-1,1,1,1,1,2,0,D
1981-10-17,1981,Nottingham Forest,Coventry City,2-1,2,1,1,1,3,1,H
1981-10-17,1981,Southampton,Notts County,3-1,3,1,1,1,4,2,H
1981-10-17,1981,Stoke City,Swansea City,1-2,1,2,1,1,3,-1,A
1981-10-17,1981,Sunderland,Tottenham Hotspur,0-2,0,2,1,1,2,-2,A
1981-10-17,1981,Wolverhampton Wanderers,Middlesbrough,0-0,0,0,1,1,0,0,D
1981-10-21,1981,Manchester United,Middlesbrough,1-0,1,0,1,1,1,1,H
1981-10-24,1981,Coventry City,Swansea City,3-1,3,1,1,1,4,2,H
1981-10-24,1981,Ipswich Town,Arsenal,2-1,2,1,1,1,3,1,H
1981-10-24,1981,Leeds United,Sunderland,1-0,1,0,1,1,1,1,H
1981-10-24,1981,Liverpool,Manchester United,1-2,1,2,1,1,3,-1,A
1981-10-24,1981,Manchester City,Nottingham Forest,0-0,0,0,1,1,0,0,D
1981-10-24,1981,Middlesbrough,Everton,0-2,0,2,1,1,2,-2,A
1981-10-24,1981,Notts County,West Ham United,1-1,1,1,1,1,2,0,D
1981-10-24,1981,Stoke City,Birmingham City,1-0,1,0,1,1,1,1,H
1981-10-24,1981,Tottenham Hotspur,Brighton & Hove Albion,0-1,0,1,1,1,1,-1,A
1981-10-24,1981,West Bromwich Albion,Southampton,1-1,1,1,1,1,2,0,D
1981-10-24,1981,Wolverhampton Wanderers,Aston Villa,0-3,0,3,1,1,3,-3,A
1981-10-31,1981,Arsenal,Coventry City,1-0,1,0,1,1,1,1,H
1981-10-31,1981,Aston Villa,Ipswich Town,0-1,0,1,1,1,1,-1,A
1981-10-31,1981,Birmingham City,West Bromwich Albion,3-3,3,3,1,1,6,0,D
1981-10-31,1981,Brighton & Hove Albion,Stoke City,0-0,0,0,1,1,0,0,D
1981-10-31,1981,Everton,Manchester City,0-1,0,1,1,1,1,-1,A
1981-10-31,1981,Manchester United,Notts County,2-1,2,1,1,1,3,1,H
1981-10-31,1981,Nottingham Forest,Leeds United,2-1,2,1,1,1,3,1,H
1981-10-31,1981,Southampton,Tottenham Hotspur,1-2,1,2,1,1,3,-1,A
1981-10-31,1981,Sunderland,Liverpool,0-2,0,2,1,1,2,-2,A
1981-10-31,1981,Swansea City,Wolverhampton Wanderers,0-0,0,0,1,1,0,0,D
1981-10-31,1981,West Ham United,Middlesbrough,3-2,3,2,1,1,5,1,H
1981-11-07,1981,Aston Villa,Arsenal,0-2,0,2,1,1,2,-2,A
1981-11-07,1981,Brighton & Hove Albion,Birmingham City,1-1,1,1,1,1,2,0,D
1981-11-07,1981,Ipswich Town,Swansea City,2-3,2,3,1,1,5,-1,A
1981-11-07,1981,Leeds United,Notts County,1-0,1,0,1,1,1,1,H
1981-11-07,1981,Liverpool,Everton,3-1,3,1,1,1,4,2,H
1981-11-07,1981,Manchester City,Middlesbrough,3-2,3,2,1,1,5,1,H
1981-11-07,1981,Nottingham Forest,West Ham United,0-0,0,0,1,1,0,0,D
1981-11-07,1981,Stoke City,Southampton,0-2,0,2,1,1,2,-2,A
1981-11-07,1981,Sunderland,Manchester United,1-5,1,5,1,1,6,-4,A
1981-11-07,1981,Tottenham Hotspur,West Bromwich Albion,1-2,1,2,1,1,3,-1,A
1981-11-07,1981,Wolverhampton Wanderers,Coventry City,1-0,1,0,1,1,1,1,H
1981-11-14,1981,Middlesbrough,Sunderland,0-0,0,0,1,1,0,0,D
1981-11-14,1981,West Bromwich Albion,Stoke City,1-2,1,2,1,1,3,-1,A
1981-11-21,1981,Birmingham City,Wolverhampton Wanderers,0-3,0,3,1,1,3,-3,A
1981-11-21,1981,Brighton & Hove Albion,Notts County,2-2,2,2,1,1,4,0,D
1981-11-21,1981,Everton,Sunderland,1-2,1,2,1,1,3,-1,A
1981-11-21,1981,Manchester City,Swansea City,4-0,4,0,1,1,4,4,H
1981-11-21,1981,Middlesbrough,Aston Villa,3-3,3,3,1,1,6,0,D
1981-11-21,1981,Nottingham Forest,Arsenal,1-2,1,2,1,1,3,-1,A
1981-11-21,1981,Southampton,Leeds United,4-0,4,0,1,1,4,4,H
1981-11-21,1981,Stoke City,Ipswich Town,2-0,2,0,1,1,2,2,H
1981-11-21,1981,Tottenham Hotspur,Manchester United,3-1,3,1,1,1,4,2,H
1981-11-21,1981,West Bromwich Albion,Liverpool,1-1,1,1,1,1,2,0,D
1981-11-21,1981,West Ham United,Coventry City,5-2,5,2,1,1,7,3,H
1981-11-24,1981,Coventry City,Stoke City,3-0,3,0,1,1,3,3,H
1981-11-24,1981,Notts County,Everton,2-2,2,2,1,1,4,0,D
1981-11-24,1981,Swansea City,Brighton & Hove Albion,0-0,0,0,1,1,0,0,D
1981-11-24,1981,Wolverhampton Wanderers,Southampton,0-0,0,0,1,1,0,0,D
1981-11-25,1981,Sunderland,Nottingham Forest,2-3,2,3,1,1,5,-1,A
1981-11-28,1981,Arsenal,Everton,1-0,1,0,1,1,1,1,H
1981-11-28,1981,Aston Villa,Nottingham Forest,3-1,3,1,1,1,4,2,H
1981-11-28,1981,Coventry City,Middlesbrough,1-1,1,1,1,1,2,0,D
1981-11-28,1981,Ipswich Town,Manchester City,2-0,2,0,1,1,2,2,H
1981-11-28,1981,Leeds United,West Ham United,3-3,3,3,1,1,6,0,D
1981-11-28,1981,Liverpool,Southampton,0-1,0,1,1,1,1,-1,A
1981-11-28,1981,Manchester United,Brighton & Hove Albion,2-0,2,0,1,1,2,2,H
1981-11-28,1981,Notts County,Tottenham Hotspur,2-2,2,2,1,1,4,0,D
1981-11-28,1981,Sunderland,West Bromwich Albion,1-2,1,2,1,1,3,-1,A
1981-11-28,1981,Swansea City,Birmingham City,1-0,1,0,1,1,1,1,H
1981-11-28,1981,Wolverhampton Wanderers,Stoke City,2-0,2,0,1,1,2,2,H
1981-12-05,1981,Birmingham City,Notts County,2-1,2,1,1,1,3,1,H
1981-12-05,1981,Brighton & Hove Albion,Sunderland,2-1,2,1,1,1,3,1,H
1981-12-05,1981,Everton,Swansea City,3-1,3,1,1,1,4,2,H
1981-12-05,1981,Manchester City,Aston Villa,1-0,1,0,1,1,1,1,H
1981-12-05,1981,Middlesbrough,Ipswich Town,0-1,0,1,1,1,1,-1,A
1981-12-05,1981,Nottingham Forest,Liverpool,0-2,0,2,1,1,2,-2,A
1981-12-05,1981,Southampton,Manchester United,3-2,3,2,1,1,5,1,H
1981-12-05,1981,Stoke City,Leeds United,1-2,1,2,1,1,3,-1,A
1981-12-05,1981,Tottenham Hotspur,Coventry City,1-2,1,2,1,1,3,-1,A
1981-12-05,1981,West Bromwich Albion,Wolverhampton Wanderers,3-0,3,0,1,1,3,3,H
1981-12-05,1981,West Ham United,Arsenal,1-2,1,2,1,1,3,-1,A
1981-12-08,1981,Southampton,Brighton & Hove Albion,0-2,0,2,1,1,2,-2,A
1981-12-12,1981,Coventry City,Manchester City,0-1,0,1,1,1,1,-1,A
1981-12-12,1981,Leeds United,Tottenham Hotspur,0-0,0,0,1,1,0,0,D
1981-12-12,1981,Swansea City,Nottingham Forest,1-2,1,2,1,1,3,-1,A
1981-12-15,1981,Swansea City,Aston Villa,2-1,2,1,1,1,3,1,H
1981-12-19,1981,Everton,Aston Villa,2-0,2,0,1,1,2,2,H
1981-12-19,1981,Manchester City,Sunderland,2-3,2,3,1,1,5,-1,A
1981-12-26,1981,Coventry City,West Bromwich Albion,0-2,0,2,1,1,2,-2,A
1981-12-26,1981,Liverpool,Manchester City,1-3,1,3,1,1,4,-2,A
1981-12-28,1981,Brighton & Hove Albion,Aston Villa,0-1,0,1,1,1,1,-1,A
1981-12-28,1981,Everton,Coventry City,3-2,3,2,1,1,5,1,H
1981-12-28,1981,Manchester City,Wolverhampton Wanderers,2-1,2,1,1,1,3,1,H
1981-12-28,1981,Southampton,Swansea City,3-1,3,1,1,1,4,2,H
1982-01-05,1981,Ipswich Town,Birmingham City,3-2,3,2,1,1,5,1,H
1982-01-05,1981,Liverpool,West Ham United,3-0,3,0,1,1,3,3,H
1982-01-06,1981,Manchester United,Everton,1-1,1,1,1,1,2,0,D
1982-01-09,1981,Manchester City,Stoke City,1-1,1,1,1,1,2,0,D
1982-01-09,1981,Nottingham Forest,Birmingham City,2-1,2,1,1,1,3,1,H
1982-01-16,1981,Brighton & Hove Albion,West Ham United,1-0,1,0,1,1,1,1,H
1982-01-16,1981,Coventry City,Ipswich Town,2-4,2,4,1,1,6,-2,A
1982-01-16,1981,Leeds United,Swansea City,2-0,2,0,1,1,2,2,H
1982-01-16,1981,Liverpool,Wolverhampton Wanderers,2-1,2,1,1,1,3,1,H
1982-01-16,1981,Notts County,Aston Villa,1-0,1,0,1,1,1,1,H
1982-01-19,1981,Everton,Southampton,1-1,1,1,1,1,2,0,D
1982-01-20,1981,Stoke City,Arsenal,0-1,0,1,1,1,1,-1,A
1982-01-23,1981,Nottingham Forest,Notts County,0-2,0,2,1,1,2,-2,A
1982-01-23,1981,Southampton,Arsenal,3-1,3,1,1,1,4,2,H
1982-01-23,1981,Stoke City,Manchester United,0-3,0,3,1,1,3,-3,A
1982-01-23,1981,Wolverhampton Wanderers,Everton,0-3,0,3,1,1,3,-3,A
1982-01-26,1981,Arsenal,Brighton & Hove Albion,0-0,0,0,1,1,0,0,D
1982-01-26,1981,Birmingham City,Coventry City,3-3,3,3,1,1,6,0,D
1982-01-26,1981,Notts County,Liverpool,0-4,0,4,1,1,4,-4,A
1982-01-27,1981,Manchester United,West Ham United,1-0,1,0,1,1,1,1,H
1982-01-27,1981,Tottenham Hotspur,Middlesbrough,1-0,1,0,1,1,1,1,H
1982-01-30,1981,Arsenal,Leeds United,1-0,1,0,1,1,1,1,H
1982-01-30,1981,Aston Villa,Liverpool,0-3,0,3,1,1,3,-3,A
1982-01-30,1981,Coventry City,Brighton & Hove Albion,0-1,0,1,1,1,1,-1,A
1982-01-30,1981,Everton,Tottenham Hotspur,1-1,1,1,1,1,2,0,D
1982-01-30,1981,Ipswich Town,Notts County,1-3,1,3,1,1,4,-2,A
1982-01-30,1981,Manchester City,Birmingham City,4-2,4,2,1,1,6,2,H
1982-01-30,1981,Middlesbrough,Southampton,0-1,0,1,1,1,1,-1,A
1982-01-30,1981,Nottingham Forest,Stoke City,0-0,0,0,1,1,0,0,D
1982-01-30,1981,Swansea City,Manchester United,2-0,2,0,1,1,2,2,H
1982-01-30,1981,West Ham United,West Bromwich Albion,3-1,3,1,1,1,4,2,H
1982-01-30,1981,Wolverhampton Wanderers,Sunderland,0-1,0,1,1,1,1,-1,A
1982-02-02,1981,Arsenal,Wolverhampton Wanderers,2-1,2,1,1,1,3,1,H
1982-02-02,1981,Aston Villa,Sunderland,1-0,1,0,1,1,1,1,H
1982-02-02,1981,West Ham United,Manchester City,1-1,1,1,1,1,2,0,D
1982-02-06,1981,Birmingham City,Middlesbrough,0-0,0,0,1,1,0,0,D
1982-02-06,1981,Brighton & Hove Albion,Everton,3-1,3,1,1,1,4,2,H
1982-02-06,1981,Leeds United,Coventry City,0-0,0,0,1,1,0,0,D
1982-02-06,1981,Liverpool,Ipswich Town,4-0,4,0,1,1,4,4,H
1982-02-06,1981,Manchester United,Aston Villa,4-1,4,1,1,1,5,3,H
1982-02-06,1981,Notts County,Swansea City,0-1,0,1,1,1,1,-1,A
1982-02-06,1981,Southampton,Manchester City,2-1,2,1,1,1,3,1,H
1982-02-06,1981,Stoke City,West Ham United,2-1,2,1,1,1,3,1,H
1982-02-06,1981,Sunderland,Arsenal,0-0,0,0,1,1,0,0,D
1982-02-06,1981,Tottenham Hotspur,Wolverhampton Wanderers,6-1,6,1,1,1,7,5,H
1982-02-06,1981,West Bromwich Albion,Nottingham Forest,2-1,2,1,1,1,3,1,H
1982-02-10,1981,Aston Villa,Southampton,1-1,1,1,1,1,2,0,D
1982-02-10,1981,Sunderland,Stoke City,0-2,0,2,1,1,2,-2,A
1982-02-13,1981,Arsenal,Notts County,1-0,1,0,1,1,1,1,H
1982-02-13,1981,Everton,Stoke City,0-0,0,0,1,1,0,0,D
1982-02-13,1981,Manchester City,Brighton & Hove Albion,4-0,4,0,1,1,4,4,H
1982-02-13,1981,Middlesbrough,Swansea City,1-1,1,1,1,1,2,0,D
1982-02-13,1981,Southampton,Nottingham Forest,2-0,2,0,1,1,2,2,H
1982-02-13,1981,West Ham United,Birmingham City,2-2,2,2,1,1,4,0,D
1982-02-13,1981,Wolverhampton Wanderers,Manchester United,0-1,0,1,1,1,1,-1,A
1982-02-16,1981,Arsenal,Middlesbrough,1-0,1,0,1,1,1,1,H
1982-02-16,1981,Birmingham City,Sunderland,2-0,2,0,1,1,2,2,H
1982-02-16,1981,Coventry City,Notts County,1-5,1,5,1,1,6,-4,A
1982-02-16,1981,Ipswich Town,Southampton,5-2,5,2,1,1,7,3,H
1982-02-16,1981,Swansea City,Liverpool,2-0,2,0,1,1,2,2,H
1982-02-16,1981,Wolverhampton Wanderers,Nottingham Forest,0-0,0,0,1,1,0,0,D
1982-02-17,1981,Aston Villa,Tottenham Hotspur,1-1,1,1,1,1,2,0,D
1982-02-20,1981,Birmingham City,Aston Villa,0-1,0,1,1,1,1,-1,A
1982-02-20,1981,Brighton & Hove Albion,Nottingham Forest,0-1,0,1,1,1,1,-1,A
1982-02-20,1981,Leeds United,Ipswich Town,0-2,0,2,1,1,2,-2,A
1982-02-20,1981,Liverpool,Coventry City,4-0,4,0,1,1,4,4,H
1982-02-20,1981,Manchester United,Arsenal,0-0,0,0,1,1,0,0,D
1982-02-20,1981,Notts County,Wolverhampton Wanderers,4-0,4,0,1,1,4,4,H
1982-02-20,1981,Southampton,West Ham United,2-1,2,1,1,1,3,1,H
1982-02-20,1981,Stoke City,Middlesbrough,2-0,2,0,1,1,2,2,H
1982-02-20,1981,Sunderland,Swansea City,0-1,0,1,1,1,1,-1,A
1982-02-20,1981,Tottenham Hotspur,Manchester City,2-0,2,0,1,1,2,2,H
1982-02-20,1981,West Bromwich Albion,Everton,0-0,0,0,1,1,0,0,D
1982-02-27,1981,Arsenal,Swansea City,0-2,0,2,1,1,2,-2,A
1982-02-27,1981,Aston Villa,Coventry City,2-1,2,1,1,1,3,1,H
1982-02-27,1981,Brighton & Hove Albion,West Bromwich Albion,2-2,2,2,1,1,4,0,D
1982-02-27,1981,Everton,West Ham United,0-0,0,0,1,1,0,0,D
1982-02-27,1981,Leeds United,Liverpool,0-2,0,2,1,1,2,-2,A
1982-02-27,1981,Manchester United,Manchester City,1-1,1,1,1,1,2,0,D
1982-02-27,1981,Nottingham Forest,Middlesbrough,1-1,1,1,1,1,2,0,D
1982-02-27,1981,Southampton,Birmingham City,3-1,3,1,1,1,4,2,H
1982-02-27,1981,Stoke City,Tottenham Hotspur,0-2,0,2,1,1,2,-2,A
1982-02-27,1981,Sunderland,Notts County,1-1,1,1,1,1,2,0,D
1982-02-27,1981,Wolverhampton Wanderers,Ipswich Town,2-1,2,1,1,1,3,1,H
1982-03-02,1981,Brighton & Hove Albion,Leeds United,1-0,1,0,1,1,1,1,H
1982-03-02,1981,West Ham United,Ipswich Town,2-0,2,0,1,1,2,2,H
1982-03-06,1981,Birmingham City,Manchester United,0-1,0,1,1,1,1,-1,A
1982-03-06,1981,Ipswich Town,Everton,3-0,3,0,1,1,3,3,H
1982-03-06,1981,Liverpool,Brighton & Hove Albion,0-1,0,1,1,1,1,-1,A
1982-03-06,1981,Manchester City,Arsenal,0-0,0,0,1,1,0,0,D
1982-03-06,1981,Middlesbrough,Wolverhampton Wanderers,0-0,0,0,1,1,0,0,D
1982-03-06,1981,Notts County,Southampton,1-1,1,1,1,1,2,0,D
1982-03-06,1981,Swansea City,Stoke City,3-0,3,0,1,1,3,3,H
1982-03-06,1981,West Ham United,Aston Villa,2-2,2,2,1,1,4,0,D
1982-03-09,1981,Brighton & Hove Albion,Tottenham Hotspur,1-3,1,3,1,1,4,-2,A
1982-03-09,1981,Coventry City,Nottingham Forest,0-1,0,1,1,1,1,-1,A
1982-03-09,1981,Middlesbrough,West Bromwich Albion,1-0,1,0,1,1,1,1,H
1982-03-09,1981,Stoke City,Liverpool,1-5,1,5,1,1,6,-4,A
1982-03-10,1981,Leeds United,Manchester City,0-1,0,1,1,1,1,-1,A
1982-03-10,1981,Sunderland,Southampton,2-0,2,0,1,1,2,2,H
1982-03-13,1981,Arsenal,Ipswich Town,1-0,1,0,1,1,1,1,H
1982-03-13,1981,Aston Villa,Wolverhampton Wanderers,3-1,3,1,1,1,4,2,H
1982-03-13,1981,Birmingham City,Stoke City,2-1,2,1,1,1,3,1,H
1982-03-13,1981,Everton,Middlesbrough,2-0,2,0,1,1,2,2,H
1982-03-13,1981,Nottingham Forest,Manchester City,1-1,1,1,1,1,2,0,D
1982-03-13,1981,Southampton,West Bromwich Albion,0-0,0,0,1,1,0,0,D
1982-03-13,1981,Sunderland,Leeds United,0-1,0,1,1,1,1,-1,A
1982-03-13,1981,Swansea City,Coventry City,0-0,0,0,1,1,0,0,D
1982-03-13,1981,West Ham United,Notts County,1-0,1,0,1,1,1,1,H
1982-03-16,1981,Arsenal,West Bromwich Albion,2-2,2,2,1,1,4,0,D
1982-03-16,1981,Wolverhampton Wanderers,Leeds United,1-0,1,0,1,1,1,1,H
1982-03-17,1981,Manchester United,Coventry City,0-1,0,1,1,1,1,-1,A
1982-03-17,1981,Nottingham Forest,Ipswich Town,1-1,1,1,1,1,2,0,D
1982-03-20,1981,Coventry City,Arsenal,1-0,1,0,1,1,1,1,H
1982-03-20,1981,Ipswich Town,Aston Villa,3-1,3,1,1,1,4,2,H
1982-03-20,1981,Leeds United,Nottingham Forest,1-1,1,1,1,1,2,0,D
1982-03-20,1981,Liverpool,Sunderland,1-0,1,0,1,1,1,1,H
1982-03-20,1981,Manchester City,Everton,1-1,1,1,1,1,2,0,D
1982-03-20,1981,Middlesbrough,West Ham United,2-3,2,3,1,1,5,-1,A
1982-03-20,1981,Notts County,Manchester United,1-3,1,3,1,1,4,-2,A
1982-03-20,1981,Stoke City,Brighton & Hove Albion,0-0,0,0,1,1,0,0,D
1982-03-20,1981,Tottenham Hotspur,Southampton,3-2,3,2,1,1,5,1,H
1982-03-20,1981,West Bromwich Albion,Birmingham City,1-1,1,1,1,1,2,0,D
1982-03-20,1981,Wolverhampton Wanderers,Swansea City,0-1,0,1,1,1,1,-1,A
1982-03-23,1981,Birmingham City,Tottenham Hotspur,0-0,0,0,1,1,0,0,D
1982-03-24,1981,West Bromwich Albion,Notts County,2-4,2,4,1,1,6,-2,A
1982-03-27,1981,Arsenal,Aston Villa,4-3,4,3,1,1,7,1,H
1982-03-27,1981,Birmingham City,Brighton & Hove Albion,1-0,1,0,1,1,1,1,H
1982-03-27,1981,Coventry City,Wolverhampton Wanderers,0-0,0,0,1,1,0,0,D
1982-03-27,1981,Everton,Liverpool,1-3,1,3,1,1,4,-2,A
1982-03-27,1981,Manchester United,Sunderland,0-0,0,0,1,1,0,0,D
1982-03-27,1981,Middlesbrough,Manchester City,0-0,0,0,1,1,0,0,D
1982-03-27,1981,Notts County,Leeds United,2-1,2,1,1,1,3,1,H
1982-03-27,1981,Southampton,Stoke City,4-3,4,3,1,1,7,1,H
1982-03-27,1981,Swansea City,Ipswich Town,1-2,1,2,1,1,3,-1,A
1982-03-27,1981,West Bromwich Albion,Tottenham Hotspur,1-0,1,0,1,1,1,1,H
1982-03-27,1981,West Ham United,Nottingham Forest,0-1,0,1,1,1,1,-1,A
1982-03-29,1981,Tottenham Hotspur,Arsenal,2-2,2,2,1,1,4,0,D
1982-03-30,1981,Aston Villa,West Bromwich Albion,2-1,2,1,1,1,3,1,H
1982-03-30,1981,Ipswich Town,Brighton & Hove Albion,3-1,3,1,1,1,4,2,H
1982-03-30,1981,Liverpool,Birmingham City,3-1,3,1,1,1,4,2,H
1982-03-30,1981,Swansea City,West Ham United,0-1,0,1,1,1,1,-1,A
1982-04-02,1981,Liverpool,Notts County,1-0,1,0,1,1,1,1,H
1982-04-03,1981,Brighton & Hove Albion,Southampton,1-1,1,1,1,1,2,0,D
1982-04-03,1981,Ipswich Town,Coventry City,1-0,1,0,1,1,1,1,H
1982-04-03,1981,Leeds United,Manchester United,0-0,0,0,1,1,0,0,D
1982-04-03,1981,Manchester City,West Ham United,0-1,0,1,1,1,1,-1,A
1982-04-03,1981,Nottingham Forest,Everton,0-1,0,1,1,1,1,-1,A
1982-04-03,1981,Sunderland,Middlesbrough,0-2,0,2,1,1,2,-2,A
1982-04-03,1981,Wolverhampton Wanderers,Arsenal,1-1,1,1,1,1,2,0,D
1982-04-06,1981,Birmingham City,Everton,0-2,0,2,1,1,2,-2,A
1982-04-06,1981,Middlesbrough,Leeds United,0-0,0,0,1,1,0,0,D
1982-04-06,1981,Swansea City,West Bromwich Albion,3-1,3,1,1,1,4,2,H
1982-04-06,1981,West Ham United,Wolverhampton Wanderers,3-1,3,1,1,1,4,2,H
1982-04-07,1981,Manchester United,Liverpool,0-1,0,1,1,1,1,-1,A
1982-04-07,1981,Sunderland,Ipswich Town,1-1,1,1,1,1,2,0,D
1982-04-10,1981,Birmingham City,Leeds United,0-1,0,1,1,1,1,-1,A
1982-04-10,1981,Brighton & Hove Albion,Arsenal,2-1,2,1,1,1,3,1,H
1982-04-10,1981,Everton,Manchester United,3-3,3,3,1,1,6,0,D
1982-04-10,1981,Manchester City,Liverpool,0-5,0,5,1,1,5,-5,A
1982-04-10,1981,Middlesbrough,Notts County,3-0,3,0,1,1,3,3,H
1982-04-10,1981,Nottingham Forest,Wolverhampton Wanderers,0-1,0,1,1,1,1,-1,A
1982-04-10,1981,Southampton,Aston Villa,0-3,0,3,1,1,3,-3,A
1982-04-10,1981,Stoke City,Sunderland,0-1,0,1,1,1,1,-1,A
1982-04-10,1981,Tottenham Hotspur,Ipswich Town,1-0,1,0,1,1,1,1,H
1982-04-10,1981,West Bromwich Albion,Coventry City,1-2,1,2,1,1,3,-1,A
1982-04-10,1981,West Ham United,Swansea City,1-1,1,1,1,1,2,0,D
1982-04-12,1981,Arsenal,Tottenham Hotspur,1-3,1,3,1,1,4,-2,A
1982-04-12,1981,Aston Villa,Brighton & Hove Albion,3-0,3,0,1,1,3,3,H
1982-04-12,1981,Manchester United,West Bromwich Albion,1-0,1,0,1,1,1,1,H
1982-04-12,1981,Notts County,Nottingham Forest,1-2,1,2,1,1,3,-1,A
1982-04-12,1981,Sunderland,Birmingham City,2-0,2,0,1,1,2,2,H
1982-04-12,1981,Wolverhampton Wanderers,Manchester City,4-1,4,1,1,1,5,3,H
1982-04-13,1981,Coventry City,Everton,1-0,1,0,1,1,1,1,H
1982-04-13,1981,Ipswich Town,West Ham United,3-2,3,2,1,1,5,1,H
1982-04-13,1981,Leeds United,Middlesbrough,1-1,1,1,1,1,2,0,D
1982-04-13,1981,Liverpool,Stoke City,2-0,2,0,1,1,2,2,H
1982-04-13,1981,Swansea City,Southampton,1-0,1,0,1,1,1,1,H
1982-04-14,1981,Tottenham Hotspur,Sunderland,2-2,2,2,1,1,4,0,D
1982-04-17,1981,Arsenal,Nottingham Forest,2-0,2,0,1,1,2,2,H
1982-04-17,1981,Aston Villa,Middlesbrough,1-0,1,0,1,1,1,1,H
1982-04-17,1981,Coventry City,West Ham United,1-0,1,0,1,1,1,1,H
1982-04-17,1981,Ipswich Town,Stoke City,2-0,2,0,1,1,2,2,H
1982-04-17,1981,Leeds United,Southampton,1-3,1,3,1,1,4,-2,A
1982-04-17,1981,Liverpool,West Bromwich Albion,1-0,1,0,1,1,1,1,H
1982-04-17,1981,Manchester United,Tottenham Hotspur,2-0,2,0,1,1,2,2,H
1982-04-17,1981,Notts County,Brighton & Hove Albion,4-1,4,1,1,1,5,3,H
1982-04-17,1981,Sunderland,Everton,3-1,3,1,1,1,4,2,H
1982-04-17,1981,Swansea City,Manchester City,2-0,2,0,1,1,2,2,H
1982-04-17,1981,Wolverhampton Wanderers,Birmingham City,1-1,1,1,1,1,2,0,D
1982-04-20,1981,Everton,Nottingham Forest,2-1,2,1,1,1,3,1,H
1982-04-20,1981,Ipswich Town,Manchester United,2-1,2,1,1,1,3,1,H
1982-04-20,1981,Middlesbrough,Brighton & Hove Albion,2-1,2,1,1,1,3,1,H
1982-04-21,1981,West Bromwich Albion,Manchester City,0-1,0,1,1,1,1,-1,A
1982-04-24,1981,Birmingham City,Swansea City,2-1,2,1,1,1,3,1,H
1982-04-24,1981,Brighton & Hove Albion,Manchester United,0-1,0,1,1,1,1,-1,A
1982-04-24,1981,Everton,Arsenal,2-1,2,1,1,1,3,1,H
1982-04-24,1981,Manchester City,Ipswich Town,1-1,1,1,1,1,2,0,D
1982-04-24,1981,Middlesbrough,Coventry City,0-0,0,0,1,1,0,0,D
1982-04-24,1981,Nottingham Forest,Aston Villa,1-1,1,1,1,1,2,0,D
1982-04-24,1981,Southampton,Liverpool,2-3,2,3,1,1,5,-1,A
1982-04-24,1981,Stoke City,Wolverhampton Wanderers,2-1,2,1,1,1,3,1,H
1982-04-24,1981,Tottenham Hotspur,Notts County,3-1,3,1,1,1,4,2,H
1982-04-24,1981,West Bromwich Albion,Sunderland,2-3,2,3,1,1,5,-1,A
1982-04-24,1981,West Ham United,Leeds United,4-3,4,3,1,1,7,1,H
1982-04-26,1981,Notts County,Stoke City,3-1,3,1,1,1,4,2,H
1982-04-27,1981,Coventry City,Sunderland,6-1,6,1,1,1,7,5,H
1982-04-28,1981,Aston Villa,Leeds United,1-4,1,4,1,1,5,-3,A
1982-04-28,1981,Tottenham Hotspur,Birmingham City,1-1,1,1,1,1,2,0,D
1982-05-01,1981,Arsenal,West Ham United,2-0,2,0,1,1,2,2,H
1982-05-01,1981,Aston Villa,Manchester City,0-0,0,0,1,1,0,0,D
1982-05-01,1981,Coventry City,Tottenham Hotspur,0-0,0,0,1,1,0,0,D
1982-05-01,1981,Ipswich Town,Middlesbrough,3-1,3,1,1,1,4,2,H
1982-05-01,1981,Leeds United,Stoke City,0-0,0,0,1,1,0,0,D
1982-05-01,1981,Liverpool,Nottingham Forest,2-0,2,0,1,1,2,2,H
1982-05-01,1981,Manchester United,Southampton,1-0,1,0,1,1,1,1,H
1982-05-01,1981,Notts County,Birmingham City,1-4,1,4,1,1,5,-3,A
1982-05-01,1981,Sunderland,Brighton & Hove Albion,3-0,3,0,1,1,3,3,H
1982-05-01,1981,Swansea City,Everton,1-3,1,3,1,1,4,-2,A
1982-05-01,1981,Wolverhampton Wanderers,West Bromwich Albion,1-2,1,2,1,1,3,-1,A
1982-05-03,1981,Tottenham Hotspur,Liverpool,2-2,2,2,1,1,4,0,D
1982-05-04,1981,Birmingham City,Arsenal,0-1,0,1,1,1,1,-1,A
1982-05-04,1981,Brighton & Hove Albion,Wolverhampton Wanderers,2-0,2,0,1,1,2,2,H
1982-05-04,1981,Everton,Leeds United,1-0,1,0,1,1,1,1,H
1982-05-04,1981,Southampton,Coventry City,5-5,5,5,1,1,10,0,D
1982-05-04,1981,West Ham United,Sunderland,1-1,1,1,1,1,2,0,D
1982-05-05,1981,Manchester City,Notts County,1-0,1,0,1,1,1,1,H
1982-05-05,1981,Nottingham Forest,Manchester United,0-1,0,1,1,1,1,-1,A
1982-05-05,1981,Stoke City,Aston Villa,1-0,1,0,1,1,1,1,H
1982-05-05,1981,Tottenham Hotspur,Swansea City,2-1,2,1,1,1,3,1,H
1982-05-05,1981,West Bromwich Albion,Ipswich Town,1-2,1,2,1,1,3,-1,A
1982-05-08,1981,Birmingham City,Liverpool,0-1,0,1,1,1,1,-1,A
1982-05-08,1981,Brighton & Hove Albion,Ipswich Town,0-1,0,1,1,1,1,-1,A
1982-05-08,1981,Everton,Wolverhampton Wanderers,1-1,1,1,1,1,2,0,D
1982-05-08,1981,Manchester City,Coventry City,1-3,1,3,1,1,4,-2,A
1982-05-08,1981,Middlesbrough,Arsenal,1-3,1,3,1,1,4,-2,A
1982-05-08,1981,Nottingham Forest,Swansea City,0-2,0,2,1,1,2,-2,A
1982-05-08,1981,Southampton,Sunderland,1-0,1,0,1,1,1,1,H
1982-05-08,1981,Stoke City,Notts County,2-2,2,2,1,1,4,0,D
1982-05-08,1981,Tottenham Hotspur,Leeds United,2-1,2,1,1,1,3,1,H
1982-05-08,1981,West Bromwich Albion,Aston Villa,0-1,0,1,1,1,1,-1,A
1982-05-08,1981,West Ham United,Manchester United,1-1,1,1,1,1,2,0,D
1982-05-10,1981,West Ham United,Tottenham Hotspur,2-2,2,2,1,1,4,0,D
1982-05-11,1981,Arsenal,Liverpool,1-1,1,1,1,1,2,0,D
1982-05-11,1981,Notts County,Middlesbrough,0-1,0,1,1,1,1,-1,A
1982-05-12,1981,Leeds United,Birmingham City,3-3,3,3,1,1,6,0,D
1982-05-12,1981,Nottingham Forest,Tottenham Hotspur,2-0,2,0,1,1,2,2,H
1982-05-12,1981,West Bromwich Albion,Manchester United,0-3,0,3,1,1,3,-3,A
1982-05-15,1981,Arsenal,Southampton,4-1,4,1,1,1,5,3,H
1982-05-15,1981,Aston Villa,Everton,1-2,1,2,1,1,3,-1,A
1982-05-15,1981,Coventry City,Birmingham City,0-1,0,1,1,1,1,-1,A
1982-05-15,1981,Ipswich Town,Nottingham Forest,1-3,1,3,1,1,4,-2,A
1982-05-15,1981,Leeds United,Brighton & Hove Albion,2-1,2,1,1,1,3,1,H
1982-05-15,1981,Liverpool,Tottenham Hotspur,3-1,3,1,1,1,4,2,H
1982-05-15,1981,Manchester United,Stoke City,2-0,2,0,1,1,2,2,H
1982-05-15,1981,Notts County,West Bromwich Albion,1-2,1,2,1,1,3,-1,A
1982-05-15,1981,Sunderland,Manchester City,1-0,1,0,1,1,1,1,H
1982-05-15,1981,Swansea City,Middlesbrough,1-2,1,2,1,1,3,-1,A
1982-05-15,1981,Wolverhampton Wanderers,West Ham United,2-1,2,1,1,1,3,1,H
1982-05-17,1981,Ipswich Town,Tottenham Hotspur,2-1,2,1,1,1,3,1,H
1982-05-18,1981,Middlesbrough,Liverpool,0-0,0,0,1,1,0,0,D
1982-05-18,1981,West Bromwich Albion,Leeds United,2-0,2,0,1,1,2,2,H
1982-05-20,1981,Stoke City,West Bromwich Albion,3-0,3,0,1,1,3,3,H
1982-05-21,1981,Aston Villa,Swansea City,3-0,3,0,1,1,3,3,H
1982-08-28,1982,Aston Villa,Sunderland,1-3,1,3,1,1,4,-2,A
1982-08-28,1982,Brighton & Hove Albion,Ipswich Town,1-1,1,1,1,1,2,0,D
1982-08-28,1982,Coventry City,Southampton,1-0,1,0,1,1,1,1,H
1982-08-28,1982,Liverpool,West Bromwich Albion,2-0,2,0,1,1,2,2,H
1982-08-28,1982,Manchester United,Birmingham City,3-0,3,0,1,1,3,3,H
1982-08-28,1982,Norwich City,Manchester City,1-2,1,2,1,1,3,-1,A
1982-08-28,1982,Notts County,Swansea City,0-0,0,0,1,1,0,0,D
1982-08-28,1982,Stoke City,Arsenal,2-1,2,1,1,1,3,1,H
1982-08-28,1982,Tottenham Hotspur,Luton Town,2-2,2,2,1,1,4,0,D
1982-08-28,1982,Watford,Everton,2-0,2,0,1,1,2,2,H
1982-08-28,1982,West Ham United,Nottingham Forest,1-2,1,2,1,1,3,-1,A
1982-08-31,1982,Arsenal,Norwich City,1-1,1,1,1,1,2,0,D
1982-08-31,1982,Birmingham City,Liverpool,0-0,0,0,1,1,0,0,D
1982-08-31,1982,Everton,Aston Villa,5-0,5,0,1,1,5,5,H
1982-08-31,1982,Ipswich Town,Tottenham Hotspur,1-2,1,2,1,1,3,-1,A
1982-08-31,1982,Luton Town,West Ham United,0-2,0,2,1,1,2,-2,A
1982-08-31,1982,Southampton,Watford,1-4,1,4,1,1,5,-3,A
1982-08-31,1982,Swansea City,Coventry City,2-1,2,1,1,1,3,1,H
1982-09-01,1982,Manchester City,Stoke City,1-0,1,0,1,1,1,1,H
1982-09-01,1982,Nottingham Forest,Manchester United,0-3,0,3,1,1,3,-3,A
1982-09-01,1982,Sunderland,Notts County,1-1,1,1,1,1,2,0,D
1982-09-01,1982,West Bromwich Albion,Brighton & Hove Albion,5-0,5,0,1,1,5,5,H
1982-09-04,1982,Arsenal,Liverpool,0-2,0,2,1,1,2,-2,A
1982-09-04,1982,Birmingham City,Stoke City,1-4,1,4,1,1,5,-3,A
1982-09-04,1982,Everton,Tottenham Hotspur,3-1,3,1,1,1,4,2,H
1982-09-04,1982,Ipswich Town,Coventry City,1-1,1,1,1,1,2,0,D
1982-09-04,1982,Luton Town,Notts County,5-3,5,3,1,1,8,2,H
1982-09-04,1982,Manchester City,Watford,1-0,1,0,1,1,1,1,H
1982-09-04,1982,Nottingham Forest,Brighton & Hove Albion,4-0,4,0,1,1,4,4,H
1982-09-04,1982,Southampton,Aston Villa,1-0,1,0,1,1,1,1,H
1982-09-04,1982,Sunderland,West Ham United,1-0,1,0,1,1,1,1,H
1982-09-04,1982,Swansea City,Norwich City,4-0,4,0,1,1,4,4,H
1982-09-04,1982,West Bromwich Albion,Manchester United,3-1,3,1,1,1,4,2,H
1982-09-07,1982,Brighton & Hove Albion,Arsenal,1-0,1,0,1,1,1,1,H
1982-09-07,1982,Coventry City,Sunderland,1-0,1,0,1,1,1,1,H
1982-09-07,1982,Liverpool,Nottingham Forest,4-3,4,3,1,1,7,1,H
1982-09-07,1982,Notts County,Manchester City,1-0,1,0,1,1,1,1,H
1982-09-07,1982,Watford,Swansea City,2-1,2,1,1,1,3,1,H
1982-09-07,1982,West Ham United,Ipswich Town,1-1,1,1,1,1,2,0,D
1982-09-08,1982,Aston Villa,Luton Town,4-1,4,1,1,1,5,3,H
1982-09-08,1982,Manchester United,Everton,2-1,2,1,1,1,3,1,H
1982-09-08,1982,Norwich City,Birmingham City,5-1,5,1,1,1,6,4,H
1982-09-08,1982,Stoke City,West Bromwich Albion,0-3,0,3,1,1,3,-3,A
1982-09-08,1982,Tottenham Hotspur,Southampton,6-0,6,0,1,1,6,6,H
1982-09-11,1982,Aston Villa,Nottingham Forest,4-1,4,1,1,1,5,3,H
1982-09-11,1982,Brighton & Hove Albion,Sunderland,3-2,3,2,1,1,5,1,H
1982-09-11,1982,Coventry City,Arsenal,0-2,0,2,1,1,2,-2,A
1982-09-11,1982,Liverpool,Luton Town,3-3,3,3,1,1,6,0,D
1982-09-11,1982,Manchester United,Ipswich Town,3-1,3,1,1,1,4,2,H
1982-09-11,1982,Norwich City,Southampton,1-1,1,1,1,1,2,0,D
1982-09-11,1982,Notts County,Everton,1-0,1,0,1,1,1,1,H
1982-09-11,1982,Stoke City,Swansea City,4-1,4,1,1,1,5,3,H
1982-09-11,1982,Tottenham Hotspur,Manchester City,1-2,1,2,1,1,3,-1,A
1982-09-11,1982,Watford,West Bromwich Albion,3-0,3,0,1,1,3,3,H
1982-09-11,1982,West Ham United,Birmingham City,5-0,5,0,1,1,5,5,H
1982-09-18,1982,Arsenal,Notts County,2-0,2,0,1,1,2,2,H
1982-09-18,1982,Birmingham City,Coventry City,1-0,1,0,1,1,1,1,H
1982-09-18,1982,Everton,Norwich City,1-1,1,1,1,1,2,0,D
1982-09-18,1982,Ipswich Town,Stoke City,2-3,2,3,1,1,5,-1,A
1982-09-18,1982,Luton Town,Brighton & Hove Albion,5-0,5,0,1,1,5,5,H
1982-09-18,1982,Manchester City,Aston Villa,0-1,0,1,1,1,1,-1,A
1982-09-18,1982,Nottingham Forest,Watford,2-0,2,0,1,1,2,2,H
1982-09-18,1982,Southampton,Manchester United,0-1,0,1,1,1,1,-1,A
1982-09-18,1982,Sunderland,Tottenham Hotspur,0-1,0,1,1,1,1,-1,A
1982-09-18,1982,Swansea City,Liverpool,0-3,0,3,1,1,3,-3,A
1982-09-18,1982,West Bromwich Albion,West Ham United,1-2,1,2,1,1,3,-1,A
1982-09-25,1982,Aston Villa,Swansea City,2-0,2,0,1,1,2,2,H
1982-09-25,1982,Brighton & Hove Albion,Birmingham City,1-0,1,0,1,1,1,1,H
1982-09-25,1982,Coventry City,Everton,4-2,4,2,1,1,6,2,H
1982-09-25,1982,Liverpool,Southampton,5-0,5,0,1,1,5,5,H
1982-09-25,1982,Manchester United,Arsenal,0-0,0,0,1,1,0,0,D
1982-09-25,1982,Norwich City,West Bromwich Albion,1-3,1,3,1,1,4,-2,A
1982-09-25,1982,Notts County,Ipswich Town,0-6,0,6,1,1,6,-6,A
1982-09-25,1982,Stoke City,Luton Town,4-4,4,4,1,1,8,0,D
1982-09-25,1982,Tottenham Hotspur,Nottingham Forest,4-1,4,1,1,1,5,3,H
1982-09-25,1982,Watford,Sunderland,8-0,8,0,1,1,8,8,H
1982-09-25,1982,West Ham United,Manchester City,4-1,4,1,1,1,5,3,H
1982-10-02,1982,Arsenal,West Ham United,2-3,2,3,1,1,5,-1,A
1982-10-02,1982,Birmingham City,Watford,1-1,1,1,1,1,2,0,D
1982-10-02,1982,Everton,Brighton & Hove Albion,2-2,2,2,1,1,4,0,D
1982-10-02,1982,Ipswich Town,Liverpool,1-0,1,0,1,1,1,1,H
1982-10-02,1982,Luton Town,Manchester United,1-1,1,1,1,1,2,0,D
1982-10-02,1982,Manchester City,Coventry City,3-2,3,2,1,1,5,1,H
1982-10-02,1982,Nottingham Forest,Stoke City,1-0,1,0,1,1,1,1,H
1982-10-02,1982,Southampton,Notts County,1-0,1,0,1,1,1,1,H
1982-10-02,1982,Sunderland,Norwich City,4-1,4,1,1,1,5,3,H
1982-10-02,1982,Swansea City,Tottenham Hotspur,2-0,2,0,1,1,2,2,H
1982-10-02,1982,West Bromwich Albion,Aston Villa,1-0,1,0,1,1,1,1,H
1982-10-09,1982,Birmingham City,Luton Town,2-3,2,3,1,1,5,-1,A
1982-10-09,1982,Brighton & Hove Albion,Swansea City,1-1,1,1,1,1,2,0,D
1982-10-09,1982,Everton,Manchester City,2-1,2,1,1,1,3,1,H
1982-10-09,1982,Ipswich Town,Arsenal,0-1,0,1,1,1,1,-1,A
1982-10-09,1982,Manchester United,Stoke City,1-0,1,0,1,1,1,1,H
1982-10-09,1982,Notts County,Aston Villa,4-1,4,1,1,1,5,3,H
1982-10-09,1982,Sunderland,Southampton,1-1,1,1,1,1,2,0,D
1982-10-09,1982,Tottenham Hotspur,Coventry City,4-0,4,0,1,1,4,4,H
1982-10-09,1982,Watford,Norwich City,2-2,2,2,1,1,4,0,D
1982-10-09,1982,West Bromwich Albion,Nottingham Forest,2-1,2,1,1,1,3,1,H
1982-10-09,1982,West Ham United,Liverpool,3-1,3,1,1,1,4,2,H
1982-10-16,1982,Arsenal,West Bromwich Albion,2-0,2,0,1,1,2,2,H
1982-10-16,1982,Aston Villa,Watford,3-0,3,0,1,1,3,3,H
1982-10-16,1982,Coventry City,Notts County,1-0,1,0,1,1,1,1,H
1982-10-16,1982,Liverpool,Manchester United,0-0,0,0,1,1,0,0,D
1982-10-16,1982,Luton Town,Ipswich Town,1-1,1,1,1,1,2,0,D
1982-10-16,1982,Manchester City,Sunderland,2-2,2,2,1,1,4,0,D
1982-10-16,1982,Norwich City,Tottenham Hotspur,0-0,0,0,1,1,0,0,D
1982-10-16,1982,Nottingham Forest,Birmingham City,1-1,1,1,1,1,2,0,D
1982-10-16,1982,Southampton,West Ham United,3-0,3,0,1,1,3,3,H
1982-10-16,1982,Stoke City,Brighton & Hove Albion,3-0,3,0,1,1,3,3,H
1982-10-16,1982,Swansea City,Everton,0-3,0,3,1,1,3,-3,A
1982-10-23,1982,Birmingham City,Ipswich Town,0-0,0,0,1,1,0,0,D
1982-10-23,1982,Brighton & Hove Albion,West Ham United,3-1,3,1,1,1,4,2,H
1982-10-23,1982,Everton,Sunderland,3-1,3,1,1,1,4,2,H
1982-10-23,1982,Manchester United,Manchester City,2-2,2,2,1,1,4,0,D
1982-10-23,1982,Norwich City,Aston Villa,1-0,1,0,1,1,1,1,H
1982-10-23,1982,Nottingham Forest,Arsenal,3-0,3,0,1,1,3,3,H
1982-10-23,1982,Stoke City,Liverpool,1-1,1,1,1,1,2,0,D
1982-10-23,1982,Swansea City,Southampton,3-2,3,2,1,1,5,1,H
1982-10-23,1982,Tottenham Hotspur,Notts County,4-2,4,2,1,1,6,2,H
1982-10-23,1982,Watford,Coventry City,0-0,0,0,1,1,0,0,D
1982-10-23,1982,West Bromwich Albion,Luton Town,1-0,1,0,1,1,1,1,H
1982-10-30,1982,Arsenal,Birmingham City,0-0,0,0,1,1,0,0,D
1982-10-30,1982,Aston Villa,Tottenham Hotspur,4-0,4,0,1,1,4,4,H
1982-10-30,1982,Coventry City,Norwich City,2-0,2,0,1,1,2,2,H
1982-10-30,1982,Ipswich Town,West Bromwich Albion,6-1,6,1,1,1,7,5,H
1982-10-30,1982,Liverpool,Brighton & Hove Albion,3-1,3,1,1,1,4,2,H
1982-10-30,1982,Luton Town,Nottingham Forest,0-2,0,2,1,1,2,-2,A
1982-10-30,1982,Manchester City,Swansea City,2-1,2,1,1,1,3,1,H
1982-10-30,1982,Notts County,Watford,3-2,3,2,1,1,5,1,H
1982-10-30,1982,Southampton,Everton,3-2,3,2,1,1,5,1,H
1982-10-30,1982,Sunderland,Stoke City,2-2,2,2,1,1,4,0,D
1982-10-30,1982,West Ham United,Manchester United,3-1,3,1,1,1,4,2,H
1982-11-06,1982,Birmingham City,West Bromwich Albion,2-1,2,1,1,1,3,1,H
1982-11-06,1982,Brighton & Hove Albion,Manchester United,1-0,1,0,1,1,1,1,H
1982-11-06,1982,Coventry City,Aston Villa,0-0,0,0,1,1,0,0,D
1982-11-06,1982,Everton,Liverpool,0-5,0,5,1,1,5,-5,A
1982-11-06,1982,Luton Town,Arsenal,2-2,2,2,1,1,4,0,D
1982-11-06,1982,Manchester City,Southampton,2-0,2,0,1,1,2,2,H
1982-11-06,1982,Norwich City,Notts County,1-2,1,2,1,1,3,-1,A
1982-11-06,1982,Nottingham Forest,Ipswich Town,2-1,2,1,1,1,3,1,H
1982-11-06,1982,Stoke City,West Ham United,5-2,5,2,1,1,7,3,H
1982-11-06,1982,Swansea City,Sunderland,3-0,3,0,1,1,3,3,H
1982-11-06,1982,Tottenham Hotspur,Watford,0-1,0,1,1,1,1,-1,A
1982-11-13,1982,Arsenal,Everton,1-1,1,1,1,1,2,0,D
1982-11-13,1982,Aston Villa,Brighton & Hove Albion,1-0,1,0,1,1,1,1,H
1982-11-13,1982,Ipswich Town,Manchester City,1-0,1,0,1,1,1,1,H
1982-11-13,1982,Liverpool,Coventry City,4-0,4,0,1,1,4,4,H
1982-11-13,1982,Manchester United,Tottenham Hotspur,1-0,1,0,1,1,1,1,H
1982-11-13,1982,Notts County,Birmingham City,0-0,0,0,1,1,0,0,D
1982-11-13,1982,Southampton,Nottingham Forest,1-1,1,1,1,1,2,0,D
1982-11-13,1982,Sunderland,Luton Town,1-1,1,1,1,1,2,0,D
1982-11-13,1982,Watford,Stoke City,1-0,1,0,1,1,1,1,H
1982-11-13,1982,West Bromwich Albion,Swansea City,3-3,3,3,1,1,6,0,D
1982-11-13,1982,West Ham United,Norwich City,1-0,1,0,1,1,1,1,H
1982-11-20,1982,Aston Villa,Manchester United,2-1,2,1,1,1,3,1,H
1982-11-20,1982,Coventry City,Luton Town,4-2,4,2,1,1,6,2,H
1982-11-20,1982,Everton,West Bromwich Albion,0-0,0,0,1,1,0,0,D
1982-11-20,1982,Manchester City,Birmingham City,0-0,0,0,1,1,0,0,D
1982-11-20,1982,Norwich City,Stoke City,4-2,4,2,1,1,6,2,H
1982-11-20,1982,Notts County,Liverpool,1-2,1,2,1,1,3,-1,A
1982-11-20,1982,Southampton,Ipswich Town,0-1,0,1,1,1,1,-1,A
1982-11-20,1982,Sunderland,Nottingham Forest,0-1,0,1,1,1,1,-1,A
1982-11-20,1982,Swansea City,Arsenal,1-2,1,2,1,1,3,-1,A
1982-11-20,1982,Tottenham Hotspur,West Ham United,2-1,2,1,1,1,3,1,H
1982-11-20,1982,Watford,Brighton & Hove Albion,4-1,4,1,1,1,5,3,H
1982-11-23,1982,Coventry City,Ipswich Town,1-1,1,1,1,1,2,0,D
1982-11-27,1982,Arsenal,Watford,2-4,2,4,1,1,6,-2,A
1982-11-27,1982,Birmingham City,Sunderland,2-1,2,1,1,1,3,1,H
1982-11-27,1982,Brighton & Hove Albion,Notts County,0-2,0,2,1,1,2,-2,A
1982-11-27,1982,Ipswich Town,Swansea City,3-1,3,1,1,1,4,2,H
1982-11-27,1982,Liverpool,Tottenham Hotspur,3-0,3,0,1,1,3,3,H
1982-11-27,1982,Luton Town,Southampton,3-3,3,3,1,1,6,0,D
1982-11-27,1982,Manchester United,Norwich City,3-0,3,0,1,1,3,3,H
1982-11-27,1982,Nottingham Forest,Manchester City,3-0,3,0,1,1,3,3,H
1982-11-27,1982,Stoke City,Aston Villa,0-3,0,3,1,1,3,-3,A
1982-11-27,1982,West Bromwich Albion,Coventry City,2-0,2,0,1,1,2,2,H
1982-11-27,1982,West Ham United,Everton,2-0,2,0,1,1,2,2,H
1982-12-04,1982,Aston Villa,West Ham United,1-0,1,0,1,1,1,1,H
1982-12-04,1982,Coventry City,Brighton & Hove Albion,2-0,2,0,1,1,2,2,H
1982-12-04,1982,Everton,Birmingham City,0-0,0,0,1,1,0,0,D
1982-12-04,1982,Manchester City,Arsenal,2-1,2,1,1,1,3,1,H
1982-12-04,1982,Norwich City,Liverpool,1-0,1,0,1,1,1,1,H
1982-12-04,1982,Notts County,Nottingham Forest,3-2,3,2,1,1,5,1,H
1982-12-04,1982,Southampton,Stoke City,1-0,1,0,1,1,1,1,H
1982-12-04,1982,Sunderland,Ipswich Town,2-3,2,3,1,1,5,-1,A
1982-12-04,1982,Swansea City,Luton Town,2-0,2,0,1,1,2,2,H
1982-12-04,1982,Tottenham Hotspur,West Bromwich Albion,1-1,1,1,1,1,2,0,D
1982-12-04,1982,Watford,Manchester United,0-1,0,1,1,1,1,-1,A
1982-12-07,1982,Arsenal,Aston Villa,2-1,2,1,1,1,3,1,H
1982-12-11,1982,Birmingham City,Southampton,0-2,0,2,1,1,2,-2,A
1982-12-11,1982,Brighton & Hove Albion,Norwich City,3-0,3,0,1,1,3,3,H
1982-12-11,1982,Ipswich Town,Everton,0-2,0,2,1,1,2,-2,A
1982-12-11,1982,Liverpool,Watford,3-1,3,1,1,1,4,2,H
1982-12-11,1982,Luton Town,Manchester City,3-1,3,1,1,1,4,2,H
1982-12-11,1982,Manchester United,Notts County,4-0,4,0,1,1,4,4,H
1982-12-11,1982,Nottingham Forest,Swansea City,2-1,2,1,1,1,3,1,H
1982-12-11,1982,Stoke City,Tottenham Hotspur,2-0,2,0,1,1,2,2,H
1982-12-11,1982,West Bromwich Albion,Sunderland,3-0,3,0,1,1,3,3,H
1982-12-11,1982,West Ham United,Coventry City,0-3,0,3,1,1,3,-3,A
1982-12-18,1982,Aston Villa,Liverpool,2-4,2,4,1,1,6,-2,A
1982-12-18,1982,Coventry City,Stoke City,2-0,2,0,1,1,2,2,H
1982-12-18,1982,Everton,Luton Town,5-0,5,0,1,1,5,5,H
1982-12-18,1982,Manchester City,Brighton & Hove Albion,1-1,1,1,1,1,2,0,D
1982-12-18,1982,Norwich City,Nottingham Forest,0-1,0,1,1,1,1,-1,A
1982-12-18,1982,Notts County,West Ham United,1-2,1,2,1,1,3,-1,A
1982-12-18,1982,Southampton,West Bromwich Albion,4-1,4,1,1,1,5,3,H
1982-12-18,1982,Sunderland,Arsenal,3-0,3,0,1,1,3,3,H
1982-12-18,1982,Swansea City,Manchester United,0-0,0,0,1,1,0,0,D
1982-12-18,1982,Tottenham Hotspur,Birmingham City,2-1,2,1,1,1,3,1,H
1982-12-18,1982,Watford,Ipswich Town,2-1,2,1,1,1,3,1,H
1982-12-27,1982,Arsenal,Tottenham Hotspur,2-0,2,0,1,1,2,2,H
1982-12-27,1982,Birmingham City,Aston Villa,3-0,3,0,1,1,3,3,H
1982-12-27,1982,Brighton & Hove Albion,Southampton,0-1,0,1,1,1,1,-1,A
1982-12-27,1982,Ipswich Town,Norwich City,2-3,2,3,1,1,5,-1,A
1982-12-27,1982,Liverpool,Manchester City,5-2,5,2,1,1,7,3,H
1982-12-27,1982,Luton Town,Watford,1-0,1,0,1,1,1,1,H
1982-12-27,1982,Manchester United,Sunderland,0-0,0,0,1,1,0,0,D
1982-12-27,1982,Nottingham Forest,Coventry City,4-2,4,2,1,1,6,2,H
1982-12-27,1982,Stoke City,Everton,1-0,1,0,1,1,1,1,H
1982-12-27,1982,West Bromwich Albion,Notts County,2-2,2,2,1,1,4,0,D
1982-12-27,1982,West Ham United,Swansea City,3-2,3,2,1,1,5,1,H
1982-12-28,1982,Coventry City,Manchester United,3-0,3,0,1,1,3,3,H
1982-12-28,1982,Everton,Nottingham Forest,3-1,3,1,1,1,4,2,H
1982-12-28,1982,Manchester City,West Bromwich Albion,2-1,2,1,1,1,3,1,H
1982-12-28,1982,Norwich City,Luton Town,1-0,1,0,1,1,1,1,H
1982-12-28,1982,Notts County,Stoke City,4-0,4,0,1,1,4,4,H
1982-12-28,1982,Southampton,Arsenal,2-2,2,2,1,1,4,0,D
1982-12-28,1982,Sunderland,Liverpool,0-0,0,0,1,1,0,0,D
1982-12-28,1982,Tottenham Hotspur,Brighton & Hove Albion,2-0,2,0,1,1,2,2,H
1982-12-29,1982,Aston Villa,Ipswich Town,1-1,1,1,1,1,2,0,D
1982-12-29,1982,Swansea City,Birmingham City,0-0,0,0,1,1,0,0,D
1982-12-29,1982,Watford,West Ham United,2-1,2,1,1,1,3,1,H
1983-01-01,1982,Arsenal,Swansea City,2-1,2,1,1,1,3,1,H
1983-01-01,1982,Birmingham City,Manchester City,2-2,2,2,1,1,4,0,D
1983-01-01,1982,Brighton & Hove Albion,Watford,1-1,1,1,1,1,2,0,D
1983-01-01,1982,Ipswich Town,Southampton,2-1,2,1,1,1,3,1,H
1983-01-01,1982,Liverpool,Notts County,5-1,5,1,1,1,6,4,H
1983-01-01,1982,Luton Town,Coventry City,1-2,1,2,1,1,3,-1,A
1983-01-01,1982,Manchester United,Aston Villa,3-1,3,1,1,1,4,2,H
1983-01-01,1982,Nottingham Forest,Sunderland,0-0,0,0,1,1,0,0,D
1983-01-01,1982,Stoke City,Norwich City,1-0,1,0,1,1,1,1,H
1983-01-01,1982,West Bromwich Albion,Everton,2-2,2,2,1,1,4,0,D
1983-01-01,1982,West Ham United,Tottenham Hotspur,3-0,3,0,1,1,3,3,H
1983-01-03,1982,Aston Villa,Southampton,2-0,2,0,1,1,2,2,H
1983-01-03,1982,Brighton & Hove Albion,Nottingham Forest,1-1,1,1,1,1,2,0,D
1983-01-03,1982,Liverpool,Arsenal,3-1,3,1,1,1,4,2,H
1983-01-03,1982,Manchester United,West Bromwich Albion,0-0,0,0,1,1,0,0,D
1983-01-03,1982,Norwich City,Swansea City,1-0,1,0,1,1,1,1,H
1983-01-03,1982,Notts County,Sunderland,0-1,0,1,1,1,1,-1,A
1983-01-03,1982,Stoke City,Birmingham City,1-1,1,1,1,1,2,0,D
1983-01-03,1982,Tottenham Hotspur,Everton,2-1,2,1,1,1,3,1,H
1983-01-03,1982,Watford,Manchester City,2-0,2,0,1,1,2,2,H
1983-01-04,1982,West Ham United,Luton Town,2-3,2,3,1,1,5,-1,A
1983-01-15,1982,Arsenal,Stoke City,3-0,3,0,1,1,3,3,H
1983-01-15,1982,Birmingham City,Manchester United,1-2,1,2,1,1,3,-1,A
1983-01-15,1982,Everton,Watford,1-0,1,0,1,1,1,1,H
1983-01-15,1982,Ipswich Town,Brighton & Hove Albion,2-0,2,0,1,1,2,2,H
1983-01-15,1982,Luton Town,Tottenham Hotspur,1-1,1,1,1,1,2,0,D
1983-01-15,1982,Manchester City,Norwich City,4-1,4,1,1,1,5,3,H
1983-01-15,1982,Nottingham Forest,West Ham United,1-0,1,0,1,1,1,1,H
1983-01-15,1982,Southampton,Coventry City,1-1,1,1,1,1,2,0,D
1983-01-15,1982,Sunderland,Aston Villa,2-0,2,0,1,1,2,2,H
1983-01-15,1982,Swansea City,Notts County,2-0,2,0,1,1,2,2,H
1983-01-15,1982,West Bromwich Albion,Liverpool,0-1,0,1,1,1,1,-1,A
1983-01-22,1982,Aston Villa,Manchester City,1-1,1,1,1,1,2,0,D
1983-01-22,1982,Brighton & Hove Albion,Luton Town,2-4,2,4,1,1,6,-2,A
1983-01-22,1982,Coventry City,Swansea City,0-0,0,0,1,1,0,0,D
1983-01-22,1982,Liverpool,Birmingham City,1-0,1,0,1,1,1,1,H
1983-01-22,1982,Manchester United,Nottingham Forest,2-0,2,0,1,1,2,2,H
1983-01-22,1982,Norwich City,Everton,0-1,0,1,1,1,1,-1,A
1983-01-22,1982,Notts County,Arsenal,1-0,1,0,1,1,1,1,H
1983-01-22,1982,Stoke City,Ipswich Town,1-0,1,0,1,1,1,1,H
1983-01-22,1982,Tottenham Hotspur,Sunderland,1-1,1,1,1,1,2,0,D
1983-01-22,1982,Watford,Southampton,2-0,2,0,1,1,2,2,H
1983-01-22,1982,West Ham United,West Bromwich Albion,0-1,0,1,1,1,1,-1,A
1983-02-05,1982,Arsenal,Brighton & Hove Albion,3-1,3,1,1,1,4,2,H
1983-02-05,1982,Birmingham City,West Ham United,3-0,3,0,1,1,3,3,H
1983-02-05,1982,Everton,Notts County,3-0,3,0,1,1,3,3,H
1983-02-05,1982,Ipswich Town,Manchester United,1-1,1,1,1,1,2,0,D
1983-02-05,1982,Luton Town,Liverpool,1-3,1,3,1,1,4,-2,A
1983-02-05,1982,Manchester City,Tottenham Hotspur,2-2,2,2,1,1,4,0,D
1983-02-05,1982,Nottingham Forest,Aston Villa,1-2,1,2,1,1,3,-1,A
1983-02-05,1982,Southampton,Norwich City,4-0,4,0,1,1,4,4,H
1983-02-05,1982,Sunderland,Coventry City,2-1,2,1,1,1,3,1,H
1983-02-05,1982,West Bromwich Albion,Stoke City,1-1,1,1,1,1,2,0,D
1983-02-06,1982,Swansea City,Watford,1-3,1,3,1,1,4,-2,A
1983-02-12,1982,Aston Villa,Everton,2-0,2,0,1,1,2,2,H
1983-02-12,1982,Brighton & Hove Albion,West Bromwich Albion,0-0,0,0,1,1,0,0,D
1983-02-12,1982,Coventry City,Manchester City,4-0,4,0,1,1,4,4,H
1983-02-12,1982,Liverpool,Ipswich Town,1-0,1,0,1,1,1,1,H
1983-02-12,1982,Tottenham Hotspur,Swansea City,1-0,1,0,1,1,1,1,H
1983-02-15,1982,Notts County,Southampton,1-2,1,2,1,1,3,-1,A
1983-02-19,1982,Manchester City,Notts County,0-1,0,1,1,1,1,-1,A
1983-02-19,1982,Nottingham Forest,West Bromwich Albion,0-0,0,0,1,1,0,0,D
1983-02-19,1982,Southampton,Sunderland,2-0,2,0,1,1,2,2,H
1983-02-26,1982,Birmingham City,Nottingham Forest,1-1,1,1,1,1,2,0,D
1983-02-26,1982,Brighton & Hove Albion,Stoke City,1-2,1,2,1,1,3,-1,A
1983-02-26,1982,Everton,Swansea City,2-2,2,2,1,1,4,0,D
1983-02-26,1982,Ipswich Town,Luton Town,3-0,3,0,1,1,3,3,H
1983-02-26,1982,Manchester United,Liverpool,1-1,1,1,1,1,2,0,D
1983-02-26,1982,Notts County,Coventry City,5-1,5,1,1,1,6,4,H
1983-02-26,1982,Sunderland,Manchester City,3-2,3,2,1,1,5,1,H
1983-02-26,1982,Tottenham Hotspur,Norwich City,0-0,0,0,1,1,0,0,D
1983-02-26,1982,Watford,Aston Villa,2-1,2,1,1,1,3,1,H
1983-02-26,1982,West Bromwich Albion,Arsenal,0-0,0,0,1,1,0,0,D
1983-02-26,1982,West Ham United,Southampton,1-1,1,1,1,1,2,0,D
1983-03-01,1982,Swansea City,Brighton & Hove Albion,1-2,1,2,1,1,3,-1,A
1983-03-02,1982,Manchester City,Everton,0-0,0,0,1,1,0,0,D
1983-03-02,1982,Norwich City,Watford,3-0,3,0,1,1,3,3,H
1983-03-02,1982,Stoke City,Manchester United,1-0,1,0,1,1,1,1,H
1983-03-05,1982,Arsenal,Nottingham Forest,0-0,0,0,1,1,0,0,D
1983-03-05,1982,Aston Villa,Norwich City,3-2,3,2,1,1,5,1,H
1983-03-05,1982,Coventry City,Watford,0-1,0,1,1,1,1,-1,A
1983-03-05,1982,Ipswich Town,Birmingham City,3-1,3,1,1,1,4,2,H
1983-03-05,1982,Liverpool,Stoke City,5-1,5,1,1,1,6,4,H
1983-03-05,1982,Luton Town,West Bromwich Albion,0-0,0,0,1,1,0,0,D
1983-03-05,1982,Manchester City,Manchester United,1-2,1,2,1,1,3,-1,A
1983-03-05,1982,Notts County,Tottenham Hotspur,3-0,3,0,1,1,3,3,H
1983-03-05,1982,Southampton,Swansea City,2-1,2,1,1,1,3,1,H
1983-03-05,1982,Sunderland,Everton,2-1,2,1,1,1,3,1,H
1983-03-05,1982,West Ham United,Brighton & Hove Albion,2-1,2,1,1,1,3,1,H
1983-03-08,1982,Aston Villa,Notts County,2-0,2,0,1,1,2,2,H
1983-03-12,1982,Coventry City,Tottenham Hotspur,1-1,1,1,1,1,2,0,D
1983-03-12,1982,Liverpool,West Ham United,3-0,3,0,1,1,3,3,H
1983-03-12,1982,Nottingham Forest,Luton Town,0-1,0,1,1,1,1,-1,A
1983-03-12,1982,Stoke City,Sunderland,0-1,0,1,1,1,1,-1,A
1983-03-12,1982,Swansea City,Manchester City,4-1,4,1,1,1,5,3,H
1983-03-12,1982,Watford,Notts County,5-3,5,3,1,1,8,2,H
1983-03-12,1982,West Bromwich Albion,Ipswich Town,4-1,4,1,1,1,5,3,H
1983-03-15,1982,Birmingham City,Arsenal,2-1,2,1,1,1,3,1,H
1983-03-15,1982,Everton,Southampton,2-0,2,0,1,1,2,2,H
1983-03-16,1982,Stoke City,Nottingham Forest,1-0,1,0,1,1,1,1,H
1983-03-19,1982,Arsenal,Luton Town,4-1,4,1,1,1,5,3,H
1983-03-19,1982,Aston Villa,Coventry City,4-0,4,0,1,1,4,4,H
1983-03-19,1982,Ipswich Town,Nottingham Forest,2-0,2,0,1,1,2,2,H
1983-03-19,1982,Liverpool,Everton,0-0,0,0,1,1,0,0,D
1983-03-19,1982,Manchester United,Brighton & Hove Albion,1-1,1,1,1,1,2,0,D
1983-03-19,1982,Notts County,Norwich City,2-2,2,2,1,1,4,0,D
1983-03-19,1982,Southampton,Manchester City,4-1,4,1,1,1,5,3,H
1983-03-19,1982,Sunderland,Swansea City,1-1,1,1,1,1,2,0,D
1983-03-19,1982,Watford,Tottenham Hotspur,0-1,0,1,1,1,1,-1,A
1983-03-19,1982,West Bromwich Albion,Birmingham City,2-0,2,0,1,1,2,2,H
1983-03-19,1982,West Ham United,Stoke City,1-1,1,1,1,1,2,0,D
1983-03-22,1982,Arsenal,Ipswich Town,2-2,2,2,1,1,4,0,D
1983-03-22,1982,Brighton & Hove Albion,Liverpool,2-2,2,2,1,1,4,0,D
1983-03-22,1982,Manchester United,West Ham United,2-1,2,1,1,1,3,1,H
1983-03-22,1982,Watford,Birmingham City,2-1,2,1,1,1,3,1,H
1983-03-23,1982,Norwich City,Coventry City,1-1,1,1,1,1,2,0,D
1983-03-23,1982,Tottenham Hotspur,Aston Villa,2-0,2,0,1,1,2,2,H
1983-03-26,1982,Birmingham City,Notts County,3-0,3,0,1,1,3,3,H
1983-03-26,1982,Brighton & Hove Albion,Aston Villa,0-0,0,0,1,1,0,0,D
1983-03-26,1982,Everton,Arsenal,2-3,2,3,1,1,5,-1,A
1983-03-26,1982,Luton Town,Sunderland,1-3,1,3,1,1,4,-2,A
1983-03-26,1982,Manchester City,Ipswich Town,0-1,0,1,1,1,1,-1,A
1983-03-26,1982,Norwich City,West Ham United,1-1,1,1,1,1,2,0,D
1983-03-26,1982,Nottingham Forest,Southampton,1-2,1,2,1,1,3,-1,A
1983-03-26,1982,Stoke City,Watford,4-0,4,0,1,1,4,4,H
1983-03-26,1982,Swansea City,West Bromwich Albion,2-1,2,1,1,1,3,1,H
1983-04-02,1982,Arsenal,Southampton,0-0,0,0,1,1,0,0,D
1983-04-02,1982,Birmingham City,Swansea City,1-1,1,1,1,1,2,0,D
1983-04-02,1982,Brighton & Hove Albion,Tottenham Hotspur,2-1,2,1,1,1,3,1,H
1983-04-02,1982,Ipswich Town,Aston Villa,1-2,1,2,1,1,3,-1,A
1983-04-02,1982,Liverpool,Sunderland,1-0,1,0,1,1,1,1,H
1983-04-02,1982,Luton Town,Norwich City,0-1,0,1,1,1,1,-1,A
1983-04-02,1982,Manchester United,Coventry City,3-0,3,0,1,1,3,3,H
1983-04-02,1982,Nottingham Forest,Everton,2-0,2,0,1,1,2,2,H
1983-04-02,1982,Stoke City,Notts County,1-0,1,0,1,1,1,1,H
1983-04-02,1982,West Bromwich Albion,Manchester City,0-2,0,2,1,1,2,-2,A
1983-04-02,1982,West Ham United,Watford,2-1,2,1,1,1,3,1,H
1983-04-04,1982,Aston Villa,Birmingham City,1-0,1,0,1,1,1,1,H
1983-04-04,1982,Everton,Stoke City,3-1,3,1,1,1,4,2,H
1983-04-04,1982,Manchester City,Liverpool,0-4,0,4,1,1,4,-4,A
1983-04-04,1982,Norwich City,Ipswich Town,0-0,0,0,1,1,0,0,D
1983-04-04,1982,Notts County,West Bromwich Albion,2-1,2,1,1,1,3,1,H
1983-04-04,1982,Sunderland,Manchester United,0-0,0,0,1,1,0,0,D
1983-04-04,1982,Tottenham Hotspur,Arsenal,5-0,5,0,1,1,5,5,H
1983-04-04,1982,Watford,Luton Town,5-2,5,2,1,1,7,3,H
1983-04-05,1982,Coventry City,Nottingham Forest,1-2,1,2,1,1,3,-1,A
1983-04-05,1982,Southampton,Brighton & Hove Albion,0-0,0,0,1,1,0,0,D
1983-04-05,1982,Swansea City,West Ham United,1-5,1,5,1,1,6,-4,A
1983-04-09,1982,Arsenal,Coventry City,2-1,2,1,1,1,3,1,H
1983-04-09,1982,Birmingham City,Norwich City,0-4,0,4,1,1,4,-4,A
1983-04-09,1982,Brighton & Hove Albion,Everton,1-2,1,2,1,1,3,-1,A
1983-04-09,1982,Ipswich Town,Notts County,0-0,0,0,1,1,0,0,D
1983-04-09,1982,Liverpool,Swansea City,3-0,3,0,1,1,3,3,H
1983-04-09,1982,Luton Town,Aston Villa,2-1,2,1,1,1,3,1,H
1983-04-09,1982,Manchester United,Southampton,1-1,1,1,1,1,2,0,D
1983-04-09,1982,Nottingham Forest,Tottenham Hotspur,2-2,2,2,1,1,4,0,D
1983-04-09,1982,Stoke City,Manchester City,1-0,1,0,1,1,1,1,H
1983-04-09,1982,West Bromwich Albion,Watford,1-3,1,3,1,1,4,-2,A
1983-04-09,1982,West Ham United,Sunderland,2-1,2,1,1,1,3,1,H
1983-04-12,1982,Coventry City,Liverpool,0-0,0,0,1,1,0,0,D
1983-04-12,1982,Luton Town,Birmingham City,3-1,3,1,1,1,4,2,H
1983-04-16,1982,Coventry City,Birmingham City,0-1,0,1,1,1,1,-1,A
1983-04-16,1982,Manchester City,West Ham United,2-0,2,0,1,1,2,2,H
1983-04-16,1982,Norwich City,Sunderland,2-0,2,0,1,1,2,2,H
1983-04-16,1982,Notts County,Luton Town,1-1,1,1,1,1,2,0,D
1983-04-16,1982,Southampton,Liverpool,3-2,3,2,1,1,5,1,H
1983-04-16,1982,Swansea City,Stoke City,1-1,1,1,1,1,2,0,D
1983-04-16,1982,Tottenham Hotspur,Ipswich Town,3-1,3,1,1,1,4,2,H
1983-04-16,1982,Watford,Nottingham Forest,1-3,1,3,1,1,4,-2,A
1983-04-19,1982,Aston Villa,West Bromwich Albion,1-0,1,0,1,1,1,1,H
1983-04-19,1982,Everton,Manchester United,2-0,2,0,1,1,2,2,H
1983-04-19,1982,Sunderland,Brighton & Hove Albion,1-1,1,1,1,1,2,0,D
1983-04-20,1982,Norwich City,Arsenal,3-1,3,1,1,1,4,2,H
1983-04-23,1982,Arsenal,Manchester City,3-0,3,0,1,1,3,3,H
1983-04-23,1982,Birmingham City,Everton,1-0,1,0,1,1,1,1,H
1983-04-23,1982,Brighton & Hove Albion,Coventry City,1-0,1,0,1,1,1,1,H
1983-04-23,1982,Ipswich Town,Sunderland,4-1,4,1,1,1,5,3,H
1983-04-23,1982,Liverpool,Norwich City,0-2,0,2,1,1,2,-2,A
1983-04-23,1982,Luton Town,Swansea City,3-1,3,1,1,1,4,2,H
1983-04-23,1982,Manchester United,Watford,2-0,2,0,1,1,2,2,H
1983-04-23,1982,Nottingham Forest,Notts County,2-1,2,1,1,1,3,1,H
1983-04-23,1982,Stoke City,Southampton,1-1,1,1,1,1,2,0,D
1983-04-23,1982,West Bromwich Albion,Tottenham Hotspur,0-1,0,1,1,1,1,-1,A
1983-04-23,1982,West Ham United,Aston Villa,2-0,2,0,1,1,2,2,H
1983-04-30,1982,Aston Villa,Stoke City,4-0,4,0,1,1,4,4,H
1983-04-30,1982,Coventry City,West Bromwich Albion,0-1,0,1,1,1,1,-1,A
1983-04-30,1982,Everton,West Ham United,2-0,2,0,1,1,2,2,H
1983-04-30,1982,Manchester City,Nottingham Forest,1-2,1,2,1,1,3,-1,A
1983-04-30,1982,Norwich City,Manchester United,1-1,1,1,1,1,2,0,D
1983-04-30,1982,Notts County,Brighton & Hove Albion,1-0,1,0,1,1,1,1,H
1983-04-30,1982,Southampton,Luton Town,2-2,2,2,1,1,4,0,D
1983-04-30,1982,Sunderland,Birmingham City,1-2,1,2,1,1,3,-1,A
1983-04-30,1982,Swansea City,Ipswich Town,1-1,1,1,1,1,2,0,D
1983-04-30,1982,Tottenham Hotspur,Liverpool,2-0,2,0,1,1,2,2,H
1983-04-30,1982,Watford,Arsenal,2-1,2,1,1,1,3,1,H
1983-05-02,1982,Arsenal,Manchester United,3-0,3,0,1,1,3,3,H
1983-05-02,1982,Birmingham City,Brighton & Hove Albion,1-1,1,1,1,1,2,0,D
1983-05-02,1982,Everton,Coventry City,1-0,1,0,1,1,1,1,H
1983-05-02,1982,Luton Town,Stoke City,0-0,0,0,1,1,0,0,D
1983-05-02,1982,Nottingham Forest,Liverpool,1-0,1,0,1,1,1,1,H
1983-05-02,1982,Sunderland,Watford,2-2,2,2,1,1,4,0,D
1983-05-02,1982,Swansea City,Aston Villa,2-1,2,1,1,1,3,1,H
1983-05-02,1982,West Bromwich Albion,Norwich City,1-0,1,0,1,1,1,1,H
1983-05-03,1982,Ipswich Town,West Ham United,1-2,1,2,1,1,3,-1,A
1983-05-03,1982,Southampton,Tottenham Hotspur,1-2,1,2,1,1,3,-1,A
1983-05-07,1982,Arsenal,Sunderland,0-1,0,1,1,1,1,-1,A
1983-05-07,1982,Birmingham City,Tottenham Hotspur,2-0,2,0,1,1,2,2,H
1983-05-07,1982,Brighton & Hove Albion,Manchester City,0-1,0,1,1,1,1,-1,A
1983-05-07,1982,Ipswich Town,Watford,3-1,3,1,1,1,4,2,H
1983-05-07,1982,Liverpool,Aston Villa,1-1,1,1,1,1,2,0,D
1983-05-07,1982,Luton Town,Everton,1-5,1,5,1,1,6,-4,A
1983-05-07,1982,Manchester United,Swansea City,2-1,2,1,1,1,3,1,H
1983-05-07,1982,Nottingham Forest,Norwich City,2-2,2,2,1,1,4,0,D
1983-05-07,1982,Stoke City,Coventry City,0-3,0,3,1,1,3,-3,A
1983-05-07,1982,West Bromwich Albion,Southampton,1-0,1,0,1,1,1,1,H
1983-05-07,1982,West Ham United,Notts County,2-0,2,0,1,1,2,2,H
1983-05-09,1982,Manchester United,Luton Town,3-0,3,0,1,1,3,3,H
1983-05-10,1982,West Ham United,Arsenal,1-3,1,3,1,1,4,-2,A
1983-05-11,1982,Tottenham Hotspur,Manchester United,2-0,2,0,1,1,2,2,H
1983-05-14,1982,Aston Villa,Arsenal,2-1,2,1,1,1,3,1,H
1983-05-14,1982,Coventry City,West Ham United,2-4,2,4,1,1,6,-2,A
1983-05-14,1982,Everton,Ipswich Town,1-1,1,1,1,1,2,0,D
1983-05-14,1982,Manchester City,Luton Town,0-1,0,1,1,1,1,-1,A
1983-05-14,1982,Norwich City,Brighton & Hove Albion,2-1,2,1,1,1,3,1,H
1983-05-14,1982,Notts County,Manchester United,3-2,3,2,1,1,5,1,H
1983-05-14,1982,Southampton,Birmingham City,0-1,0,1,1,1,1,-1,A
1983-05-14,1982,Sunderland,West Bromwich Albion,1-1,1,1,1,1,2,0,D
1983-05-14,1982,Swansea City,Nottingham Forest,0-3,0,3,1,1,3,-3,A
1983-05-14,1982,Tottenham Hotspur,Stoke City,4-1,4,1,1,1,5,3,H
1983-05-14,1982,Watford,Liverpool,2-1,2,1,1,1,3,1,H
1983-08-27,1983,Arsenal,Luton Town,2-1,2,1,1,1,3,1,H
1983-08-27,1983,Aston Villa,West Bromwich Albion,4-3,4,3,1,1,7,1,H
1983-08-27,1983,Everton,Stoke City,1-0,1,0,1,1,1,1,H
1983-08-27,1983,Ipswich Town,Tottenham Hotspur,3-1,3,1,1,1,4,2,H
1983-08-27,1983,Leicester City,Notts County,0-4,0,4,1,1,4,-4,A
1983-08-27,1983,Manchester United,Queens Park Rangers,3-1,3,1,1,1,4,2,H
1983-08-27,1983,Nottingham Forest,Southampton,0-1,0,1,1,1,1,-1,A
1983-08-27,1983,Sunderland,Norwich City,1-1,1,1,1,1,2,0,D
1983-08-27,1983,Watford,Coventry City,2-3,2,3,1,1,5,-1,A
1983-08-27,1983,West Ham United,Birmingham City,4-0,4,0,1,1,4,4,H
1983-08-27,1983,Wolverhampton Wanderers,Liverpool,1-1,1,1,1,1,2,0,D
1983-08-29,1983,Aston Villa,Sunderland,1-0,1,0,1,1,1,1,H
1983-08-29,1983,Everton,West Ham United,0-1,0,1,1,1,1,-1,A
1983-08-29,1983,Manchester United,Nottingham Forest,1-2,1,2,1,1,3,-1,A
1983-08-29,1983,Southampton,Queens Park Rangers,0-0,0,0,1,1,0,0,D
1983-08-29,1983,Stoke City,West Bromwich Albion,3-1,3,1,1,1,4,2,H
1983-08-29,1983,Tottenham Hotspur,Coventry City,1-1,1,1,1,1,2,0,D
1983-08-29,1983,Wolverhampton Wanderers,Arsenal,1-2,1,2,1,1,3,-1,A
1983-08-30,1983,Notts County,Birmingham City,2-1,2,1,1,1,3,1,H
1983-08-30,1983,Watford,Ipswich Town,2-2,2,2,1,1,4,0,D
1983-08-31,1983,Leicester City,Luton Town,0-3,0,3,1,1,3,-3,A
1983-08-31,1983,Norwich City,Liverpool,0-1,0,1,1,1,1,-1,A
1983-09-03,1983,Birmingham City,Watford,2-0,2,0,1,1,2,2,H
1983-09-03,1983,Coventry City,Everton,1-1,1,1,1,1,2,0,D
1983-09-03,1983,Liverpool,Nottingham Forest,1-0,1,0,1,1,1,1,H
1983-09-03,1983,Luton Town,Sunderland,4-1,4,1,1,1,5,3,H
1983-09-03,1983,Norwich City,Wolverhampton Wanderers,3-0,3,0,1,1,3,3,H
1983-09-03,1983,Notts County,Ipswich Town,0-2,0,2,1,1,2,-2,A
1983-09-03,1983,Queens Park Rangers,Aston Villa,2-1,2,1,1,1,3,1,H
1983-09-03,1983,Southampton,Arsenal,1-0,1,0,1,1,1,1,H
1983-09-03,1983,Stoke City,Manchester United,0-1,0,1,1,1,1,-1,A
1983-09-03,1983,Tottenham Hotspur,West Ham United,0-2,0,2,1,1,2,-2,A
1983-09-03,1983,West Bromwich Albion,Leicester City,1-0,1,0,1,1,1,1,H
1983-09-06,1983,Arsenal,Manchester United,2-3,2,3,1,1,5,-1,A
1983-09-06,1983,Birmingham City,Stoke City,1-0,1,0,1,1,1,1,H
1983-09-06,1983,Coventry City,Notts County,2-1,2,1,1,1,3,1,H
1983-09-06,1983,Ipswich Town,Everton,3-0,3,0,1,1,3,3,H
1983-09-06,1983,Liverpool,Southampton,1-1,1,1,1,1,2,0,D
1983-09-06,1983,Luton Town,Norwich City,2-2,2,2,1,1,4,0,D
1983-09-06,1983,Queens Park Rangers,Watford,1-1,1,1,1,1,2,0,D
1983-09-06,1983,West Ham United,Leicester City,3-1,3,1,1,1,4,2,H
1983-09-07,1983,Nottingham Forest,Aston Villa,2-2,2,2,1,1,4,0,D
1983-09-07,1983,Sunderland,Wolverhampton Wanderers,3-2,3,2,1,1,5,1,H
1983-09-07,1983,West Bromwich Albion,Tottenham Hotspur,1-1,1,1,1,1,2,0,D
1983-09-10,1983,Arsenal,Liverpool,0-2,0,2,1,1,2,-2,A
1983-09-10,1983,Aston Villa,Norwich City,1-0,1,0,1,1,1,1,H
1983-09-10,1983,Everton,West Bromwich Albion,0-0,0,0,1,1,0,0,D
1983-09-10,1983,Ipswich Town,Stoke City,5-0,5,0,1,1,5,5,H
1983-09-10,1983,Leicester City,Tottenham Hotspur,0-3,0,3,1,1,3,-3,A
1983-09-10,1983,Manchester United,Luton Town,2-0,2,0,1,1,2,2,H
1983-09-10,1983,Nottingham Forest,Queens Park Rangers,3-2,3,2,1,1,5,1,H
1983-09-10,1983,Sunderland,Southampton,0-2,0,2,1,1,2,-2,A
1983-09-10,1983,Watford,Notts County,3-1,3,1,1,1,4,2,H
1983-09-10,1983,West Ham United,Coventry City,5-2,5,2,1,1,7,3,H
1983-09-10,1983,Wolverhampton Wanderers,Birmingham City,1-1,1,1,1,1,2,0,D
1983-09-17,1983,Birmingham City,Ipswich Town,1-0,1,0,1,1,1,1,H
1983-09-17,1983,Coventry City,Leicester City,2-1,2,1,1,1,3,1,H
1983-09-17,1983,Liverpool,Aston Villa,2-1,2,1,1,1,3,1,H
1983-09-17,1983,Luton Town,Wolverhampton Wanderers,4-0,4,0,1,1,4,4,H
1983-09-17,1983,Norwich City,Nottingham Forest,2-3,2,3,1,1,5,-1,A
1983-09-17,1983,Notts County,Arsenal,0-4,0,4,1,1,4,-4,A
1983-09-17,1983,Queens Park Rangers,Sunderland,3-0,3,0,1,1,3,3,H
1983-09-17,1983,Southampton,Manchester United,3-0,3,0,1,1,3,3,H
1983-09-17,1983,Stoke City,Watford,0-4,0,4,1,1,4,-4,A
1983-09-17,1983,Tottenham Hotspur,Everton,1-2,1,2,1,1,3,-1,A
1983-09-17,1983,West Bromwich Albion,West Ham United,1-0,1,0,1,1,1,1,H
1983-09-24,1983,Arsenal,Norwich City,3-0,3,0,1,1,3,3,H
1983-09-24,1983,Aston Villa,Southampton,1-0,1,0,1,1,1,1,H
1983-09-24,1983,Everton,Birmingham City,1-1,1,1,1,1,2,0,D
1983-09-24,1983,Ipswich Town,West Bromwich Albion,3-4,3,4,1,1,7,-1,A
1983-09-24,1983,Leicester City,Stoke City,2-2,2,2,1,1,4,0,D
1983-09-24,1983,Manchester United,Liverpool,1-0,1,0,1,1,1,1,H
1983-09-24,1983,Nottingham Forest,Luton Town,1-0,1,0,1,1,1,1,H
1983-09-24,1983,Sunderland,Coventry City,1-0,1,0,1,1,1,1,H
1983-09-24,1983,Watford,Tottenham Hotspur,2-3,2,3,1,1,5,-1,A
1983-09-24,1983,West Ham United,Notts County,3-0,3,0,1,1,3,3,H
1983-09-24,1983,Wolverhampton Wanderers,Queens Park Rangers,0-4,0,4,1,1,4,-4,A
1983-10-01,1983,Birmingham City,Leicester City,2-1,2,1,1,1,3,1,H
1983-10-01,1983,Coventry City,Ipswich Town,1-2,1,2,1,1,3,-1,A
1983-10-01,1983,Liverpool,Sunderland,0-1,0,1,1,1,1,-1,A
1983-10-01,1983,Luton Town,Aston Villa,1-0,1,0,1,1,1,1,H
1983-10-01,1983,Norwich City,Manchester United,3-3,3,3,1,1,6,0,D
1983-10-01,1983,Notts County,Everton,0-1,0,1,1,1,1,-1,A
1983-10-01,1983,Queens Park Rangers,Arsenal,2-0,2,0,1,1,2,2,H
1983-10-01,1983,Southampton,Wolverhampton Wanderers,1-0,1,0,1,1,1,1,H
1983-10-01,1983,Stoke City,West Ham United,3-1,3,1,1,1,4,2,H
1983-10-01,1983,West Bromwich Albion,Watford,2-0,2,0,1,1,2,2,H
1983-10-02,1983,Tottenham Hotspur,Nottingham Forest,2-1,2,1,1,1,3,1,H
1983-10-15,1983,Arsenal,Coventry City,0-1,0,1,1,1,1,-1,A
1983-10-15,1983,Aston Villa,Birmingham City,1-0,1,0,1,1,1,1,H
1983-10-15,1983,Everton,Luton Town,0-1,0,1,1,1,1,-1,A
1983-10-15,1983,Ipswich Town,Queens Park Rangers,0-2,0,2,1,1,2,-2,A
1983-10-15,1983,Manchester United,West Bromwich Albion,3-0,3,0,1,1,3,3,H
1983-10-15,1983,Sunderland,Stoke City,2-2,2,2,1,1,4,0,D
1983-10-15,1983,Watford,Norwich City,1-3,1,3,1,1,4,-2,A
1983-10-15,1983,West Ham United,Liverpool,1-3,1,3,1,1,4,-2,A
1983-10-15,1983,Wolverhampton Wanderers,Tottenham Hotspur,2-3,2,3,1,1,5,-1,A
1983-10-16,1983,Nottingham Forest,Notts County,3-1,3,1,1,1,4,2,H
1983-10-19,1983,Norwich City,Leicester City,3-1,3,1,1,1,4,2,H
1983-10-22,1983,Arsenal,Nottingham Forest,4-1,4,1,1,1,5,3,H
1983-10-22,1983,Birmingham City,Tottenham Hotspur,0-1,0,1,1,1,1,-1,A
1983-10-22,1983,Coventry City,West Bromwich Albion,1-2,1,2,1,1,3,-1,A
1983-10-22,1983,Everton,Watford,1-0,1,0,1,1,1,1,H
1983-10-22,1983,Ipswich Town,Leicester City,0-0,0,0,1,1,0,0,D
1983-10-22,1983,Luton Town,Southampton,3-1,3,1,1,1,4,2,H
1983-10-22,1983,Notts County,Stoke City,1-1,1,1,1,1,2,0,D
1983-10-22,1983,Queens Park Rangers,Liverpool,0-1,0,1,1,1,1,-1,A
1983-10-22,1983,Sunderland,Manchester United,0-1,0,1,1,1,1,-1,A
1983-10-22,1983,West Ham United,Norwich City,0-0,0,0,1,1,0,0,D
1983-10-23,1983,Wolverhampton Wanderers,Aston Villa,1-1,1,1,1,1,2,0,D
1983-10-28,1983,Watford,West Ham United,0-0,0,0,1,1,0,0,D
1983-10-29,1983,Aston Villa,Arsenal,2-6,2,6,1,1,8,-4,A
1983-10-29,1983,Leicester City,Everton,2-0,2,0,1,1,2,2,H
1983-10-29,1983,Liverpool,Luton Town,6-0,6,0,1,1,6,6,H
1983-10-29,1983,Manchester United,Wolverhampton Wanderers,3-0,3,0,1,1,3,3,H
1983-10-29,1983,Norwich City,Queens Park Rangers,0-3,0,3,1,1,3,-3,A
1983-10-29,1983,Nottingham Forest,Sunderland,1-1,1,1,1,1,2,0,D
1983-10-29,1983,Southampton,Ipswich Town,3-2,3,2,1,1,5,1,H
1983-10-29,1983,Stoke City,Coventry City,1-3,1,3,1,1,4,-2,A
1983-10-29,1983,Tottenham Hotspur,Notts County,1-0,1,0,1,1,1,1,H
1983-10-29,1983,West Bromwich Albion,Birmingham City,1-2,1,2,1,1,3,-1,A
1983-11-05,1983,Arsenal,Sunderland,1-2,1,2,1,1,3,-1,A
1983-11-05,1983,Birmingham City,Coventry City,1-2,1,2,1,1,3,-1,A
1983-11-05,1983,Manchester United,Aston Villa,1-2,1,2,1,1,3,-1,A
1983-11-05,1983,Norwich City,Southampton,1-0,1,0,1,1,1,1,H
1983-11-05,1983,Nottingham Forest,Wolverhampton Wanderers,5-0,5,0,1,1,5,5,H
1983-11-05,1983,Queens Park Rangers,Luton Town,0-1,0,1,1,1,1,-1,A
1983-11-05,1983,Stoke City,Tottenham Hotspur,1-1,1,1,1,1,2,0,D
1983-11-05,1983,Watford,Leicester City,3-3,3,3,1,1,6,0,D
1983-11-05,1983,West Bromwich Albion,Notts County,2-0,2,0,1,1,2,2,H
1983-11-05,1983,West Ham United,Ipswich Town,2-1,2,1,1,1,3,1,H
1983-11-06,1983,Liverpool,Everton,3-0,3,0,1,1,3,3,H
1983-11-12,1983,Aston Villa,Stoke City,1-1,1,1,1,1,2,0,D
1983-11-12,1983,Coventry City,Queens Park Rangers,1-0,1,0,1,1,1,1,H
1983-11-12,1983,Everton,Nottingham Forest,1-0,1,0,1,1,1,1,H
1983-11-12,1983,Ipswich Town,Arsenal,1-0,1,0,1,1,1,1,H
1983-11-12,1983,Leicester City,Manchester United,1-1,1,1,1,1,2,0,D
1983-11-12,1983,Luton Town,Birmingham City,1-1,1,1,1,1,2,0,D
1983-11-12,1983,Notts County,Norwich City,1-1,1,1,1,1,2,0,D
1983-11-12,1983,Southampton,West Bromwich Albion,1-0,1,0,1,1,1,1,H
1983-11-12,1983,Sunderland,Watford,3-0,3,0,1,1,3,3,H
1983-11-12,1983,Tottenham Hotspur,Liverpool,2-2,2,2,1,1,4,0,D
1983-11-12,1983,Wolverhampton Wanderers,West Ham United,0-3,0,3,1,1,3,-3,A
1983-11-19,1983,Arsenal,Everton,2-1,2,1,1,1,3,1,H
1983-11-19,1983,Aston Villa,Leicester City,3-1,3,1,1,1,4,2,H
1983-11-19,1983,Liverpool,Stoke City,1-0,1,0,1,1,1,1,H
1983-11-19,1983,Luton Town,Tottenham Hotspur,2-4,2,4,1,1,6,-2,A
1983-11-19,1983,Manchester United,Watford,4-1,4,1,1,1,5,3,H
1983-11-19,1983,Norwich City,West Bromwich Albion,2-0,2,0,1,1,2,2,H
1983-11-19,1983,Nottingham Forest,Ipswich Town,2-1,2,1,1,1,3,1,H
1983-11-19,1983,Queens Park Rangers,Birmingham City,2-1,2,1,1,1,3,1,H
1983-11-19,1983,Southampton,Notts County,0-2,0,2,1,1,2,-2,A
1983-11-19,1983,Sunderland,West Ham United,0-1,0,1,1,1,1,-1,A
1983-11-19,1983,Wolverhampton Wanderers,Coventry City,0-0,0,0,1,1,0,0,D
1983-11-26,1983,Birmingham City,Sunderland,0-1,0,1,1,1,1,-1,A
1983-11-26,1983,Coventry City,Southampton,0-0,0,0,1,1,0,0,D
1983-11-26,1983,Everton,Norwich City,0-2,0,2,1,1,2,-2,A
1983-11-26,1983,Ipswich Town,Liverpool,1-1,1,1,1,1,2,0,D
1983-11-26,1983,Leicester City,Arsenal,3-0,3,0,1,1,3,3,H
1983-11-26,1983,Notts County,Aston Villa,5-2,5,2,1,1,7,3,H
1983-11-26,1983,Stoke City,Nottingham Forest,1-1,1,1,1,1,2,0,D
1983-11-26,1983,Tottenham Hotspur,Queens Park Rangers,3-2,3,2,1,1,5,1,H
1983-11-26,1983,Watford,Luton Town,1-2,1,2,1,1,3,-1,A
1983-11-26,1983,West Bromwich Albion,Wolverhampton Wanderers,1-3,1,3,1,1,4,-2,A
1983-11-27,1983,West Ham United,Manchester United,1-1,1,1,1,1,2,0,D
1983-11-30,1983,Leicester City,Southampton,2-1,2,1,1,1,3,1,H
1983-12-03,1983,Arsenal,West Bromwich Albion,0-1,0,1,1,1,1,-1,A
1983-12-03,1983,Aston Villa,West Ham United,1-0,1,0,1,1,1,1,H
1983-12-03,1983,Liverpool,Birmingham City,1-0,1,0,1,1,1,1,H
1983-12-03,1983,Luton Town,Coventry City,2-4,2,4,1,1,6,-2,A
1983-12-03,1983,Manchester United,Everton,0-1,0,1,1,1,1,-1,A
1983-12-03,1983,Norwich City,Tottenham Hotspur,2-1,2,1,1,1,3,1,H
1983-12-03,1983,Queens Park Rangers,Notts County,1-0,1,0,1,1,1,1,H
1983-12-03,1983,Southampton,Stoke City,3-1,3,1,1,1,4,2,H
1983-12-03,1983,Sunderland,Ipswich Town,1-1,1,1,1,1,2,0,D
1983-12-03,1983,Wolverhampton Wanderers,Watford,0-5,0,5,1,1,5,-5,A
1983-12-04,1983,Nottingham Forest,Leicester City,3-2,3,2,1,1,5,1,H
1983-12-10,1983,Birmingham City,Norwich City,0-1,0,1,1,1,1,-1,A
1983-12-10,1983,Coventry City,Liverpool,4-0,4,0,1,1,4,4,H
1983-12-10,1983,Everton,Aston Villa,1-1,1,1,1,1,2,0,D
1983-12-10,1983,Ipswich Town,Manchester United,0-2,0,2,1,1,2,-2,A
1983-12-10,1983,Leicester City,Wolverhampton Wanderers,5-1,5,1,1,1,6,4,H
1983-12-10,1983,Notts County,Sunderland,6-1,6,1,1,1,7,5,H
1983-12-10,1983,Stoke City,Luton Town,2-4,2,4,1,1,6,-2,A
1983-12-10,1983,Tottenham Hotspur,Southampton,0-0,0,0,1,1,0,0,D
1983-12-10,1983,Watford,Nottingham Forest,3-2,3,2,1,1,5,1,H
1983-12-10,1983,West Bromwich Albion,Queens Park Rangers,1-2,1,2,1,1,3,-1,A
1983-12-10,1983,West Ham United,Arsenal,3-1,3,1,1,1,4,2,H
1983-12-16,1983,Manchester United,Tottenham Hotspur,4-2,4,2,1,1,6,2,H
1983-12-17,1983,Arsenal,Watford,3-1,3,1,1,1,4,2,H
1983-12-17,1983,Aston Villa,Ipswich Town,4-0,4,0,1,1,4,4,H
1983-12-17,1983,Liverpool,Notts County,5-0,5,0,1,1,5,5,H
1983-12-17,1983,Norwich City,Coventry City,0-0,0,0,1,1,0,0,D
1983-12-17,1983,Nottingham Forest,West Ham United,3-0,3,0,1,1,3,3,H
1983-12-17,1983,Queens Park Rangers,Everton,2-0,2,0,1,1,2,2,H
1983-12-17,1983,Southampton,Birmingham City,2-1,2,1,1,1,3,1,H
1983-12-17,1983,Wolverhampton Wanderers,Stoke City,0-0,0,0,1,1,0,0,D
1983-12-18,1983,Luton Town,West Bromwich Albion,2-0,2,0,1,1,2,2,H
1983-12-18,1983,Sunderland,Leicester City,1-1,1,1,1,1,2,0,D
1983-12-26,1983,Birmingham City,Nottingham Forest,1-2,1,2,1,1,3,-1,A
1983-12-26,1983,Coventry City,Manchester United,1-1,1,1,1,1,2,0,D
1983-12-26,1983,Everton,Sunderland,0-0,0,0,1,1,0,0,D
1983-12-26,1983,Ipswich Town,Wolverhampton Wanderers,3-1,3,1,1,1,4,2,H
1983-12-26,1983,Leicester City,Queens Park Rangers,2-1,2,1,1,1,3,1,H
1983-12-26,1983,Notts County,Luton Town,0-3,0,3,1,1,3,-3,A
1983-12-26,1983,Stoke City,Norwich City,2-0,2,0,1,1,2,2,H
1983-12-26,1983,Tottenham Hotspur,Arsenal,2-4,2,4,1,1,6,-2,A
1983-12-26,1983,Watford,Aston Villa,3-2,3,2,1,1,5,1,H
1983-12-26,1983,West Bromwich Albion,Liverpool,1-2,1,2,1,1,3,-1,A
1983-12-26,1983,West Ham United,Southampton,0-1,0,1,1,1,1,-1,A
1983-12-27,1983,Arsenal,Birmingham City,1-1,1,1,1,1,2,0,D
1983-12-27,1983,Aston Villa,Tottenham Hotspur,0-0,0,0,1,1,0,0,D
1983-12-27,1983,Liverpool,Leicester City,2-2,2,2,1,1,4,0,D
1983-12-27,1983,Luton Town,West Ham United,0-1,0,1,1,1,1,-1,A
1983-12-27,1983,Manchester United,Notts County,3-3,3,3,1,1,6,0,D
1983-12-27,1983,Norwich City,Ipswich Town,0-0,0,0,1,1,0,0,D
1983-12-27,1983,Southampton,Watford,1-0,1,0,1,1,1,1,H
1983-12-27,1983,Sunderland,West Bromwich Albion,3-0,3,0,1,1,3,3,H
1983-12-27,1983,Wolverhampton Wanderers,Everton,3-0,3,0,1,1,3,3,H
1983-12-28,1983,Nottingham Forest,Coventry City,3-0,3,0,1,1,3,3,H
1983-12-31,1983,Arsenal,Southampton,2-2,2,2,1,1,4,0,D
1983-12-31,1983,Aston Villa,Queens Park Rangers,2-1,2,1,1,1,3,1,H
1983-12-31,1983,Everton,Coventry City,0-0,0,0,1,1,0,0,D
1983-12-31,1983,Ipswich Town,Notts County,1-0,1,0,1,1,1,1,H
1983-12-31,1983,Leicester City,West Bromwich Albion,1-1,1,1,1,1,2,0,D
1983-12-31,1983,Manchester United,Stoke City,1-0,1,0,1,1,1,1,H
1983-12-31,1983,Nottingham Forest,Liverpool,0-1,0,1,1,1,1,-1,A
1983-12-31,1983,Sunderland,Luton Town,2-0,2,0,1,1,2,2,H
1983-12-31,1983,Watford,Birmingham City,1-0,1,0,1,1,1,1,H
1983-12-31,1983,West Ham United,Tottenham Hotspur,4-1,4,1,1,1,5,3,H
1983-12-31,1983,Wolverhampton Wanderers,Norwich City,2-0,2,0,1,1,2,2,H
1984-01-02,1983,Birmingham City,Everton,0-2,0,2,1,1,2,-2,A
1984-01-02,1983,Coventry City,Sunderland,2-1,2,1,1,1,3,1,H
1984-01-02,1983,Liverpool,Manchester United,1-1,1,1,1,1,2,0,D
1984-01-02,1983,Luton Town,Nottingham Forest,2-3,2,3,1,1,5,-1,A
1984-01-02,1983,Norwich City,Arsenal,1-1,1,1,1,1,2,0,D
1984-01-02,1983,Notts County,West Ham United,2-2,2,2,1,1,4,0,D
1984-01-02,1983,Queens Park Rangers,Wolverhampton Wanderers,2-1,2,1,1,1,3,1,H
1984-01-02,1983,Southampton,Aston Villa,2-2,2,2,1,1,4,0,D
1984-01-02,1983,Stoke City,Leicester City,0-1,0,1,1,1,1,-1,A
1984-01-02,1983,Tottenham Hotspur,Watford,2-3,2,3,1,1,5,-1,A
1984-01-02,1983,West Bromwich Albion,Ipswich Town,2-1,2,1,1,1,3,1,H
1984-01-13,1983,Queens Park Rangers,Manchester United,1-1,1,1,1,1,2,0,D
1984-01-14,1983,Birmingham City,West Ham United,3-0,3,0,1,1,3,3,H
1984-01-14,1983,Coventry City,Watford,1-2,1,2,1,1,3,-1,A
1984-01-14,1983,Liverpool,Wolverhampton Wanderers,0-1,0,1,1,1,1,-1,A
1984-01-14,1983,Luton Town,Arsenal,1-2,1,2,1,1,3,-1,A
1984-01-14,1983,Norwich City,Sunderland,3-0,3,0,1,1,3,3,H
1984-01-14,1983,Notts County,Leicester City,2-5,2,5,1,1,7,-3,A
1984-01-14,1983,Stoke City,Everton,1-1,1,1,1,1,2,0,D
1984-01-14,1983,Tottenham Hotspur,Ipswich Town,2-0,2,0,1,1,2,2,H
1984-01-14,1983,West Bromwich Albion,Aston Villa,3-1,3,1,1,1,4,2,H
1984-01-17,1983,Queens Park Rangers,Stoke City,6-0,6,0,1,1,6,6,H
1984-01-20,1983,Aston Villa,Liverpool,1-3,1,3,1,1,4,-2,A
1984-01-21,1983,Arsenal,Notts County,1-1,1,1,1,1,2,0,D
1984-01-21,1983,Everton,Tottenham Hotspur,2-1,2,1,1,1,3,1,H
1984-01-21,1983,Ipswich Town,Birmingham City,1-2,1,2,1,1,3,-1,A
1984-01-21,1983,Leicester City,Coventry City,1-1,1,1,1,1,2,0,D
1984-01-21,1983,Manchester United,Southampton,3-2,3,2,1,1,5,1,H
1984-01-21,1983,Nottingham Forest,Norwich City,3-0,3,0,1,1,3,3,H
1984-01-21,1983,Watford,Stoke City,2-0,2,0,1,1,2,2,H
1984-01-21,1983,West Ham United,West Bromwich Albion,1-0,1,0,1,1,1,1,H
1984-01-21,1983,Wolverhampton Wanderers,Luton Town,1-2,1,2,1,1,3,-1,A
1984-01-23,1983,Southampton,Nottingham Forest,0-1,0,1,1,1,1,-1,A
1984-01-28,1983,Stoke City,Arsenal,1-0,1,0,1,1,1,1,H
1984-02-01,1983,Liverpool,Watford,3-0,3,0,1,1,3,3,H
1984-02-04,1983,Arsenal,Queens Park Rangers,0-2,0,2,1,1,2,-2,A
1984-02-04,1983,Aston Villa,Luton Town,0-0,0,0,1,1,0,0,D
1984-02-04,1983,Everton,Notts County,4-1,4,1,1,1,5,3,H
1984-02-04,1983,Ipswich Town,Coventry City,3-1,3,1,1,1,4,2,H
1984-02-04,1983,Leicester City,Birmingham City,2-3,2,3,1,1,5,-1,A
1984-02-04,1983,Manchester United,Norwich City,0-0,0,0,1,1,0,0,D
1984-02-04,1983,Nottingham Forest,Tottenham Hotspur,2-2,2,2,1,1,4,0,D
1984-02-04,1983,Sunderland,Liverpool,0-0,0,0,1,1,0,0,D
1984-02-04,1983,Watford,West Bromwich Albion,3-1,3,1,1,1,4,2,H
1984-02-04,1983,West Ham United,Stoke City,3-0,3,0,1,1,3,3,H
1984-02-04,1983,Wolverhampton Wanderers,Southampton,0-1,0,1,1,1,1,-1,A
1984-02-07,1983,Birmingham City,Manchester United,2-2,2,2,1,1,4,0,D
1984-02-07,1983,Queens Park Rangers,West Ham United,1-1,1,1,1,1,2,0,D
1984-02-08,1983,Tottenham Hotspur,Sunderland,3-0,3,0,1,1,3,3,H
1984-02-08,1983,West Bromwich Albion,Nottingham Forest,0-5,0,5,1,1,5,-5,A
1984-02-11,1983,Birmingham City,Wolverhampton Wanderers,0-0,0,0,1,1,0,0,D
1984-02-11,1983,Coventry City,West Ham United,1-2,1,2,1,1,3,-1,A
1984-02-11,1983,Liverpool,Arsenal,2-1,2,1,1,1,3,1,H
1984-02-11,1983,Norwich City,Aston Villa,3-1,3,1,1,1,4,2,H
1984-02-11,1983,Notts County,Watford,3-5,3,5,1,1,8,-2,A
1984-02-11,1983,Queens Park Rangers,Nottingham Forest,0-1,0,1,1,1,1,-1,A
1984-02-11,1983,Southampton,Sunderland,1-1,1,1,1,1,2,0,D
1984-02-11,1983,Stoke City,Ipswich Town,1-0,1,0,1,1,1,1,H
1984-02-11,1983,Tottenham Hotspur,Leicester City,3-2,3,2,1,1,5,1,H
1984-02-11,1983,West Bromwich Albion,Everton,1-1,1,1,1,1,2,0,D
1984-02-12,1983,Luton Town,Manchester United,0-5,0,5,1,1,5,-5,A
1984-02-14,1983,Queens Park Rangers,Norwich City,2-0,2,0,1,1,2,2,H
1984-02-18,1983,Arsenal,Aston Villa,1-1,1,1,1,1,2,0,D
1984-02-18,1983,Coventry City,Stoke City,2-3,2,3,1,1,5,-1,A
1984-02-18,1983,Luton Town,Liverpool,0-0,0,0,1,1,0,0,D
1984-02-18,1983,Sunderland,Nottingham Forest,1-1,1,1,1,1,2,0,D
1984-02-18,1983,Wolverhampton Wanderers,Manchester United,1-1,1,1,1,1,2,0,D
1984-02-21,1983,Ipswich Town,Southampton,0-3,0,3,1,1,3,-3,A
1984-02-21,1983,Notts County,Tottenham Hotspur,0-0,0,0,1,1,0,0,D
1984-02-21,1983,West Ham United,Watford,2-4,2,4,1,1,6,-2,A
1984-02-25,1983,Aston Villa,Wolverhampton Wanderers,4-0,4,0,1,1,4,4,H
1984-02-25,1983,Leicester City,Ipswich Town,2-0,2,0,1,1,2,2,H
1984-02-25,1983,Liverpool,Queens Park Rangers,2-0,2,0,1,1,2,2,H
1984-02-25,1983,Manchester United,Sunderland,2-1,2,1,1,1,3,1,H
1984-02-25,1983,Norwich City,West Ham United,1-0,1,0,1,1,1,1,H
1984-02-25,1983,Nottingham Forest,Arsenal,0-1,0,1,1,1,1,-1,A
1984-02-25,1983,Southampton,Luton Town,2-1,2,1,1,1,3,1,H
1984-02-25,1983,Stoke City,Notts County,1-0,1,0,1,1,1,1,H
1984-02-25,1983,Tottenham Hotspur,Birmingham City,0-1,0,1,1,1,1,-1,A
1984-02-25,1983,Watford,Everton,4-4,4,4,1,1,8,0,D
1984-02-25,1983,West Bromwich Albion,Coventry City,1-1,1,1,1,1,2,0,D
1984-02-28,1983,Birmingham City,West Bromwich Albion,2-1,2,1,1,1,3,1,H
1984-03-03,1983,Aston Villa,Manchester United,0-3,0,3,1,1,3,-3,A
1984-03-03,1983,Coventry City,Birmingham City,0-1,0,1,1,1,1,-1,A
1984-03-03,1983,Everton,Liverpool,1-1,1,1,1,1,2,0,D
1984-03-03,1983,Ipswich Town,West Ham United,0-3,0,3,1,1,3,-3,A
1984-03-03,1983,Leicester City,Watford,4-1,4,1,1,1,5,3,H
1984-03-03,1983,Luton Town,Queens Park Rangers,0-0,0,0,1,1,0,0,D
1984-03-03,1983,Notts County,West Bromwich Albion,1-1,1,1,1,1,2,0,D
1984-03-03,1983,Southampton,Norwich City,2-1,2,1,1,1,3,1,H
1984-03-03,1983,Sunderland,Arsenal,2-2,2,2,1,1,4,0,D
1984-03-03,1983,Tottenham Hotspur,Stoke City,1-0,1,0,1,1,1,1,H
1984-03-03,1983,Wolverhampton Wanderers,Nottingham Forest,1-0,1,0,1,1,1,1,H
1984-03-07,1983,Sunderland,Queens Park Rangers,1-0,1,0,1,1,1,1,H
1984-03-10,1983,Arsenal,Ipswich Town,4-1,4,1,1,1,5,3,H
1984-03-10,1983,Liverpool,Tottenham Hotspur,3-1,3,1,1,1,4,2,H
1984-03-10,1983,Manchester United,Leicester City,2-0,2,0,1,1,2,2,H
1984-03-10,1983,Queens Park Rangers,Coventry City,2-1,2,1,1,1,3,1,H
1984-03-10,1983,Stoke City,Aston Villa,1-0,1,0,1,1,1,1,H
1984-03-10,1983,West Ham United,Wolverhampton Wanderers,1-1,1,1,1,1,2,0,D
1984-03-13,1983,Coventry City,Aston Villa,3-3,3,3,1,1,6,0,D
1984-03-13,1983,Luton Town,Ipswich Town,2-1,2,1,1,1,3,1,H
1984-03-13,1983,Norwich City,Notts County,0-1,0,1,1,1,1,-1,A
1984-03-13,1983,Nottingham Forest,Everton,1-0,1,0,1,1,1,1,H
1984-03-16,1983,Southampton,Liverpool,2-0,2,0,1,1,2,2,H
1984-03-17,1983,Aston Villa,Nottingham Forest,1-0,1,0,1,1,1,1,H
1984-03-17,1983,Everton,Ipswich Town,1-0,1,0,1,1,1,1,H
1984-03-17,1983,Leicester City,West Ham United,4-1,4,1,1,1,5,3,H
1984-03-17,1983,Manchester United,Arsenal,4-0,4,0,1,1,4,4,H
1984-03-17,1983,Norwich City,Luton Town,0-0,0,0,1,1,0,0,D
1984-03-17,1983,Notts County,Coventry City,2-1,2,1,1,1,3,1,H
1984-03-17,1983,Stoke City,Birmingham City,2-1,2,1,1,1,3,1,H
1984-03-17,1983,Tottenham Hotspur,West Bromwich Albion,0-1,0,1,1,1,1,-1,A
1984-03-17,1983,Watford,Queens Park Rangers,1-0,1,0,1,1,1,1,H
1984-03-17,1983,Wolverhampton Wanderers,Sunderland,0-0,0,0,1,1,0,0,D
1984-03-20,1983,Birmingham City,Luton Town,1-1,1,1,1,1,2,0,D
1984-03-20,1983,Everton,Leicester City,1-1,1,1,1,1,2,0,D
1984-03-20,1983,Watford,Sunderland,2-1,2,1,1,1,3,1,H
1984-03-24,1983,Arsenal,Wolverhampton Wanderers,4-1,4,1,1,1,5,3,H
1984-03-24,1983,Birmingham City,Notts County,0-0,0,0,1,1,0,0,D
1984-03-24,1983,Coventry City,Tottenham Hotspur,2-4,2,4,1,1,6,-2,A
1984-03-24,1983,Ipswich Town,Watford,0-0,0,0,1,1,0,0,D
1984-03-24,1983,Luton Town,Leicester City,0-0,0,0,1,1,0,0,D
1984-03-24,1983,Queens Park Rangers,Southampton,4-0,4,0,1,1,4,4,H
1984-03-24,1983,Sunderland,Aston Villa,0-1,0,1,1,1,1,-1,A
1984-03-24,1983,West Bromwich Albion,Stoke City,3-0,3,0,1,1,3,3,H
1984-03-31,1983,Birmingham City,Aston Villa,2-1,2,1,1,1,3,1,H
1984-03-31,1983,Coventry City,Arsenal,1-4,1,4,1,1,5,-3,A
1984-03-31,1983,Everton,Southampton,1-0,1,0,1,1,1,1,H
1984-03-31,1983,Ipswich Town,Luton Town,3-0,3,0,1,1,3,3,H
1984-03-31,1983,Leicester City,Norwich City,2-1,2,1,1,1,3,1,H
1984-03-31,1983,Notts County,Nottingham Forest,0-0,0,0,1,1,0,0,D
1984-03-31,1983,Stoke City,Sunderland,2-1,2,1,1,1,3,1,H
1984-03-31,1983,Tottenham Hotspur,Wolverhampton Wanderers,1-0,1,0,1,1,1,1,H
1984-03-31,1983,Watford,Liverpool,0-2,0,2,1,1,2,-2,A
1984-03-31,1983,West Bromwich Albion,Manchester United,2-0,2,0,1,1,2,2,H
1984-03-31,1983,West Ham United,Queens Park Rangers,2-2,2,2,1,1,4,0,D
1984-04-07,1983,Arsenal,Stoke City,3-1,3,1,1,1,4,2,H
1984-04-07,1983,Aston Villa,Coventry City,2-0,2,0,1,1,2,2,H
1984-04-07,1983,Liverpool,West Ham United,6-0,6,0,1,1,6,6,H
1984-04-07,1983,Luton Town,Everton,0-3,0,3,1,1,3,-3,A
1984-04-07,1983,Manchester United,Birmingham City,1-0,1,0,1,1,1,1,H
1984-04-07,1983,Norwich City,Watford,6-1,6,1,1,1,7,5,H
1984-04-07,1983,Nottingham Forest,West Bromwich Albion,3-1,3,1,1,1,4,2,H
1984-04-07,1983,Queens Park Rangers,Ipswich Town,1-0,1,0,1,1,1,1,H
1984-04-07,1983,Southampton,Leicester City,2-2,2,2,1,1,4,0,D
1984-04-07,1983,Sunderland,Tottenham Hotspur,1-1,1,1,1,1,2,0,D
1984-04-07,1983,Wolverhampton Wanderers,Notts County,0-1,0,1,1,1,1,-1,A
1984-04-09,1983,Everton,Arsenal,0-0,0,0,1,1,0,0,D
1984-04-14,1983,Birmingham City,Queens Park Rangers,0-2,0,2,1,1,2,-2,A
1984-04-14,1983,Coventry City,Wolverhampton Wanderers,2-1,2,1,1,1,3,1,H
1984-04-14,1983,Ipswich Town,Nottingham Forest,2-2,2,2,1,1,4,0,D
1984-04-14,1983,Leicester City,Aston Villa,2-0,2,0,1,1,2,2,H
1984-04-14,1983,Notts County,Manchester United,1-0,1,0,1,1,1,1,H
1984-04-14,1983,Stoke City,Liverpool,2-0,2,0,1,1,2,2,H
1984-04-14,1983,Tottenham Hotspur,Luton Town,2-1,2,1,1,1,3,1,H
1984-04-14,1983,West Bromwich Albion,Norwich City,0-0,0,0,1,1,0,0,D
1984-04-14,1983,West Ham United,Sunderland,0-1,0,1,1,1,1,-1,A
1984-04-17,1983,Coventry City,Nottingham Forest,2-1,2,1,1,1,3,1,H
1984-04-17,1983,Southampton,Everton,3-1,3,1,1,1,4,2,H
1984-04-17,1983,Watford,Manchester United,0-0,0,0,1,1,0,0,D
1984-04-17,1983,West Ham United,Luton Town,3-1,3,1,1,1,4,2,H
1984-04-18,1983,Leicester City,Liverpool,3-3,3,3,1,1,6,0,D
1984-04-18,1983,Tottenham Hotspur,Aston Villa,2-1,2,1,1,1,3,1,H
1984-04-21,1983,Arsenal,Tottenham Hotspur,3-2,3,2,1,1,5,1,H
1984-04-21,1983,Aston Villa,Watford,2-1,2,1,1,1,3,1,H
1984-04-21,1983,Liverpool,West Bromwich Albion,3-0,3,0,1,1,3,3,H
1984-04-21,1983,Luton Town,Notts County,3-2,3,2,1,1,5,1,H
1984-04-21,1983,Manchester United,Coventry City,4-1,4,1,1,1,5,3,H
1984-04-21,1983,Norwich City,Stoke City,2-2,2,2,1,1,4,0,D
1984-04-21,1983,Nottingham Forest,Birmingham City,5-1,5,1,1,1,6,4,H
1984-04-21,1983,Queens Park Rangers,Leicester City,2-0,2,0,1,1,2,2,H
1984-04-21,1983,Southampton,West Ham United,2-0,2,0,1,1,2,2,H
1984-04-21,1983,Sunderland,Everton,2-1,2,1,1,1,3,1,H
1984-04-21,1983,Wolverhampton Wanderers,Ipswich Town,0-3,0,3,1,1,3,-3,A
1984-04-23,1983,Birmingham City,Arsenal,1-1,1,1,1,1,2,0,D
1984-04-23,1983,Everton,Wolverhampton Wanderers,2-0,2,0,1,1,2,2,H
1984-04-23,1983,Ipswich Town,Norwich City,2-0,2,0,1,1,2,2,H
1984-04-23,1983,Stoke City,Queens Park Rangers,1-2,1,2,1,1,3,-1,A
1984-04-23,1983,West Bromwich Albion,Sunderland,3-1,3,1,1,1,4,2,H
1984-04-24,1983,Watford,Southampton,1-1,1,1,1,1,2,0,D
1984-04-28,1983,Arsenal,Leicester City,2-1,2,1,1,1,3,1,H
1984-04-28,1983,Aston Villa,Notts County,3-1,3,1,1,1,4,2,H
1984-04-28,1983,Liverpool,Ipswich Town,2-2,2,2,1,1,4,0,D
1984-04-28,1983,Luton Town,Watford,1-2,1,2,1,1,3,-1,A
1984-04-28,1983,Manchester United,West Ham United,0-0,0,0,1,1,0,0,D
1984-04-28,1983,Norwich City,Everton,1-1,1,1,1,1,2,0,D
1984-04-28,1983,Nottingham Forest,Stoke City,0-0,0,0,1,1,0,0,D
1984-04-28,1983,Queens Park Rangers,Tottenham Hotspur,2-1,2,1,1,1,3,1,H
1984-04-28,1983,Southampton,Coventry City,8-2,8,2,1,1,10,6,H
1984-04-28,1983,Sunderland,Birmingham City,2-1,2,1,1,1,3,1,H
1984-04-28,1983,Wolverhampton Wanderers,West Bromwich Albion,0-0,0,0,1,1,0,0,D
1984-05-01,1983,Notts County,Wolverhampton Wanderers,4-0,4,0,1,1,4,4,H
1984-05-05,1983,Birmingham City,Liverpool,0-0,0,0,1,1,0,0,D
1984-05-05,1983,Coventry City,Luton Town,2-2,2,2,1,1,4,0,D
1984-05-05,1983,Everton,Manchester United,1-1,1,1,1,1,2,0,D
1984-05-05,1983,Ipswich Town,Sunderland,1-0,1,0,1,1,1,1,H
1984-05-05,1983,Leicester City,Nottingham Forest,2-1,2,1,1,1,3,1,H
1984-05-05,1983,Notts County,Queens Park Rangers,0-3,0,3,1,1,3,-3,A
1984-05-05,1983,Stoke City,Southampton,1-1,1,1,1,1,2,0,D
1984-05-05,1983,Tottenham Hotspur,Norwich City,2-0,2,0,1,1,2,2,H
1984-05-05,1983,Watford,Wolverhampton Wanderers,0-0,0,0,1,1,0,0,D
1984-05-05,1983,West Bromwich Albion,Arsenal,1-3,1,3,1,1,4,-2,A
1984-05-05,1983,West Ham United,Aston Villa,0-1,0,1,1,1,1,-1,A
1984-05-07,1983,Arsenal,West Ham United,3-3,3,3,1,1,6,0,D
1984-05-07,1983,Aston Villa,Everton,0-2,0,2,1,1,2,-2,A
1984-05-07,1983,Liverpool,Coventry City,5-0,5,0,1,1,5,5,H
1984-05-07,1983,Luton Town,Stoke City,0-1,0,1,1,1,1,-1,A
1984-05-07,1983,Manchester United,Ipswich Town,1-2,1,2,1,1,3,-1,A
1984-05-07,1983,Norwich City,Birmingham City,1-1,1,1,1,1,2,0,D
1984-05-07,1983,Nottingham Forest,Watford,5-1,5,1,1,1,6,4,H
1984-05-07,1983,Queens Park Rangers,West Bromwich Albion,1-1,1,1,1,1,2,0,D
1984-05-07,1983,Southampton,Tottenham Hotspur,5-0,5,0,1,1,5,5,H
1984-05-07,1983,Sunderland,Notts County,0-0,0,0,1,1,0,0,D
1984-05-07,1983,Wolverhampton Wanderers,Leicester City,1-0,1,0,1,1,1,1,H
1984-05-12,1983,Birmingham City,Southampton,0-0,0,0,1,1,0,0,D
1984-05-12,1983,Coventry City,Norwich City,2-1,2,1,1,1,3,1,H
1984-05-12,1983,Everton,Queens Park Rangers,3-1,3,1,1,1,4,2,H
1984-05-12,1983,Ipswich Town,Aston Villa,2-1,2,1,1,1,3,1,H
1984-05-12,1983,Leicester City,Sunderland,0-2,0,2,1,1,2,-2,A
1984-05-12,1983,Notts County,Liverpool,0-0,0,0,1,1,0,0,D
1984-05-12,1983,Stoke City,Wolverhampton Wanderers,4-0,4,0,1,1,4,4,H
1984-05-12,1983,Tottenham Hotspur,Manchester United,1-1,1,1,1,1,2,0,D
1984-05-12,1983,Watford,Arsenal,2-1,2,1,1,1,3,1,H
1984-05-12,1983,West Bromwich Albion,Luton Town,3-0,3,0,1,1,3,3,H
1984-05-12,1983,West Ham United,Nottingham Forest,1-2,1,2,1,1,3,-1,A
1984-05-14,1983,West Bromwich Albion,Southampton,0-2,0,2,1,1,2,-2,A
1984-05-14,1983,West Ham United,Everton,0-1,0,1,1,1,1,-1,A
1984-05-15,1983,Liverpool,Norwich City,1-1,1,1,1,1,2,0,D
1984-05-16,1983,Nottingham Forest,Manchester United,2-0,2,0,1,1,2,2,H
1984-05-17,1983,Notts County,Southampton,1-3,1,3,1,1,4,-2,A
1984-08-25,1984,Arsenal,Chelsea,1-1,1,1,1,1,2,0,D
1984-08-25,1984,Aston Villa,Coventry City,1-0,1,0,1,1,1,1,H
1984-08-25,1984,Everton,Tottenham Hotspur,1-4,1,4,1,1,5,-3,A
1984-08-25,1984,Leicester City,Newcastle United,2-3,2,3,1,1,5,-1,A
1984-08-25,1984,Luton Town,Stoke City,2-0,2,0,1,1,2,2,H
1984-08-25,1984,Manchester United,Watford,1-1,1,1,1,1,2,0,D
1984-08-25,1984,Norwich City,Liverpool,3-3,3,3,1,1,6,0,D
1984-08-25,1984,Queens Park Rangers,West Bromwich Albion,3-1,3,1,1,1,4,2,H
1984-08-25,1984,Sheffield Wednesday,Nottingham Forest,3-1,3,1,1,1,4,2,H
1984-08-25,1984,Sunderland,Southampton,3-1,3,1,1,1,4,2,H
1984-08-25,1984,West Ham United,Ipswich Town,0-0,0,0,1,1,0,0,D
1984-08-27,1984,Chelsea,Sunderland,1-0,1,0,1,1,1,1,H
1984-08-27,1984,Liverpool,West Ham United,3-0,3,0,1,1,3,3,H
1984-08-27,1984,Newcastle United,Sheffield Wednesday,2-1,2,1,1,1,3,1,H
1984-08-27,1984,Stoke City,Aston Villa,1-3,1,3,1,1,4,-2,A
1984-08-27,1984,Tottenham Hotspur,Leicester City,2-2,2,2,1,1,4,0,D
1984-08-27,1984,West Bromwich Albion,Everton,2-1,2,1,1,1,3,1,H
1984-08-28,1984,Coventry City,Norwich City,0-0,0,0,1,1,0,0,D
1984-08-28,1984,Ipswich Town,Luton Town,1-1,1,1,1,1,2,0,D
1984-08-28,1984,Southampton,Manchester United,0-0,0,0,1,1,0,0,D
1984-08-28,1984,Watford,Queens Park Rangers,1-1,1,1,1,1,2,0,D
1984-08-29,1984,Nottingham Forest,Arsenal,2-0,2,0,1,1,2,2,H
1984-08-31,1984,Chelsea,Everton,0-1,0,1,1,1,1,-1,A
1984-09-01,1984,Coventry City,Leicester City,2-0,2,0,1,1,2,2,H
1984-09-01,1984,Ipswich Town,Manchester United,1-1,1,1,1,1,2,0,D
1984-09-01,1984,Liverpool,Queens Park Rangers,1-1,1,1,1,1,2,0,D
1984-09-01,1984,Newcastle United,Aston Villa,3-0,3,0,1,1,3,3,H
1984-09-01,1984,Nottingham Forest,Sunderland,3-1,3,1,1,1,4,2,H
1984-09-01,1984,Southampton,West Ham United,2-3,2,3,1,1,5,-1,A
1984-09-01,1984,Stoke City,Sheffield Wednesday,2-1,2,1,1,1,3,1,H
1984-09-01,1984,Tottenham Hotspur,Norwich City,3-1,3,1,1,1,4,2,H
1984-09-01,1984,Watford,Arsenal,3-4,3,4,1,1,7,-1,A
1984-09-01,1984,West Bromwich Albion,Luton Town,4-0,4,0,1,1,4,4,H
1984-09-04,1984,Arsenal,Newcastle United,2-0,2,0,1,1,2,2,H
1984-09-04,1984,Everton,Ipswich Town,1-1,1,1,1,1,2,0,D
1984-09-04,1984,Luton Town,Liverpool,1-2,1,2,1,1,3,-1,A
1984-09-04,1984,Sheffield Wednesday,Southampton,2-1,2,1,1,1,3,1,H
1984-09-04,1984,Sunderland,Tottenham Hotspur,1-0,1,0,1,1,1,1,H
1984-09-04,1984,West Ham United,Coventry City,3-1,3,1,1,1,4,2,H
1984-09-05,1984,Aston Villa,Nottingham Forest,0-5,0,5,1,1,5,-5,A
1984-09-05,1984,Leicester City,Watford,1-1,1,1,1,1,2,0,D
1984-09-05,1984,Manchester United,Chelsea,1-1,1,1,1,1,2,0,D
1984-09-05,1984,Norwich City,West Bromwich Albion,2-1,2,1,1,1,3,1,H
1984-09-08,1984,Arsenal,Liverpool,3-1,3,1,1,1,4,2,H
1984-09-08,1984,Aston Villa,Chelsea,4-2,4,2,1,1,6,2,H
1984-09-08,1984,Everton,Coventry City,2-1,2,1,1,1,3,1,H
1984-09-08,1984,Leicester City,Ipswich Town,2-1,2,1,1,1,3,1,H
1984-09-08,1984,Luton Town,Southampton,1-1,1,1,1,1,2,0,D
1984-09-08,1984,Manchester United,Newcastle United,5-0,5,0,1,1,5,5,H
1984-09-08,1984,Queens Park Rangers,Nottingham Forest,3-0,3,0,1,1,3,3,H
1984-09-08,1984,Sheffield Wednesday,Tottenham Hotspur,2-1,2,1,1,1,3,1,H
1984-09-08,1984,Sunderland,West Bromwich Albion,1-1,1,1,1,1,2,0,D
1984-09-08,1984,West Ham United,Watford,2-0,2,0,1,1,2,2,H
1984-09-15,1984,Chelsea,West Ham United,3-0,3,0,1,1,3,3,H
1984-09-15,1984,Coventry City,Manchester United,0-3,0,3,1,1,3,-3,A
1984-09-15,1984,Ipswich Town,Arsenal,2-1,2,1,1,1,3,1,H
1984-09-15,1984,Liverpool,Sunderland,1-1,1,1,1,1,2,0,D
1984-09-15,1984,Newcastle United,Everton,2-3,2,3,1,1,5,-1,A
1984-09-15,1984,Southampton,Norwich City,2-1,2,1,1,1,3,1,H
1984-09-15,1984,Stoke City,Leicester City,2-2,2,2,1,1,4,0,D
1984-09-15,1984,Tottenham Hotspur,Queens Park Rangers,5-0,5,0,1,1,5,5,H
1984-09-15,1984,Watford,Aston Villa,3-3,3,3,1,1,6,0,D
1984-09-15,1984,West Bromwich Albion,Sheffield Wednesday,2-2,2,2,1,1,4,0,D
1984-09-16,1984,Nottingham Forest,Luton Town,3-1,3,1,1,1,4,2,H
1984-09-19,1984,Norwich City,Stoke City,0-0,0,0,1,1,0,0,D
1984-09-22,1984,Arsenal,Stoke City,4-0,4,0,1,1,4,4,H
1984-09-22,1984,Aston Villa,Tottenham Hotspur,0-1,0,1,1,1,1,-1,A
1984-09-22,1984,Everton,Southampton,2-2,2,2,1,1,4,0,D
1984-09-22,1984,Leicester City,West Bromwich Albion,2-1,2,1,1,1,3,1,H
1984-09-22,1984,Luton Town,Chelsea,0-0,0,0,1,1,0,0,D
1984-09-22,1984,Manchester United,Liverpool,1-1,1,1,1,1,2,0,D
1984-09-22,1984,Norwich City,Watford,3-2,3,2,1,1,5,1,H
1984-09-22,1984,Queens Park Rangers,Newcastle United,5-5,5,5,1,1,10,0,D
1984-09-22,1984,Sheffield Wednesday,Ipswich Town,2-2,2,2,1,1,4,0,D
1984-09-22,1984,Sunderland,Coventry City,0-0,0,0,1,1,0,0,D
1984-09-22,1984,West Ham United,Nottingham Forest,0-0,0,0,1,1,0,0,D
1984-09-29,1984,Chelsea,Leicester City,3-0,3,0,1,1,3,3,H
1984-09-29,1984,Coventry City,Arsenal,1-2,1,2,1,1,3,-1,A
1984-09-29,1984,Ipswich Town,Aston Villa,3-0,3,0,1,1,3,3,H
1984-09-29,1984,Liverpool,Sheffield Wednesday,0-2,0,2,1,1,2,-2,A
1984-09-29,1984,Newcastle United,West Ham United,1-1,1,1,1,1,2,0,D
1984-09-29,1984,Nottingham Forest,Norwich City,3-1,3,1,1,1,4,2,H
1984-09-29,1984,Southampton,Queens Park Rangers,1-1,1,1,1,1,2,0,D
1984-09-29,1984,Stoke City,Sunderland,2-2,2,2,1,1,4,0,D
1984-09-29,1984,Tottenham Hotspur,Luton Town,4-2,4,2,1,1,6,2,H
1984-09-29,1984,Watford,Everton,4-5,4,5,1,1,9,-1,A
1984-09-29,1984,West Bromwich Albion,Manchester United,1-2,1,2,1,1,3,-1,A
1984-10-06,1984,Arsenal,Everton,1-0,1,0,1,1,1,1,H
1984-10-06,1984,Aston Villa,Manchester United,3-0,3,0,1,1,3,3,H
1984-10-06,1984,Liverpool,West Bromwich Albion,0-0,0,0,1,1,0,0,D
1984-10-06,1984,Newcastle United,Ipswich Town,3-0,3,0,1,1,3,3,H
1984-10-06,1984,Norwich City,Chelsea,0-0,0,0,1,1,0,0,D
1984-10-06,1984,Nottingham Forest,Stoke City,1-1,1,1,1,1,2,0,D
1984-10-06,1984,Queens Park Rangers,Luton Town,2-3,2,3,1,1,5,-1,A
1984-10-06,1984,Sheffield Wednesday,Sunderland,2-2,2,2,1,1,4,0,D
1984-10-06,1984,Southampton,Tottenham Hotspur,1-0,1,0,1,1,1,1,H
1984-10-06,1984,Watford,Coventry City,0-1,0,1,1,1,1,-1,A
1984-10-06,1984,West Ham United,Leicester City,3-1,3,1,1,1,4,2,H
1984-10-12,1984,Tottenham Hotspur,Liverpool,1-0,1,0,1,1,1,1,H
1984-10-13,1984,Chelsea,Watford,2-3,2,3,1,1,5,-1,A
1984-10-13,1984,Coventry City,Newcastle United,1-1,1,1,1,1,2,0,D
1984-10-13,1984,Everton,Aston Villa,2-1,2,1,1,1,3,1,H
1984-10-13,1984,Ipswich Town,Queens Park Rangers,1-1,1,1,1,1,2,0,D
1984-10-13,1984,Leicester City,Arsenal,1-4,1,4,1,1,5,-3,A
1984-10-13,1984,Luton Town,Sheffield Wednesday,1-2,1,2,1,1,3,-1,A
1984-10-13,1984,Manchester United,West Ham United,5-1,5,1,1,1,6,4,H
1984-10-13,1984,Stoke City,Southampton,1-3,1,3,1,1,4,-2,A
1984-10-13,1984,Sunderland,Norwich City,2-1,2,1,1,1,3,1,H
1984-10-13,1984,West Bromwich Albion,Nottingham Forest,4-1,4,1,1,1,5,3,H
1984-10-20,1984,Arsenal,Sunderland,3-2,3,2,1,1,5,1,H
1984-10-20,1984,Aston Villa,Norwich City,2-2,2,2,1,1,4,0,D
1984-10-20,1984,Ipswich Town,West Bromwich Albion,2-0,2,0,1,1,2,2,H
1984-10-20,1984,Liverpool,Everton,0-1,0,1,1,1,1,-1,A
1984-10-20,1984,Luton Town,Watford,3-2,3,2,1,1,5,1,H
1984-10-20,1984,Manchester United,Tottenham Hotspur,1-0,1,0,1,1,1,1,H
1984-10-20,1984,Newcastle United,Nottingham Forest,1-1,1,1,1,1,2,0,D
1984-10-20,1984,Queens Park Rangers,Coventry City,2-1,2,1,1,1,3,1,H
1984-10-20,1984,Sheffield Wednesday,Leicester City,5-0,5,0,1,1,5,5,H
1984-10-20,1984,Southampton,Chelsea,1-0,1,0,1,1,1,1,H
1984-10-20,1984,Stoke City,West Ham United,2-4,2,4,1,1,6,-2,A
1984-10-27,1984,Chelsea,Ipswich Town,2-0,2,0,1,1,2,2,H
1984-10-27,1984,Coventry City,Sheffield Wednesday,1-0,1,0,1,1,1,1,H
1984-10-27,1984,Everton,Manchester United,5-0,5,0,1,1,5,5,H
1984-10-27,1984,Leicester City,Aston Villa,5-0,5,0,1,1,5,5,H
1984-10-27,1984,Norwich City,Queens Park Rangers,2-0,2,0,1,1,2,2,H
1984-10-27,1984,Sunderland,Luton Town,3-0,3,0,1,1,3,3,H
1984-10-27,1984,Tottenham Hotspur,Stoke City,4-0,4,0,1,1,4,4,H
1984-10-27,1984,Watford,Newcastle United,3-3,3,3,1,1,6,0,D
1984-10-27,1984,West Bromwich Albion,Southampton,0-0,0,0,1,1,0,0,D
1984-10-27,1984,West Ham United,Arsenal,3-1,3,1,1,1,4,2,H
1984-10-28,1984,Nottingham Forest,Liverpool,0-2,0,2,1,1,2,-2,A
1984-11-02,1984,Manchester United,Arsenal,4-2,4,2,1,1,6,2,H
1984-11-03,1984,Aston Villa,West Ham United,0-0,0,0,1,1,0,0,D
1984-11-03,1984,Chelsea,Coventry City,6-2,6,2,1,1,8,4,H
1984-11-03,1984,Everton,Leicester City,3-0,3,0,1,1,3,3,H
1984-11-03,1984,Ipswich Town,Watford,3-3,3,3,1,1,6,0,D
1984-11-03,1984,Luton Town,Newcastle United,2-2,2,2,1,1,4,0,D
1984-11-03,1984,Sheffield Wednesday,Norwich City,1-2,1,2,1,1,3,-1,A
1984-11-03,1984,Southampton,Nottingham Forest,1-0,1,0,1,1,1,1,H
1984-11-03,1984,Stoke City,Liverpool,0-1,0,1,1,1,1,-1,A
1984-11-03,1984,Sunderland,Queens Park Rangers,3-0,3,0,1,1,3,3,H
1984-11-03,1984,Tottenham Hotspur,West Bromwich Albion,2-3,2,3,1,1,5,-1,A
1984-11-10,1984,Arsenal,Aston Villa,1-1,1,1,1,1,2,0,D
1984-11-10,1984,Coventry City,Ipswich Town,1-0,1,0,1,1,1,1,H
1984-11-10,1984,Leicester City,Manchester United,2-3,2,3,1,1,5,-1,A
1984-11-10,1984,Liverpool,Southampton,1-1,1,1,1,1,2,0,D
1984-11-10,1984,Newcastle United,Chelsea,2-1,2,1,1,1,3,1,H
1984-11-10,1984,Norwich City,Luton Town,3-0,3,0,1,1,3,3,H
1984-11-10,1984,Nottingham Forest,Tottenham Hotspur,1-2,1,2,1,1,3,-1,A
1984-11-10,1984,Queens Park Rangers,Sheffield Wednesday,0-0,0,0,1,1,0,0,D
1984-11-10,1984,Watford,Sunderland,3-1,3,1,1,1,4,2,H
1984-11-10,1984,West Bromwich Albion,Stoke City,2-0,2,0,1,1,2,2,H
1984-11-10,1984,West Ham United,Everton,0-1,0,1,1,1,1,-1,A
1984-11-17,1984,Arsenal,Queens Park Rangers,1-0,1,0,1,1,1,1,H
1984-11-17,1984,Aston Villa,Southampton,2-2,2,2,1,1,4,0,D
1984-11-17,1984,Chelsea,West Bromwich Albion,3-1,3,1,1,1,4,2,H
1984-11-17,1984,Coventry City,Nottingham Forest,1-3,1,3,1,1,4,-2,A
1984-11-17,1984,Everton,Stoke City,4-0,4,0,1,1,4,4,H
1984-11-17,1984,Ipswich Town,Tottenham Hotspur,0-3,0,3,1,1,3,-3,A
1984-11-17,1984,Leicester City,Norwich City,2-0,2,0,1,1,2,2,H
1984-11-17,1984,Manchester United,Luton Town,2-0,2,0,1,1,2,2,H
1984-11-17,1984,Watford,Sheffield Wednesday,1-0,1,0,1,1,1,1,H
1984-11-17,1984,West Ham United,Sunderland,1-0,1,0,1,1,1,1,H
1984-11-18,1984,Newcastle United,Liverpool,0-2,0,2,1,1,2,-2,A
1984-11-24,1984,Liverpool,Ipswich Town,2-0,2,0,1,1,2,2,H
1984-11-24,1984,Luton Town,West Ham United,2-2,2,2,1,1,4,0,D
1984-11-24,1984,Norwich City,Everton,4-2,4,2,1,1,6,2,H
1984-11-24,1984,Queens Park Rangers,Aston Villa,2-0,2,0,1,1,2,2,H
1984-11-24,1984,Southampton,Newcastle United,1-0,1,0,1,1,1,1,H
1984-11-24,1984,Stoke City,Watford,1-3,1,3,1,1,4,-2,A
1984-11-24,1984,Sunderland,Manchester United,3-2,3,2,1,1,5,1,H
1984-11-24,1984,Tottenham Hotspur,Chelsea,1-1,1,1,1,1,2,0,D
1984-11-24,1984,West Bromwich Albion,Coventry City,5-2,5,2,1,1,7,3,H
1984-11-25,1984,Nottingham Forest,Leicester City,2-1,2,1,1,1,3,1,H
1984-11-25,1984,Sheffield Wednesday,Arsenal,2-1,2,1,1,1,3,1,H
1984-12-01,1984,Arsenal,Luton Town,3-1,3,1,1,1,4,2,H
1984-12-01,1984,Aston Villa,Sunderland,1-0,1,0,1,1,1,1,H
1984-12-01,1984,Chelsea,Liverpool,3-1,3,1,1,1,4,2,H
1984-12-01,1984,Coventry City,Tottenham Hotspur,1-1,1,1,1,1,2,0,D
1984-12-01,1984,Everton,Sheffield Wednesday,1-1,1,1,1,1,2,0,D
1984-12-01,1984,Ipswich Town,Southampton,0-1,0,1,1,1,1,-1,A
1984-12-01,1984,Leicester City,Queens Park Rangers,4-0,4,0,1,1,4,4,H
1984-12-01,1984,Manchester United,Norwich City,2-0,2,0,1,1,2,2,H
1984-12-01,1984,Newcastle United,Stoke City,2-1,2,1,1,1,3,1,H
1984-12-01,1984,Watford,Nottingham Forest,2-0,2,0,1,1,2,2,H
1984-12-01,1984,West Ham United,West Bromwich Albion,0-2,0,2,1,1,2,-2,A
1984-12-04,1984,Liverpool,Coventry City,3-1,3,1,1,1,4,2,H
1984-12-04,1984,Queens Park Rangers,Stoke City,2-0,2,0,1,1,2,2,H
1984-12-08,1984,Luton Town,Aston Villa,1-0,1,0,1,1,1,1,H
1984-12-08,1984,Norwich City,West Ham United,1-0,1,0,1,1,1,1,H
1984-12-08,1984,Nottingham Forest,Manchester United,3-2,3,2,1,1,5,1,H
1984-12-08,1984,Queens Park Rangers,Everton,0-0,0,0,1,1,0,0,D
1984-12-08,1984,Sheffield Wednesday,Chelsea,1-1,1,1,1,1,2,0,D
1984-12-08,1984,Southampton,Arsenal,1-0,1,0,1,1,1,1,H
1984-12-08,1984,Stoke City,Ipswich Town,0-2,0,2,1,1,2,-2,A
1984-12-08,1984,Sunderland,Leicester City,0-4,0,4,1,1,4,-4,A
1984-12-08,1984,Tottenham Hotspur,Newcastle United,3-1,3,1,1,1,4,2,H
1984-12-08,1984,West Bromwich Albion,Watford,2-1,2,1,1,1,3,1,H
1984-12-15,1984,Arsenal,West Bromwich Albion,4-0,4,0,1,1,4,4,H
1984-12-15,1984,Aston Villa,Liverpool,0-0,0,0,1,1,0,0,D
1984-12-15,1984,Chelsea,Stoke City,1-1,1,1,1,1,2,0,D
1984-12-15,1984,Coventry City,Southampton,2-1,2,1,1,1,3,1,H
1984-12-15,1984,Everton,Nottingham Forest,5-0,5,0,1,1,5,5,H
1984-12-15,1984,Ipswich Town,Sunderland,0-2,0,2,1,1,2,-2,A
1984-12-15,1984,Leicester City,Luton Town,2-2,2,2,1,1,4,0,D
1984-12-15,1984,Manchester United,Queens Park Rangers,3-0,3,0,1,1,3,3,H
1984-12-15,1984,Newcastle United,Norwich City,1-1,1,1,1,1,2,0,D
1984-12-15,1984,Watford,Tottenham Hotspur,1-2,1,2,1,1,3,-1,A
1984-12-15,1984,West Ham United,Sheffield Wednesday,0-0,0,0,1,1,0,0,D
1984-12-18,1984,Luton Town,West Bromwich Albion,1-2,1,2,1,1,3,-1,A
1984-12-21,1984,Queens Park Rangers,Liverpool,0-2,0,2,1,1,2,-2,A
1984-12-22,1984,Arsenal,Watford,1-1,1,1,1,1,2,0,D
1984-12-22,1984,Aston Villa,Newcastle United,4-0,4,0,1,1,4,4,H
1984-12-22,1984,Everton,Chelsea,3-4,3,4,1,1,7,-1,A
1984-12-22,1984,Manchester United,Ipswich Town,3-0,3,0,1,1,3,3,H
1984-12-22,1984,Norwich City,Tottenham Hotspur,1-2,1,2,1,1,3,-1,A
1984-12-22,1984,Sheffield Wednesday,Stoke City,2-1,2,1,1,1,3,1,H
1984-12-22,1984,West Ham United,Southampton,2-3,2,3,1,1,5,-1,A
1984-12-23,1984,Leicester City,Coventry City,5-1,5,1,1,1,6,4,H
1984-12-23,1984,Sunderland,Nottingham Forest,0-2,0,2,1,1,2,-2,A
1984-12-26,1984,Liverpool,Leicester City,1-2,1,2,1,1,3,-1,A
1984-12-26,1984,Luton Town,Coventry City,2-0,2,0,1,1,2,2,H
1984-12-26,1984,Norwich City,Arsenal,1-0,1,0,1,1,1,1,H
1984-12-26,1984,Nottingham Forest,Ipswich Town,2-0,2,0,1,1,2,2,H
1984-12-26,1984,Queens Park Rangers,Chelsea,2-2,2,2,1,1,4,0,D
1984-12-26,1984,Sheffield Wednesday,Aston Villa,1-1,1,1,1,1,2,0,D
1984-12-26,1984,Southampton,Watford,1-2,1,2,1,1,3,-1,A
1984-12-26,1984,Stoke City,Manchester United,2-1,2,1,1,1,3,1,H
1984-12-26,1984,Sunderland,Everton,1-2,1,2,1,1,3,-1,A
1984-12-26,1984,Tottenham Hotspur,West Ham United,2-2,2,2,1,1,4,0,D
1984-12-26,1984,West Bromwich Albion,Newcastle United,2-1,2,1,1,1,3,1,H
1984-12-29,1984,Chelsea,Manchester United,1-3,1,3,1,1,4,-2,A
1984-12-29,1984,Coventry City,West Ham United,1-2,1,2,1,1,3,-1,A
1984-12-29,1984,Ipswich Town,Everton,0-2,0,2,1,1,2,-2,A
1984-12-29,1984,Liverpool,Luton Town,1-0,1,0,1,1,1,1,H
1984-12-29,1984,Newcastle United,Arsenal,1-3,1,3,1,1,4,-2,A
1984-12-29,1984,Nottingham Forest,Aston Villa,3-2,3,2,1,1,5,1,H
1984-12-29,1984,Southampton,Sheffield Wednesday,0-3,0,3,1,1,3,-3,A
1984-12-29,1984,Stoke City,Queens Park Rangers,0-2,0,2,1,1,2,-2,A
1984-12-29,1984,Tottenham Hotspur,Sunderland,2-0,2,0,1,1,2,2,H
1984-12-29,1984,Watford,Leicester City,4-1,4,1,1,1,5,3,H
1984-12-29,1984,West Bromwich Albion,Norwich City,0-1,0,1,1,1,1,-1,A
1985-01-01,1984,Arsenal,Tottenham Hotspur,1-2,1,2,1,1,3,-1,A
1985-01-01,1984,Aston Villa,West Bromwich Albion,3-1,3,1,1,1,4,2,H
1985-01-01,1984,Chelsea,Nottingham Forest,1-0,1,0,1,1,1,1,H
1985-01-01,1984,Coventry City,Stoke City,4-0,4,0,1,1,4,4,H
1985-01-01,1984,Everton,Luton Town,2-1,2,1,1,1,3,1,H
1985-01-01,1984,Ipswich Town,Norwich City,2-0,2,0,1,1,2,2,H
1985-01-01,1984,Leicester City,Southampton,1-2,1,2,1,1,3,-1,A
1985-01-01,1984,Manchester United,Sheffield Wednesday,1-2,1,2,1,1,3,-1,A
1985-01-01,1984,Newcastle United,Sunderland,3-1,3,1,1,1,4,2,H
1985-01-01,1984,Watford,Liverpool,1-1,1,1,1,1,2,0,D
1985-01-01,1984,West Ham United,Queens Park Rangers,1-3,1,3,1,1,4,-2,A
1985-01-12,1984,Everton,Newcastle United,4-0,4,0,1,1,4,4,H
1985-01-12,1984,Leicester City,Stoke City,0-0,0,0,1,1,0,0,D
1985-01-12,1984,Manchester United,Coventry City,0-1,0,1,1,1,1,-1,A
1985-01-12,1984,Norwich City,Southampton,1-0,1,0,1,1,1,1,H
1985-01-12,1984,Queens Park Rangers,Tottenham Hotspur,2-2,2,2,1,1,4,0,D
1985-01-12,1984,Sheffield Wednesday,West Bromwich Albion,2-0,2,0,1,1,2,2,H
1985-01-19,1984,Chelsea,Arsenal,1-1,1,1,1,1,2,0,D
1985-01-19,1984,Coventry City,Aston Villa,0-3,0,3,1,1,3,-3,A
1985-01-19,1984,Liverpool,Norwich City,4-0,4,0,1,1,4,4,H
1985-01-26,1984,West Bromwich Albion,Queens Park Rangers,0-0,0,0,1,1,0,0,D
1985-01-29,1984,Southampton,Sunderland,1-0,1,0,1,1,1,1,H
1985-02-02,1984,Arsenal,Coventry City,2-1,2,1,1,1,3,1,H
1985-02-02,1984,Aston Villa,Ipswich Town,2-1,2,1,1,1,3,1,H
1985-02-02,1984,Everton,Watford,4-0,4,0,1,1,4,4,H
1985-02-02,1984,Leicester City,Chelsea,1-1,1,1,1,1,2,0,D
1985-02-02,1984,Luton Town,Tottenham Hotspur,2-2,2,2,1,1,4,0,D
1985-02-02,1984,Manchester United,West Bromwich Albion,2-0,2,0,1,1,2,2,H
1985-02-02,1984,Norwich City,Nottingham Forest,0-1,0,1,1,1,1,-1,A
1985-02-02,1984,Queens Park Rangers,Southampton,0-4,0,4,1,1,4,-4,A
1985-02-02,1984,Sheffield Wednesday,Liverpool,1-1,1,1,1,1,2,0,D
1985-02-02,1984,Sunderland,Stoke City,1-0,1,0,1,1,1,1,H
1985-02-02,1984,West Ham United,Newcastle United,1-1,1,1,1,1,2,0,D
1985-02-09,1984,Newcastle United,Manchester United,1-1,1,1,1,1,2,0,D
1985-02-09,1984,Nottingham Forest,Queens Park Rangers,2-0,2,0,1,1,2,2,H
1985-02-12,1984,Liverpool,Arsenal,3-0,3,0,1,1,3,3,H
1985-02-16,1984,Chelsea,Newcastle United,1-0,1,0,1,1,1,1,H
1985-02-23,1984,Arsenal,Manchester United,0-1,0,1,1,1,1,-1,A
1985-02-23,1984,Coventry City,Chelsea,1-0,1,0,1,1,1,1,H
1985-02-23,1984,Leicester City,Everton,1-2,1,2,1,1,3,-1,A
1985-02-23,1984,Liverpool,Stoke City,2-0,2,0,1,1,2,2,H
1985-02-23,1984,Newcastle United,Luton Town,1-0,1,0,1,1,1,1,H
1985-02-23,1984,Nottingham Forest,Southampton,2-0,2,0,1,1,2,2,H
1985-02-23,1984,Queens Park Rangers,Sunderland,1-0,1,0,1,1,1,1,H
1985-02-23,1984,West Bromwich Albion,Tottenham Hotspur,0-1,0,1,1,1,1,-1,A
1985-02-23,1984,West Ham United,Aston Villa,1-2,1,2,1,1,3,-1,A
1985-02-24,1984,Sheffield Wednesday,Watford,1-1,1,1,1,1,2,0,D
1985-03-02,1984,Arsenal,West Ham United,2-1,2,1,1,1,3,1,H
1985-03-02,1984,Aston Villa,Leicester City,0-1,0,1,1,1,1,-1,A
1985-03-02,1984,Ipswich Town,Chelsea,2-0,2,0,1,1,2,2,H
1985-03-02,1984,Liverpool,Nottingham Forest,1-0,1,0,1,1,1,1,H
1985-03-02,1984,Luton Town,Sunderland,2-1,2,1,1,1,3,1,H
1985-03-02,1984,Manchester United,Everton,1-1,1,1,1,1,2,0,D
1985-03-02,1984,Newcastle United,Watford,3-1,3,1,1,1,4,2,H
1985-03-02,1984,Queens Park Rangers,Norwich City,2-2,2,2,1,1,4,0,D
1985-03-02,1984,Sheffield Wednesday,Coventry City,1-0,1,0,1,1,1,1,H
1985-03-02,1984,Southampton,West Bromwich Albion,4-3,4,3,1,1,7,1,H
1985-03-02,1984,Stoke City,Tottenham Hotspur,0-1,0,1,1,1,1,-1,A
1985-03-09,1984,Chelsea,Southampton,0-2,0,2,1,1,2,-2,A
1985-03-09,1984,Coventry City,Queens Park Rangers,3-0,3,0,1,1,3,3,H
1985-03-09,1984,Leicester City,Sheffield Wednesday,3-1,3,1,1,1,4,2,H
1985-03-09,1984,Norwich City,Aston Villa,2-2,2,2,1,1,4,0,D
1985-03-09,1984,Nottingham Forest,Newcastle United,0-0,0,0,1,1,0,0,D
1985-03-09,1984,Sunderland,Arsenal,0-0,0,0,1,1,0,0,D
1985-03-12,1984,Stoke City,West Bromwich Albion,0-0,0,0,1,1,0,0,D
1985-03-12,1984,Sunderland,Watford,1-1,1,1,1,1,2,0,D
1985-03-12,1984,Tottenham Hotspur,Manchester United,1-2,1,2,1,1,3,-1,A
1985-03-13,1984,Aston Villa,Arsenal,0-0,0,0,1,1,0,0,D
1985-03-15,1984,West Ham United,Manchester United,2-2,2,2,1,1,4,0,D
1985-03-16,1984,Arsenal,Leicester City,2-0,2,0,1,1,2,2,H
1985-03-16,1984,Aston Villa,Everton,1-1,1,1,1,1,2,0,D
1985-03-16,1984,Liverpool,Tottenham Hotspur,0-1,0,1,1,1,1,-1,A
1985-03-16,1984,Norwich City,Sunderland,1-3,1,3,1,1,4,-2,A
1985-03-16,1984,Nottingham Forest,West Bromwich Albion,1-2,1,2,1,1,3,-1,A
1985-03-16,1984,Queens Park Rangers,Ipswich Town,3-0,3,0,1,1,3,3,H
1985-03-16,1984,Sheffield Wednesday,Luton Town,1-1,1,1,1,1,2,0,D
1985-03-16,1984,Southampton,Stoke City,0-0,0,0,1,1,0,0,D
1985-03-16,1984,Watford,Chelsea,1-3,1,3,1,1,4,-2,A
1985-03-19,1984,Arsenal,Ipswich Town,1-1,1,1,1,1,2,0,D
1985-03-19,1984,Watford,Luton Town,3-0,3,0,1,1,3,3,H
1985-03-20,1984,Newcastle United,Leicester City,1-4,1,4,1,1,5,-3,A
1985-03-20,1984,Nottingham Forest,Sheffield Wednesday,0-0,0,0,1,1,0,0,D
1985-03-23,1984,Coventry City,Watford,3-1,3,1,1,1,4,2,H
1985-03-23,1984,Everton,Arsenal,2-0,2,0,1,1,2,2,H
1985-03-23,1984,Ipswich Town,Newcastle United,1-1,1,1,1,1,2,0,D
1985-03-23,1984,Leicester City,West Ham United,1-0,1,0,1,1,1,1,H
1985-03-23,1984,Luton Town,Queens Park Rangers,2-0,2,0,1,1,2,2,H
1985-03-23,1984,Manchester United,Aston Villa,4-0,4,0,1,1,4,4,H
1985-03-23,1984,Stoke City,Nottingham Forest,1-4,1,4,1,1,5,-3,A
1985-03-23,1984,Tottenham Hotspur,Southampton,5-1,5,1,1,1,6,4,H
1985-03-23,1984,West Bromwich Albion,Liverpool,0-5,0,5,1,1,5,-5,A
1985-03-27,1984,Aston Villa,Stoke City,2-0,2,0,1,1,2,2,H
1985-03-30,1984,Luton Town,Ipswich Town,3-1,3,1,1,1,4,2,H
1985-03-30,1984,Norwich City,Coventry City,2-1,2,1,1,1,3,1,H
1985-03-30,1984,Nottingham Forest,West Ham United,1-2,1,2,1,1,3,-1,A
1985-03-30,1984,Queens Park Rangers,Watford,2-0,2,0,1,1,2,2,H
1985-03-30,1984,Sheffield Wednesday,Newcastle United,4-2,4,2,1,1,6,2,H
1985-03-30,1984,Southampton,Everton,1-2,1,2,1,1,3,-1,A
1985-03-30,1984,Stoke City,Arsenal,2-0,2,0,1,1,2,2,H
1985-03-30,1984,Sunderland,Chelsea,0-2,0,2,1,1,2,-2,A
1985-03-30,1984,Tottenham Hotspur,Aston Villa,0-2,0,2,1,1,2,-2,A
1985-03-30,1984,West Bromwich Albion,Leicester City,2-0,2,0,1,1,2,2,H
1985-03-31,1984,Liverpool,Manchester United,0-1,0,1,1,1,1,-1,A
1985-04-02,1984,Southampton,Luton Town,1-0,1,0,1,1,1,1,H
1985-04-02,1984,Watford,West Ham United,5-0,5,0,1,1,5,5,H
1985-04-03,1984,Manchester United,Leicester City,2-1,2,1,1,1,3,1,H
1985-04-03,1984,Norwich City,Sheffield Wednesday,1-1,1,1,1,1,2,0,D
1985-04-03,1984,Sunderland,Liverpool,0-3,0,3,1,1,3,-3,A
1985-04-03,1984,Tottenham Hotspur,Everton,1-2,1,2,1,1,3,-1,A
1985-04-03,1984,West Bromwich Albion,Ipswich Town,1-2,1,2,1,1,3,-1,A
1985-04-06,1984,Arsenal,Norwich City,2-0,2,0,1,1,2,2,H
1985-04-06,1984,Aston Villa,Sheffield Wednesday,3-0,3,0,1,1,3,3,H
1985-04-06,1984,Chelsea,Queens Park Rangers,1-0,1,0,1,1,1,1,H
1985-04-06,1984,Everton,Sunderland,4-1,4,1,1,1,5,3,H
1985-04-06,1984,Ipswich Town,Nottingham Forest,1-0,1,0,1,1,1,1,H
1985-04-06,1984,Leicester City,Liverpool,0-1,0,1,1,1,1,-1,A
1985-04-06,1984,Manchester United,Stoke City,5-0,5,0,1,1,5,5,H
1985-04-06,1984,Newcastle United,West Bromwich Albion,1-0,1,0,1,1,1,1,H
1985-04-06,1984,Watford,Southampton,1-1,1,1,1,1,2,0,D
1985-04-06,1984,West Ham United,Tottenham Hotspur,1-1,1,1,1,1,2,0,D
1985-04-08,1984,Norwich City,Ipswich Town,0-2,0,2,1,1,2,-2,A
1985-04-08,1984,Queens Park Rangers,West Ham United,4-2,4,2,1,1,6,2,H
1985-04-08,1984,Stoke City,Luton Town,0-4,0,4,1,1,4,-4,A
1985-04-08,1984,Sunderland,Newcastle United,0-0,0,0,1,1,0,0,D
1985-04-08,1984,West Bromwich Albion,Aston Villa,1-0,1,0,1,1,1,1,H
1985-04-09,1984,Sheffield Wednesday,Manchester United,1-0,1,0,1,1,1,1,H
1985-04-09,1984,Southampton,Leicester City,3-1,3,1,1,1,4,2,H
1985-04-10,1984,Nottingham Forest,Chelsea,2-0,2,0,1,1,2,2,H
1985-04-13,1984,Arsenal,Nottingham Forest,1-1,1,1,1,1,2,0,D
1985-04-13,1984,Coventry City,Sunderland,0-1,0,1,1,1,1,-1,A
1985-04-13,1984,Ipswich Town,Sheffield Wednesday,1-2,1,2,1,1,3,-1,A
1985-04-13,1984,Leicester City,Tottenham Hotspur,1-2,1,2,1,1,3,-1,A
1985-04-13,1984,Newcastle United,Queens Park Rangers,1-0,1,0,1,1,1,1,H
1985-04-13,1984,Watford,Norwich City,2-0,2,0,1,1,2,2,H
1985-04-13,1984,West Ham United,Chelsea,1-1,1,1,1,1,2,0,D
1985-04-16,1984,Chelsea,Aston Villa,3-1,3,1,1,1,4,2,H
1985-04-16,1984,Everton,West Bromwich Albion,4-1,4,1,1,1,5,3,H
1985-04-16,1984,Luton Town,Norwich City,3-1,3,1,1,1,4,2,H
1985-04-16,1984,Sunderland,Sheffield Wednesday,0-0,0,0,1,1,0,0,D
1985-04-16,1984,Watford,Ipswich Town,3-1,3,1,1,1,4,2,H
1985-04-17,1984,Newcastle United,Coventry City,0-1,0,1,1,1,1,-1,A
1985-04-17,1984,Tottenham Hotspur,Arsenal,0-2,0,2,1,1,2,-2,A
1985-04-20,1984,Liverpool,Newcastle United,3-1,3,1,1,1,4,2,H
1985-04-20,1984,Norwich City,Leicester City,1-3,1,3,1,1,4,-2,A
1985-04-20,1984,Nottingham Forest,Coventry City,2-0,2,0,1,1,2,2,H
1985-04-20,1984,Queens Park Rangers,Arsenal,1-0,1,0,1,1,1,1,H
1985-04-20,1984,Southampton,Aston Villa,2-0,2,0,1,1,2,2,H
1985-04-20,1984,Stoke City,Everton,0-2,0,2,1,1,2,-2,A
1985-04-20,1984,Sunderland,West Ham United,0-1,0,1,1,1,1,-1,A
1985-04-20,1984,Tottenham Hotspur,Ipswich Town,2-3,2,3,1,1,5,-1,A
1985-04-20,1984,West Bromwich Albion,Chelsea,0-1,0,1,1,1,1,-1,A
1985-04-21,1984,Luton Town,Manchester United,2-1,2,1,1,1,3,1,H
1985-04-23,1984,Ipswich Town,Leicester City,2-0,2,0,1,1,2,2,H
1985-04-23,1984,Sheffield Wednesday,Queens Park Rangers,3-1,3,1,1,1,4,2,H
1985-04-24,1984,Aston Villa,Watford,1-1,1,1,1,1,2,0,D
1985-04-24,1984,Luton Town,Nottingham Forest,1-2,1,2,1,1,3,-1,A
1985-04-24,1984,Manchester United,Southampton,0-0,0,0,1,1,0,0,D
1985-04-24,1984,Stoke City,Norwich City,2-3,2,3,1,1,5,-1,A
1985-04-24,1984,West Bromwich Albion,Sunderland,1-0,1,0,1,1,1,1,H
1985-04-27,1984,Arsenal,Sheffield Wednesday,1-0,1,0,1,1,1,1,H
1985-04-27,1984,Aston Villa,Queens Park Rangers,5-2,5,2,1,1,7,3,H
1985-04-27,1984,Chelsea,Tottenham Hotspur,1-1,1,1,1,1,2,0,D
1985-04-27,1984,Coventry City,West Bromwich Albion,2-1,2,1,1,1,3,1,H
1985-04-27,1984,Everton,Norwich City,3-0,3,0,1,1,3,3,H
1985-04-27,1984,Ipswich Town,Liverpool,0-0,0,0,1,1,0,0,D
1985-04-27,1984,Leicester City,Nottingham Forest,1-0,1,0,1,1,1,1,H
1985-04-27,1984,Manchester United,Sunderland,2-2,2,2,1,1,4,0,D
1985-04-27,1984,Newcastle United,Southampton,2-1,2,1,1,1,3,1,H
1985-04-27,1984,Watford,Stoke City,2-0,2,0,1,1,2,2,H
1985-04-27,1984,West Ham United,Luton Town,0-0,0,0,1,1,0,0,D
1985-05-04,1984,Liverpool,Chelsea,4-3,4,3,1,1,7,1,H
1985-05-04,1984,Luton Town,Arsenal,3-1,3,1,1,1,4,2,H
1985-05-04,1984,Norwich City,Manchester United,0-1,0,1,1,1,1,-1,A
1985-05-04,1984,Nottingham Forest,Watford,1-1,1,1,1,1,2,0,D
1985-05-04,1984,Queens Park Rangers,Leicester City,4-3,4,3,1,1,7,1,H
1985-05-04,1984,Sheffield Wednesday,Everton,0-1,0,1,1,1,1,-1,A
1985-05-04,1984,Southampton,Ipswich Town,3-0,3,0,1,1,3,3,H
1985-05-04,1984,Stoke City,Newcastle United,0-1,0,1,1,1,1,-1,A
1985-05-04,1984,Sunderland,Aston Villa,0-4,0,4,1,1,4,-4,A
1985-05-04,1984,Tottenham Hotspur,Coventry City,4-2,4,2,1,1,6,2,H
1985-05-04,1984,West Bromwich Albion,West Ham United,5-1,5,1,1,1,6,4,H
1985-05-06,1984,Arsenal,Southampton,1-0,1,0,1,1,1,1,H
1985-05-06,1984,Aston Villa,Luton Town,0-1,0,1,1,1,1,-1,A
1985-05-06,1984,Chelsea,Sheffield Wednesday,2-1,2,1,1,1,3,1,H
1985-05-06,1984,Coventry City,Liverpool,0-2,0,2,1,1,2,-2,A
1985-05-06,1984,Everton,Queens Park Rangers,2-0,2,0,1,1,2,2,H
1985-05-06,1984,Ipswich Town,Stoke City,5-1,5,1,1,1,6,4,H
1985-05-06,1984,Leicester City,Sunderland,2-0,2,0,1,1,2,2,H
1985-05-06,1984,Manchester United,Nottingham Forest,2-0,2,0,1,1,2,2,H
1985-05-06,1984,Newcastle United,Tottenham Hotspur,2-3,2,3,1,1,5,-1,A
1985-05-06,1984,West Ham United,Norwich City,1-0,1,0,1,1,1,1,H
1985-05-07,1984,Watford,West Bromwich Albion,0-2,0,2,1,1,2,-2,A
1985-05-08,1984,Chelsea,Luton Town,2-0,2,0,1,1,2,2,H
1985-05-08,1984,Everton,West Ham United,3-0,3,0,1,1,3,3,H
1985-05-11,1984,Liverpool,Aston Villa,2-1,2,1,1,1,3,1,H
1985-05-11,1984,Luton Town,Leicester City,4-0,4,0,1,1,4,4,H
1985-05-11,1984,Norwich City,Newcastle United,0-0,0,0,1,1,0,0,D
1985-05-11,1984,Nottingham Forest,Everton,1-0,1,0,1,1,1,1,H
1985-05-11,1984,Queens Park Rangers,Manchester United,1-3,1,3,1,1,4,-2,A
1985-05-11,1984,Sheffield Wednesday,West Ham United,2-1,2,1,1,1,3,1,H
1985-05-11,1984,Southampton,Coventry City,2-1,2,1,1,1,3,1,H
1985-05-11,1984,Stoke City,Chelsea,0-1,0,1,1,1,1,-1,A
1985-05-11,1984,Sunderland,Ipswich Town,1-2,1,2,1,1,3,-1,A
1985-05-11,1984,Tottenham Hotspur,Watford,1-5,1,5,1,1,6,-4,A
1985-05-11,1984,West Bromwich Albion,Arsenal,2-2,2,2,1,1,4,0,D
1985-05-13,1984,Watford,Manchester United,5-1,5,1,1,1,6,4,H
1985-05-14,1984,Chelsea,Norwich City,1-2,1,2,1,1,3,-1,A
1985-05-14,1984,Ipswich Town,Coventry City,0-0,0,0,1,1,0,0,D
1985-05-14,1984,Southampton,Liverpool,1-1,1,1,1,1,2,0,D
1985-05-14,1984,Tottenham Hotspur,Sheffield Wednesday,2-0,2,0,1,1,2,2,H
1985-05-14,1984,West Ham United,Stoke City,5-1,5,1,1,1,6,4,H
1985-05-17,1984,Ipswich Town,West Ham United,0-1,0,1,1,1,1,-1,A
1985-05-17,1984,Liverpool,Watford,4-3,4,3,1,1,7,1,H
1985-05-17,1984,Stoke City,Coventry City,0-1,0,1,1,1,1,-1,A
1985-05-17,1984,Tottenham Hotspur,Nottingham Forest,1-0,1,0,1,1,1,1,H
1985-05-20,1984,West Ham United,Liverpool,0-3,0,3,1,1,3,-3,A
1985-05-23,1984,Coventry City,Luton Town,1-0,1,0,1,1,1,1,H
1985-05-23,1984,Everton,Liverpool,1-0,1,0,1,1,1,1,H
1985-05-26,1984,Coventry City,Everton,4-1,4,1,1,1,5,3,H
1985-05-28,1984,Luton Town,Everton,2-0,2,0,1,1,2,2,H
1985-08-17,1985,Birmingham City,West Ham United,1-0,1,0,1,1,1,1,H
1985-08-17,1985,Coventry City,Manchester City,1-1,1,1,1,1,2,0,D
1985-08-17,1985,Leicester City,Everton,3-1,3,1,1,1,4,2,H
1985-08-17,1985,Liverpool,Arsenal,2-0,2,0,1,1,2,2,H
1985-08-17,1985,Luton Town,Nottingham Forest,1-1,1,1,1,1,2,0,D
1985-08-17,1985,Manchester United,Aston Villa,4-0,4,0,1,1,4,4,H
1985-08-17,1985,Queens Park Rangers,Ipswich Town,1-0,1,0,1,1,1,1,H
1985-08-17,1985,Sheffield Wednesday,Chelsea,1-1,1,1,1,1,2,0,D
1985-08-17,1985,Southampton,Newcastle United,1-1,1,1,1,1,2,0,D
1985-08-17,1985,Tottenham Hotspur,Watford,4-0,4,0,1,1,4,4,H
1985-08-17,1985,West Bromwich Albion,Oxford United,1-1,1,1,1,1,2,0,D
1985-08-20,1985,Arsenal,Southampton,3-2,3,2,1,1,5,1,H
1985-08-20,1985,Chelsea,Coventry City,1-0,1,0,1,1,1,1,H
1985-08-20,1985,Everton,West Bromwich Albion,2-0,2,0,1,1,2,2,H
1985-08-20,1985,Ipswich Town,Manchester United,0-1,0,1,1,1,1,-1,A
1985-08-20,1985,Watford,Birmingham City,3-0,3,0,1,1,3,3,H
1985-08-20,1985,West Ham United,Queens Park Rangers,3-1,3,1,1,1,4,2,H
1985-08-21,1985,Aston Villa,Liverpool,2-2,2,2,1,1,4,0,D
1985-08-21,1985,Manchester City,Leicester City,1-1,1,1,1,1,2,0,D
1985-08-21,1985,Newcastle United,Luton Town,2-2,2,2,1,1,4,0,D
1985-08-21,1985,Nottingham Forest,Sheffield Wednesday,0-1,0,1,1,1,1,-1,A
1985-08-21,1985,Oxford United,Tottenham Hotspur,1-1,1,1,1,1,2,0,D
1985-08-24,1985,Arsenal,Manchester United,1-2,1,2,1,1,3,-1,A
1985-08-24,1985,Aston Villa,Queens Park Rangers,1-2,1,2,1,1,3,-1,A
1985-08-24,1985,Chelsea,Birmingham City,2-0,2,0,1,1,2,2,H
1985-08-24,1985,Everton,Coventry City,1-1,1,1,1,1,2,0,D
1985-08-24,1985,Ipswich Town,Tottenham Hotspur,1-0,1,0,1,1,1,1,H
1985-08-24,1985,Manchester City,Sheffield Wednesday,1-3,1,3,1,1,4,-2,A
1985-08-24,1985,Newcastle United,Liverpool,1-0,1,0,1,1,1,1,H
1985-08-24,1985,Nottingham Forest,Southampton,2-1,2,1,1,1,3,1,H
1985-08-24,1985,Oxford United,Leicester City,5-0,5,0,1,1,5,5,H
1985-08-24,1985,Watford,West Bromwich Albion,5-1,5,1,1,1,6,4,H
1985-08-24,1985,West Ham United,Luton Town,0-1,0,1,1,1,1,-1,A
1985-08-26,1985,Birmingham City,Oxford United,3-1,3,1,1,1,4,2,H
1985-08-26,1985,Coventry City,Newcastle United,1-2,1,2,1,1,3,-1,A
1985-08-26,1985,Liverpool,Ipswich Town,5-0,5,0,1,1,5,5,H
1985-08-26,1985,Manchester United,West Ham United,2-0,2,0,1,1,2,2,H
1985-08-26,1985,Sheffield Wednesday,Watford,2-1,2,1,1,1,3,1,H
1985-08-26,1985,Tottenham Hotspur,Everton,0-1,0,1,1,1,1,-1,A
1985-08-26,1985,West Bromwich Albion,Manchester City,2-3,2,3,1,1,5,-1,A
1985-08-27,1985,Luton Town,Arsenal,2-2,2,2,1,1,4,0,D
1985-08-27,1985,Queens Park Rangers,Nottingham Forest,2-1,2,1,1,1,3,1,H
1985-08-27,1985,Southampton,Aston Villa,0-0,0,0,1,1,0,0,D
1985-08-28,1985,Leicester City,Chelsea,0-0,0,0,1,1,0,0,D
1985-08-31,1985,Arsenal,Leicester City,1-0,1,0,1,1,1,1,H
1985-08-31,1985,Aston Villa,Luton Town,3-1,3,1,1,1,4,2,H
1985-08-31,1985,Chelsea,West Bromwich Albion,3-0,3,0,1,1,3,3,H
1985-08-31,1985,Everton,Birmingham City,4-1,4,1,1,1,5,3,H
1985-08-31,1985,Ipswich Town,Southampton,1-1,1,1,1,1,2,0,D
1985-08-31,1985,Manchester City,Tottenham Hotspur,2-1,2,1,1,1,3,1,H
1985-08-31,1985,Newcastle United,Queens Park Rangers,3-1,3,1,1,1,4,2,H
1985-08-31,1985,Nottingham Forest,Manchester United,1-3,1,3,1,1,4,-2,A
1985-08-31,1985,Oxford United,Sheffield Wednesday,0-1,0,1,1,1,1,-1,A
1985-08-31,1985,Watford,Coventry City,3-0,3,0,1,1,3,3,H
1985-08-31,1985,West Ham United,Liverpool,2-2,2,2,1,1,4,0,D
1985-09-03,1985,Birmingham City,Manchester City,1-0,1,0,1,1,1,1,H
1985-09-03,1985,Coventry City,Oxford United,5-2,5,2,1,1,7,3,H
1985-09-03,1985,Liverpool,Nottingham Forest,2-0,2,0,1,1,2,2,H
1985-09-03,1985,Queens Park Rangers,Arsenal,0-1,0,1,1,1,1,-1,A
1985-09-03,1985,Sheffield Wednesday,Everton,1-5,1,5,1,1,6,-4,A
1985-09-03,1985,Southampton,West Ham United,1-1,1,1,1,1,2,0,D
1985-09-04,1985,Leicester City,Watford,2-2,2,2,1,1,4,0,D
1985-09-04,1985,Manchester United,Newcastle United,3-0,3,0,1,1,3,3,H
1985-09-04,1985,Tottenham Hotspur,Chelsea,4-1,4,1,1,1,5,3,H
1985-09-04,1985,West Bromwich Albion,Aston Villa,0-3,0,3,1,1,3,-3,A
1985-09-07,1985,Birmingham City,Aston Villa,0-0,0,0,1,1,0,0,D
1985-09-07,1985,Coventry City,Arsenal,0-2,0,2,1,1,2,-2,A
1985-09-07,1985,Liverpool,Watford,3-1,3,1,1,1,4,2,H
1985-09-07,1985,Luton Town,Chelsea,1-1,1,1,1,1,2,0,D
1985-09-07,1985,Manchester United,Oxford United,3-0,3,0,1,1,3,3,H
1985-09-07,1985,Queens Park Rangers,Everton,3-0,3,0,1,1,3,3,H
1985-09-07,1985,Sheffield Wednesday,West Ham United,2-2,2,2,1,1,4,0,D
1985-09-07,1985,Southampton,Manchester City,3-0,3,0,1,1,3,3,H
1985-09-07,1985,Tottenham Hotspur,Newcastle United,5-1,5,1,1,1,6,4,H
1985-09-07,1985,West Bromwich Albion,Ipswich Town,1-2,1,2,1,1,3,-1,A
1985-09-08,1985,Leicester City,Nottingham Forest,0-3,0,3,1,1,3,-3,A
1985-09-14,1985,Arsenal,Sheffield Wednesday,1-0,1,0,1,1,1,1,H
1985-09-14,1985,Aston Villa,Coventry City,1-1,1,1,1,1,2,0,D
1985-09-14,1985,Chelsea,Southampton,2-0,2,0,1,1,2,2,H
1985-09-14,1985,Everton,Luton Town,2-0,2,0,1,1,2,2,H
1985-09-14,1985,Ipswich Town,Birmingham City,0-1,0,1,1,1,1,-1,A
1985-09-14,1985,Manchester City,Manchester United,0-3,0,3,1,1,3,-3,A
1985-09-14,1985,Newcastle United,West Bromwich Albion,4-1,4,1,1,1,5,3,H
1985-09-14,1985,Nottingham Forest,Tottenham Hotspur,0-1,0,1,1,1,1,-1,A
1985-09-14,1985,Oxford United,Liverpool,2-2,2,2,1,1,4,0,D
1985-09-14,1985,Watford,Queens Park Rangers,2-0,2,0,1,1,2,2,H
1985-09-14,1985,West Ham United,Leicester City,3-0,3,0,1,1,3,3,H
1985-09-21,1985,Birmingham City,Leicester City,2-1,2,1,1,1,3,1,H
1985-09-21,1985,Chelsea,Arsenal,2-1,2,1,1,1,3,1,H
1985-09-21,1985,Everton,Liverpool,2-3,2,3,1,1,5,-1,A
1985-09-21,1985,Ipswich Town,Aston Villa,0-3,0,3,1,1,3,-3,A
1985-09-21,1985,Luton Town,Queens Park Rangers,2-0,2,0,1,1,2,2,H
1985-09-21,1985,Manchester City,West Ham United,2-2,2,2,1,1,4,0,D
1985-09-21,1985,Newcastle United,Oxford United,3-0,3,0,1,1,3,3,H
1985-09-21,1985,Nottingham Forest,Watford,3-2,3,2,1,1,5,1,H
1985-09-21,1985,Southampton,Coventry City,1-1,1,1,1,1,2,0,D
1985-09-21,1985,Tottenham Hotspur,Sheffield Wednesday,5-1,5,1,1,1,6,4,H
1985-09-21,1985,West Bromwich Albion,Manchester United,1-5,1,5,1,1,6,-4,A
1985-09-28,1985,Arsenal,Newcastle United,0-0,0,0,1,1,0,0,D
1985-09-28,1985,Aston Villa,Everton,0-0,0,0,1,1,0,0,D
1985-09-28,1985,Coventry City,West Bromwich Albion,3-0,3,0,1,1,3,3,H
1985-09-28,1985,Leicester City,Ipswich Town,1-0,1,0,1,1,1,1,H
1985-09-28,1985,Liverpool,Tottenham Hotspur,4-1,4,1,1,1,5,3,H
1985-09-28,1985,Manchester United,Southampton,1-0,1,0,1,1,1,1,H
1985-09-28,1985,Oxford United,Manchester City,1-0,1,0,1,1,1,1,H
1985-09-28,1985,Queens Park Rangers,Birmingham City,3-1,3,1,1,1,4,2,H
1985-09-28,1985,Sheffield Wednesday,Luton Town,3-2,3,2,1,1,5,1,H
1985-09-28,1985,Watford,Chelsea,3-1,3,1,1,1,4,2,H
1985-09-28,1985,West Ham United,Nottingham Forest,4-2,4,2,1,1,6,2,H
1985-10-01,1985,Luton Town,Ipswich Town,1-0,1,0,1,1,1,1,H
1985-10-02,1985,Leicester City,Oxford United,4-4,4,4,1,1,8,0,D
1985-10-05,1985,Arsenal,Aston Villa,3-2,3,2,1,1,5,1,H
1985-10-05,1985,Birmingham City,Sheffield Wednesday,0-2,0,2,1,1,2,-2,A
1985-10-05,1985,Everton,Oxford United,2-0,2,0,1,1,2,2,H
1985-10-05,1985,Luton Town,Manchester United,1-1,1,1,1,1,2,0,D
1985-10-05,1985,Manchester City,Chelsea,0-1,0,1,1,1,1,-1,A
1985-10-05,1985,Newcastle United,West Ham United,1-2,1,2,1,1,3,-1,A
1985-10-05,1985,Nottingham Forest,Ipswich Town,3-1,3,1,1,1,4,2,H
1985-10-05,1985,Queens Park Rangers,Liverpool,2-1,2,1,1,1,3,1,H
1985-10-05,1985,Southampton,Watford,3-1,3,1,1,1,4,2,H
1985-10-05,1985,West Bromwich Albion,Tottenham Hotspur,1-1,1,1,1,1,2,0,D
1985-10-06,1985,Coventry City,Leicester City,3-0,3,0,1,1,3,3,H
1985-10-12,1985,Aston Villa,Nottingham Forest,1-2,1,2,1,1,3,-1,A
1985-10-12,1985,Chelsea,Everton,2-1,2,1,1,1,3,1,H
1985-10-12,1985,Ipswich Town,Newcastle United,2-2,2,2,1,1,4,0,D
1985-10-12,1985,Leicester City,West Bromwich Albion,2-2,2,2,1,1,4,0,D
1985-10-12,1985,Liverpool,Southampton,1-0,1,0,1,1,1,1,H
1985-10-12,1985,Manchester United,Queens Park Rangers,2-0,2,0,1,1,2,2,H
1985-10-12,1985,Oxford United,Luton Town,1-1,1,1,1,1,2,0,D
1985-10-12,1985,Sheffield Wednesday,Coventry City,2-2,2,2,1,1,4,0,D
1985-10-12,1985,Watford,Manchester City,3-2,3,2,1,1,5,1,H
1985-10-12,1985,West Ham United,Arsenal,0-0,0,0,1,1,0,0,D
1985-10-19,1985,Arsenal,Ipswich Town,1-0,1,0,1,1,1,1,H
1985-10-19,1985,Everton,Watford,4-1,4,1,1,1,5,3,H
1985-10-19,1985,Leicester City,Sheffield Wednesday,2-3,2,3,1,1,5,-1,A
1985-10-19,1985,Luton Town,Southampton,7-0,7,0,1,1,7,7,H
1985-10-19,1985,Manchester United,Liverpool,1-1,1,1,1,1,2,0,D
1985-10-19,1985,Newcastle United,Nottingham Forest,0-3,0,3,1,1,3,-3,A
1985-10-19,1985,Oxford United,Chelsea,2-1,2,1,1,1,3,1,H
1985-10-19,1985,Queens Park Rangers,Manchester City,0-0,0,0,1,1,0,0,D
1985-10-19,1985,West Bromwich Albion,Birmingham City,2-1,2,1,1,1,3,1,H
1985-10-19,1985,West Ham United,Aston Villa,4-1,4,1,1,1,5,3,H
1985-10-20,1985,Coventry City,Tottenham Hotspur,2-3,2,3,1,1,5,-1,A
1985-10-26,1985,Aston Villa,Newcastle United,1-2,1,2,1,1,3,-1,A
1985-10-26,1985,Birmingham City,Coventry City,0-1,0,1,1,1,1,-1,A
1985-10-26,1985,Chelsea,Manchester United,1-2,1,2,1,1,3,-1,A
1985-10-26,1985,Ipswich Town,West Ham United,0-1,0,1,1,1,1,-1,A
1985-10-26,1985,Liverpool,Luton Town,3-2,3,2,1,1,5,1,H
1985-10-26,1985,Manchester City,Everton,1-1,1,1,1,1,2,0,D
1985-10-26,1985,Nottingham Forest,Arsenal,3-2,3,2,1,1,5,1,H
1985-10-26,1985,Sheffield Wednesday,West Bromwich Albion,1-0,1,0,1,1,1,1,H
1985-10-26,1985,Southampton,Queens Park Rangers,3-0,3,0,1,1,3,3,H
1985-10-26,1985,Tottenham Hotspur,Leicester City,1-3,1,3,1,1,4,-2,A
1985-10-26,1985,Watford,Oxford United,2-2,2,2,1,1,4,0,D
1985-11-02,1985,Arsenal,Manchester City,1-0,1,0,1,1,1,1,H
1985-11-02,1985,Aston Villa,Oxford United,2-0,2,0,1,1,2,2,H
1985-11-02,1985,Ipswich Town,Chelsea,0-2,0,2,1,1,2,-2,A
1985-11-02,1985,Liverpool,Leicester City,1-0,1,0,1,1,1,1,H
1985-11-02,1985,Luton Town,Birmingham City,2-0,2,0,1,1,2,2,H
1985-11-02,1985,Manchester United,Coventry City,2-0,2,0,1,1,2,2,H
1985-11-02,1985,Newcastle United,Watford,1-1,1,1,1,1,2,0,D
1985-11-02,1985,Queens Park Rangers,Sheffield Wednesday,1-1,1,1,1,1,2,0,D
1985-11-02,1985,Southampton,Tottenham Hotspur,1-0,1,0,1,1,1,1,H
1985-11-02,1985,West Ham United,Everton,2-1,2,1,1,1,3,1,H
1985-11-03,1985,Nottingham Forest,West Bromwich Albion,2-1,2,1,1,1,3,1,H
1985-11-09,1985,Birmingham City,Newcastle United,0-1,0,1,1,1,1,-1,A
1985-11-09,1985,Chelsea,Nottingham Forest,4-2,4,2,1,1,6,2,H
1985-11-09,1985,Coventry City,Liverpool,0-3,0,3,1,1,3,-3,A
1985-11-09,1985,Everton,Arsenal,6-1,6,1,1,1,7,5,H
1985-11-09,1985,Leicester City,Southampton,2-2,2,2,1,1,4,0,D
1985-11-09,1985,Manchester City,Ipswich Town,1-1,1,1,1,1,2,0,D
1985-11-09,1985,Oxford United,West Ham United,1-2,1,2,1,1,3,-1,A
1985-11-09,1985,Sheffield Wednesday,Manchester United,1-0,1,0,1,1,1,1,H
1985-11-09,1985,Tottenham Hotspur,Luton Town,1-3,1,3,1,1,4,-2,A
1985-11-09,1985,Watford,Aston Villa,1-1,1,1,1,1,2,0,D
1985-11-09,1985,West Bromwich Albion,Queens Park Rangers,0-1,0,1,1,1,1,-1,A
1985-11-16,1985,Arsenal,Oxford United,2-1,2,1,1,1,3,1,H
1985-11-16,1985,Aston Villa,Sheffield Wednesday,1-1,1,1,1,1,2,0,D
1985-11-16,1985,Ipswich Town,Everton,3-4,3,4,1,1,7,-1,A
1985-11-16,1985,Liverpool,West Bromwich Albion,4-1,4,1,1,1,5,3,H
1985-11-16,1985,Luton Town,Coventry City,0-1,0,1,1,1,1,-1,A
1985-11-16,1985,Manchester United,Tottenham Hotspur,0-0,0,0,1,1,0,0,D
1985-11-16,1985,Newcastle United,Chelsea,1-3,1,3,1,1,4,-2,A
1985-11-16,1985,Nottingham Forest,Manchester City,0-2,0,2,1,1,2,-2,A
1985-11-16,1985,Queens Park Rangers,Leicester City,2-0,2,0,1,1,2,2,H
1985-11-16,1985,Southampton,Birmingham City,1-0,1,0,1,1,1,1,H
1985-11-16,1985,West Ham United,Watford,2-1,2,1,1,1,3,1,H
1985-11-23,1985,Birmingham City,Liverpool,0-2,0,2,1,1,2,-2,A
1985-11-23,1985,Chelsea,Aston Villa,2-1,2,1,1,1,3,1,H
1985-11-23,1985,Coventry City,West Ham United,0-1,0,1,1,1,1,-1,A
1985-11-23,1985,Everton,Nottingham Forest,1-1,1,1,1,1,2,0,D
1985-11-23,1985,Leicester City,Manchester United,3-0,3,0,1,1,3,3,H
1985-11-23,1985,Manchester City,Newcastle United,1-0,1,0,1,1,1,1,H
1985-11-23,1985,Oxford United,Ipswich Town,4-3,4,3,1,1,7,1,H
1985-11-23,1985,Sheffield Wednesday,Southampton,2-1,2,1,1,1,3,1,H
1985-11-23,1985,Tottenham Hotspur,Queens Park Rangers,1-1,1,1,1,1,2,0,D
1985-11-23,1985,Watford,Luton Town,1-2,1,2,1,1,3,-1,A
1985-11-23,1985,West Bromwich Albion,Arsenal,0-0,0,0,1,1,0,0,D
1985-11-30,1985,Arsenal,Birmingham City,0-0,0,0,1,1,0,0,D
1985-11-30,1985,Aston Villa,Tottenham Hotspur,1-2,1,2,1,1,3,-1,A
1985-11-30,1985,Ipswich Town,Sheffield Wednesday,2-1,2,1,1,1,3,1,H
1985-11-30,1985,Liverpool,Chelsea,1-1,1,1,1,1,2,0,D
1985-11-30,1985,Luton Town,Manchester City,2-1,2,1,1,1,3,1,H
1985-11-30,1985,Manchester United,Watford,1-1,1,1,1,1,2,0,D
1985-11-30,1985,Newcastle United,Leicester City,2-1,2,1,1,1,3,1,H
1985-11-30,1985,Queens Park Rangers,Coventry City,0-2,0,2,1,1,2,-2,A
1985-11-30,1985,Southampton,Everton,2-3,2,3,1,1,5,-1,A
1985-11-30,1985,West Ham United,West Bromwich Albion,4-0,4,0,1,1,4,4,H
1985-12-01,1985,Nottingham Forest,Oxford United,1-1,1,1,1,1,2,0,D
1985-12-07,1985,Birmingham City,Watford,1-2,1,2,1,1,3,-1,A
1985-12-07,1985,Coventry City,Chelsea,1-1,1,1,1,1,2,0,D
1985-12-07,1985,Leicester City,Manchester City,1-1,1,1,1,1,2,0,D
1985-12-07,1985,Liverpool,Aston Villa,3-0,3,0,1,1,3,3,H
1985-12-07,1985,Luton Town,Newcastle United,2-0,2,0,1,1,2,2,H
1985-12-07,1985,Manchester United,Ipswich Town,1-0,1,0,1,1,1,1,H
1985-12-07,1985,Queens Park Rangers,West Ham United,0-1,0,1,1,1,1,-1,A
1985-12-07,1985,Sheffield Wednesday,Nottingham Forest,2-1,2,1,1,1,3,1,H
1985-12-07,1985,Southampton,Arsenal,3-0,3,0,1,1,3,3,H
1985-12-07,1985,Tottenham Hotspur,Oxford United,5-1,5,1,1,1,6,4,H
1985-12-07,1985,West Bromwich Albion,Everton,0-3,0,3,1,1,3,-3,A
1985-12-14,1985,Arsenal,Liverpool,2-0,2,0,1,1,2,2,H
1985-12-14,1985,Aston Villa,Manchester United,1-3,1,3,1,1,4,-2,A
1985-12-14,1985,Chelsea,Sheffield Wednesday,2-1,2,1,1,1,3,1,H
1985-12-14,1985,Everton,Leicester City,1-2,1,2,1,1,3,-1,A
1985-12-14,1985,Ipswich Town,Queens Park Rangers,1-0,1,0,1,1,1,1,H
1985-12-14,1985,Manchester City,Coventry City,5-1,5,1,1,1,6,4,H
1985-12-14,1985,Newcastle United,Southampton,2-1,2,1,1,1,3,1,H
1985-12-14,1985,Nottingham Forest,Luton Town,2-0,2,0,1,1,2,2,H
1985-12-14,1985,Oxford United,West Bromwich Albion,2-2,2,2,1,1,4,0,D
1985-12-14,1985,Watford,Tottenham Hotspur,1-0,1,0,1,1,1,1,H
1985-12-14,1985,West Ham United,Birmingham City,2-0,2,0,1,1,2,2,H
1985-12-17,1985,Queens Park Rangers,Aston Villa,0-1,0,1,1,1,1,-1,A
1985-12-20,1985,Southampton,Nottingham Forest,3-1,3,1,1,1,4,2,H
1985-12-21,1985,Birmingham City,Chelsea,1-2,1,2,1,1,3,-1,A
1985-12-21,1985,Coventry City,Everton,1-3,1,3,1,1,4,-2,A
1985-12-21,1985,Liverpool,Newcastle United,1-1,1,1,1,1,2,0,D
1985-12-21,1985,Luton Town,West Ham United,0-0,0,0,1,1,0,0,D
1985-12-21,1985,Manchester United,Arsenal,0-1,0,1,1,1,1,-1,A
1985-12-21,1985,Sheffield Wednesday,Manchester City,3-2,3,2,1,1,5,1,H
1985-12-21,1985,Tottenham Hotspur,Ipswich Town,2-0,2,0,1,1,2,2,H
1985-12-22,1985,West Bromwich Albion,Watford,3-1,3,1,1,1,4,2,H
1985-12-26,1985,Birmingham City,Nottingham Forest,0-1,0,1,1,1,1,-1,A
1985-12-26,1985,Coventry City,Ipswich Town,0-1,0,1,1,1,1,-1,A
1985-12-26,1985,Everton,Manchester United,3-1,3,1,1,1,4,2,H
1985-12-26,1985,Leicester City,Aston Villa,3-1,3,1,1,1,4,2,H
1985-12-26,1985,Manchester City,Liverpool,1-0,1,0,1,1,1,1,H
1985-12-26,1985,Oxford United,Southampton,3-0,3,0,1,1,3,3,H
1985-12-26,1985,Sheffield Wednesday,Newcastle United,2-2,2,2,1,1,4,0,D
1985-12-26,1985,Tottenham Hotspur,West Ham United,1-0,1,0,1,1,1,1,H
1985-12-26,1985,West Bromwich Albion,Luton Town,1-2,1,2,1,1,3,-1,A
1985-12-28,1985,Arsenal,Queens Park Rangers,3-1,3,1,1,1,4,2,H
1985-12-28,1985,Aston Villa,West Bromwich Albion,1-1,1,1,1,1,2,0,D
1985-12-28,1985,Chelsea,Tottenham Hotspur,2-0,2,0,1,1,2,2,H
1985-12-28,1985,Everton,Sheffield Wednesday,3-1,3,1,1,1,4,2,H
1985-12-28,1985,Ipswich Town,Luton Town,1-1,1,1,1,1,2,0,D
1985-12-28,1985,Manchester City,Birmingham City,1-1,1,1,1,1,2,0,D
1985-12-28,1985,Nottingham Forest,Liverpool,1-1,1,1,1,1,2,0,D
1985-12-28,1985,Watford,Leicester City,2-1,2,1,1,1,3,1,H
1986-01-01,1985,Arsenal,Tottenham Hotspur,0-0,0,0,1,1,0,0,D
1986-01-01,1985,Aston Villa,Manchester City,0-1,0,1,1,1,1,-1,A
1986-01-01,1985,Ipswich Town,Watford,0-0,0,0,1,1,0,0,D
1986-01-01,1985,Liverpool,Sheffield Wednesday,2-2,2,2,1,1,4,0,D
1986-01-01,1985,Luton Town,Leicester City,3-1,3,1,1,1,4,2,H
1986-01-01,1985,Manchester United,Birmingham City,1-0,1,0,1,1,1,1,H
1986-01-01,1985,Newcastle United,Everton,2-2,2,2,1,1,4,0,D
1986-01-01,1985,Nottingham Forest,Coventry City,5-2,5,2,1,1,7,3,H
1986-01-01,1985,Queens Park Rangers,Oxford United,3-1,3,1,1,1,4,2,H
1986-01-01,1985,Southampton,West Bromwich Albion,3-1,3,1,1,1,4,2,H
1986-01-11,1985,Birmingham City,Ipswich Town,0-1,0,1,1,1,1,-1,A
1986-01-11,1985,Chelsea,Luton Town,1-0,1,0,1,1,1,1,H
1986-01-11,1985,Coventry City,Aston Villa,3-3,3,3,1,1,6,0,D
1986-01-11,1985,Everton,Queens Park Rangers,4-3,4,3,1,1,7,1,H
1986-01-11,1985,Leicester City,West Ham United,0-1,0,1,1,1,1,-1,A
1986-01-11,1985,Manchester City,Southampton,1-0,1,0,1,1,1,1,H
1986-01-11,1985,Oxford United,Manchester United,1-3,1,3,1,1,4,-2,A
1986-01-11,1985,Tottenham Hotspur,Nottingham Forest,0-3,0,3,1,1,3,-3,A
1986-01-11,1985,West Bromwich Albion,Newcastle United,1-1,1,1,1,1,2,0,D
1986-01-12,1985,Watford,Liverpool,2-3,2,3,1,1,5,-1,A
1986-01-18,1985,Birmingham City,Everton,0-2,0,2,1,1,2,-2,A
1986-01-18,1985,Coventry City,Watford,0-2,0,2,1,1,2,-2,A
1986-01-18,1985,Leicester City,Arsenal,2-2,2,2,1,1,4,0,D
1986-01-18,1985,Liverpool,West Ham United,3-1,3,1,1,1,4,2,H
1986-01-18,1985,Luton Town,Aston Villa,2-0,2,0,1,1,2,2,H
1986-01-18,1985,Manchester United,Nottingham Forest,2-3,2,3,1,1,5,-1,A
1986-01-18,1985,Queens Park Rangers,Newcastle United,3-1,3,1,1,1,4,2,H
1986-01-18,1985,Sheffield Wednesday,Oxford United,2-1,2,1,1,1,3,1,H
1986-01-18,1985,Southampton,Ipswich Town,1-0,1,0,1,1,1,1,H
1986-01-18,1985,Tottenham Hotspur,Manchester City,0-2,0,2,1,1,2,-2,A
1986-01-18,1985,West Bromwich Albion,Chelsea,0-3,0,3,1,1,3,-3,A
1986-01-25,1985,Oxford United,Coventry City,0-1,0,1,1,1,1,-1,A
1986-02-01,1985,Arsenal,Luton Town,2-1,2,1,1,1,3,1,H
1986-02-01,1985,Aston Villa,Southampton,0-0,0,0,1,1,0,0,D
1986-02-01,1985,Chelsea,Leicester City,2-2,2,2,1,1,4,0,D
1986-02-01,1985,Everton,Tottenham Hotspur,1-0,1,0,1,1,1,1,H
1986-02-01,1985,Ipswich Town,Liverpool,2-1,2,1,1,1,3,1,H
1986-02-01,1985,Manchester City,West Bromwich Albion,2-1,2,1,1,1,3,1,H
1986-02-01,1985,Newcastle United,Coventry City,3-2,3,2,1,1,5,1,H
1986-02-01,1985,Nottingham Forest,Queens Park Rangers,4-0,4,0,1,1,4,4,H
1986-02-01,1985,Oxford United,Birmingham City,0-1,0,1,1,1,1,-1,A
1986-02-01,1985,Watford,Sheffield Wednesday,2-1,2,1,1,1,3,1,H
1986-02-02,1985,West Ham United,Manchester United,2-1,2,1,1,1,3,1,H
1986-02-08,1985,Birmingham City,West Bromwich Albion,0-1,0,1,1,1,1,-1,A
1986-02-08,1985,Chelsea,Oxford United,1-4,1,4,1,1,5,-3,A
1986-02-08,1985,Manchester City,Queens Park Rangers,2-0,2,0,1,1,2,2,H
1986-02-08,1985,Nottingham Forest,Newcastle United,1-2,1,2,1,1,3,-1,A
1986-02-08,1985,Southampton,Luton Town,1-2,1,2,1,1,3,-1,A
1986-02-08,1985,Tottenham Hotspur,Coventry City,0-1,0,1,1,1,1,-1,A
1986-02-09,1985,Liverpool,Manchester United,1-1,1,1,1,1,2,0,D
1986-02-11,1985,Everton,Manchester City,4-0,4,0,1,1,4,4,H
1986-02-16,1985,Coventry City,Birmingham City,4-4,4,4,1,1,8,0,D
1986-02-22,1985,Coventry City,Southampton,3-2,3,2,1,1,5,1,H
1986-02-22,1985,Liverpool,Everton,0-2,0,2,1,1,2,-2,A
1986-02-22,1985,Manchester United,West Bromwich Albion,3-0,3,0,1,1,3,3,H
1986-02-22,1985,Queens Park Rangers,Luton Town,1-1,1,1,1,1,2,0,D
1986-02-22,1985,Sheffield Wednesday,Tottenham Hotspur,1-2,1,2,1,1,3,-1,A
1986-03-01,1985,Birmingham City,Queens Park Rangers,2-0,2,0,1,1,2,2,H
1986-03-01,1985,Everton,Aston Villa,2-0,2,0,1,1,2,2,H
1986-03-01,1985,Luton Town,Sheffield Wednesday,1-0,1,0,1,1,1,1,H
1986-03-01,1985,Manchester City,Oxford United,0-3,0,3,1,1,3,-3,A
1986-03-01,1985,Newcastle United,Arsenal,1-0,1,0,1,1,1,1,H
1986-03-01,1985,Southampton,Manchester United,1-0,1,0,1,1,1,1,H
1986-03-02,1985,Tottenham Hotspur,Liverpool,1-2,1,2,1,1,3,-1,A
1986-03-08,1985,Aston Villa,Arsenal,1-4,1,4,1,1,5,-3,A
1986-03-08,1985,Chelsea,Manchester City,1-0,1,0,1,1,1,1,H
1986-03-08,1985,Ipswich Town,Nottingham Forest,1-0,1,0,1,1,1,1,H
1986-03-08,1985,Leicester City,Coventry City,2-1,2,1,1,1,3,1,H
1986-03-08,1985,Liverpool,Queens Park Rangers,4-1,4,1,1,1,5,3,H
1986-03-08,1985,Sheffield Wednesday,Birmingham City,5-1,5,1,1,1,6,4,H
1986-03-08,1985,Tottenham Hotspur,West Bromwich Albion,5-0,5,0,1,1,5,5,H
1986-03-11,1985,Ipswich Town,Arsenal,1-2,1,2,1,1,3,-1,A
1986-03-11,1985,Queens Park Rangers,Southampton,0-2,0,2,1,1,2,-2,A
1986-03-12,1985,Leicester City,Birmingham City,4-2,4,2,1,1,6,2,H
1986-03-15,1985,Arsenal,West Ham United,1-0,1,0,1,1,1,1,H
1986-03-15,1985,Birmingham City,Tottenham Hotspur,1-2,1,2,1,1,3,-1,A
1986-03-15,1985,Coventry City,Sheffield Wednesday,0-1,0,1,1,1,1,-1,A
1986-03-15,1985,Luton Town,Oxford United,1-2,1,2,1,1,3,-1,A
1986-03-15,1985,Manchester City,Watford,0-1,0,1,1,1,1,-1,A
1986-03-15,1985,Newcastle United,Ipswich Town,3-1,3,1,1,1,4,2,H
1986-03-15,1985,Nottingham Forest,Aston Villa,1-1,1,1,1,1,2,0,D
1986-03-15,1985,Queens Park Rangers,Manchester United,1-0,1,0,1,1,1,1,H
1986-03-15,1985,Southampton,Liverpool,1-2,1,2,1,1,3,-1,A
1986-03-15,1985,West Bromwich Albion,Leicester City,2-2,2,2,1,1,4,0,D
1986-03-16,1985,Everton,Chelsea,1-1,1,1,1,1,2,0,D
1986-03-18,1985,Sheffield Wednesday,Leicester City,1-0,1,0,1,1,1,1,H
1986-03-19,1985,Aston Villa,West Ham United,2-1,2,1,1,1,3,1,H
1986-03-19,1985,Chelsea,Queens Park Rangers,1-1,1,1,1,1,2,0,D
1986-03-19,1985,Manchester United,Luton Town,2-0,2,0,1,1,2,2,H
1986-03-19,1985,Oxford United,Newcastle United,1-2,1,2,1,1,3,-1,A
1986-03-19,1985,West Bromwich Albion,Coventry City,0-0,0,0,1,1,0,0,D
1986-03-22,1985,Arsenal,Coventry City,3-0,3,0,1,1,3,3,H
1986-03-22,1985,Aston Villa,Birmingham City,0-3,0,3,1,1,3,-3,A
1986-03-22,1985,Ipswich Town,West Bromwich Albion,1-0,1,0,1,1,1,1,H
1986-03-22,1985,Liverpool,Oxford United,6-0,6,0,1,1,6,6,H
1986-03-22,1985,Luton Town,Everton,2-1,2,1,1,1,3,1,H
1986-03-22,1985,Manchester United,Manchester City,2-2,2,2,1,1,4,0,D
1986-03-22,1985,Newcastle United,Tottenham Hotspur,2-2,2,2,1,1,4,0,D
1986-03-22,1985,Nottingham Forest,Leicester City,4-3,4,3,1,1,7,1,H
1986-03-22,1985,Queens Park Rangers,Watford,2-1,2,1,1,1,3,1,H
1986-03-22,1985,Southampton,Chelsea,0-1,0,1,1,1,1,-1,A
1986-03-22,1985,West Ham United,Sheffield Wednesday,1-0,1,0,1,1,1,1,H
1986-03-29,1985,Birmingham City,Manchester United,1-1,1,1,1,1,2,0,D
1986-03-29,1985,Chelsea,West Ham United,0-4,0,4,1,1,4,-4,A
1986-03-29,1985,Coventry City,Nottingham Forest,0-0,0,0,1,1,0,0,D
1986-03-29,1985,Everton,Newcastle United,1-0,1,0,1,1,1,1,H
1986-03-29,1985,Leicester City,Luton Town,0-0,0,0,1,1,0,0,D
1986-03-29,1985,Manchester City,Aston Villa,2-2,2,2,1,1,4,0,D
1986-03-29,1985,Oxford United,Queens Park Rangers,3-3,3,3,1,1,6,0,D
1986-03-29,1985,Sheffield Wednesday,Liverpool,0-0,0,0,1,1,0,0,D
1986-03-29,1985,Tottenham Hotspur,Arsenal,1-0,1,0,1,1,1,1,H
1986-03-29,1985,Watford,Ipswich Town,0-0,0,0,1,1,0,0,D
1986-03-29,1985,West Bromwich Albion,Southampton,1-0,1,0,1,1,1,1,H
1986-03-31,1985,Arsenal,Watford,0-2,0,2,1,1,2,-2,A
1986-03-31,1985,Aston Villa,Leicester City,1-0,1,0,1,1,1,1,H
1986-03-31,1985,Ipswich Town,Coventry City,1-0,1,0,1,1,1,1,H
1986-03-31,1985,Liverpool,Manchester City,2-0,2,0,1,1,2,2,H
1986-03-31,1985,Manchester United,Everton,0-0,0,0,1,1,0,0,D
1986-03-31,1985,Newcastle United,Sheffield Wednesday,4-1,4,1,1,1,5,3,H
1986-03-31,1985,Nottingham Forest,Birmingham City,3-0,3,0,1,1,3,3,H
1986-03-31,1985,Queens Park Rangers,Chelsea,6-0,6,0,1,1,6,6,H
1986-03-31,1985,West Ham United,Tottenham Hotspur,2-1,2,1,1,1,3,1,H
1986-04-01,1985,Luton Town,West Bromwich Albion,3-0,3,0,1,1,3,3,H
1986-04-01,1985,Southampton,Oxford United,1-1,1,1,1,1,2,0,D
1986-04-01,1985,Watford,Arsenal,3-0,3,0,1,1,3,3,H
1986-04-02,1985,Nottingham Forest,West Ham United,2-1,2,1,1,1,3,1,H
1986-04-05,1985,Chelsea,Ipswich Town,1-1,1,1,1,1,2,0,D
1986-04-05,1985,Coventry City,Manchester United,1-3,1,3,1,1,4,-2,A
1986-04-05,1985,Leicester City,Tottenham Hotspur,1-4,1,4,1,1,5,-3,A
1986-04-05,1985,Manchester City,Arsenal,0-1,0,1,1,1,1,-1,A
1986-04-05,1985,Oxford United,Aston Villa,1-1,1,1,1,1,2,0,D
1986-04-05,1985,Watford,Newcastle United,4-1,4,1,1,1,5,3,H
1986-04-05,1985,West Bromwich Albion,Nottingham Forest,1-1,1,1,1,1,2,0,D
1986-04-06,1985,Birmingham City,Luton Town,0-2,0,2,1,1,2,-2,A
1986-04-08,1985,Arsenal,Nottingham Forest,1-1,1,1,1,1,2,0,D
1986-04-08,1985,Ipswich Town,Leicester City,0-2,0,2,1,1,2,-2,A
1986-04-08,1985,Sheffield Wednesday,Queens Park Rangers,0-0,0,0,1,1,0,0,D
1986-04-08,1985,West Ham United,Southampton,1-0,1,0,1,1,1,1,H
1986-04-09,1985,Manchester United,Chelsea,1-2,1,2,1,1,3,-1,A
1986-04-09,1985,Newcastle United,Aston Villa,2-2,2,2,1,1,4,0,D
1986-04-09,1985,Oxford United,Watford,1-1,1,1,1,1,2,0,D
1986-04-12,1985,Arsenal,Everton,0-1,0,1,1,1,1,-1,A
1986-04-12,1985,Aston Villa,Watford,4-1,4,1,1,1,5,3,H
1986-04-12,1985,Ipswich Town,Manchester City,0-0,0,0,1,1,0,0,D
1986-04-12,1985,Liverpool,Coventry City,5-0,5,0,1,1,5,5,H
1986-04-12,1985,Luton Town,Tottenham Hotspur,1-1,1,1,1,1,2,0,D
1986-04-12,1985,Newcastle United,Birmingham City,4-1,4,1,1,1,5,3,H
1986-04-12,1985,Nottingham Forest,Chelsea,0-0,0,0,1,1,0,0,D
1986-04-12,1985,Queens Park Rangers,West Bromwich Albion,1-0,1,0,1,1,1,1,H
1986-04-12,1985,Southampton,Leicester City,0-0,0,0,1,1,0,0,D
1986-04-12,1985,West Ham United,Oxford United,3-1,3,1,1,1,4,2,H
1986-04-13,1985,Manchester United,Sheffield Wednesday,0-2,0,2,1,1,2,-2,A
1986-04-14,1985,Leicester City,Queens Park Rangers,1-4,1,4,1,1,5,-3,A
1986-04-15,1985,Watford,Everton,0-2,0,2,1,1,2,-2,A
1986-04-15,1985,West Ham United,Chelsea,1-2,1,2,1,1,3,-1,A
1986-04-16,1985,Aston Villa,Ipswich Town,1-0,1,0,1,1,1,1,H
1986-04-16,1985,Luton Town,Liverpool,0-1,0,1,1,1,1,-1,A
1986-04-16,1985,Newcastle United,Manchester United,2-4,2,4,1,1,6,-2,A
1986-04-16,1985,Sheffield Wednesday,Arsenal,2-0,2,0,1,1,2,2,H
1986-04-16,1985,Tottenham Hotspur,Birmingham City,2-0,2,0,1,1,2,2,H
1986-04-19,1985,Birmingham City,Southampton,0-2,0,2,1,1,2,-2,A
1986-04-19,1985,Chelsea,Newcastle United,1-1,1,1,1,1,2,0,D
1986-04-19,1985,Coventry City,Luton Town,1-0,1,0,1,1,1,1,H
1986-04-19,1985,Everton,Ipswich Town,1-0,1,0,1,1,1,1,H
1986-04-19,1985,Manchester City,Nottingham Forest,1-2,1,2,1,1,3,-1,A
1986-04-19,1985,Sheffield Wednesday,Aston Villa,2-0,2,0,1,1,2,2,H
1986-04-19,1985,Tottenham Hotspur,Manchester United,0-0,0,0,1,1,0,0,D
1986-04-19,1985,Watford,West Ham United,0-2,0,2,1,1,2,-2,A
1986-04-19,1985,West Bromwich Albion,Liverpool,1-2,1,2,1,1,3,-1,A
1986-04-21,1985,Watford,Nottingham Forest,1-1,1,1,1,1,2,0,D
1986-04-21,1985,West Ham United,Newcastle United,8-1,8,1,1,1,9,7,H
1986-04-22,1985,West Bromwich Albion,Sheffield Wednesday,1-1,1,1,1,1,2,0,D
1986-04-26,1985,Arsenal,West Bromwich Albion,2-2,2,2,1,1,4,0,D
1986-04-26,1985,Aston Villa,Chelsea,3-1,3,1,1,1,4,2,H
1986-04-26,1985,Ipswich Town,Oxford United,3-2,3,2,1,1,5,1,H
1986-04-26,1985,Liverpool,Birmingham City,5-0,5,0,1,1,5,5,H
1986-04-26,1985,Luton Town,Watford,3-2,3,2,1,1,5,1,H
1986-04-26,1985,Manchester United,Leicester City,4-0,4,0,1,1,4,4,H
1986-04-26,1985,Newcastle United,Manchester City,3-1,3,1,1,1,4,2,H
1986-04-26,1985,Nottingham Forest,Everton,0-0,0,0,1,1,0,0,D
1986-04-26,1985,Queens Park Rangers,Tottenham Hotspur,2-5,2,5,1,1,7,-3,A
1986-04-26,1985,Southampton,Sheffield Wednesday,2-3,2,3,1,1,5,-1,A
1986-04-26,1985,West Ham United,Coventry City,1-0,1,0,1,1,1,1,H
1986-04-28,1985,West Ham United,Manchester City,1-0,1,0,1,1,1,1,H
1986-04-29,1985,Arsenal,Chelsea,2-0,2,0,1,1,2,2,H
1986-04-29,1985,Watford,Southampton,1-1,1,1,1,1,2,0,D
1986-04-30,1985,Leicester City,Liverpool,0-2,0,2,1,1,2,-2,A
1986-04-30,1985,Oxford United,Everton,1-0,1,0,1,1,1,1,H
1986-04-30,1985,West Ham United,Ipswich Town,2-1,2,1,1,1,3,1,H
1986-05-03,1985,Birmingham City,Arsenal,0-1,0,1,1,1,1,-1,A
1986-05-03,1985,Chelsea,Liverpool,0-1,0,1,1,1,1,-1,A
1986-05-03,1985,Coventry City,Queens Park Rangers,2-1,2,1,1,1,3,1,H
1986-05-03,1985,Everton,Southampton,6-1,6,1,1,1,7,5,H
1986-05-03,1985,Leicester City,Newcastle United,2-0,2,0,1,1,2,2,H
1986-05-03,1985,Manchester City,Luton Town,1-1,1,1,1,1,2,0,D
1986-05-03,1985,Oxford United,Nottingham Forest,1-2,1,2,1,1,3,-1,A
1986-05-03,1985,Sheffield Wednesday,Ipswich Town,1-0,1,0,1,1,1,1,H
1986-05-03,1985,Tottenham Hotspur,Aston Villa,4-2,4,2,1,1,6,2,H
1986-05-03,1985,Watford,Manchester United,1-1,1,1,1,1,2,0,D
1986-05-03,1985,West Bromwich Albion,West Ham United,2-3,2,3,1,1,5,-1,A
1986-05-05,1985,Chelsea,Watford,1-5,1,5,1,1,6,-4,A
1986-05-05,1985,Everton,West Ham United,3-1,3,1,1,1,4,2,H
1986-05-05,1985,Oxford United,Arsenal,3-0,3,0,1,1,3,3,H
1986-05-05,1985,Tottenham Hotspur,Southampton,5-3,5,3,1,1,8,2,H
1986-08-23,1986,Arsenal,Manchester United,1-0,1,0,1,1,1,1,H
1986-08-23,1986,Aston Villa,Tottenham Hotspur,0-3,0,3,1,1,3,-3,A
1986-08-23,1986,Charlton Athletic,Sheffield Wednesday,1-1,1,1,1,1,2,0,D
1986-08-23,1986,Chelsea,Norwich City,0-0,0,0,1,1,0,0,D
1986-08-23,1986,Everton,Nottingham Forest,2-0,2,0,1,1,2,2,H
1986-08-23,1986,Leicester City,Luton Town,1-1,1,1,1,1,2,0,D
1986-08-23,1986,Manchester City,Wimbledon,3-1,3,1,1,1,4,2,H
1986-08-23,1986,Newcastle United,Liverpool,0-2,0,2,1,1,2,-2,A
1986-08-23,1986,Southampton,Queens Park Rangers,5-1,5,1,1,1,6,4,H
1986-08-23,1986,Watford,Oxford United,3-0,3,0,1,1,3,3,H
1986-08-23,1986,West Ham United,Coventry City,1-0,1,0,1,1,1,1,H
1986-08-25,1986,Liverpool,Manchester City,0-0,0,0,1,1,0,0,D
1986-08-25,1986,Manchester United,West Ham United,2-3,2,3,1,1,5,-1,A
1986-08-25,1986,Oxford United,Chelsea,1-1,1,1,1,1,2,0,D
1986-08-25,1986,Sheffield Wednesday,Everton,2-2,2,2,1,1,4,0,D
1986-08-25,1986,Tottenham Hotspur,Newcastle United,1-1,1,1,1,1,2,0,D
1986-08-26,1986,Coventry City,Arsenal,2-1,2,1,1,1,3,1,H
1986-08-26,1986,Luton Town,Southampton,2-1,2,1,1,1,3,1,H
1986-08-26,1986,Queens Park Rangers,Watford,3-2,3,2,1,1,5,1,H
1986-08-26,1986,Wimbledon,Aston Villa,3-2,3,2,1,1,5,1,H
1986-08-27,1986,Nottingham Forest,Charlton Athletic,4-0,4,0,1,1,4,4,H
1986-08-30,1986,Coventry City,Everton,1-1,1,1,1,1,2,0,D
1986-08-30,1986,Liverpool,Arsenal,2-1,2,1,1,1,3,1,H
1986-08-30,1986,Luton Town,Newcastle United,0-0,0,0,1,1,0,0,D
1986-08-30,1986,Manchester United,Charlton Athletic,0-1,0,1,1,1,1,-1,A
1986-08-30,1986,Norwich City,Southampton,4-3,4,3,1,1,7,1,H
1986-08-30,1986,Nottingham Forest,Watford,1-1,1,1,1,1,2,0,D
1986-08-30,1986,Oxford United,West Ham United,0-0,0,0,1,1,0,0,D
1986-08-30,1986,Queens Park Rangers,Aston Villa,1-0,1,0,1,1,1,1,H
1986-08-30,1986,Sheffield Wednesday,Chelsea,2-0,2,0,1,1,2,2,H
1986-08-30,1986,Tottenham Hotspur,Manchester City,1-0,1,0,1,1,1,1,H
1986-08-30,1986,Wimbledon,Leicester City,1-0,1,0,1,1,1,1,H
1986-09-02,1986,Arsenal,Sheffield Wednesday,2-0,2,0,1,1,2,2,H
1986-09-02,1986,Charlton Athletic,Wimbledon,0-1,0,1,1,1,1,-1,A
1986-09-02,1986,Chelsea,Coventry City,0-0,0,0,1,1,0,0,D
1986-09-02,1986,Everton,Oxford United,3-1,3,1,1,1,4,2,H
1986-09-02,1986,Southampton,Tottenham Hotspur,2-0,2,0,1,1,2,2,H
1986-09-02,1986,West Ham United,Nottingham Forest,1-2,1,2,1,1,3,-1,A
1986-09-03,1986,Aston Villa,Luton Town,2-1,2,1,1,1,3,1,H
1986-09-03,1986,Leicester City,Liverpool,2-1,2,1,1,1,3,1,H
1986-09-03,1986,Manchester City,Norwich City,2-2,2,2,1,1,4,0,D
1986-09-03,1986,Newcastle United,Queens Park Rangers,0-2,0,2,1,1,2,-2,A
1986-09-06,1986,Arsenal,Tottenham Hotspur,0-0,0,0,1,1,0,0,D
1986-09-06,1986,Aston Villa,Oxford United,1-2,1,2,1,1,3,-1,A
1986-09-06,1986,Charlton Athletic,Norwich City,1-2,1,2,1,1,3,-1,A
1986-09-06,1986,Chelsea,Luton Town,1-3,1,3,1,1,4,-2,A
1986-09-06,1986,Everton,Queens Park Rangers,0-0,0,0,1,1,0,0,D
1986-09-06,1986,Leicester City,Manchester United,1-1,1,1,1,1,2,0,D
1986-09-06,1986,Manchester City,Coventry City,0-1,0,1,1,1,1,-1,A
1986-09-06,1986,Newcastle United,Sheffield Wednesday,2-3,2,3,1,1,5,-1,A
1986-09-06,1986,Southampton,Nottingham Forest,1-3,1,3,1,1,4,-2,A
1986-09-06,1986,Watford,Wimbledon,0-1,0,1,1,1,1,-1,A
1986-09-06,1986,West Ham United,Liverpool,2-5,2,5,1,1,7,-3,A
1986-09-13,1986,Coventry City,Newcastle United,3-0,3,0,1,1,3,3,H
1986-09-13,1986,Liverpool,Charlton Athletic,2-0,2,0,1,1,2,2,H
1986-09-13,1986,Luton Town,Arsenal,0-0,0,0,1,1,0,0,D
1986-09-13,1986,Manchester United,Southampton,5-1,5,1,1,1,6,4,H
1986-09-13,1986,Norwich City,Watford,1-3,1,3,1,1,4,-2,A
1986-09-13,1986,Nottingham Forest,Aston Villa,6-0,6,0,1,1,6,6,H
1986-09-13,1986,Oxford United,Manchester City,0-0,0,0,1,1,0,0,D
1986-09-13,1986,Queens Park Rangers,West Ham United,2-3,2,3,1,1,5,-1,A
1986-09-13,1986,Sheffield Wednesday,Leicester City,2-2,2,2,1,1,4,0,D
1986-09-13,1986,Tottenham Hotspur,Chelsea,1-3,1,3,1,1,4,-2,A
1986-09-13,1986,Wimbledon,Everton,1-2,1,2,1,1,3,-1,A
1986-09-16,1986,Watford,Manchester United,1-0,1,0,1,1,1,1,H
1986-09-17,1986,Norwich City,Leicester City,2-1,2,1,1,1,3,1,H
1986-09-20,1986,Arsenal,Oxford United,0-0,0,0,1,1,0,0,D
1986-09-20,1986,Aston Villa,Norwich City,1-4,1,4,1,1,5,-3,A
1986-09-20,1986,Charlton Athletic,Coventry City,1-1,1,1,1,1,2,0,D
1986-09-20,1986,Chelsea,Nottingham Forest,2-6,2,6,1,1,8,-4,A
1986-09-20,1986,Leicester City,Tottenham Hotspur,1-2,1,2,1,1,3,-1,A
1986-09-20,1986,Manchester City,Queens Park Rangers,0-0,0,0,1,1,0,0,D
1986-09-20,1986,Newcastle United,Wimbledon,1-0,1,0,1,1,1,1,H
1986-09-20,1986,Southampton,Liverpool,2-1,2,1,1,1,3,1,H
1986-09-20,1986,Watford,Sheffield Wednesday,0-1,0,1,1,1,1,-1,A
1986-09-20,1986,West Ham United,Luton Town,2-0,2,0,1,1,2,2,H
1986-09-21,1986,Everton,Manchester United,3-1,3,1,1,1,4,2,H
1986-09-27,1986,Coventry City,Watford,1-0,1,0,1,1,1,1,H
1986-09-27,1986,Liverpool,Aston Villa,3-3,3,3,1,1,6,0,D
1986-09-27,1986,Luton Town,Manchester City,1-0,1,0,1,1,1,1,H
1986-09-27,1986,Norwich City,Newcastle United,2-0,2,0,1,1,2,2,H
1986-09-27,1986,Nottingham Forest,Arsenal,1-0,1,0,1,1,1,1,H
1986-09-27,1986,Oxford United,Charlton Athletic,3-2,3,2,1,1,5,1,H
1986-09-27,1986,Queens Park Rangers,Leicester City,0-1,0,1,1,1,1,-1,A
1986-09-27,1986,Sheffield Wednesday,West Ham United,2-2,2,2,1,1,4,0,D
1986-09-27,1986,Tottenham Hotspur,Everton,2-0,2,0,1,1,2,2,H
1986-09-27,1986,Wimbledon,Southampton,2-2,2,2,1,1,4,0,D
1986-09-28,1986,Manchester United,Chelsea,0-1,0,1,1,1,1,-1,A
1986-10-04,1986,Chelsea,Charlton Athletic,0-1,0,1,1,1,1,-1,A
1986-10-04,1986,Coventry City,Aston Villa,0-1,0,1,1,1,1,-1,A
1986-10-04,1986,Everton,Arsenal,0-1,0,1,1,1,1,-1,A
1986-10-04,1986,Manchester City,Leicester City,1-2,1,2,1,1,3,-1,A
1986-10-04,1986,Norwich City,Queens Park Rangers,1-0,1,0,1,1,1,1,H
1986-10-04,1986,Nottingham Forest,Manchester United,1-1,1,1,1,1,2,0,D
1986-10-04,1986,Sheffield Wednesday,Oxford United,6-1,6,1,1,1,7,5,H
1986-10-04,1986,Southampton,Newcastle United,4-1,4,1,1,1,5,3,H
1986-10-04,1986,Tottenham Hotspur,Luton Town,0-0,0,0,1,1,0,0,D
1986-10-04,1986,Watford,West Ham United,2-2,2,2,1,1,4,0,D
1986-10-04,1986,Wimbledon,Liverpool,1-3,1,3,1,1,4,-2,A
1986-10-11,1986,Arsenal,Watford,3-1,3,1,1,1,4,2,H
1986-10-11,1986,Aston Villa,Southampton,3-1,3,1,1,1,4,2,H
1986-10-11,1986,Charlton Athletic,Everton,3-2,3,2,1,1,5,1,H
1986-10-11,1986,Leicester City,Nottingham Forest,3-1,3,1,1,1,4,2,H
1986-10-11,1986,Liverpool,Tottenham Hotspur,0-1,0,1,1,1,1,-1,A
1986-10-11,1986,Luton Town,Norwich City,0-0,0,0,1,1,0,0,D
1986-10-11,1986,Manchester United,Sheffield Wednesday,3-1,3,1,1,1,4,2,H
1986-10-11,1986,Newcastle United,Manchester City,3-1,3,1,1,1,4,2,H
1986-10-11,1986,Oxford United,Coventry City,2-0,2,0,1,1,2,2,H
1986-10-11,1986,Queens Park Rangers,Wimbledon,2-1,2,1,1,1,3,1,H
1986-10-11,1986,West Ham United,Chelsea,5-3,5,3,1,1,8,2,H
1986-10-18,1986,Charlton Athletic,Leicester City,2-0,2,0,1,1,2,2,H
1986-10-18,1986,Chelsea,Manchester City,2-1,2,1,1,1,3,1,H
1986-10-18,1986,Liverpool,Oxford United,4-0,4,0,1,1,4,4,H
1986-10-18,1986,Manchester United,Luton Town,1-0,1,0,1,1,1,1,H
1986-10-18,1986,Newcastle United,Arsenal,1-2,1,2,1,1,3,-1,A
1986-10-18,1986,Norwich City,West Ham United,1-1,1,1,1,1,2,0,D
1986-10-18,1986,Nottingham Forest,Queens Park Rangers,1-0,1,0,1,1,1,1,H
1986-10-18,1986,Southampton,Everton,0-2,0,2,1,1,2,-2,A
1986-10-18,1986,Tottenham Hotspur,Sheffield Wednesday,1-1,1,1,1,1,2,0,D
1986-10-18,1986,Watford,Aston Villa,4-2,4,2,1,1,6,2,H
1986-10-19,1986,Coventry City,Wimbledon,1-0,1,0,1,1,1,1,H
1986-10-25,1986,Arsenal,Chelsea,3-1,3,1,1,1,4,2,H
1986-10-25,1986,Aston Villa,Newcastle United,2-0,2,0,1,1,2,2,H
1986-10-25,1986,Everton,Watford,3-2,3,2,1,1,5,1,H
1986-10-25,1986,Leicester City,Southampton,2-3,2,3,1,1,5,-1,A
1986-10-25,1986,Luton Town,Liverpool,4-1,4,1,1,1,5,3,H
1986-10-25,1986,Oxford United,Nottingham Forest,2-1,2,1,1,1,3,1,H
1986-10-25,1986,Queens Park Rangers,Tottenham Hotspur,2-0,2,0,1,1,2,2,H
1986-10-25,1986,Sheffield Wednesday,Coventry City,2-2,2,2,1,1,4,0,D
1986-10-25,1986,West Ham United,Charlton Athletic,1-3,1,3,1,1,4,-2,A
1986-10-25,1986,Wimbledon,Norwich City,2-0,2,0,1,1,2,2,H
1986-10-26,1986,Manchester City,Manchester United,1-1,1,1,1,1,2,0,D
1986-11-01,1986,Aston Villa,Leicester City,2-0,2,0,1,1,2,2,H
1986-11-01,1986,Charlton Athletic,Arsenal,0-2,0,2,1,1,2,-2,A
1986-11-01,1986,Chelsea,Watford,0-0,0,0,1,1,0,0,D
1986-11-01,1986,Liverpool,Norwich City,6-2,6,2,1,1,8,4,H
1986-11-01,1986,Luton Town,Queens Park Rangers,1-0,1,0,1,1,1,1,H
1986-11-01,1986,Manchester United,Coventry City,1-1,1,1,1,1,2,0,D
1986-11-01,1986,Newcastle United,Oxford United,0-0,0,0,1,1,0,0,D
1986-11-01,1986,Nottingham Forest,Sheffield Wednesday,3-2,3,2,1,1,5,1,H
1986-11-01,1986,Southampton,Manchester City,1-1,1,1,1,1,2,0,D
1986-11-01,1986,Tottenham Hotspur,Wimbledon,1-2,1,2,1,1,3,-1,A
1986-11-02,1986,West Ham United,Everton,1-0,1,0,1,1,1,1,H
1986-11-08,1986,Arsenal,West Ham United,0-0,0,0,1,1,0,0,D
1986-11-08,1986,Coventry City,Nottingham Forest,1-0,1,0,1,1,1,1,H
1986-11-08,1986,Everton,Chelsea,2-2,2,2,1,1,4,0,D
1986-11-08,1986,Leicester City,Newcastle United,1-1,1,1,1,1,2,0,D
1986-11-08,1986,Manchester City,Aston Villa,3-1,3,1,1,1,4,2,H
1986-11-08,1986,Norwich City,Tottenham Hotspur,2-1,2,1,1,1,3,1,H
1986-11-08,1986,Oxford United,Manchester United,2-0,2,0,1,1,2,2,H
1986-11-08,1986,Queens Park Rangers,Liverpool,1-3,1,3,1,1,4,-2,A
1986-11-08,1986,Sheffield Wednesday,Southampton,3-1,3,1,1,1,4,2,H
1986-11-08,1986,Watford,Charlton Athletic,4-1,4,1,1,1,5,3,H
1986-11-08,1986,Wimbledon,Luton Town,0-1,0,1,1,1,1,-1,A
1986-11-15,1986,Aston Villa,Chelsea,0-0,0,0,1,1,0,0,D
1986-11-15,1986,Leicester City,Everton,0-2,0,2,1,1,2,-2,A
1986-11-15,1986,Luton Town,Nottingham Forest,4-2,4,2,1,1,6,2,H
1986-11-15,1986,Manchester City,Charlton Athletic,2-1,2,1,1,1,3,1,H
1986-11-15,1986,Newcastle United,Watford,2-2,2,2,1,1,4,0,D
1986-11-15,1986,Norwich City,Manchester United,0-0,0,0,1,1,0,0,D
1986-11-15,1986,Queens Park Rangers,Oxford United,1-1,1,1,1,1,2,0,D
1986-11-15,1986,Southampton,Arsenal,0-4,0,4,1,1,4,-4,A
1986-11-15,1986,Tottenham Hotspur,Coventry City,1-0,1,0,1,1,1,1,H
1986-11-15,1986,Wimbledon,West Ham United,0-1,0,1,1,1,1,-1,A
1986-11-16,1986,Liverpool,Sheffield Wednesday,1-1,1,1,1,1,2,0,D
1986-11-22,1986,Arsenal,Manchester City,3-0,3,0,1,1,3,3,H
1986-11-22,1986,Charlton Athletic,Southampton,1-3,1,3,1,1,4,-2,A
1986-11-22,1986,Chelsea,Newcastle United,1-3,1,3,1,1,4,-2,A
1986-11-22,1986,Coventry City,Norwich City,2-1,2,1,1,1,3,1,H
1986-11-22,1986,Manchester United,Queens Park Rangers,1-0,1,0,1,1,1,1,H
1986-11-22,1986,Nottingham Forest,Wimbledon,3-2,3,2,1,1,5,1,H
1986-11-22,1986,Oxford United,Tottenham Hotspur,2-4,2,4,1,1,6,-2,A
1986-11-22,1986,Sheffield Wednesday,Luton Town,1-0,1,0,1,1,1,1,H
1986-11-22,1986,Watford,Leicester City,5-1,5,1,1,1,6,4,H
1986-11-22,1986,West Ham United,Aston Villa,1-1,1,1,1,1,2,0,D
1986-11-23,1986,Everton,Liverpool,0-0,0,0,1,1,0,0,D
1986-11-29,1986,Aston Villa,Arsenal,0-4,0,4,1,1,4,-4,A
1986-11-29,1986,Leicester City,Chelsea,2-2,2,2,1,1,4,0,D
1986-11-29,1986,Liverpool,Coventry City,2-0,2,0,1,1,2,2,H
1986-11-29,1986,Luton Town,Charlton Athletic,1-0,1,0,1,1,1,1,H
1986-11-29,1986,Manchester City,Everton,1-3,1,3,1,1,4,-2,A
1986-11-29,1986,Norwich City,Oxford United,2-1,2,1,1,1,3,1,H
1986-11-29,1986,Queens Park Rangers,Sheffield Wednesday,2-2,2,2,1,1,4,0,D
1986-11-29,1986,Southampton,Watford,3-1,3,1,1,1,4,2,H
1986-11-29,1986,Tottenham Hotspur,Nottingham Forest,2-3,2,3,1,1,5,-1,A
1986-11-29,1986,Wimbledon,Manchester United,1-0,1,0,1,1,1,1,H
1986-11-30,1986,Newcastle United,West Ham United,4-0,4,0,1,1,4,4,H
1986-12-06,1986,Arsenal,Queens Park Rangers,3-1,3,1,1,1,4,2,H
1986-12-06,1986,Charlton Athletic,Newcastle United,1-1,1,1,1,1,2,0,D
1986-12-06,1986,Chelsea,Wimbledon,0-4,0,4,1,1,4,-4,A
1986-12-06,1986,Coventry City,Leicester City,1-0,1,0,1,1,1,1,H
1986-12-06,1986,Everton,Norwich City,4-0,4,0,1,1,4,4,H
1986-12-06,1986,Nottingham Forest,Manchester City,2-0,2,0,1,1,2,2,H
1986-12-06,1986,Oxford United,Luton Town,4-2,4,2,1,1,6,2,H
1986-12-06,1986,Sheffield Wednesday,Aston Villa,2-1,2,1,1,1,3,1,H
1986-12-06,1986,Watford,Liverpool,2-0,2,0,1,1,2,2,H
1986-12-06,1986,West Ham United,Southampton,3-1,3,1,1,1,4,2,H
1986-12-07,1986,Manchester United,Tottenham Hotspur,3-3,3,3,1,1,6,0,D
1986-12-13,1986,Aston Villa,Manchester United,3-3,3,3,1,1,6,0,D
1986-12-13,1986,Luton Town,Everton,1-0,1,0,1,1,1,1,H
1986-12-13,1986,Manchester City,West Ham United,3-1,3,1,1,1,4,2,H
1986-12-13,1986,Newcastle United,Nottingham Forest,3-2,3,2,1,1,5,1,H
1986-12-13,1986,Norwich City,Arsenal,1-1,1,1,1,1,2,0,D
1986-12-13,1986,Queens Park Rangers,Charlton Athletic,0-0,0,0,1,1,0,0,D
1986-12-13,1986,Tottenham Hotspur,Watford,2-1,2,1,1,1,3,1,H
1986-12-13,1986,Wimbledon,Sheffield Wednesday,3-0,3,0,1,1,3,3,H
1986-12-14,1986,Leicester City,Oxford United,2-0,2,0,1,1,2,2,H
1986-12-14,1986,Liverpool,Chelsea,3-0,3,0,1,1,3,3,H
1986-12-19,1986,Watford,Norwich City,1-1,1,1,1,1,2,0,D
1986-12-20,1986,Arsenal,Luton Town,3-0,3,0,1,1,3,3,H
1986-12-20,1986,Charlton Athletic,Liverpool,0-0,0,0,1,1,0,0,D
1986-12-20,1986,Chelsea,Tottenham Hotspur,0-2,0,2,1,1,2,-2,A
1986-12-20,1986,Everton,Wimbledon,3-0,3,0,1,1,3,3,H
1986-12-20,1986,Manchester United,Leicester City,2-0,2,0,1,1,2,2,H
1986-12-20,1986,Nottingham Forest,Southampton,0-0,0,0,1,1,0,0,D
1986-12-20,1986,Oxford United,Aston Villa,2-2,2,2,1,1,4,0,D
1986-12-20,1986,West Ham United,Queens Park Rangers,1-1,1,1,1,1,2,0,D
1986-12-21,1986,Coventry City,Manchester City,2-2,2,2,1,1,4,0,D
1986-12-21,1986,Sheffield Wednesday,Newcastle United,2-0,2,0,1,1,2,2,H
1986-12-26,1986,Aston Villa,Charlton Athletic,2-0,2,0,1,1,2,2,H
1986-12-26,1986,Leicester City,Arsenal,1-1,1,1,1,1,2,0,D
1986-12-26,1986,Liverpool,Manchester United,0-1,0,1,1,1,1,-1,A
1986-12-26,1986,Luton Town,Watford,0-2,0,2,1,1,2,-2,A
1986-12-26,1986,Manchester City,Sheffield Wednesday,1-0,1,0,1,1,1,1,H
1986-12-26,1986,Newcastle United,Everton,0-4,0,4,1,1,4,-4,A
1986-12-26,1986,Norwich City,Nottingham Forest,2-1,2,1,1,1,3,1,H
1986-12-26,1986,Queens Park Rangers,Coventry City,3-1,3,1,1,1,4,2,H
1986-12-26,1986,Southampton,Chelsea,1-2,1,2,1,1,3,-1,A
1986-12-26,1986,Tottenham Hotspur,West Ham United,4-0,4,0,1,1,4,4,H
1986-12-26,1986,Wimbledon,Oxford United,1-1,1,1,1,1,2,0,D
1986-12-27,1986,Arsenal,Southampton,1-0,1,0,1,1,1,1,H
1986-12-27,1986,Chelsea,Aston Villa,4-1,4,1,1,1,5,3,H
1986-12-27,1986,Coventry City,Tottenham Hotspur,4-3,4,3,1,1,7,1,H
1986-12-27,1986,Manchester United,Norwich City,0-1,0,1,1,1,1,-1,A
1986-12-27,1986,Oxford United,Queens Park Rangers,0-1,0,1,1,1,1,-1,A
1986-12-27,1986,Sheffield Wednesday,Liverpool,0-1,0,1,1,1,1,-1,A
1986-12-27,1986,Watford,Newcastle United,1-0,1,0,1,1,1,1,H
1986-12-27,1986,West Ham United,Wimbledon,2-3,2,3,1,1,5,-1,A
1986-12-28,1986,Charlton Athletic,Manchester City,5-0,5,0,1,1,5,5,H
1986-12-28,1986,Everton,Leicester City,5-1,5,1,1,1,6,4,H
1986-12-28,1986,Nottingham Forest,Luton Town,2-2,2,2,1,1,4,0,D
1987-01-01,1986,Arsenal,Wimbledon,3-1,3,1,1,1,4,2,H
1987-01-01,1986,Charlton Athletic,Tottenham Hotspur,0-2,0,2,1,1,2,-2,A
1987-01-01,1986,Chelsea,Queens Park Rangers,3-1,3,1,1,1,4,2,H
1987-01-01,1986,Coventry City,Luton Town,0-1,0,1,1,1,1,-1,A
1987-01-01,1986,Everton,Aston Villa,3-0,3,0,1,1,3,3,H
1987-01-01,1986,Manchester United,Newcastle United,4-1,4,1,1,1,5,3,H
1987-01-01,1986,Nottingham Forest,Liverpool,1-1,1,1,1,1,2,0,D
1987-01-01,1986,Oxford United,Southampton,3-1,3,1,1,1,4,2,H
1987-01-01,1986,Sheffield Wednesday,Norwich City,1-1,1,1,1,1,2,0,D
1987-01-01,1986,Watford,Manchester City,1-1,1,1,1,1,2,0,D
1987-01-01,1986,West Ham United,Leicester City,4-1,4,1,1,1,5,3,H
1987-01-03,1986,Aston Villa,Nottingham Forest,0-0,0,0,1,1,0,0,D
1987-01-03,1986,Leicester City,Sheffield Wednesday,6-1,6,1,1,1,7,5,H
1987-01-03,1986,Liverpool,West Ham United,1-0,1,0,1,1,1,1,H
1987-01-03,1986,Luton Town,Chelsea,1-0,1,0,1,1,1,1,H
1987-01-03,1986,Manchester City,Oxford United,1-0,1,0,1,1,1,1,H
1987-01-03,1986,Newcastle United,Coventry City,1-2,1,2,1,1,3,-1,A
1987-01-03,1986,Norwich City,Charlton Athletic,1-1,1,1,1,1,2,0,D
1987-01-03,1986,Queens Park Rangers,Everton,0-1,0,1,1,1,1,-1,A
1987-01-03,1986,Southampton,Manchester United,1-1,1,1,1,1,2,0,D
1987-01-03,1986,Wimbledon,Watford,2-1,2,1,1,1,3,1,H
1987-01-04,1986,Tottenham Hotspur,Arsenal,1-2,1,2,1,1,3,-1,A
1987-01-17,1986,Everton,Sheffield Wednesday,2-0,2,0,1,1,2,2,H
1987-01-17,1986,Manchester City,Liverpool,0-1,0,1,1,1,1,-1,A
1987-01-18,1986,Arsenal,Coventry City,0-0,0,0,1,1,0,0,D
1987-01-24,1986,Coventry City,West Ham United,1-3,1,3,1,1,4,-2,A
1987-01-24,1986,Liverpool,Newcastle United,2-0,2,0,1,1,2,2,H
1987-01-24,1986,Luton Town,Leicester City,1-0,1,0,1,1,1,1,H
1987-01-24,1986,Manchester United,Arsenal,2-0,2,0,1,1,2,2,H
1987-01-24,1986,Norwich City,Chelsea,2-2,2,2,1,1,4,0,D
1987-01-24,1986,Oxford United,Watford,1-3,1,3,1,1,4,-2,A
1987-01-24,1986,Queens Park Rangers,Southampton,2-1,2,1,1,1,3,1,H
1987-01-24,1986,Sheffield Wednesday,Charlton Athletic,1-1,1,1,1,1,2,0,D
1987-01-24,1986,Tottenham Hotspur,Aston Villa,3-0,3,0,1,1,3,3,H
1987-01-24,1986,Wimbledon,Manchester City,0-0,0,0,1,1,0,0,D
1987-01-25,1986,Nottingham Forest,Everton,1-0,1,0,1,1,1,1,H
1987-01-31,1986,Charlton Athletic,Nottingham Forest,0-1,0,1,1,1,1,-1,A
1987-02-03,1986,Southampton,Coventry City,2-0,2,0,1,1,2,2,H
1987-02-07,1986,Aston Villa,Queens Park Rangers,0-1,0,1,1,1,1,-1,A
1987-02-07,1986,Charlton Athletic,Manchester United,0-0,0,0,1,1,0,0,D
1987-02-07,1986,Chelsea,Sheffield Wednesday,2-0,2,0,1,1,2,2,H
1987-02-07,1986,Everton,Coventry City,3-1,3,1,1,1,4,2,H
1987-02-07,1986,Leicester City,Wimbledon,3-1,3,1,1,1,4,2,H
1987-02-07,1986,Newcastle United,Luton Town,2-2,2,2,1,1,4,0,D
1987-02-07,1986,Southampton,Norwich City,1-2,1,2,1,1,3,-1,A
1987-02-07,1986,Watford,Nottingham Forest,1-1,1,1,1,1,2,0,D
1987-02-07,1986,West Ham United,Oxford United,0-1,0,1,1,1,1,-1,A
1987-02-10,1986,Chelsea,Oxford United,4-0,4,0,1,1,4,4,H
1987-02-14,1986,Coventry City,Chelsea,3-0,3,0,1,1,3,3,H
1987-02-14,1986,Liverpool,Leicester City,4-3,4,3,1,1,7,1,H
1987-02-14,1986,Luton Town,Aston Villa,2-1,2,1,1,1,3,1,H
1987-02-14,1986,Manchester United,Watford,3-1,3,1,1,1,4,2,H
1987-02-14,1986,Norwich City,Manchester City,1-1,1,1,1,1,2,0,D
1987-02-14,1986,Nottingham Forest,West Ham United,1-1,1,1,1,1,2,0,D
1987-02-14,1986,Oxford United,Everton,1-1,1,1,1,1,2,0,D
1987-02-14,1986,Queens Park Rangers,Newcastle United,2-1,2,1,1,1,3,1,H
1987-02-14,1986,Sheffield Wednesday,Arsenal,1-1,1,1,1,1,2,0,D
1987-02-14,1986,Tottenham Hotspur,Southampton,2-0,2,0,1,1,2,2,H
1987-02-15,1986,Wimbledon,Charlton Athletic,2-0,2,0,1,1,2,2,H
1987-02-21,1986,Aston Villa,Liverpool,2-2,2,2,1,1,4,0,D
1987-02-21,1986,Chelsea,Manchester United,1-1,1,1,1,1,2,0,D
1987-02-21,1986,Leicester City,Norwich City,0-2,0,2,1,1,2,-2,A
1987-02-21,1986,Manchester City,Luton Town,1-1,1,1,1,1,2,0,D
1987-02-25,1986,Oxford United,Arsenal,0-0,0,0,1,1,0,0,D
1987-02-25,1986,Tottenham Hotspur,Leicester City,5-0,5,0,1,1,5,5,H
1987-02-28,1986,Coventry City,Charlton Athletic,2-1,2,1,1,1,3,1,H
1987-02-28,1986,Liverpool,Southampton,1-0,1,0,1,1,1,1,H
1987-02-28,1986,Luton Town,West Ham United,2-1,2,1,1,1,3,1,H
1987-02-28,1986,Manchester United,Everton,0-0,0,0,1,1,0,0,D
1987-02-28,1986,Norwich City,Aston Villa,1-1,1,1,1,1,2,0,D
1987-02-28,1986,Nottingham Forest,Chelsea,0-1,0,1,1,1,1,-1,A
1987-02-28,1986,Queens Park Rangers,Manchester City,1-0,1,0,1,1,1,1,H
1987-02-28,1986,Sheffield Wednesday,Watford,0-1,0,1,1,1,1,-1,A
1987-02-28,1986,Wimbledon,Newcastle United,3-1,3,1,1,1,4,2,H
1987-03-04,1986,Aston Villa,Wimbledon,0-0,0,0,1,1,0,0,D
1987-03-07,1986,Charlton Athletic,West Ham United,2-1,2,1,1,1,3,1,H
1987-03-07,1986,Chelsea,Arsenal,1-0,1,0,1,1,1,1,H
1987-03-07,1986,Coventry City,Sheffield Wednesday,1-0,1,0,1,1,1,1,H
1987-03-07,1986,Liverpool,Luton Town,2-0,2,0,1,1,2,2,H
1987-03-07,1986,Manchester United,Manchester City,2-0,2,0,1,1,2,2,H
1987-03-07,1986,Newcastle United,Aston Villa,2-1,2,1,1,1,3,1,H
1987-03-07,1986,Norwich City,Wimbledon,0-0,0,0,1,1,0,0,D
1987-03-07,1986,Nottingham Forest,Oxford United,2-0,2,0,1,1,2,2,H
1987-03-07,1986,Southampton,Leicester City,4-0,4,0,1,1,4,4,H
1987-03-07,1986,Tottenham Hotspur,Queens Park Rangers,1-0,1,0,1,1,1,1,H
1987-03-08,1986,Watford,Everton,2-1,2,1,1,1,3,1,H
1987-03-10,1986,Arsenal,Liverpool,0-1,0,1,1,1,1,-1,A
1987-03-14,1986,Everton,Southampton,3-0,3,0,1,1,3,3,H
1987-03-14,1986,Leicester City,Charlton Athletic,1-0,1,0,1,1,1,1,H
1987-03-14,1986,Luton Town,Manchester United,2-1,2,1,1,1,3,1,H
1987-03-14,1986,Manchester City,Chelsea,1-2,1,2,1,1,3,-1,A
1987-03-14,1986,Oxford United,Liverpool,1-3,1,3,1,1,4,-2,A
1987-03-14,1986,Queens Park Rangers,Nottingham Forest,3-1,3,1,1,1,4,2,H
1987-03-14,1986,West Ham United,Norwich City,0-2,0,2,1,1,2,-2,A
1987-03-17,1986,Arsenal,Nottingham Forest,0-0,0,0,1,1,0,0,D
1987-03-18,1986,Liverpool,Queens Park Rangers,2-1,2,1,1,1,3,1,H
1987-03-20,1986,Coventry City,Oxford United,3-0,3,0,1,1,3,3,H
1987-03-21,1986,Chelsea,West Ham United,1-0,1,0,1,1,1,1,H
1987-03-21,1986,Everton,Charlton Athletic,2-1,2,1,1,1,3,1,H
1987-03-21,1986,Manchester City,Newcastle United,0-0,0,0,1,1,0,0,D
1987-03-21,1986,Norwich City,Luton Town,0-0,0,0,1,1,0,0,D
1987-03-21,1986,Sheffield Wednesday,Manchester United,1-0,1,0,1,1,1,1,H
1987-03-21,1986,Southampton,Aston Villa,5-0,5,0,1,1,5,5,H
1987-03-21,1986,Watford,Arsenal,2-0,2,0,1,1,2,2,H
1987-03-21,1986,Wimbledon,Queens Park Rangers,1-1,1,1,1,1,2,0,D
1987-03-22,1986,Nottingham Forest,Leicester City,2-1,2,1,1,1,3,1,H
1987-03-22,1986,Tottenham Hotspur,Liverpool,1-0,1,0,1,1,1,1,H
1987-03-24,1986,Charlton Athletic,Oxford United,0-0,0,0,1,1,0,0,D
1987-03-24,1986,Southampton,Luton Town,3-0,3,0,1,1,3,3,H
1987-03-24,1986,West Ham United,Sheffield Wednesday,0-2,0,2,1,1,2,-2,A
1987-03-24,1986,Wimbledon,Coventry City,2-1,2,1,1,1,3,1,H
1987-03-25,1986,Aston Villa,Watford,1-1,1,1,1,1,2,0,D
1987-03-25,1986,Leicester City,Queens Park Rangers,4-1,4,1,1,1,5,3,H
1987-03-25,1986,Newcastle United,Tottenham Hotspur,1-1,1,1,1,1,2,0,D
1987-03-28,1986,Arsenal,Everton,0-1,0,1,1,1,1,-1,A
1987-03-28,1986,Aston Villa,Coventry City,1-0,1,0,1,1,1,1,H
1987-03-28,1986,Leicester City,Manchester City,4-0,4,0,1,1,4,4,H
1987-03-28,1986,Liverpool,Wimbledon,1-2,1,2,1,1,3,-1,A
1987-03-28,1986,Luton Town,Tottenham Hotspur,3-1,3,1,1,1,4,2,H
1987-03-28,1986,Manchester United,Nottingham Forest,2-0,2,0,1,1,2,2,H
1987-03-28,1986,Newcastle United,Southampton,2-0,2,0,1,1,2,2,H
1987-03-28,1986,Oxford United,Sheffield Wednesday,2-1,2,1,1,1,3,1,H
1987-03-28,1986,Queens Park Rangers,Norwich City,1-1,1,1,1,1,2,0,D
1987-03-28,1986,West Ham United,Watford,1-0,1,0,1,1,1,1,H
1987-04-04,1986,Aston Villa,Manchester City,0-0,0,0,1,1,0,0,D
1987-04-04,1986,Charlton Athletic,Watford,4-3,4,3,1,1,7,1,H
1987-04-04,1986,Chelsea,Everton,1-2,1,2,1,1,3,-1,A
1987-04-04,1986,Luton Town,Wimbledon,0-0,0,0,1,1,0,0,D
1987-04-04,1986,Manchester United,Oxford United,3-2,3,2,1,1,5,1,H
1987-04-04,1986,Newcastle United,Leicester City,2-0,2,0,1,1,2,2,H
1987-04-04,1986,Nottingham Forest,Coventry City,0-0,0,0,1,1,0,0,D
1987-04-04,1986,Tottenham Hotspur,Norwich City,3-0,3,0,1,1,3,3,H
1987-04-06,1986,Watford,Queens Park Rangers,0-3,0,3,1,1,3,-3,A
1987-04-07,1986,Charlton Athletic,Chelsea,0-0,0,0,1,1,0,0,D
1987-04-07,1986,Sheffield Wednesday,Tottenham Hotspur,0-1,0,1,1,1,1,-1,A
1987-04-07,1986,Southampton,Wimbledon,2-2,2,2,1,1,4,0,D
1987-04-08,1986,Newcastle United,Norwich City,4-1,4,1,1,1,5,3,H
1987-04-08,1986,West Ham United,Arsenal,3-1,3,1,1,1,4,2,H
1987-04-11,1986,Arsenal,Charlton Athletic,2-1,2,1,1,1,3,1,H
1987-04-11,1986,Everton,West Ham United,4-0,4,0,1,1,4,4,H
1987-04-11,1986,Leicester City,Aston Villa,1-1,1,1,1,1,2,0,D
1987-04-11,1986,Manchester City,Southampton,2-4,2,4,1,1,6,-2,A
1987-04-11,1986,Norwich City,Liverpool,2-1,2,1,1,1,3,1,H
1987-04-11,1986,Oxford United,Newcastle United,1-1,1,1,1,1,2,0,D
1987-04-11,1986,Queens Park Rangers,Luton Town,2-2,2,2,1,1,4,0,D
1987-04-14,1986,Arsenal,Newcastle United,0-1,0,1,1,1,1,-1,A
1987-04-14,1986,Sheffield Wednesday,Nottingham Forest,2-3,2,3,1,1,5,-1,A
1987-04-14,1986,Watford,Chelsea,3-1,3,1,1,1,4,2,H
1987-04-14,1986,West Ham United,Manchester United,0-0,0,0,1,1,0,0,D
1987-04-15,1986,Manchester City,Tottenham Hotspur,1-1,1,1,1,1,2,0,D
1987-04-18,1986,Aston Villa,Everton,0-1,0,1,1,1,1,-1,A
1987-04-18,1986,Leicester City,West Ham United,2-0,2,0,1,1,2,2,H
1987-04-18,1986,Liverpool,Nottingham Forest,3-0,3,0,1,1,3,3,H
1987-04-18,1986,Luton Town,Coventry City,2-0,2,0,1,1,2,2,H
1987-04-18,1986,Manchester City,Watford,1-2,1,2,1,1,3,-1,A
1987-04-18,1986,Newcastle United,Manchester United,2-1,2,1,1,1,3,1,H
1987-04-18,1986,Norwich City,Sheffield Wednesday,1-0,1,0,1,1,1,1,H
1987-04-18,1986,Queens Park Rangers,Chelsea,1-1,1,1,1,1,2,0,D
1987-04-18,1986,Southampton,Oxford United,3-0,3,0,1,1,3,3,H
1987-04-18,1986,Tottenham Hotspur,Charlton Athletic,1-0,1,0,1,1,1,1,H
1987-04-18,1986,Wimbledon,Arsenal,1-2,1,2,1,1,3,-1,A
1987-04-20,1986,Arsenal,Leicester City,4-1,4,1,1,1,5,3,H
1987-04-20,1986,Charlton Athletic,Aston Villa,3-0,3,0,1,1,3,3,H
1987-04-20,1986,Chelsea,Southampton,1-1,1,1,1,1,2,0,D
1987-04-20,1986,Coventry City,Queens Park Rangers,4-1,4,1,1,1,5,3,H
1987-04-20,1986,Everton,Newcastle United,3-0,3,0,1,1,3,3,H
1987-04-20,1986,Manchester United,Liverpool,1-0,1,0,1,1,1,1,H
1987-04-20,1986,Nottingham Forest,Norwich City,1-1,1,1,1,1,2,0,D
1987-04-20,1986,Oxford United,Wimbledon,3-1,3,1,1,1,4,2,H
1987-04-20,1986,Sheffield Wednesday,Manchester City,2-1,2,1,1,1,3,1,H
1987-04-20,1986,West Ham United,Tottenham Hotspur,2-1,2,1,1,1,3,1,H
1987-04-21,1986,Watford,Luton Town,2-0,2,0,1,1,2,2,H
1987-04-22,1986,Southampton,Sheffield Wednesday,1-1,1,1,1,1,2,0,D
1987-04-22,1986,Wimbledon,Tottenham Hotspur,2-2,2,2,1,1,4,0,D
1987-04-25,1986,Aston Villa,West Ham United,4-0,4,0,1,1,4,4,H
1987-04-25,1986,Leicester City,Watford,1-2,1,2,1,1,3,-1,A
1987-04-25,1986,Liverpool,Everton,3-1,3,1,1,1,4,2,H
1987-04-25,1986,Luton Town,Sheffield Wednesday,0-0,0,0,1,1,0,0,D
1987-04-25,1986,Manchester City,Arsenal,3-0,3,0,1,1,3,3,H
1987-04-25,1986,Newcastle United,Chelsea,1-0,1,0,1,1,1,1,H
1987-04-25,1986,Norwich City,Coventry City,1-1,1,1,1,1,2,0,D
1987-04-25,1986,Queens Park Rangers,Manchester United,1-1,1,1,1,1,2,0,D
1987-04-25,1986,Southampton,Charlton Athletic,2-2,2,2,1,1,4,0,D
1987-04-25,1986,Tottenham Hotspur,Oxford United,3-1,3,1,1,1,4,2,H
1987-04-25,1986,Wimbledon,Nottingham Forest,2-1,2,1,1,1,3,1,H
1987-04-30,1986,Watford,Coventry City,2-3,2,3,1,1,5,-1,A
1987-05-02,1986,Arsenal,Aston Villa,2-1,2,1,1,1,3,1,H
1987-05-02,1986,Charlton Athletic,Luton Town,0-1,0,1,1,1,1,-1,A
1987-05-02,1986,Chelsea,Leicester City,3-1,3,1,1,1,4,2,H
1987-05-02,1986,Coventry City,Liverpool,1-0,1,0,1,1,1,1,H
1987-05-02,1986,Everton,Manchester City,0-0,0,0,1,1,0,0,D
1987-05-02,1986,Manchester United,Wimbledon,0-1,0,1,1,1,1,-1,A
1987-05-02,1986,Nottingham Forest,Tottenham Hotspur,2-0,2,0,1,1,2,2,H
1987-05-02,1986,Oxford United,Norwich City,0-1,0,1,1,1,1,-1,A
1987-05-02,1986,Sheffield Wednesday,Queens Park Rangers,7-1,7,1,1,1,8,6,H
1987-05-02,1986,Watford,Southampton,1-1,1,1,1,1,2,0,D
1987-05-02,1986,West Ham United,Newcastle United,1-1,1,1,1,1,2,0,D
1987-05-04,1986,Aston Villa,Sheffield Wednesday,1-2,1,2,1,1,3,-1,A
1987-05-04,1986,Leicester City,Coventry City,1-1,1,1,1,1,2,0,D
1987-05-04,1986,Liverpool,Watford,1-0,1,0,1,1,1,1,H
1987-05-04,1986,Manchester City,Nottingham Forest,1-0,1,0,1,1,1,1,H
1987-05-04,1986,Newcastle United,Charlton Athletic,0-3,0,3,1,1,3,-3,A
1987-05-04,1986,Norwich City,Everton,0-1,0,1,1,1,1,-1,A
1987-05-04,1986,Queens Park Rangers,Arsenal,1-4,1,4,1,1,5,-3,A
1987-05-04,1986,Southampton,West Ham United,1-0,1,0,1,1,1,1,H
1987-05-04,1986,Tottenham Hotspur,Manchester United,4-0,4,0,1,1,4,4,H
1987-05-05,1986,Luton Town,Oxford United,2-3,2,3,1,1,5,-1,A
1987-05-05,1986,Wimbledon,Chelsea,2-1,2,1,1,1,3,1,H
1987-05-06,1986,Coventry City,Manchester United,1-1,1,1,1,1,2,0,D
1987-05-09,1986,Arsenal,Norwich City,1-2,1,2,1,1,3,-1,A
1987-05-09,1986,Charlton Athletic,Queens Park Rangers,2-1,2,1,1,1,3,1,H
1987-05-09,1986,Chelsea,Liverpool,3-3,3,3,1,1,6,0,D
1987-05-09,1986,Coventry City,Southampton,1-1,1,1,1,1,2,0,D
1987-05-09,1986,Everton,Luton Town,3-1,3,1,1,1,4,2,H
1987-05-09,1986,Manchester United,Aston Villa,3-1,3,1,1,1,4,2,H
1987-05-09,1986,Nottingham Forest,Newcastle United,2-1,2,1,1,1,3,1,H
1987-05-09,1986,Oxford United,Leicester City,0-0,0,0,1,1,0,0,D
1987-05-09,1986,Sheffield Wednesday,Wimbledon,0-2,0,2,1,1,2,-2,A
1987-05-09,1986,Watford,Tottenham Hotspur,1-0,1,0,1,1,1,1,H
1987-05-09,1986,West Ham United,Manchester City,2-0,2,0,1,1,2,2,H
1987-05-11,1986,Everton,Tottenham Hotspur,1-0,1,0,1,1,1,1,H
1987-08-15,1987,Arsenal,Liverpool,1-2,1,2,1,1,3,-1,A
1987-08-15,1987,Charlton Athletic,Nottingham Forest,1-2,1,2,1,1,3,-1,A
1987-08-15,1987,Chelsea,Sheffield Wednesday,2-1,2,1,1,1,3,1,H
1987-08-15,1987,Coventry City,Tottenham Hotspur,2-1,2,1,1,1,3,1,H
1987-08-15,1987,Derby County,Luton Town,1-0,1,0,1,1,1,1,H
1987-08-15,1987,Everton,Norwich City,1-0,1,0,1,1,1,1,H
1987-08-15,1987,Oxford United,Portsmouth,4-2,4,2,1,1,6,2,H
1987-08-15,1987,Southampton,Manchester United,2-2,2,2,1,1,4,0,D
1987-08-15,1987,Watford,Wimbledon,1-0,1,0,1,1,1,1,H
1987-08-15,1987,West Ham United,Queens Park Rangers,0-3,0,3,1,1,3,-3,A
1987-08-18,1987,Luton Town,Coventry City,0-1,0,1,1,1,1,-1,A
1987-08-18,1987,Portsmouth,Chelsea,0-3,0,3,1,1,3,-3,A
1987-08-18,1987,Sheffield Wednesday,Oxford United,1-1,1,1,1,1,2,0,D
1987-08-18,1987,Wimbledon,Everton,1-1,1,1,1,1,2,0,D
1987-08-19,1987,Manchester United,Arsenal,0-0,0,0,1,1,0,0,D
1987-08-19,1987,Norwich City,Southampton,0-1,0,1,1,1,1,-1,A
1987-08-19,1987,Nottingham Forest,Watford,1-0,1,0,1,1,1,1,H
1987-08-19,1987,Queens Park Rangers,Derby County,1-1,1,1,1,1,2,0,D
1987-08-19,1987,Tottenham Hotspur,Newcastle United,3-1,3,1,1,1,4,2,H
1987-08-22,1987,Luton Town,West Ham United,2-2,2,2,1,1,4,0,D
1987-08-22,1987,Manchester United,Watford,2-0,2,0,1,1,2,2,H
1987-08-22,1987,Norwich City,Coventry City,3-1,3,1,1,1,4,2,H
1987-08-22,1987,Nottingham Forest,Everton,0-0,0,0,1,1,0,0,D
1987-08-22,1987,Portsmouth,Southampton,2-2,2,2,1,1,4,0,D
1987-08-22,1987,Queens Park Rangers,Arsenal,2-0,2,0,1,1,2,2,H
1987-08-22,1987,Sheffield Wednesday,Newcastle United,0-1,0,1,1,1,1,-1,A
1987-08-22,1987,Tottenham Hotspur,Chelsea,1-0,1,0,1,1,1,1,H
1987-08-22,1987,Wimbledon,Oxford United,1-1,1,1,1,1,2,0,D
1987-08-29,1987,Arsenal,Portsmouth,6-0,6,0,1,1,6,6,H
1987-08-29,1987,Charlton Athletic,Manchester United,1-3,1,3,1,1,4,-2,A
1987-08-29,1987,Chelsea,Luton Town,3-0,3,0,1,1,3,3,H
1987-08-29,1987,Coventry City,Liverpool,1-4,1,4,1,1,5,-3,A
1987-08-29,1987,Derby County,Wimbledon,0-1,0,1,1,1,1,-1,A
1987-08-29,1987,Everton,Sheffield Wednesday,4-0,4,0,1,1,4,4,H
1987-08-29,1987,Newcastle United,Nottingham Forest,0-1,0,1,1,1,1,-1,A
1987-08-29,1987,Southampton,Queens Park Rangers,0-1,0,1,1,1,1,-1,A
1987-08-29,1987,Watford,Tottenham Hotspur,1-1,1,1,1,1,2,0,D
1987-08-29,1987,West Ham United,Norwich City,2-0,2,0,1,1,2,2,H
1987-08-31,1987,Luton Town,Arsenal,1-1,1,1,1,1,2,0,D
1987-08-31,1987,Manchester United,Chelsea,3-1,3,1,1,1,4,2,H
1987-08-31,1987,Portsmouth,West Ham United,2-1,2,1,1,1,3,1,H
1987-08-31,1987,Sheffield Wednesday,Coventry City,0-3,0,3,1,1,3,-3,A
1987-09-01,1987,Norwich City,Newcastle United,1-1,1,1,1,1,2,0,D
1987-09-01,1987,Tottenham Hotspur,Oxford United,3-0,3,0,1,1,3,3,H
1987-09-01,1987,Wimbledon,Charlton Athletic,4-1,4,1,1,1,5,3,H
1987-09-02,1987,Nottingham Forest,Southampton,3-3,3,3,1,1,6,0,D
1987-09-02,1987,Queens Park Rangers,Everton,1-0,1,0,1,1,1,1,H
1987-09-05,1987,Charlton Athletic,Queens Park Rangers,0-1,0,1,1,1,1,-1,A
1987-09-05,1987,Chelsea,Nottingham Forest,4-3,4,3,1,1,7,1,H
1987-09-05,1987,Coventry City,Manchester United,0-0,0,0,1,1,0,0,D
1987-09-05,1987,Derby County,Portsmouth,0-0,0,0,1,1,0,0,D
1987-09-05,1987,Everton,Tottenham Hotspur,0-0,0,0,1,1,0,0,D
1987-09-05,1987,Newcastle United,Wimbledon,1-2,1,2,1,1,3,-1,A
1987-09-05,1987,Oxford United,Luton Town,2-5,2,5,1,1,7,-3,A
1987-09-05,1987,Southampton,Sheffield Wednesday,1-1,1,1,1,1,2,0,D
1987-09-05,1987,Watford,Norwich City,0-1,0,1,1,1,1,-1,A
1987-09-05,1987,West Ham United,Liverpool,1-1,1,1,1,1,2,0,D
1987-09-12,1987,Liverpool,Oxford United,2-0,2,0,1,1,2,2,H
1987-09-12,1987,Luton Town,Everton,2-1,2,1,1,1,3,1,H
1987-09-12,1987,Manchester United,Newcastle United,2-2,2,2,1,1,4,0,D
1987-09-12,1987,Norwich City,Derby County,1-2,1,2,1,1,3,-1,A
1987-09-12,1987,Nottingham Forest,Arsenal,0-1,0,1,1,1,1,-1,A
1987-09-12,1987,Portsmouth,Charlton Athletic,1-1,1,1,1,1,2,0,D
1987-09-12,1987,Queens Park Rangers,Chelsea,3-1,3,1,1,1,4,2,H
1987-09-12,1987,Sheffield Wednesday,Watford,2-3,2,3,1,1,5,-1,A
1987-09-12,1987,Tottenham Hotspur,Southampton,2-1,2,1,1,1,3,1,H
1987-09-12,1987,Wimbledon,West Ham United,1-1,1,1,1,1,2,0,D
1987-09-15,1987,Liverpool,Charlton Athletic,3-2,3,2,1,1,5,1,H
1987-09-19,1987,Arsenal,Wimbledon,3-0,3,0,1,1,3,3,H
1987-09-19,1987,Charlton Athletic,Luton Town,1-0,1,0,1,1,1,1,H
1987-09-19,1987,Chelsea,Norwich City,1-0,1,0,1,1,1,1,H
1987-09-19,1987,Coventry City,Nottingham Forest,0-3,0,3,1,1,3,-3,A
1987-09-19,1987,Derby County,Sheffield Wednesday,2-2,2,2,1,1,4,0,D
1987-09-19,1987,Everton,Manchester United,2-1,2,1,1,1,3,1,H
1987-09-19,1987,Oxford United,Queens Park Rangers,2-0,2,0,1,1,2,2,H
1987-09-19,1987,Watford,Portsmouth,0-0,0,0,1,1,0,0,D
1987-09-19,1987,West Ham United,Tottenham Hotspur,0-1,0,1,1,1,1,-1,A
1987-09-20,1987,Newcastle United,Liverpool,1-4,1,4,1,1,5,-3,A
1987-09-26,1987,Arsenal,West Ham United,1-0,1,0,1,1,1,1,H
1987-09-26,1987,Derby County,Oxford United,0-1,0,1,1,1,1,-1,A
1987-09-26,1987,Everton,Coventry City,1-2,1,2,1,1,3,-1,A
1987-09-26,1987,Manchester United,Tottenham Hotspur,1-0,1,0,1,1,1,1,H
1987-09-26,1987,Newcastle United,Southampton,2-1,2,1,1,1,3,1,H
1987-09-26,1987,Norwich City,Nottingham Forest,0-2,0,2,1,1,2,-2,A
1987-09-26,1987,Portsmouth,Wimbledon,2-1,2,1,1,1,3,1,H
1987-09-26,1987,Queens Park Rangers,Luton Town,2-0,2,0,1,1,2,2,H
1987-09-26,1987,Sheffield Wednesday,Charlton Athletic,2-0,2,0,1,1,2,2,H
1987-09-26,1987,Watford,Chelsea,0-3,0,3,1,1,3,-3,A
1987-09-29,1987,Liverpool,Derby County,4-0,4,0,1,1,4,4,H
1987-10-03,1987,Charlton Athletic,Arsenal,0-3,0,3,1,1,3,-3,A
1987-10-03,1987,Chelsea,Newcastle United,2-2,2,2,1,1,4,0,D
1987-10-03,1987,Coventry City,Watford,1-0,1,0,1,1,1,1,H
1987-10-03,1987,Liverpool,Portsmouth,4-0,4,0,1,1,4,4,H
1987-10-03,1987,Luton Town,Manchester United,1-1,1,1,1,1,2,0,D
1987-10-03,1987,Oxford United,Norwich City,3-0,3,0,1,1,3,3,H
1987-10-03,1987,Southampton,Everton,0-4,0,4,1,1,4,-4,A
1987-10-03,1987,Tottenham Hotspur,Sheffield Wednesday,2-0,2,0,1,1,2,2,H
1987-10-03,1987,West Ham United,Derby County,1-1,1,1,1,1,2,0,D
1987-10-03,1987,Wimbledon,Queens Park Rangers,1-2,1,2,1,1,3,-1,A
1987-10-10,1987,Arsenal,Oxford United,2-0,2,0,1,1,2,2,H
1987-10-10,1987,Derby County,Nottingham Forest,0-1,0,1,1,1,1,-1,A
1987-10-10,1987,Everton,Chelsea,4-1,4,1,1,1,5,3,H
1987-10-10,1987,Norwich City,Tottenham Hotspur,2-1,2,1,1,1,3,1,H
1987-10-10,1987,Portsmouth,Luton Town,3-1,3,1,1,1,4,2,H
1987-10-10,1987,Sheffield Wednesday,Manchester United,2-4,2,4,1,1,6,-2,A
1987-10-10,1987,West Ham United,Charlton Athletic,1-1,1,1,1,1,2,0,D
1987-10-17,1987,Charlton Athletic,Derby County,0-1,0,1,1,1,1,-1,A
1987-10-17,1987,Chelsea,Coventry City,1-0,1,0,1,1,1,1,H
1987-10-17,1987,Liverpool,Queens Park Rangers,4-0,4,0,1,1,4,4,H
1987-10-17,1987,Luton Town,Wimbledon,2-0,2,0,1,1,2,2,H
1987-10-17,1987,Manchester United,Norwich City,2-1,2,1,1,1,3,1,H
1987-10-17,1987,Newcastle United,Everton,1-1,1,1,1,1,2,0,D
1987-10-17,1987,Nottingham Forest,Sheffield Wednesday,3-0,3,0,1,1,3,3,H
1987-10-17,1987,Oxford United,West Ham United,1-2,1,2,1,1,3,-1,A
1987-10-17,1987,Southampton,Watford,1-0,1,0,1,1,1,1,H
1987-10-18,1987,Tottenham Hotspur,Arsenal,1-2,1,2,1,1,3,-1,A
1987-10-20,1987,Coventry City,Southampton,2-3,2,3,1,1,5,-1,A
1987-10-24,1987,Arsenal,Derby County,2-1,2,1,1,1,3,1,H
1987-10-24,1987,Coventry City,Newcastle United,1-3,1,3,1,1,4,-2,A
1987-10-24,1987,Everton,Watford,2-0,2,0,1,1,2,2,H
1987-10-24,1987,Luton Town,Liverpool,0-1,0,1,1,1,1,-1,A
1987-10-24,1987,Nottingham Forest,Tottenham Hotspur,3-0,3,0,1,1,3,3,H
1987-10-24,1987,Oxford United,Charlton Athletic,2-1,2,1,1,1,3,1,H
1987-10-24,1987,Queens Park Rangers,Portsmouth,2-1,2,1,1,1,3,1,H
1987-10-24,1987,Sheffield Wednesday,Norwich City,1-0,1,0,1,1,1,1,H
1987-10-24,1987,Southampton,Chelsea,3-0,3,0,1,1,3,3,H
1987-10-25,1987,West Ham United,Manchester United,1-1,1,1,1,1,2,0,D
1987-10-31,1987,Charlton Athletic,Southampton,1-1,1,1,1,1,2,0,D
1987-10-31,1987,Chelsea,Oxford United,2-1,2,1,1,1,3,1,H
1987-10-31,1987,Derby County,Coventry City,2-0,2,0,1,1,2,2,H
1987-10-31,1987,Manchester United,Nottingham Forest,2-2,2,2,1,1,4,0,D
1987-10-31,1987,Newcastle United,Arsenal,0-1,0,1,1,1,1,-1,A
1987-10-31,1987,Norwich City,Queens Park Rangers,1-1,1,1,1,1,2,0,D
1987-10-31,1987,Portsmouth,Sheffield Wednesday,1-2,1,2,1,1,3,-1,A
1987-10-31,1987,Tottenham Hotspur,Wimbledon,0-3,0,3,1,1,3,-3,A
1987-10-31,1987,Watford,West Ham United,1-2,1,2,1,1,3,-1,A
1987-11-01,1987,Liverpool,Everton,2-0,2,0,1,1,2,2,H
1987-11-03,1987,Arsenal,Chelsea,3-1,3,1,1,1,4,2,H
1987-11-04,1987,Portsmouth,Tottenham Hotspur,0-0,0,0,1,1,0,0,D
1987-11-04,1987,Wimbledon,Liverpool,1-1,1,1,1,1,2,0,D
1987-11-07,1987,Charlton Athletic,Norwich City,2-0,2,0,1,1,2,2,H
1987-11-07,1987,Luton Town,Newcastle United,4-0,4,0,1,1,4,4,H
1987-11-07,1987,Oxford United,Coventry City,1-0,1,0,1,1,1,1,H
1987-11-07,1987,Queens Park Rangers,Watford,0-0,0,0,1,1,0,0,D
1987-11-07,1987,West Ham United,Sheffield Wednesday,0-1,0,1,1,1,1,-1,A
1987-11-07,1987,Wimbledon,Southampton,2-0,2,0,1,1,2,2,H
1987-11-14,1987,Coventry City,Wimbledon,3-3,3,3,1,1,6,0,D
1987-11-14,1987,Everton,West Ham United,3-1,3,1,1,1,4,2,H
1987-11-14,1987,Newcastle United,Derby County,0-0,0,0,1,1,0,0,D
1987-11-14,1987,Norwich City,Arsenal,2-4,2,4,1,1,6,-2,A
1987-11-14,1987,Nottingham Forest,Portsmouth,5-0,5,0,1,1,5,5,H
1987-11-14,1987,Sheffield Wednesday,Luton Town,0-2,0,2,1,1,2,-2,A
1987-11-14,1987,Southampton,Oxford United,3-0,3,0,1,1,3,3,H
1987-11-14,1987,Tottenham Hotspur,Queens Park Rangers,1-1,1,1,1,1,2,0,D
1987-11-14,1987,Watford,Charlton Athletic,2-1,2,1,1,1,3,1,H
1987-11-15,1987,Manchester United,Liverpool,1-1,1,1,1,1,2,0,D
1987-11-21,1987,Arsenal,Southampton,0-1,0,1,1,1,1,-1,A
1987-11-21,1987,Charlton Athletic,Coventry City,2-2,2,2,1,1,4,0,D
1987-11-21,1987,Liverpool,Norwich City,0-0,0,0,1,1,0,0,D
1987-11-21,1987,Luton Town,Tottenham Hotspur,2-0,2,0,1,1,2,2,H
1987-11-21,1987,Oxford United,Watford,1-1,1,1,1,1,2,0,D
1987-11-21,1987,Portsmouth,Everton,0-1,0,1,1,1,1,-1,A
1987-11-21,1987,Queens Park Rangers,Newcastle United,1-1,1,1,1,1,2,0,D
1987-11-21,1987,West Ham United,Nottingham Forest,3-2,3,2,1,1,5,1,H
1987-11-21,1987,Wimbledon,Manchester United,2-1,2,1,1,1,3,1,H
1987-11-22,1987,Derby County,Chelsea,2-0,2,0,1,1,2,2,H
1987-11-24,1987,Liverpool,Watford,4-0,4,0,1,1,4,4,H
1987-11-28,1987,Chelsea,Wimbledon,1-1,1,1,1,1,2,0,D
1987-11-28,1987,Coventry City,West Ham United,0-0,0,0,1,1,0,0,D
1987-11-28,1987,Everton,Oxford United,0-0,0,0,1,1,0,0,D
1987-11-28,1987,Newcastle United,Charlton Athletic,2-1,2,1,1,1,3,1,H
1987-11-28,1987,Norwich City,Portsmouth,0-1,0,1,1,1,1,-1,A
1987-11-28,1987,Sheffield Wednesday,Queens Park Rangers,3-1,3,1,1,1,4,2,H
1987-11-28,1987,Southampton,Derby County,1-2,1,2,1,1,3,-1,A
1987-11-28,1987,Tottenham Hotspur,Liverpool,0-2,0,2,1,1,2,-2,A
1987-11-28,1987,Watford,Arsenal,2-0,2,0,1,1,2,2,H
1987-12-05,1987,Arsenal,Sheffield Wednesday,3-1,3,1,1,1,4,2,H
1987-12-05,1987,Charlton Athletic,Everton,0-0,0,0,1,1,0,0,D
1987-12-05,1987,Derby County,Watford,1-1,1,1,1,1,2,0,D
1987-12-05,1987,Luton Town,Norwich City,1-2,1,2,1,1,3,-1,A
1987-12-05,1987,Oxford United,Newcastle United,1-3,1,3,1,1,4,-2,A
1987-12-05,1987,Portsmouth,Coventry City,0-0,0,0,1,1,0,0,D
1987-12-05,1987,Queens Park Rangers,Manchester United,0-2,0,2,1,1,2,-2,A
1987-12-05,1987,West Ham United,Southampton,2-1,2,1,1,1,3,1,H
1987-12-05,1987,Wimbledon,Nottingham Forest,1-1,1,1,1,1,2,0,D
1987-12-06,1987,Liverpool,Chelsea,2-1,2,1,1,1,3,1,H
1987-12-12,1987,Chelsea,West Ham United,1-1,1,1,1,1,2,0,D
1987-12-12,1987,Everton,Derby County,3-0,3,0,1,1,3,3,H
1987-12-12,1987,Manchester United,Oxford United,3-1,3,1,1,1,4,2,H
1987-12-12,1987,Newcastle United,Portsmouth,1-1,1,1,1,1,2,0,D
1987-12-12,1987,Sheffield Wednesday,Wimbledon,1-0,1,0,1,1,1,1,H
1987-12-12,1987,Southampton,Liverpool,2-2,2,2,1,1,4,0,D
1987-12-12,1987,Watford,Luton Town,0-1,0,1,1,1,1,-1,A
1987-12-13,1987,Coventry City,Arsenal,0-0,0,0,1,1,0,0,D
1987-12-13,1987,Nottingham Forest,Queens Park Rangers,4-0,4,0,1,1,4,4,H
1987-12-13,1987,Tottenham Hotspur,Charlton Athletic,0-1,0,1,1,1,1,-1,A
1987-12-18,1987,Luton Town,Southampton,2-2,2,2,1,1,4,0,D
1987-12-18,1987,Queens Park Rangers,Coventry City,1-2,1,2,1,1,3,-1,A
1987-12-18,1987,Wimbledon,Norwich City,1-0,1,0,1,1,1,1,H
1987-12-19,1987,Arsenal,Everton,1-1,1,1,1,1,2,0,D
1987-12-19,1987,Liverpool,Sheffield Wednesday,1-0,1,0,1,1,1,1,H
1987-12-19,1987,Oxford United,Nottingham Forest,0-2,0,2,1,1,2,-2,A
1987-12-19,1987,Portsmouth,Manchester United,1-2,1,2,1,1,3,-1,A
1987-12-19,1987,West Ham United,Newcastle United,2-1,2,1,1,1,3,1,H
1987-12-20,1987,Charlton Athletic,Chelsea,2-2,2,2,1,1,4,0,D
1987-12-20,1987,Derby County,Tottenham Hotspur,1-2,1,2,1,1,3,-1,A
1987-12-26,1987,Arsenal,Nottingham Forest,0-2,0,2,1,1,2,-2,A
1987-12-26,1987,Charlton Athletic,Portsmouth,2-1,2,1,1,1,3,1,H
1987-12-26,1987,Chelsea,Queens Park Rangers,1-1,1,1,1,1,2,0,D
1987-12-26,1987,Derby County,Norwich City,1-2,1,2,1,1,3,-1,A
1987-12-26,1987,Everton,Luton Town,2-0,2,0,1,1,2,2,H
1987-12-26,1987,Newcastle United,Manchester United,1-0,1,0,1,1,1,1,H
1987-12-26,1987,Oxford United,Liverpool,0-3,0,3,1,1,3,-3,A
1987-12-26,1987,Southampton,Tottenham Hotspur,2-1,2,1,1,1,3,1,H
1987-12-26,1987,Watford,Sheffield Wednesday,1-3,1,3,1,1,4,-2,A
1987-12-26,1987,West Ham United,Wimbledon,1-2,1,2,1,1,3,-1,A
1987-12-28,1987,Liverpool,Newcastle United,4-0,4,0,1,1,4,4,H
1987-12-28,1987,Luton Town,Charlton Athletic,1-0,1,0,1,1,1,1,H
1987-12-28,1987,Manchester United,Everton,2-1,2,1,1,1,3,1,H
1987-12-28,1987,Norwich City,Chelsea,3-0,3,0,1,1,3,3,H
1987-12-28,1987,Nottingham Forest,Coventry City,4-1,4,1,1,1,5,3,H
1987-12-28,1987,Portsmouth,Watford,1-1,1,1,1,1,2,0,D
1987-12-28,1987,Queens Park Rangers,Oxford United,3-2,3,2,1,1,5,1,H
1987-12-28,1987,Sheffield Wednesday,Derby County,2-1,2,1,1,1,3,1,H
1987-12-28,1987,Tottenham Hotspur,West Ham United,2-1,2,1,1,1,3,1,H
1987-12-28,1987,Wimbledon,Arsenal,3-1,3,1,1,1,4,2,H
1988-01-01,1987,Liverpool,Coventry City,4-0,4,0,1,1,4,4,H
1988-01-01,1987,Luton Town,Chelsea,3-0,3,0,1,1,3,3,H
1988-01-01,1987,Manchester United,Charlton Athletic,0-0,0,0,1,1,0,0,D
1988-01-01,1987,Norwich City,West Ham United,4-1,4,1,1,1,5,3,H
1988-01-01,1987,Nottingham Forest,Newcastle United,0-2,0,2,1,1,2,-2,A
1988-01-01,1987,Portsmouth,Arsenal,1-1,1,1,1,1,2,0,D
1988-01-01,1987,Queens Park Rangers,Southampton,3-0,3,0,1,1,3,3,H
1988-01-01,1987,Sheffield Wednesday,Everton,1-0,1,0,1,1,1,1,H
1988-01-01,1987,Tottenham Hotspur,Watford,2-1,2,1,1,1,3,1,H
1988-01-01,1987,Wimbledon,Derby County,2-1,2,1,1,1,3,1,H
1988-01-02,1987,Arsenal,Queens Park Rangers,0-0,0,0,1,1,0,0,D
1988-01-02,1987,Chelsea,Tottenham Hotspur,0-0,0,0,1,1,0,0,D
1988-01-02,1987,Newcastle United,Sheffield Wednesday,2-2,2,2,1,1,4,0,D
1988-01-02,1987,Oxford United,Wimbledon,2-5,2,5,1,1,7,-3,A
1988-01-02,1987,Watford,Manchester United,0-1,0,1,1,1,1,-1,A
1988-01-02,1987,West Ham United,Luton Town,1-1,1,1,1,1,2,0,D
1988-01-03,1987,Everton,Nottingham Forest,1-0,1,0,1,1,1,1,H
1988-01-03,1987,Southampton,Portsmouth,0-2,0,2,1,1,2,-2,A
1988-01-16,1987,Liverpool,Arsenal,2-0,2,0,1,1,2,2,H
1988-01-16,1987,Luton Town,Derby County,1-0,1,0,1,1,1,1,H
1988-01-16,1987,Manchester United,Southampton,0-2,0,2,1,1,2,-2,A
1988-01-16,1987,Norwich City,Everton,0-3,0,3,1,1,3,-3,A
1988-01-16,1987,Nottingham Forest,Charlton Athletic,2-2,2,2,1,1,4,0,D
1988-01-16,1987,Portsmouth,Oxford United,2-2,2,2,1,1,4,0,D
1988-01-16,1987,Queens Park Rangers,West Ham United,0-1,0,1,1,1,1,-1,A
1988-01-16,1987,Sheffield Wednesday,Chelsea,3-0,3,0,1,1,3,3,H
1988-01-16,1987,Tottenham Hotspur,Coventry City,2-2,2,2,1,1,4,0,D
1988-01-16,1987,Wimbledon,Watford,1-2,1,2,1,1,3,-1,A
1988-01-23,1987,Charlton Athletic,Liverpool,0-2,0,2,1,1,2,-2,A
1988-01-23,1987,Chelsea,Portsmouth,0-0,0,0,1,1,0,0,D
1988-01-23,1987,Newcastle United,Tottenham Hotspur,2-0,2,0,1,1,2,2,H
1988-01-23,1987,Southampton,Norwich City,0-0,0,0,1,1,0,0,D
1988-01-23,1987,Watford,Nottingham Forest,0-0,0,0,1,1,0,0,D
1988-01-24,1987,Arsenal,Manchester United,1-2,1,2,1,1,3,-1,A
1988-02-06,1987,Liverpool,West Ham United,0-0,0,0,1,1,0,0,D
1988-02-06,1987,Luton Town,Oxford United,7-4,7,4,1,1,11,3,H
1988-02-06,1987,Manchester United,Coventry City,1-0,1,0,1,1,1,1,H
1988-02-06,1987,Norwich City,Watford,0-0,0,0,1,1,0,0,D
1988-02-06,1987,Nottingham Forest,Chelsea,3-2,3,2,1,1,5,1,H
1988-02-06,1987,Portsmouth,Derby County,2-1,2,1,1,1,3,1,H
1988-02-06,1987,Queens Park Rangers,Charlton Athletic,2-0,2,0,1,1,2,2,H
1988-02-06,1987,Sheffield Wednesday,Southampton,2-1,2,1,1,1,3,1,H
1988-02-06,1987,Wimbledon,Newcastle United,0-0,0,0,1,1,0,0,D
1988-02-10,1987,Derby County,Manchester United,1-2,1,2,1,1,3,-1,A
1988-02-13,1987,Arsenal,Luton Town,2-1,2,1,1,1,3,1,H
1988-02-13,1987,Charlton Athletic,Wimbledon,1-1,1,1,1,1,2,0,D
1988-02-13,1987,Chelsea,Manchester United,1-2,1,2,1,1,3,-1,A
1988-02-13,1987,Coventry City,Sheffield Wednesday,3-0,3,0,1,1,3,3,H
1988-02-13,1987,Everton,Queens Park Rangers,2-0,2,0,1,1,2,2,H
1988-02-13,1987,Newcastle United,Norwich City,1-3,1,3,1,1,4,-2,A
1988-02-13,1987,Oxford United,Tottenham Hotspur,0-0,0,0,1,1,0,0,D
1988-02-13,1987,Southampton,Nottingham Forest,1-1,1,1,1,1,2,0,D
1988-02-13,1987,Watford,Liverpool,1-4,1,4,1,1,5,-3,A
1988-02-13,1987,West Ham United,Portsmouth,1-1,1,1,1,1,2,0,D
1988-02-20,1987,Charlton Athletic,Sheffield Wednesday,3-1,3,1,1,1,4,2,H
1988-02-20,1987,Coventry City,Norwich City,0-0,0,0,1,1,0,0,D
1988-02-20,1987,Oxford United,Derby County,0-0,0,0,1,1,0,0,D
1988-02-23,1987,Tottenham Hotspur,Manchester United,1-1,1,1,1,1,2,0,D
1988-02-27,1987,Arsenal,Charlton Athletic,4-0,4,0,1,1,4,4,H
1988-02-27,1987,Derby County,West Ham United,1-0,1,0,1,1,1,1,H
1988-02-27,1987,Everton,Southampton,1-0,1,0,1,1,1,1,H
1988-02-27,1987,Newcastle United,Chelsea,3-1,3,1,1,1,4,2,H
1988-02-27,1987,Portsmouth,Liverpool,0-2,0,2,1,1,2,-2,A
1988-02-27,1987,Queens Park Rangers,Wimbledon,1-0,1,0,1,1,1,1,H
1988-02-27,1987,Sheffield Wednesday,Tottenham Hotspur,0-3,0,3,1,1,3,-3,A
1988-02-27,1987,Watford,Coventry City,0-1,0,1,1,1,1,-1,A
1988-03-01,1987,Southampton,Newcastle United,1-1,1,1,1,1,2,0,D
1988-03-01,1987,Tottenham Hotspur,Derby County,0-0,0,0,1,1,0,0,D
1988-03-05,1987,Coventry City,Chelsea,3-3,3,3,1,1,6,0,D
1988-03-05,1987,Derby County,Charlton Athletic,1-1,1,1,1,1,2,0,D
1988-03-05,1987,Everton,Newcastle United,1-0,1,0,1,1,1,1,H
1988-03-05,1987,Norwich City,Manchester United,1-0,1,0,1,1,1,1,H
1988-03-05,1987,Queens Park Rangers,Liverpool,0-1,0,1,1,1,1,-1,A
1988-03-05,1987,Sheffield Wednesday,Nottingham Forest,0-1,0,1,1,1,1,-1,A
1988-03-05,1987,Watford,Southampton,0-1,0,1,1,1,1,-1,A
1988-03-05,1987,West Ham United,Oxford United,1-1,1,1,1,1,2,0,D
1988-03-05,1987,Wimbledon,Luton Town,2-0,2,0,1,1,2,2,H
1988-03-06,1987,Arsenal,Tottenham Hotspur,2-1,2,1,1,1,3,1,H
1988-03-09,1987,Tottenham Hotspur,Everton,2-1,2,1,1,1,3,1,H
1988-03-12,1987,Charlton Athletic,West Ham United,3-0,3,0,1,1,3,3,H
1988-03-12,1987,Chelsea,Everton,0-0,0,0,1,1,0,0,D
1988-03-12,1987,Manchester United,Sheffield Wednesday,4-1,4,1,1,1,5,3,H
1988-03-12,1987,Southampton,Coventry City,1-2,1,2,1,1,3,-1,A
1988-03-12,1987,Tottenham Hotspur,Norwich City,1-3,1,3,1,1,4,-2,A
1988-03-15,1987,Coventry City,Luton Town,4-0,4,0,1,1,4,4,H
1988-03-16,1987,Derby County,Liverpool,1-1,1,1,1,1,2,0,D
1988-03-16,1987,Norwich City,Oxford United,4-2,4,2,1,1,6,2,H
1988-03-16,1987,Queens Park Rangers,Nottingham Forest,2-1,2,1,1,1,3,1,H
1988-03-19,1987,Arsenal,Newcastle United,1-1,1,1,1,1,2,0,D
1988-03-19,1987,Coventry City,Derby County,0-3,0,3,1,1,3,-3,A
1988-03-19,1987,Nottingham Forest,Manchester United,0-0,0,0,1,1,0,0,D
1988-03-19,1987,Oxford United,Chelsea,4-4,4,4,1,1,8,0,D
1988-03-19,1987,Queens Park Rangers,Norwich City,3-0,3,0,1,1,3,3,H
1988-03-19,1987,Sheffield Wednesday,Portsmouth,1-0,1,0,1,1,1,1,H
1988-03-19,1987,Southampton,Charlton Athletic,0-1,0,1,1,1,1,-1,A
1988-03-19,1987,West Ham United,Watford,1-0,1,0,1,1,1,1,H
1988-03-19,1987,Wimbledon,Tottenham Hotspur,3-0,3,0,1,1,3,3,H
1988-03-20,1987,Everton,Liverpool,1-0,1,0,1,1,1,1,H
1988-03-26,1987,Charlton Athletic,Oxford United,0-0,0,0,1,1,0,0,D
1988-03-26,1987,Chelsea,Southampton,0-1,0,1,1,1,1,-1,A
1988-03-26,1987,Derby County,Arsenal,0-0,0,0,1,1,0,0,D
1988-03-26,1987,Liverpool,Wimbledon,2-1,2,1,1,1,3,1,H
1988-03-26,1987,Manchester United,West Ham United,3-1,3,1,1,1,4,2,H
1988-03-26,1987,Newcastle United,Coventry City,2-2,2,2,1,1,4,0,D
1988-03-26,1987,Norwich City,Sheffield Wednesday,0-3,0,3,1,1,3,-3,A
1988-03-26,1987,Portsmouth,Queens Park Rangers,0-1,0,1,1,1,1,-1,A
1988-03-26,1987,Tottenham Hotspur,Nottingham Forest,1-1,1,1,1,1,2,0,D
1988-03-26,1987,Watford,Everton,1-2,1,2,1,1,3,-1,A
1988-03-29,1987,Chelsea,Watford,1-1,1,1,1,1,2,0,D
1988-03-29,1987,Everton,Wimbledon,2-2,2,2,1,1,4,0,D
1988-03-29,1987,Luton Town,Portsmouth,4-1,4,1,1,1,5,3,H
1988-03-30,1987,Nottingham Forest,Derby County,2-1,2,1,1,1,3,1,H
1988-03-30,1987,Oxford United,Arsenal,0-0,0,0,1,1,0,0,D
1988-04-01,1987,Watford,Queens Park Rangers,0-1,0,1,1,1,1,-1,A
1988-04-02,1987,Chelsea,Arsenal,1-1,1,1,1,1,2,0,D
1988-04-02,1987,Coventry City,Oxford United,1-0,1,0,1,1,1,1,H
1988-04-02,1987,Manchester United,Derby County,4-1,4,1,1,1,5,3,H
1988-04-02,1987,Newcastle United,Luton Town,4-0,4,0,1,1,4,4,H
1988-04-02,1987,Norwich City,Charlton Athletic,2-0,2,0,1,1,2,2,H
1988-04-02,1987,Nottingham Forest,Liverpool,2-1,2,1,1,1,3,1,H
1988-04-02,1987,Sheffield Wednesday,West Ham United,2-1,2,1,1,1,3,1,H
1988-04-02,1987,Southampton,Wimbledon,2-2,2,2,1,1,4,0,D
1988-04-02,1987,Tottenham Hotspur,Portsmouth,0-1,0,1,1,1,1,-1,A
1988-04-04,1987,Arsenal,Norwich City,2-0,2,0,1,1,2,2,H
1988-04-04,1987,Charlton Athletic,Watford,1-0,1,0,1,1,1,1,H
1988-04-04,1987,Derby County,Newcastle United,2-1,2,1,1,1,3,1,H
1988-04-04,1987,Liverpool,Manchester United,3-3,3,3,1,1,6,0,D
1988-04-04,1987,Oxford United,Southampton,0-0,0,0,1,1,0,0,D
1988-04-04,1987,Portsmouth,Nottingham Forest,0-1,0,1,1,1,1,-1,A
1988-04-04,1987,Queens Park Rangers,Tottenham Hotspur,2-0,2,0,1,1,2,2,H
1988-04-04,1987,West Ham United,Everton,0-0,0,0,1,1,0,0,D
1988-04-05,1987,Luton Town,Sheffield Wednesday,2-2,2,2,1,1,4,0,D
1988-04-05,1987,Wimbledon,Coventry City,1-2,1,2,1,1,3,-1,A
1988-04-09,1987,Chelsea,Derby County,1-0,1,0,1,1,1,1,H
1988-04-09,1987,Coventry City,Charlton Athletic,0-0,0,0,1,1,0,0,D
1988-04-09,1987,Everton,Portsmouth,2-1,2,1,1,1,3,1,H
1988-04-09,1987,Newcastle United,Queens Park Rangers,1-1,1,1,1,1,2,0,D
1988-04-09,1987,Southampton,Arsenal,4-2,4,2,1,1,6,2,H
1988-04-09,1987,Watford,Oxford United,3-0,3,0,1,1,3,3,H
1988-04-12,1987,Manchester United,Luton Town,3-0,3,0,1,1,3,3,H
1988-04-12,1987,Newcastle United,Watford,3-0,3,0,1,1,3,3,H
1988-04-12,1987,West Ham United,Arsenal,0-1,0,1,1,1,1,-1,A
1988-04-13,1987,Derby County,Queens Park Rangers,0-2,0,2,1,1,2,-2,A
1988-04-13,1987,Liverpool,Nottingham Forest,5-0,5,0,1,1,5,5,H
1988-04-13,1987,Oxford United,Sheffield Wednesday,0-3,0,3,1,1,3,-3,A
1988-04-15,1987,Arsenal,Watford,0-1,0,1,1,1,1,-1,A
1988-04-19,1987,Coventry City,Everton,1-2,1,2,1,1,3,-1,A
1988-04-19,1987,Luton Town,Queens Park Rangers,2-1,2,1,1,1,3,1,H
1988-04-19,1987,Watford,Newcastle United,1-1,1,1,1,1,2,0,D
1988-04-19,1987,Wimbledon,Portsmouth,2-2,2,2,1,1,4,0,D
1988-04-20,1987,Norwich City,Liverpool,0-0,0,0,1,1,0,0,D
1988-04-20,1987,Nottingham Forest,West Ham United,0-0,0,0,1,1,0,0,D
1988-04-23,1987,Charlton Athletic,Newcastle United,2-0,2,0,1,1,2,2,H
1988-04-23,1987,Derby County,Southampton,2-0,2,0,1,1,2,2,H
1988-04-23,1987,Liverpool,Tottenham Hotspur,1-0,1,0,1,1,1,1,H
1988-04-23,1987,Oxford United,Everton,1-1,1,1,1,1,2,0,D
1988-04-23,1987,Portsmouth,Norwich City,2-2,2,2,1,1,4,0,D
1988-04-23,1987,Queens Park Rangers,Sheffield Wednesday,1-1,1,1,1,1,2,0,D
1988-04-23,1987,West Ham United,Coventry City,1-1,1,1,1,1,2,0,D
1988-04-23,1987,Wimbledon,Chelsea,2-2,2,2,1,1,4,0,D
1988-04-30,1987,Chelsea,Liverpool,1-1,1,1,1,1,2,0,D
1988-04-30,1987,Coventry City,Portsmouth,1-0,1,0,1,1,1,1,H
1988-04-30,1987,Everton,Charlton Athletic,1-1,1,1,1,1,2,0,D
1988-04-30,1987,Manchester United,Queens Park Rangers,2-1,2,1,1,1,3,1,H
1988-04-30,1987,Newcastle United,Oxford United,3-1,3,1,1,1,4,2,H
1988-04-30,1987,Norwich City,Luton Town,2-2,2,2,1,1,4,0,D
1988-04-30,1987,Nottingham Forest,Wimbledon,0-0,0,0,1,1,0,0,D
1988-04-30,1987,Sheffield Wednesday,Arsenal,3-3,3,3,1,1,6,0,D
1988-04-30,1987,Southampton,West Ham United,2-1,2,1,1,1,3,1,H
1988-04-30,1987,Watford,Derby County,1-1,1,1,1,1,2,0,D
1988-05-02,1987,Arsenal,Coventry City,1-1,1,1,1,1,2,0,D
1988-05-02,1987,Charlton Athletic,Tottenham Hotspur,1-1,1,1,1,1,2,0,D
1988-05-02,1987,Derby County,Everton,0-0,0,0,1,1,0,0,D
1988-05-02,1987,Liverpool,Southampton,1-1,1,1,1,1,2,0,D
1988-05-02,1987,Luton Town,Watford,2-1,2,1,1,1,3,1,H
1988-05-02,1987,Oxford United,Manchester United,0-2,0,2,1,1,2,-2,A
1988-05-02,1987,Portsmouth,Newcastle United,1-2,1,2,1,1,3,-1,A
1988-05-02,1987,West Ham United,Chelsea,4-1,4,1,1,1,5,3,H
1988-05-03,1987,Wimbledon,Sheffield Wednesday,1-1,1,1,1,1,2,0,D
1988-05-04,1987,Nottingham Forest,Norwich City,2-0,2,0,1,1,2,2,H
1988-05-04,1987,Tottenham Hotspur,Luton Town,2-1,2,1,1,1,3,1,H
1988-05-07,1987,Chelsea,Charlton Athletic,1-1,1,1,1,1,2,0,D
1988-05-07,1987,Coventry City,Queens Park Rangers,0-0,0,0,1,1,0,0,D
1988-05-07,1987,Everton,Arsenal,1-2,1,2,1,1,3,-1,A
1988-05-07,1987,Manchester United,Portsmouth,4-1,4,1,1,1,5,3,H
1988-05-07,1987,Newcastle United,West Ham United,2-1,2,1,1,1,3,1,H
1988-05-07,1987,Norwich City,Wimbledon,0-1,0,1,1,1,1,-1,A
1988-05-07,1987,Nottingham Forest,Oxford United,5-3,5,3,1,1,8,2,H
1988-05-07,1987,Sheffield Wednesday,Liverpool,1-5,1,5,1,1,6,-4,A
1988-05-07,1987,Southampton,Luton Town,1-1,1,1,1,1,2,0,D
1988-05-09,1987,Liverpool,Luton Town,1-1,1,1,1,1,2,0,D
1988-05-09,1987,Manchester United,Wimbledon,2-1,2,1,1,1,3,1,H
1988-05-13,1987,Luton Town,Nottingham Forest,1-1,1,1,1,1,2,0,D
1988-05-15,1987,Nottingham Forest,Luton Town,1-1,1,1,1,1,2,0,D
1988-08-27,1988,Aston Villa,Millwall,2-2,2,2,1,1,4,0,D
1988-08-27,1988,Charlton Athletic,Liverpool,0-3,0,3,1,1,3,-3,A
1988-08-27,1988,Derby County,Middlesbrough,1-0,1,0,1,1,1,1,H
1988-08-27,1988,Everton,Newcastle United,4-0,4,0,1,1,4,4,H
1988-08-27,1988,Manchester United,Queens Park Rangers,0-0,0,0,1,1,0,0,D
1988-08-27,1988,Norwich City,Nottingham Forest,2-1,2,1,1,1,3,1,H
1988-08-27,1988,Sheffield Wednesday,Luton Town,1-0,1,0,1,1,1,1,H
1988-08-27,1988,Southampton,West Ham United,4-0,4,0,1,1,4,4,H
1988-08-27,1988,Wimbledon,Arsenal,1-5,1,5,1,1,6,-4,A
1988-09-03,1988,Arsenal,Aston Villa,2-3,2,3,1,1,5,-1,A
1988-09-03,1988,Coventry City,Everton,0-1,0,1,1,1,1,-1,A
1988-09-03,1988,Liverpool,Manchester United,1-0,1,0,1,1,1,1,H
1988-09-03,1988,Luton Town,Wimbledon,2-2,2,2,1,1,4,0,D
1988-09-03,1988,Middlesbrough,Norwich City,2-3,2,3,1,1,5,-1,A
1988-09-03,1988,Millwall,Derby County,1-0,1,0,1,1,1,1,H
1988-09-03,1988,Newcastle United,Tottenham Hotspur,2-2,2,2,1,1,4,0,D
1988-09-03,1988,Nottingham Forest,Sheffield Wednesday,1-1,1,1,1,1,2,0,D
1988-09-03,1988,Queens Park Rangers,Southampton,0-1,0,1,1,1,1,-1,A
1988-09-03,1988,West Ham United,Charlton Athletic,1-3,1,3,1,1,4,-2,A
1988-09-10,1988,Aston Villa,Liverpool,1-1,1,1,1,1,2,0,D
1988-09-10,1988,Charlton Athletic,Millwall,0-3,0,3,1,1,3,-3,A
1988-09-10,1988,Derby County,Newcastle United,2-0,2,0,1,1,2,2,H
1988-09-10,1988,Everton,Nottingham Forest,1-1,1,1,1,1,2,0,D
1988-09-10,1988,Manchester United,Middlesbrough,1-0,1,0,1,1,1,1,H
1988-09-10,1988,Norwich City,Queens Park Rangers,1-0,1,0,1,1,1,1,H
1988-09-10,1988,Sheffield Wednesday,Coventry City,1-2,1,2,1,1,3,-1,A
1988-09-10,1988,Southampton,Luton Town,2-1,2,1,1,1,3,1,H
1988-09-10,1988,Tottenham Hotspur,Arsenal,2-3,2,3,1,1,5,-1,A
1988-09-10,1988,Wimbledon,West Ham United,0-1,0,1,1,1,1,-1,A
1988-09-17,1988,Arsenal,Southampton,2-2,2,2,1,1,4,0,D
1988-09-17,1988,Coventry City,Charlton Athletic,3-0,3,0,1,1,3,3,H
1988-09-17,1988,Liverpool,Tottenham Hotspur,1-1,1,1,1,1,2,0,D
1988-09-17,1988,Luton Town,Manchester United,0-2,0,2,1,1,2,-2,A
1988-09-17,1988,Middlesbrough,Wimbledon,1-0,1,0,1,1,1,1,H
1988-09-17,1988,Millwall,Everton,2-1,2,1,1,1,3,1,H
1988-09-17,1988,Newcastle United,Norwich City,0-2,0,2,1,1,2,-2,A
1988-09-17,1988,Nottingham Forest,Derby County,1-1,1,1,1,1,2,0,D
1988-09-17,1988,Queens Park Rangers,Sheffield Wednesday,2-0,2,0,1,1,2,2,H
1988-09-17,1988,West Ham United,Aston Villa,2-2,2,2,1,1,4,0,D
1988-09-24,1988,Aston Villa,Nottingham Forest,1-1,1,1,1,1,2,0,D
1988-09-24,1988,Charlton Athletic,Newcastle United,2-2,2,2,1,1,4,0,D
1988-09-24,1988,Derby County,Queens Park Rangers,0-1,0,1,1,1,1,-1,A
1988-09-24,1988,Everton,Luton Town,0-2,0,2,1,1,2,-2,A
1988-09-24,1988,Manchester United,West Ham United,2-0,2,0,1,1,2,2,H
1988-09-24,1988,Norwich City,Millwall,2-2,2,2,1,1,4,0,D
1988-09-24,1988,Sheffield Wednesday,Arsenal,2-1,2,1,1,1,3,1,H
1988-09-24,1988,Southampton,Liverpool,1-3,1,3,1,1,4,-2,A
1988-09-24,1988,Tottenham Hotspur,Middlesbrough,3-2,3,2,1,1,5,1,H
1988-09-24,1988,Wimbledon,Coventry City,0-1,0,1,1,1,1,-1,A
1988-10-01,1988,Coventry City,Middlesbrough,3-4,3,4,1,1,7,-1,A
1988-10-01,1988,Liverpool,Newcastle United,1-2,1,2,1,1,3,-1,A
1988-10-01,1988,Millwall,Queens Park Rangers,3-2,3,2,1,1,5,1,H
1988-10-01,1988,Norwich City,Charlton Athletic,1-3,1,3,1,1,4,-2,A
1988-10-01,1988,Nottingham Forest,Luton Town,0-0,0,0,1,1,0,0,D
1988-10-01,1988,Sheffield Wednesday,Aston Villa,1-0,1,0,1,1,1,1,H
1988-10-01,1988,Southampton,Derby County,0-0,0,0,1,1,0,0,D
1988-10-01,1988,Tottenham Hotspur,Manchester United,2-2,2,2,1,1,4,0,D
1988-10-01,1988,West Ham United,Arsenal,1-4,1,4,1,1,5,-3,A
1988-10-01,1988,Wimbledon,Everton,2-1,2,1,1,1,3,1,H
1988-10-08,1988,Aston Villa,Wimbledon,0-1,0,1,1,1,1,-1,A
1988-10-08,1988,Charlton Athletic,Tottenham Hotspur,2-2,2,2,1,1,4,0,D
1988-10-08,1988,Derby County,Norwich City,0-1,0,1,1,1,1,-1,A
1988-10-08,1988,Everton,Southampton,4-1,4,1,1,1,5,3,H
1988-10-08,1988,Luton Town,Liverpool,1-0,1,0,1,1,1,1,H
1988-10-08,1988,Middlesbrough,West Ham United,1-0,1,0,1,1,1,1,H
1988-10-08,1988,Newcastle United,Coventry City,0-3,0,3,1,1,3,-3,A
1988-10-08,1988,Queens Park Rangers,Nottingham Forest,1-2,1,2,1,1,3,-1,A
1988-10-15,1988,Charlton Athletic,Aston Villa,2-2,2,2,1,1,4,0,D
1988-10-15,1988,Coventry City,Millwall,0-0,0,0,1,1,0,0,D
1988-10-15,1988,Queens Park Rangers,West Ham United,2-1,2,1,1,1,3,1,H
1988-10-22,1988,Arsenal,Queens Park Rangers,2-1,2,1,1,1,3,1,H
1988-10-22,1988,Aston Villa,Everton,2-0,2,0,1,1,2,2,H
1988-10-22,1988,Derby County,Charlton Athletic,0-0,0,0,1,1,0,0,D
1988-10-22,1988,Liverpool,Coventry City,0-0,0,0,1,1,0,0,D
1988-10-22,1988,Middlesbrough,Luton Town,2-1,2,1,1,1,3,1,H
1988-10-22,1988,Millwall,Nottingham Forest,2-2,2,2,1,1,4,0,D
1988-10-22,1988,Norwich City,Tottenham Hotspur,3-1,3,1,1,1,4,2,H
1988-10-22,1988,Southampton,Sheffield Wednesday,1-2,1,2,1,1,3,-1,A
1988-10-22,1988,West Ham United,Newcastle United,2-0,2,0,1,1,2,2,H
1988-10-22,1988,Wimbledon,Manchester United,1-1,1,1,1,1,2,0,D
1988-10-25,1988,Luton Town,Arsenal,1-1,1,1,1,1,2,0,D
1988-10-25,1988,Tottenham Hotspur,Southampton,1-2,1,2,1,1,3,-1,A
1988-10-26,1988,Manchester United,Norwich City,1-2,1,2,1,1,3,-1,A
1988-10-26,1988,Newcastle United,Middlesbrough,3-0,3,0,1,1,3,3,H
1988-10-26,1988,Nottingham Forest,Liverpool,2-1,2,1,1,1,3,1,H
1988-10-29,1988,Arsenal,Coventry City,2-0,2,0,1,1,2,2,H
1988-10-29,1988,Aston Villa,Tottenham Hotspur,2-1,2,1,1,1,3,1,H
1988-10-29,1988,Charlton Athletic,Sheffield Wednesday,2-1,2,1,1,1,3,1,H
1988-10-29,1988,Derby County,Wimbledon,4-1,4,1,1,1,5,3,H
1988-10-29,1988,Luton Town,Queens Park Rangers,0-0,0,0,1,1,0,0,D
1988-10-29,1988,Middlesbrough,Millwall,4-2,4,2,1,1,6,2,H
1988-10-29,1988,Newcastle United,Nottingham Forest,0-1,0,1,1,1,1,-1,A
1988-10-29,1988,Norwich City,Southampton,1-1,1,1,1,1,2,0,D
1988-10-29,1988,West Ham United,Liverpool,0-2,0,2,1,1,2,-2,A
1988-10-30,1988,Everton,Manchester United,1-1,1,1,1,1,2,0,D
1988-11-05,1988,Coventry City,West Ham United,1-1,1,1,1,1,2,0,D
1988-11-05,1988,Liverpool,Middlesbrough,3-0,3,0,1,1,3,3,H
1988-11-05,1988,Manchester United,Aston Villa,1-1,1,1,1,1,2,0,D
1988-11-05,1988,Millwall,Luton Town,3-1,3,1,1,1,4,2,H
1988-11-05,1988,Queens Park Rangers,Newcastle United,3-0,3,0,1,1,3,3,H
1988-11-05,1988,Sheffield Wednesday,Everton,1-1,1,1,1,1,2,0,D
1988-11-05,1988,Southampton,Charlton Athletic,2-0,2,0,1,1,2,2,H
1988-11-05,1988,Tottenham Hotspur,Derby County,1-3,1,3,1,1,4,-2,A
1988-11-05,1988,Wimbledon,Norwich City,0-2,0,2,1,1,2,-2,A
1988-11-06,1988,Nottingham Forest,Arsenal,1-4,1,4,1,1,5,-3,A
1988-11-12,1988,Charlton Athletic,Everton,1-2,1,2,1,1,3,-1,A
1988-11-12,1988,Coventry City,Luton Town,1-0,1,0,1,1,1,1,H
1988-11-12,1988,Derby County,Manchester United,2-2,2,2,1,1,4,0,D
1988-11-12,1988,Liverpool,Millwall,1-1,1,1,1,1,2,0,D
1988-11-12,1988,Middlesbrough,Queens Park Rangers,1-0,1,0,1,1,1,1,H
1988-11-12,1988,Newcastle United,Arsenal,0-1,0,1,1,1,1,-1,A
1988-11-12,1988,Norwich City,Sheffield Wednesday,1-1,1,1,1,1,2,0,D
1988-11-12,1988,Southampton,Aston Villa,3-1,3,1,1,1,4,2,H
1988-11-12,1988,Tottenham Hotspur,Wimbledon,3-2,3,2,1,1,5,1,H
1988-11-12,1988,West Ham United,Nottingham Forest,3-3,3,3,1,1,6,0,D
1988-11-19,1988,Arsenal,Middlesbrough,3-0,3,0,1,1,3,3,H
1988-11-19,1988,Aston Villa,Derby County,1-2,1,2,1,1,3,-1,A
1988-11-19,1988,Everton,Norwich City,1-1,1,1,1,1,2,0,D
1988-11-19,1988,Luton Town,West Ham United,4-1,4,1,1,1,5,3,H
1988-11-19,1988,Manchester United,Southampton,2-2,2,2,1,1,4,0,D
1988-11-19,1988,Millwall,Newcastle United,4-0,4,0,1,1,4,4,H
1988-11-19,1988,Nottingham Forest,Coventry City,0-0,0,0,1,1,0,0,D
1988-11-19,1988,Queens Park Rangers,Liverpool,0-1,0,1,1,1,1,-1,A
1988-11-19,1988,Wimbledon,Charlton Athletic,1-1,1,1,1,1,2,0,D
1988-11-20,1988,Sheffield Wednesday,Tottenham Hotspur,0-2,0,2,1,1,2,-2,A
1988-11-23,1988,Manchester United,Sheffield Wednesday,1-1,1,1,1,1,2,0,D
1988-11-23,1988,Tottenham Hotspur,Coventry City,1-1,1,1,1,1,2,0,D
1988-11-26,1988,Charlton Athletic,Nottingham Forest,0-1,0,1,1,1,1,-1,A
1988-11-26,1988,Coventry City,Aston Villa,2-1,2,1,1,1,3,1,H
1988-11-26,1988,Derby County,Arsenal,2-1,2,1,1,1,3,1,H
1988-11-26,1988,Liverpool,Wimbledon,1-1,1,1,1,1,2,0,D
1988-11-26,1988,Middlesbrough,Sheffield Wednesday,0-1,0,1,1,1,1,-1,A
1988-11-26,1988,Norwich City,Luton Town,2-2,2,2,1,1,4,0,D
1988-11-26,1988,Southampton,Millwall,2-2,2,2,1,1,4,0,D
1988-11-26,1988,Tottenham Hotspur,Queens Park Rangers,2-2,2,2,1,1,4,0,D
1988-11-26,1988,West Ham United,Everton,0-1,0,1,1,1,1,-1,A
1988-11-27,1988,Newcastle United,Manchester United,0-0,0,0,1,1,0,0,D
1988-12-03,1988,Aston Villa,Norwich City,3-1,3,1,1,1,4,2,H
1988-12-03,1988,Everton,Tottenham Hotspur,1-0,1,0,1,1,1,1,H
1988-12-03,1988,Luton Town,Newcastle United,0-0,0,0,1,1,0,0,D
1988-12-03,1988,Manchester United,Charlton Athletic,3-0,3,0,1,1,3,3,H
1988-12-03,1988,Millwall,West Ham United,0-1,0,1,1,1,1,-1,A
1988-12-03,1988,Nottingham Forest,Middlesbrough,2-2,2,2,1,1,4,0,D
1988-12-03,1988,Queens Park Rangers,Coventry City,2-1,2,1,1,1,3,1,H
1988-12-03,1988,Sheffield Wednesday,Derby County,1-1,1,1,1,1,2,0,D
1988-12-03,1988,Wimbledon,Southampton,2-1,2,1,1,1,3,1,H
1988-12-04,1988,Arsenal,Liverpool,1-1,1,1,1,1,2,0,D
1988-12-10,1988,Charlton Athletic,Queens Park Rangers,1-1,1,1,1,1,2,0,D
1988-12-10,1988,Coventry City,Manchester United,1-0,1,0,1,1,1,1,H
1988-12-10,1988,Derby County,Luton Town,0-1,0,1,1,1,1,-1,A
1988-12-10,1988,Middlesbrough,Aston Villa,3-3,3,3,1,1,6,0,D
1988-12-10,1988,Newcastle United,Wimbledon,2-1,2,1,1,1,3,1,H
1988-12-10,1988,Norwich City,Arsenal,0-0,0,0,1,1,0,0,D
1988-12-10,1988,Southampton,Nottingham Forest,1-1,1,1,1,1,2,0,D
1988-12-10,1988,Tottenham Hotspur,Millwall,2-0,2,0,1,1,2,2,H
1988-12-10,1988,West Ham United,Sheffield Wednesday,0-0,0,0,1,1,0,0,D
1988-12-11,1988,Liverpool,Everton,1-1,1,1,1,1,2,0,D
1988-12-17,1988,Arsenal,Manchester United,2-1,2,1,1,1,3,1,H
1988-12-17,1988,Coventry City,Derby County,0-2,0,2,1,1,2,-2,A
1988-12-17,1988,Liverpool,Norwich City,0-1,0,1,1,1,1,-1,A
1988-12-17,1988,Luton Town,Aston Villa,1-1,1,1,1,1,2,0,D
1988-12-17,1988,Middlesbrough,Charlton Athletic,0-0,0,0,1,1,0,0,D
1988-12-17,1988,Millwall,Sheffield Wednesday,1-0,1,0,1,1,1,1,H
1988-12-17,1988,Newcastle United,Southampton,3-3,3,3,1,1,6,0,D
1988-12-17,1988,Queens Park Rangers,Everton,0-0,0,0,1,1,0,0,D
1988-12-17,1988,West Ham United,Tottenham Hotspur,0-2,0,2,1,1,2,-2,A
1988-12-18,1988,Nottingham Forest,Wimbledon,0-1,0,1,1,1,1,-1,A
1988-12-26,1988,Aston Villa,Queens Park Rangers,2-1,2,1,1,1,3,1,H
1988-12-26,1988,Charlton Athletic,Arsenal,2-3,2,3,1,1,5,-1,A
1988-12-26,1988,Derby County,Liverpool,0-1,0,1,1,1,1,-1,A
1988-12-26,1988,Everton,Middlesbrough,2-1,2,1,1,1,3,1,H
1988-12-26,1988,Manchester United,Nottingham Forest,2-0,2,0,1,1,2,2,H
1988-12-26,1988,Sheffield Wednesday,Newcastle United,1-2,1,2,1,1,3,-1,A
1988-12-26,1988,Southampton,Coventry City,2-2,2,2,1,1,4,0,D
1988-12-26,1988,Tottenham Hotspur,Luton Town,0-0,0,0,1,1,0,0,D
1988-12-26,1988,Wimbledon,Millwall,1-0,1,0,1,1,1,1,H
1988-12-27,1988,Norwich City,West Ham United,2-1,2,1,1,1,3,1,H
1988-12-31,1988,Aston Villa,Arsenal,0-3,0,3,1,1,3,-3,A
1988-12-31,1988,Charlton Athletic,West Ham United,0-0,0,0,1,1,0,0,D
1988-12-31,1988,Derby County,Millwall,0-1,0,1,1,1,1,-1,A
1988-12-31,1988,Everton,Coventry City,3-1,3,1,1,1,4,2,H
1988-12-31,1988,Norwich City,Middlesbrough,0-0,0,0,1,1,0,0,D
1988-12-31,1988,Sheffield Wednesday,Nottingham Forest,0-3,0,3,1,1,3,-3,A
1988-12-31,1988,Southampton,Queens Park Rangers,1-4,1,4,1,1,5,-3,A
1988-12-31,1988,Tottenham Hotspur,Newcastle United,2-0,2,0,1,1,2,2,H
1988-12-31,1988,Wimbledon,Luton Town,4-0,4,0,1,1,4,4,H
1989-01-01,1988,Manchester United,Liverpool,3-1,3,1,1,1,4,2,H
1989-01-02,1988,Arsenal,Tottenham Hotspur,2-0,2,0,1,1,2,2,H
1989-01-02,1988,Coventry City,Sheffield Wednesday,5-0,5,0,1,1,5,5,H
1989-01-02,1988,Luton Town,Southampton,6-1,6,1,1,1,7,5,H
1989-01-02,1988,Middlesbrough,Manchester United,1-0,1,0,1,1,1,1,H
1989-01-02,1988,Millwall,Charlton Athletic,1-0,1,0,1,1,1,1,H
1989-01-02,1988,Newcastle United,Derby County,0-1,0,1,1,1,1,-1,A
1989-01-02,1988,Nottingham Forest,Everton,2-0,2,0,1,1,2,2,H
1989-01-02,1988,Queens Park Rangers,Norwich City,1-1,1,1,1,1,2,0,D
1989-01-02,1988,West Ham United,Wimbledon,1-2,1,2,1,1,3,-1,A
1989-01-03,1988,Liverpool,Aston Villa,1-0,1,0,1,1,1,1,H
1989-01-14,1988,Aston Villa,Newcastle United,3-1,3,1,1,1,4,2,H
1989-01-14,1988,Charlton Athletic,Luton Town,3-0,3,0,1,1,3,3,H
1989-01-14,1988,Derby County,West Ham United,1-2,1,2,1,1,3,-1,A
1989-01-14,1988,Everton,Arsenal,1-3,1,3,1,1,4,-2,A
1989-01-14,1988,Manchester United,Millwall,3-0,3,0,1,1,3,3,H
1989-01-14,1988,Norwich City,Coventry City,1-2,1,2,1,1,3,-1,A
1989-01-14,1988,Sheffield Wednesday,Liverpool,2-2,2,2,1,1,4,0,D
1989-01-14,1988,Southampton,Middlesbrough,1-3,1,3,1,1,4,-2,A
1989-01-14,1988,Wimbledon,Queens Park Rangers,1-0,1,0,1,1,1,1,H
1989-01-15,1988,Tottenham Hotspur,Nottingham Forest,1-2,1,2,1,1,3,-1,A
1989-01-21,1988,Arsenal,Sheffield Wednesday,1-1,1,1,1,1,2,0,D
1989-01-21,1988,Coventry City,Wimbledon,2-1,2,1,1,1,3,1,H
1989-01-21,1988,Liverpool,Southampton,2-0,2,0,1,1,2,2,H
1989-01-21,1988,Luton Town,Everton,1-0,1,0,1,1,1,1,H
1989-01-21,1988,Middlesbrough,Tottenham Hotspur,2-2,2,2,1,1,4,0,D
1989-01-21,1988,Newcastle United,Charlton Athletic,0-2,0,2,1,1,2,-2,A
1989-01-21,1988,Nottingham Forest,Aston Villa,4-0,4,0,1,1,4,4,H
1989-01-21,1988,Queens Park Rangers,Derby County,0-1,0,1,1,1,1,-1,A
1989-01-21,1988,West Ham United,Manchester United,1-3,1,3,1,1,4,-2,A
1989-01-22,1988,Millwall,Norwich City,2-3,2,3,1,1,5,-1,A
1989-02-04,1988,Arsenal,West Ham United,2-1,2,1,1,1,3,1,H
1989-02-04,1988,Aston Villa,Sheffield Wednesday,2-0,2,0,1,1,2,2,H
1989-02-04,1988,Charlton Athletic,Norwich City,1-2,1,2,1,1,3,-1,A
1989-02-04,1988,Derby County,Southampton,3-1,3,1,1,1,4,2,H
1989-02-04,1988,Everton,Wimbledon,1-1,1,1,1,1,2,0,D
1989-02-04,1988,Luton Town,Nottingham Forest,2-3,2,3,1,1,5,-1,A
1989-02-04,1988,Middlesbrough,Coventry City,1-1,1,1,1,1,2,0,D
1989-02-04,1988,Newcastle United,Liverpool,2-2,2,2,1,1,4,0,D
1989-02-04,1988,Queens Park Rangers,Millwall,1-2,1,2,1,1,3,-1,A
1989-02-05,1988,Manchester United,Tottenham Hotspur,1-0,1,0,1,1,1,1,H
1989-02-11,1988,Coventry City,Newcastle United,1-2,1,2,1,1,3,-1,A
1989-02-11,1988,Millwall,Arsenal,1-2,1,2,1,1,3,-1,A
1989-02-11,1988,Norwich City,Derby County,1-0,1,0,1,1,1,1,H
1989-02-11,1988,Nottingham Forest,Queens Park Rangers,0-0,0,0,1,1,0,0,D
1989-02-11,1988,Sheffield Wednesday,Manchester United,0-2,0,2,1,1,2,-2,A
1989-02-11,1988,Southampton,Everton,1-1,1,1,1,1,2,0,D
1989-02-11,1988,Tottenham Hotspur,Charlton Athletic,1-1,1,1,1,1,2,0,D
1989-02-11,1988,Wimbledon,Aston Villa,1-0,1,0,1,1,1,1,H
1989-02-14,1988,Everton,Aston Villa,1-1,1,1,1,1,2,0,D
1989-02-18,1988,Luton Town,Middlesbrough,1-0,1,0,1,1,1,1,H
1989-02-18,1988,Queens Park Rangers,Arsenal,0-0,0,0,1,1,0,0,D
1989-02-18,1988,Sheffield Wednesday,Southampton,1-1,1,1,1,1,2,0,D
1989-02-21,1988,Coventry City,Arsenal,1-0,1,0,1,1,1,1,H
1989-02-21,1988,Millwall,Middlesbrough,2-0,2,0,1,1,2,2,H
1989-02-21,1988,Tottenham Hotspur,Norwich City,2-1,2,1,1,1,3,1,H
1989-02-25,1988,Arsenal,Luton Town,2-0,2,0,1,1,2,2,H
1989-02-25,1988,Aston Villa,Charlton Athletic,1-2,1,2,1,1,3,-1,A
1989-02-25,1988,Derby County,Everton,3-2,3,2,1,1,5,1,H
1989-02-25,1988,Millwall,Coventry City,1-0,1,0,1,1,1,1,H
1989-02-25,1988,Norwich City,Manchester United,2-1,2,1,1,1,3,1,H
1989-02-25,1988,Southampton,Tottenham Hotspur,0-2,0,2,1,1,2,-2,A
1989-02-25,1988,West Ham United,Queens Park Rangers,0-0,0,0,1,1,0,0,D
1989-02-25,1988,Wimbledon,Sheffield Wednesday,1-0,1,0,1,1,1,1,H
1989-02-26,1988,Middlesbrough,Newcastle United,1-1,1,1,1,1,2,0,D
1989-02-28,1988,Arsenal,Millwall,0-0,0,0,1,1,0,0,D
1989-03-01,1988,Liverpool,Charlton Athletic,2-0,2,0,1,1,2,2,H
1989-03-01,1988,Tottenham Hotspur,Aston Villa,2-0,2,0,1,1,2,2,H
1989-03-01,1988,Wimbledon,Derby County,4-0,4,0,1,1,4,4,H
1989-03-04,1988,Sheffield Wednesday,Charlton Athletic,3-1,3,1,1,1,4,2,H
1989-03-11,1988,Arsenal,Nottingham Forest,1-3,1,3,1,1,4,-2,A
1989-03-11,1988,Charlton Athletic,Southampton,2-2,2,2,1,1,4,0,D
1989-03-11,1988,Derby County,Tottenham Hotspur,1-1,1,1,1,1,2,0,D
1989-03-11,1988,Everton,Sheffield Wednesday,1-0,1,0,1,1,1,1,H
1989-03-11,1988,Luton Town,Millwall,1-2,1,2,1,1,3,-1,A
1989-03-11,1988,Middlesbrough,Liverpool,0-4,0,4,1,1,4,-4,A
1989-03-11,1988,Newcastle United,Queens Park Rangers,1-2,1,2,1,1,3,-1,A
1989-03-11,1988,Norwich City,Wimbledon,1-0,1,0,1,1,1,1,H
1989-03-11,1988,West Ham United,Coventry City,1-1,1,1,1,1,2,0,D
1989-03-12,1988,Aston Villa,Manchester United,0-0,0,0,1,1,0,0,D
1989-03-14,1988,Liverpool,Luton Town,5-0,5,0,1,1,5,5,H
1989-03-15,1988,Nottingham Forest,Newcastle United,1-1,1,1,1,1,2,0,D
1989-03-18,1988,Coventry City,Tottenham Hotspur,1-1,1,1,1,1,2,0,D
1989-03-18,1988,Luton Town,Sheffield Wednesday,0-1,0,1,1,1,1,-1,A
1989-03-18,1988,Middlesbrough,Derby County,0-1,0,1,1,1,1,-1,A
1989-03-18,1988,Millwall,Aston Villa,2-0,2,0,1,1,2,2,H
1989-03-21,1988,Arsenal,Charlton Athletic,2-2,2,2,1,1,4,0,D
1989-03-21,1988,Queens Park Rangers,Luton Town,1-1,1,1,1,1,2,0,D
1989-03-22,1988,Coventry City,Liverpool,1-3,1,3,1,1,4,-2,A
1989-03-22,1988,Newcastle United,Everton,2-0,2,0,1,1,2,2,H
1989-03-22,1988,Nottingham Forest,Tottenham Hotspur,1-2,1,2,1,1,3,-1,A
1989-03-25,1988,Aston Villa,West Ham United,0-1,0,1,1,1,1,-1,A
1989-03-25,1988,Charlton Athletic,Coventry City,0-0,0,0,1,1,0,0,D
1989-03-25,1988,Derby County,Nottingham Forest,0-2,0,2,1,1,2,-2,A
1989-03-25,1988,Everton,Millwall,1-1,1,1,1,1,2,0,D
1989-03-25,1988,Manchester United,Luton Town,2-0,2,0,1,1,2,2,H
1989-03-25,1988,Norwich City,Newcastle United,0-2,0,2,1,1,2,-2,A
1989-03-25,1988,Sheffield Wednesday,Queens Park Rangers,0-2,0,2,1,1,2,-2,A
1989-03-25,1988,Southampton,Arsenal,1-3,1,3,1,1,4,-2,A
1989-03-25,1988,Wimbledon,Middlesbrough,1-1,1,1,1,1,2,0,D
1989-03-26,1988,Tottenham Hotspur,Liverpool,1-2,1,2,1,1,3,-1,A
1989-03-27,1988,Coventry City,Southampton,2-1,2,1,1,1,3,1,H
1989-03-27,1988,Middlesbrough,Everton,3-3,3,3,1,1,6,0,D
1989-03-27,1988,Millwall,Wimbledon,0-1,0,1,1,1,1,-1,A
1989-03-27,1988,Newcastle United,Sheffield Wednesday,1-3,1,3,1,1,4,-2,A
1989-03-27,1988,Nottingham Forest,Manchester United,2-0,2,0,1,1,2,2,H
1989-03-27,1988,Queens Park Rangers,Aston Villa,1-0,1,0,1,1,1,1,H
1989-03-27,1988,West Ham United,Norwich City,0-2,0,2,1,1,2,-2,A
1989-03-28,1988,Luton Town,Tottenham Hotspur,1-3,1,3,1,1,4,-2,A
1989-03-29,1988,Liverpool,Derby County,1-0,1,0,1,1,1,1,H
1989-04-01,1988,Aston Villa,Luton Town,2-1,2,1,1,1,3,1,H
1989-04-01,1988,Charlton Athletic,Middlesbrough,2-0,2,0,1,1,2,2,H
1989-04-01,1988,Derby County,Coventry City,1-0,1,0,1,1,1,1,H
1989-04-01,1988,Everton,Queens Park Rangers,4-1,4,1,1,1,5,3,H
1989-04-01,1988,Norwich City,Liverpool,0-1,0,1,1,1,1,-1,A
1989-04-01,1988,Sheffield Wednesday,Millwall,3-0,3,0,1,1,3,3,H
1989-04-01,1988,Southampton,Newcastle United,1-0,1,0,1,1,1,1,H
1989-04-01,1988,Tottenham Hotspur,West Ham United,3-0,3,0,1,1,3,3,H
1989-04-01,1988,Wimbledon,Nottingham Forest,4-1,4,1,1,1,5,3,H
1989-04-02,1988,Manchester United,Arsenal,1-1,1,1,1,1,2,0,D
1989-04-05,1988,Nottingham Forest,Norwich City,2-0,2,0,1,1,2,2,H
1989-04-05,1988,Sheffield Wednesday,Wimbledon,1-1,1,1,1,1,2,0,D
1989-04-08,1988,Arsenal,Everton,2-0,2,0,1,1,2,2,H
1989-04-08,1988,Coventry City,Norwich City,2-1,2,1,1,1,3,1,H
1989-04-08,1988,Liverpool,Sheffield Wednesday,5-1,5,1,1,1,6,4,H
1989-04-08,1988,Middlesbrough,Southampton,3-3,3,3,1,1,6,0,D
1989-04-08,1988,Millwall,Manchester United,0-0,0,0,1,1,0,0,D
1989-04-08,1988,Newcastle United,Aston Villa,1-2,1,2,1,1,3,-1,A
1989-04-08,1988,Queens Park Rangers,Wimbledon,4-3,4,3,1,1,7,1,H
1989-04-08,1988,West Ham United,Derby County,1-1,1,1,1,1,2,0,D
1989-04-10,1988,Everton,Charlton Athletic,3-2,3,2,1,1,5,1,H
1989-04-11,1988,Millwall,Liverpool,1-2,1,2,1,1,3,-1,A
1989-04-11,1988,West Ham United,Middlesbrough,1-2,1,2,1,1,3,-1,A
1989-04-12,1988,Nottingham Forest,Southampton,3-0,3,0,1,1,3,3,H
1989-04-12,1988,Tottenham Hotspur,Sheffield Wednesday,0-0,0,0,1,1,0,0,D
1989-04-15,1988,Arsenal,Newcastle United,1-0,1,0,1,1,1,1,H
1989-04-15,1988,Luton Town,Coventry City,2-2,2,2,1,1,4,0,D
1989-04-15,1988,Manchester United,Derby County,0-2,0,2,1,1,2,-2,A
1989-04-15,1988,Queens Park Rangers,Middlesbrough,0-0,0,0,1,1,0,0,D
1989-04-15,1988,West Ham United,Southampton,1-2,1,2,1,1,3,-1,A
1989-04-15,1988,Wimbledon,Tottenham Hotspur,1-2,1,2,1,1,3,-1,A
1989-04-19,1988,Southampton,Norwich City,0-0,0,0,1,1,0,0,D
1989-04-22,1988,Charlton Athletic,Manchester United,1-0,1,0,1,1,1,1,H
1989-04-22,1988,Coventry City,Queens Park Rangers,0-3,0,3,1,1,3,-3,A
1989-04-22,1988,Derby County,Sheffield Wednesday,1-0,1,0,1,1,1,1,H
1989-04-22,1988,Middlesbrough,Nottingham Forest,3-4,3,4,1,1,7,-1,A
1989-04-22,1988,Newcastle United,Luton Town,0-0,0,0,1,1,0,0,D
1989-04-22,1988,Norwich City,Aston Villa,2-2,2,2,1,1,4,0,D
1989-04-22,1988,Southampton,Wimbledon,0-0,0,0,1,1,0,0,D
1989-04-22,1988,Tottenham Hotspur,Everton,2-1,2,1,1,1,3,1,H
1989-04-22,1988,West Ham United,Millwall,3-0,3,0,1,1,3,3,H
1989-04-29,1988,Aston Villa,Middlesbrough,1-1,1,1,1,1,2,0,D
1989-04-29,1988,Luton Town,Derby County,3-0,3,0,1,1,3,3,H
1989-04-29,1988,Manchester United,Coventry City,0-1,0,1,1,1,1,-1,A
1989-04-29,1988,Millwall,Tottenham Hotspur,0-5,0,5,1,1,5,-5,A
1989-04-29,1988,Queens Park Rangers,Charlton Athletic,1-0,1,0,1,1,1,1,H
1989-04-29,1988,Wimbledon,Newcastle United,4-0,4,0,1,1,4,4,H
1989-05-01,1988,Arsenal,Norwich City,5-0,5,0,1,1,5,5,H
1989-05-02,1988,Aston Villa,Southampton,1-2,1,2,1,1,3,-1,A
1989-05-02,1988,Luton Town,Charlton Athletic,5-2,5,2,1,1,7,3,H
1989-05-02,1988,Manchester United,Wimbledon,1-0,1,0,1,1,1,1,H
1989-05-03,1988,Everton,Liverpool,0-0,0,0,1,1,0,0,D
1989-05-03,1988,Newcastle United,West Ham United,1-2,1,2,1,1,3,-1,A
1989-05-03,1988,Nottingham Forest,Millwall,4-1,4,1,1,1,5,3,H
1989-05-06,1988,Charlton Athletic,Wimbledon,1-0,1,0,1,1,1,1,H
1989-05-06,1988,Derby County,Aston Villa,2-1,2,1,1,1,3,1,H
1989-05-06,1988,Middlesbrough,Arsenal,0-1,0,1,1,1,1,-1,A
1989-05-06,1988,Newcastle United,Millwall,1-1,1,1,1,1,2,0,D
1989-05-06,1988,Norwich City,Everton,1-0,1,0,1,1,1,1,H
1989-05-06,1988,Southampton,Manchester United,2-1,2,1,1,1,3,1,H
1989-05-06,1988,West Ham United,Luton Town,1-0,1,0,1,1,1,1,H
1989-05-08,1988,Queens Park Rangers,Manchester United,3-2,3,2,1,1,5,1,H
1989-05-09,1988,Sheffield Wednesday,West Ham United,0-2,0,2,1,1,2,-2,A
1989-05-10,1988,Charlton Athletic,Derby County,3-0,3,0,1,1,3,3,H
1989-05-10,1988,Liverpool,Nottingham Forest,1-0,1,0,1,1,1,1,H
1989-05-10,1988,Manchester United,Everton,1-2,1,2,1,1,3,-1,A
1989-05-13,1988,Arsenal,Derby County,1-2,1,2,1,1,3,-1,A
1989-05-13,1988,Aston Villa,Coventry City,1-1,1,1,1,1,2,0,D
1989-05-13,1988,Everton,West Ham United,3-1,3,1,1,1,4,2,H
1989-05-13,1988,Luton Town,Norwich City,1-0,1,0,1,1,1,1,H
1989-05-13,1988,Manchester United,Newcastle United,2-0,2,0,1,1,2,2,H
1989-05-13,1988,Millwall,Southampton,1-1,1,1,1,1,2,0,D
1989-05-13,1988,Nottingham Forest,Charlton Athletic,4-0,4,0,1,1,4,4,H
1989-05-13,1988,Queens Park Rangers,Tottenham Hotspur,1-0,1,0,1,1,1,1,H
1989-05-13,1988,Sheffield Wednesday,Middlesbrough,1-0,1,0,1,1,1,1,H
1989-05-13,1988,Wimbledon,Liverpool,1-2,1,2,1,1,3,-1,A
1989-05-15,1988,Coventry City,Nottingham Forest,2-2,2,2,1,1,4,0,D
1989-05-15,1988,Everton,Derby County,1-0,1,0,1,1,1,1,H
1989-05-16,1988,Liverpool,Queens Park Rangers,2-0,2,0,1,1,2,2,H
1989-05-17,1988,Arsenal,Wimbledon,2-2,2,2,1,1,4,0,D
1989-05-17,1988,Sheffield Wednesday,Norwich City,2-2,2,2,1,1,4,0,D
1989-05-18,1988,Nottingham Forest,West Ham United,1-2,1,2,1,1,3,-1,A
1989-05-23,1988,Liverpool,West Ham United,5-1,5,1,1,1,6,4,H
1989-05-26,1988,Liverpool,Arsenal,0-2,0,2,1,1,2,-2,A
1989-08-19,1989,Charlton Athletic,Derby County,0-0,0,0,1,1,0,0,D
1989-08-19,1989,Coventry City,Everton,2-0,2,0,1,1,2,2,H
1989-08-19,1989,Liverpool,Manchester City,3-1,3,1,1,1,4,2,H
1989-08-19,1989,Manchester United,Arsenal,4-1,4,1,1,1,5,3,H
1989-08-19,1989,Nottingham Forest,Aston Villa,1-1,1,1,1,1,2,0,D
1989-08-19,1989,Queens Park Rangers,Crystal Palace,2-0,2,0,1,1,2,2,H
1989-08-19,1989,Sheffield Wednesday,Norwich City,0-2,0,2,1,1,2,-2,A
1989-08-19,1989,Southampton,Millwall,1-2,1,2,1,1,3,-1,A
1989-08-19,1989,Tottenham Hotspur,Luton Town,2-1,2,1,1,1,3,1,H
1989-08-19,1989,Wimbledon,Chelsea,0-1,0,1,1,1,1,-1,A
1989-08-22,1989,Arsenal,Coventry City,2-0,2,0,1,1,2,2,H
1989-08-22,1989,Chelsea,Queens Park Rangers,1-1,1,1,1,1,2,0,D
1989-08-22,1989,Crystal Palace,Manchester United,1-1,1,1,1,1,2,0,D
1989-08-22,1989,Everton,Tottenham Hotspur,2-1,2,1,1,1,3,1,H
1989-08-22,1989,Luton Town,Sheffield Wednesday,2-0,2,0,1,1,2,2,H
1989-08-22,1989,Millwall,Charlton Athletic,2-2,2,2,1,1,4,0,D
1989-08-23,1989,Aston Villa,Liverpool,1-1,1,1,1,1,2,0,D
1989-08-23,1989,Derby County,Wimbledon,1-1,1,1,1,1,2,0,D
1989-08-23,1989,Manchester City,Southampton,1-2,1,2,1,1,3,-1,A
1989-08-23,1989,Norwich City,Nottingham Forest,1-1,1,1,1,1,2,0,D
1989-08-26,1989,Arsenal,Wimbledon,0-0,0,0,1,1,0,0,D
1989-08-26,1989,Aston Villa,Charlton Athletic,1-1,1,1,1,1,2,0,D
1989-08-26,1989,Chelsea,Sheffield Wednesday,4-0,4,0,1,1,4,4,H
1989-08-26,1989,Crystal Palace,Coventry City,0-1,0,1,1,1,1,-1,A
1989-08-26,1989,Derby County,Manchester United,2-0,2,0,1,1,2,2,H
1989-08-26,1989,Everton,Southampton,3-0,3,0,1,1,3,3,H
1989-08-26,1989,Luton Town,Liverpool,0-0,0,0,1,1,0,0,D
1989-08-26,1989,Manchester City,Tottenham Hotspur,1-1,1,1,1,1,2,0,D
1989-08-26,1989,Millwall,Nottingham Forest,1-0,1,0,1,1,1,1,H
1989-08-26,1989,Norwich City,Queens Park Rangers,0-0,0,0,1,1,0,0,D
1989-08-29,1989,Charlton Athletic,Chelsea,3-0,3,0,1,1,3,3,H
1989-08-29,1989,Southampton,Aston Villa,2-1,2,1,1,1,3,1,H
1989-08-29,1989,Wimbledon,Millwall,2-2,2,2,1,1,4,0,D
1989-08-30,1989,Coventry City,Manchester City,2-1,2,1,1,1,3,1,H
1989-08-30,1989,Manchester United,Norwich City,0-2,0,2,1,1,2,-2,A
1989-08-30,1989,Nottingham Forest,Derby County,2-1,2,1,1,1,3,1,H
1989-08-30,1989,Queens Park Rangers,Luton Town,0-0,0,0,1,1,0,0,D
1989-08-30,1989,Sheffield Wednesday,Everton,1-1,1,1,1,1,2,0,D
1989-09-09,1989,Arsenal,Sheffield Wednesday,5-0,5,0,1,1,5,5,H
1989-09-09,1989,Aston Villa,Tottenham Hotspur,2-0,2,0,1,1,2,2,H
1989-09-09,1989,Chelsea,Nottingham Forest,2-2,2,2,1,1,4,0,D
1989-09-09,1989,Crystal Palace,Wimbledon,2-0,2,0,1,1,2,2,H
1989-09-09,1989,Derby County,Liverpool,0-3,0,3,1,1,3,-3,A
1989-09-09,1989,Everton,Manchester United,3-2,3,2,1,1,5,1,H
1989-09-09,1989,Luton Town,Charlton Athletic,1-0,1,0,1,1,1,1,H
1989-09-09,1989,Manchester City,Queens Park Rangers,1-0,1,0,1,1,1,1,H
1989-09-09,1989,Millwall,Coventry City,4-1,4,1,1,1,5,3,H
1989-09-09,1989,Norwich City,Southampton,4-4,4,4,1,1,8,0,D
1989-09-12,1989,Liverpool,Crystal Palace,9-0,9,0,1,1,9,9,H
1989-09-16,1989,Charlton Athletic,Everton,0-1,0,1,1,1,1,-1,A
1989-09-16,1989,Coventry City,Luton Town,1-0,1,0,1,1,1,1,H
1989-09-16,1989,Liverpool,Norwich City,0-0,0,0,1,1,0,0,D
1989-09-16,1989,Manchester United,Millwall,5-1,5,1,1,1,6,4,H
1989-09-16,1989,Nottingham Forest,Arsenal,1-2,1,2,1,1,3,-1,A
1989-09-16,1989,Queens Park Rangers,Derby County,0-1,0,1,1,1,1,-1,A
1989-09-16,1989,Sheffield Wednesday,Aston Villa,1-0,1,0,1,1,1,1,H
1989-09-16,1989,Southampton,Crystal Palace,1-1,1,1,1,1,2,0,D
1989-09-16,1989,Tottenham Hotspur,Chelsea,1-4,1,4,1,1,5,-3,A
1989-09-16,1989,Wimbledon,Manchester City,1-0,1,0,1,1,1,1,H
1989-09-23,1989,Arsenal,Charlton Athletic,1-0,1,0,1,1,1,1,H
1989-09-23,1989,Aston Villa,Queens Park Rangers,1-3,1,3,1,1,4,-2,A
1989-09-23,1989,Chelsea,Coventry City,1-0,1,0,1,1,1,1,H
1989-09-23,1989,Crystal Palace,Nottingham Forest,1-0,1,0,1,1,1,1,H
1989-09-23,1989,Derby County,Southampton,0-1,0,1,1,1,1,-1,A
1989-09-23,1989,Everton,Liverpool,1-3,1,3,1,1,4,-2,A
1989-09-23,1989,Luton Town,Wimbledon,1-1,1,1,1,1,2,0,D
1989-09-23,1989,Manchester City,Manchester United,5-1,5,1,1,1,6,4,H
1989-09-23,1989,Millwall,Sheffield Wednesday,2-0,2,0,1,1,2,2,H
1989-09-23,1989,Norwich City,Tottenham Hotspur,2-2,2,2,1,1,4,0,D
1989-09-30,1989,Aston Villa,Derby County,1-0,1,0,1,1,1,1,H
1989-09-30,1989,Chelsea,Arsenal,0-0,0,0,1,1,0,0,D
1989-09-30,1989,Crystal Palace,Everton,2-1,2,1,1,1,3,1,H
1989-09-30,1989,Manchester City,Luton Town,3-1,3,1,1,1,4,2,H
1989-09-30,1989,Millwall,Norwich City,0-1,0,1,1,1,1,-1,A
1989-09-30,1989,Nottingham Forest,Charlton Athletic,2-0,2,0,1,1,2,2,H
1989-09-30,1989,Sheffield Wednesday,Coventry City,0-0,0,0,1,1,0,0,D
1989-09-30,1989,Southampton,Wimbledon,2-2,2,2,1,1,4,0,D
1989-09-30,1989,Tottenham Hotspur,Queens Park Rangers,3-2,3,2,1,1,5,1,H
1989-10-14,1989,Arsenal,Manchester City,4-0,4,0,1,1,4,4,H
1989-10-14,1989,Charlton Athletic,Tottenham Hotspur,1-3,1,3,1,1,4,-2,A
1989-10-14,1989,Coventry City,Nottingham Forest,0-2,0,2,1,1,2,-2,A
1989-10-14,1989,Derby County,Crystal Palace,3-1,3,1,1,1,4,2,H
1989-10-14,1989,Everton,Millwall,2-1,2,1,1,1,3,1,H
1989-10-14,1989,Luton Town,Aston Villa,0-1,0,1,1,1,1,-1,A
1989-10-14,1989,Manchester United,Sheffield Wednesday,0-0,0,0,1,1,0,0,D
1989-10-14,1989,Norwich City,Chelsea,2-0,2,0,1,1,2,2,H
1989-10-14,1989,Queens Park Rangers,Southampton,1-4,1,4,1,1,5,-3,A
1989-10-14,1989,Wimbledon,Liverpool,1-2,1,2,1,1,3,-1,A
1989-10-18,1989,Tottenham Hotspur,Arsenal,2-1,2,1,1,1,3,1,H
1989-10-21,1989,Coventry City,Manchester United,1-4,1,4,1,1,5,-3,A
1989-10-21,1989,Crystal Palace,Millwall,4-3,4,3,1,1,7,1,H
1989-10-21,1989,Derby County,Chelsea,0-1,0,1,1,1,1,-1,A
1989-10-21,1989,Everton,Arsenal,3-0,3,0,1,1,3,3,H
1989-10-21,1989,Luton Town,Norwich City,4-1,4,1,1,1,5,3,H
1989-10-21,1989,Queens Park Rangers,Charlton Athletic,0-1,0,1,1,1,1,-1,A
1989-10-21,1989,Southampton,Liverpool,4-1,4,1,1,1,5,3,H
1989-10-21,1989,Tottenham Hotspur,Sheffield Wednesday,3-0,3,0,1,1,3,3,H
1989-10-21,1989,Wimbledon,Nottingham Forest,1-3,1,3,1,1,4,-2,A
1989-10-22,1989,Manchester City,Aston Villa,0-2,0,2,1,1,2,-2,A
1989-10-28,1989,Arsenal,Derby County,1-1,1,1,1,1,2,0,D
1989-10-28,1989,Aston Villa,Crystal Palace,2-1,2,1,1,1,3,1,H
1989-10-28,1989,Charlton Athletic,Coventry City,1-1,1,1,1,1,2,0,D
1989-10-28,1989,Chelsea,Manchester City,1-1,1,1,1,1,2,0,D
1989-10-28,1989,Manchester United,Southampton,2-1,2,1,1,1,3,1,H
1989-10-28,1989,Millwall,Luton Town,1-1,1,1,1,1,2,0,D
1989-10-28,1989,Norwich City,Everton,1-1,1,1,1,1,2,0,D
1989-10-28,1989,Nottingham Forest,Queens Park Rangers,2-2,2,2,1,1,4,0,D
1989-10-28,1989,Sheffield Wednesday,Wimbledon,0-1,0,1,1,1,1,-1,A
1989-10-29,1989,Liverpool,Tottenham Hotspur,1-0,1,0,1,1,1,1,H
1989-11-04,1989,Arsenal,Norwich City,4-3,4,3,1,1,7,1,H
1989-11-04,1989,Charlton Athletic,Manchester United,2-0,2,0,1,1,2,2,H
1989-11-04,1989,Chelsea,Millwall,4-0,4,0,1,1,4,4,H
1989-11-04,1989,Liverpool,Coventry City,0-1,0,1,1,1,1,-1,A
1989-11-04,1989,Luton Town,Derby County,1-0,1,0,1,1,1,1,H
1989-11-04,1989,Manchester City,Crystal Palace,3-0,3,0,1,1,3,3,H
1989-11-04,1989,Nottingham Forest,Sheffield Wednesday,0-1,0,1,1,1,1,-1,A
1989-11-04,1989,Southampton,Tottenham Hotspur,1-1,1,1,1,1,2,0,D
1989-11-04,1989,Wimbledon,Queens Park Rangers,0-0,0,0,1,1,0,0,D
1989-11-05,1989,Aston Villa,Everton,6-2,6,2,1,1,8,4,H
1989-11-11,1989,Coventry City,Southampton,1-0,1,0,1,1,1,1,H
1989-11-11,1989,Crystal Palace,Luton Town,1-1,1,1,1,1,2,0,D
1989-11-11,1989,Derby County,Manchester City,6-0,6,0,1,1,6,6,H
1989-11-11,1989,Everton,Chelsea,0-1,0,1,1,1,1,-1,A
1989-11-11,1989,Millwall,Arsenal,1-2,1,2,1,1,3,-1,A
1989-11-11,1989,Norwich City,Aston Villa,2-0,2,0,1,1,2,2,H
1989-11-11,1989,Queens Park Rangers,Liverpool,3-2,3,2,1,1,5,1,H
1989-11-11,1989,Sheffield Wednesday,Charlton Athletic,3-0,3,0,1,1,3,3,H
1989-11-11,1989,Tottenham Hotspur,Wimbledon,0-1,0,1,1,1,1,-1,A
1989-11-12,1989,Manchester United,Nottingham Forest,1-0,1,0,1,1,1,1,H
1989-11-18,1989,Arsenal,Queens Park Rangers,3-0,3,0,1,1,3,3,H
1989-11-18,1989,Aston Villa,Coventry City,4-1,4,1,1,1,5,3,H
1989-11-18,1989,Chelsea,Southampton,2-2,2,2,1,1,4,0,D
1989-11-18,1989,Crystal Palace,Tottenham Hotspur,2-3,2,3,1,1,5,-1,A
1989-11-18,1989,Derby County,Sheffield Wednesday,2-0,2,0,1,1,2,2,H
1989-11-18,1989,Everton,Wimbledon,1-1,1,1,1,1,2,0,D
1989-11-18,1989,Luton Town,Manchester United,1-3,1,3,1,1,4,-2,A
1989-11-18,1989,Manchester City,Nottingham Forest,0-3,0,3,1,1,3,-3,A
1989-11-18,1989,Norwich City,Charlton Athletic,0-0,0,0,1,1,0,0,D
1989-11-19,1989,Millwall,Liverpool,1-2,1,2,1,1,3,-1,A
1989-11-25,1989,Charlton Athletic,Manchester City,1-1,1,1,1,1,2,0,D
1989-11-25,1989,Coventry City,Norwich City,1-0,1,0,1,1,1,1,H
1989-11-25,1989,Manchester United,Chelsea,0-0,0,0,1,1,0,0,D
1989-11-25,1989,Nottingham Forest,Everton,1-0,1,0,1,1,1,1,H
1989-11-25,1989,Queens Park Rangers,Millwall,0-0,0,0,1,1,0,0,D
1989-11-25,1989,Sheffield Wednesday,Crystal Palace,2-2,2,2,1,1,4,0,D
1989-11-25,1989,Southampton,Luton Town,6-3,6,3,1,1,9,3,H
1989-11-25,1989,Tottenham Hotspur,Derby County,1-2,1,2,1,1,3,-1,A
1989-11-25,1989,Wimbledon,Aston Villa,0-2,0,2,1,1,2,-2,A
1989-11-26,1989,Liverpool,Arsenal,2-1,2,1,1,1,3,1,H
1989-11-29,1989,Sheffield Wednesday,Liverpool,2-0,2,0,1,1,2,2,H
1989-12-02,1989,Aston Villa,Nottingham Forest,2-1,2,1,1,1,3,1,H
1989-12-02,1989,Chelsea,Wimbledon,2-5,2,5,1,1,7,-3,A
1989-12-02,1989,Crystal Palace,Queens Park Rangers,0-3,0,3,1,1,3,-3,A
1989-12-02,1989,Derby County,Charlton Athletic,2-0,2,0,1,1,2,2,H
1989-12-02,1989,Everton,Coventry City,2-0,2,0,1,1,2,2,H
1989-12-02,1989,Luton Town,Tottenham Hotspur,0-0,0,0,1,1,0,0,D
1989-12-02,1989,Manchester City,Liverpool,1-4,1,4,1,1,5,-3,A
1989-12-02,1989,Millwall,Southampton,2-2,2,2,1,1,4,0,D
1989-12-02,1989,Norwich City,Sheffield Wednesday,2-1,2,1,1,1,3,1,H
1989-12-03,1989,Arsenal,Manchester United,1-0,1,0,1,1,1,1,H
1989-12-09,1989,Charlton Athletic,Millwall,1-1,1,1,1,1,2,0,D
1989-12-09,1989,Coventry City,Arsenal,0-1,0,1,1,1,1,-1,A
1989-12-09,1989,Liverpool,Aston Villa,1-1,1,1,1,1,2,0,D
1989-12-09,1989,Manchester United,Crystal Palace,1-2,1,2,1,1,3,-1,A
1989-12-09,1989,Nottingham Forest,Norwich City,0-1,0,1,1,1,1,-1,A
1989-12-09,1989,Queens Park Rangers,Chelsea,4-2,4,2,1,1,6,2,H
1989-12-09,1989,Sheffield Wednesday,Luton Town,1-1,1,1,1,1,2,0,D
1989-12-09,1989,Southampton,Manchester City,2-1,2,1,1,1,3,1,H
1989-12-09,1989,Tottenham Hotspur,Everton,2-1,2,1,1,1,3,1,H
1989-12-09,1989,Wimbledon,Derby County,1-1,1,1,1,1,2,0,D
1989-12-16,1989,Arsenal,Luton Town,3-2,3,2,1,1,5,1,H
1989-12-16,1989,Charlton Athletic,Crystal Palace,1-2,1,2,1,1,3,-1,A
1989-12-16,1989,Chelsea,Liverpool,2-5,2,5,1,1,7,-3,A
1989-12-16,1989,Coventry City,Wimbledon,2-1,2,1,1,1,3,1,H
1989-12-16,1989,Manchester United,Tottenham Hotspur,0-1,0,1,1,1,1,-1,A
1989-12-16,1989,Millwall,Aston Villa,2-0,2,0,1,1,2,2,H
1989-12-16,1989,Norwich City,Derby County,1-0,1,0,1,1,1,1,H
1989-12-16,1989,Sheffield Wednesday,Queens Park Rangers,2-0,2,0,1,1,2,2,H
1989-12-17,1989,Everton,Manchester City,0-0,0,0,1,1,0,0,D
1989-12-17,1989,Nottingham Forest,Southampton,2-0,2,0,1,1,2,2,H
1989-12-23,1989,Liverpool,Manchester United,0-0,0,0,1,1,0,0,D
1989-12-26,1989,Aston Villa,Manchester United,3-0,3,0,1,1,3,3,H
1989-12-26,1989,Crystal Palace,Chelsea,2-2,2,2,1,1,4,0,D
1989-12-26,1989,Derby County,Everton,0-1,0,1,1,1,1,-1,A
1989-12-26,1989,Liverpool,Sheffield Wednesday,2-1,2,1,1,1,3,1,H
1989-12-26,1989,Luton Town,Nottingham Forest,1-1,1,1,1,1,2,0,D
1989-12-26,1989,Manchester City,Norwich City,1-0,1,0,1,1,1,1,H
1989-12-26,1989,Queens Park Rangers,Coventry City,1-1,1,1,1,1,2,0,D
1989-12-26,1989,Southampton,Arsenal,1-0,1,0,1,1,1,1,H
1989-12-26,1989,Tottenham Hotspur,Millwall,3-1,3,1,1,1,4,2,H
1989-12-26,1989,Wimbledon,Charlton Athletic,3-1,3,1,1,1,4,2,H
1989-12-30,1989,Aston Villa,Arsenal,2-1,2,1,1,1,3,1,H
1989-12-30,1989,Crystal Palace,Norwich City,1-0,1,0,1,1,1,1,H
1989-12-30,1989,Derby County,Coventry City,4-1,4,1,1,1,5,3,H
1989-12-30,1989,Liverpool,Charlton Athletic,1-0,1,0,1,1,1,1,H
1989-12-30,1989,Luton Town,Chelsea,0-3,0,3,1,1,3,-3,A
1989-12-30,1989,Manchester City,Millwall,2-0,2,0,1,1,2,2,H
1989-12-30,1989,Queens Park Rangers,Everton,1-0,1,0,1,1,1,1,H
1989-12-30,1989,Southampton,Sheffield Wednesday,2-2,2,2,1,1,4,0,D
1989-12-30,1989,Tottenham Hotspur,Nottingham Forest,2-3,2,3,1,1,5,-1,A
1989-12-30,1989,Wimbledon,Manchester United,2-2,2,2,1,1,4,0,D
1990-01-01,1989,Arsenal,Crystal Palace,4-1,4,1,1,1,5,3,H
1990-01-01,1989,Charlton Athletic,Southampton,2-4,2,4,1,1,6,-2,A
1990-01-01,1989,Chelsea,Aston Villa,0-3,0,3,1,1,3,-3,A
1990-01-01,1989,Coventry City,Tottenham Hotspur,0-0,0,0,1,1,0,0,D
1990-01-01,1989,Everton,Luton Town,2-1,2,1,1,1,3,1,H
1990-01-01,1989,Manchester United,Queens Park Rangers,0-0,0,0,1,1,0,0,D
1990-01-01,1989,Millwall,Derby County,1-1,1,1,1,1,2,0,D
1990-01-01,1989,Norwich City,Wimbledon,0-1,0,1,1,1,1,-1,A
1990-01-01,1989,Nottingham Forest,Liverpool,2-2,2,2,1,1,4,0,D
1990-01-01,1989,Sheffield Wednesday,Manchester City,2-0,2,0,1,1,2,2,H
1990-01-13,1989,Charlton Athletic,Aston Villa,0-2,0,2,1,1,2,-2,A
1990-01-13,1989,Coventry City,Crystal Palace,1-0,1,0,1,1,1,1,H
1990-01-13,1989,Liverpool,Luton Town,2-2,2,2,1,1,4,0,D
1990-01-13,1989,Manchester United,Derby County,1-2,1,2,1,1,3,-1,A
1990-01-13,1989,Nottingham Forest,Millwall,3-1,3,1,1,1,4,2,H
1990-01-13,1989,Queens Park Rangers,Norwich City,2-1,2,1,1,1,3,1,H
1990-01-13,1989,Southampton,Everton,2-2,2,2,1,1,4,0,D
1990-01-13,1989,Tottenham Hotspur,Manchester City,1-1,1,1,1,1,2,0,D
1990-01-13,1989,Wimbledon,Arsenal,1-0,1,0,1,1,1,1,H
1990-01-14,1989,Sheffield Wednesday,Chelsea,1-1,1,1,1,1,2,0,D
1990-01-20,1989,Arsenal,Tottenham Hotspur,1-0,1,0,1,1,1,1,H
1990-01-20,1989,Aston Villa,Southampton,2-1,2,1,1,1,3,1,H
1990-01-20,1989,Chelsea,Charlton Athletic,3-1,3,1,1,1,4,2,H
1990-01-20,1989,Crystal Palace,Liverpool,0-2,0,2,1,1,2,-2,A
1990-01-20,1989,Derby County,Nottingham Forest,0-2,0,2,1,1,2,-2,A
1990-01-20,1989,Everton,Sheffield Wednesday,2-0,2,0,1,1,2,2,H
1990-01-20,1989,Luton Town,Queens Park Rangers,1-1,1,1,1,1,2,0,D
1990-01-20,1989,Manchester City,Coventry City,1-0,1,0,1,1,1,1,H
1990-01-20,1989,Millwall,Wimbledon,0-0,0,0,1,1,0,0,D
1990-01-21,1989,Norwich City,Manchester United,2-0,2,0,1,1,2,2,H
1990-02-03,1989,Coventry City,Chelsea,3-2,3,2,1,1,5,1,H
1990-02-03,1989,Liverpool,Everton,2-1,2,1,1,1,3,1,H
1990-02-03,1989,Manchester United,Manchester City,1-1,1,1,1,1,2,0,D
1990-02-03,1989,Nottingham Forest,Crystal Palace,3-1,3,1,1,1,4,2,H
1990-02-03,1989,Sheffield Wednesday,Millwall,1-1,1,1,1,1,2,0,D
1990-02-04,1989,Tottenham Hotspur,Norwich City,4-0,4,0,1,1,4,4,H
1990-02-10,1989,Aston Villa,Sheffield Wednesday,1-0,1,0,1,1,1,1,H
1990-02-10,1989,Chelsea,Tottenham Hotspur,1-2,1,2,1,1,3,-1,A
1990-02-10,1989,Crystal Palace,Southampton,3-1,3,1,1,1,4,2,H
1990-02-10,1989,Derby County,Queens Park Rangers,2-0,2,0,1,1,2,2,H
1990-02-10,1989,Everton,Charlton Athletic,2-1,2,1,1,1,3,1,H
1990-02-10,1989,Manchester City,Wimbledon,1-1,1,1,1,1,2,0,D
1990-02-10,1989,Millwall,Manchester United,1-2,1,2,1,1,3,-1,A
1990-02-10,1989,Norwich City,Liverpool,0-0,0,0,1,1,0,0,D
1990-02-14,1989,Wimbledon,Luton Town,1-2,1,2,1,1,3,-1,A
1990-02-17,1989,Coventry City,Millwall,3-1,3,1,1,1,4,2,H
1990-02-17,1989,Nottingham Forest,Chelsea,1-1,1,1,1,1,2,0,D
1990-02-17,1989,Sheffield Wednesday,Arsenal,1-0,1,0,1,1,1,1,H
1990-02-19,1989,Charlton Athletic,Luton Town,2-0,2,0,1,1,2,2,H
1990-02-21,1989,Tottenham Hotspur,Aston Villa,0-2,0,2,1,1,2,-2,A
1990-02-24,1989,Aston Villa,Wimbledon,0-3,0,3,1,1,3,-3,A
1990-02-24,1989,Chelsea,Manchester United,1-0,1,0,1,1,1,1,H
1990-02-24,1989,Crystal Palace,Sheffield Wednesday,1-1,1,1,1,1,2,0,D
1990-02-24,1989,Derby County,Tottenham Hotspur,2-1,2,1,1,1,3,1,H
1990-02-24,1989,Luton Town,Southampton,1-1,1,1,1,1,2,0,D
1990-02-24,1989,Manchester City,Charlton Athletic,1-2,1,2,1,1,3,-1,A
1990-02-24,1989,Millwall,Queens Park Rangers,1-2,1,2,1,1,3,-1,A
1990-02-27,1989,Charlton Athletic,Arsenal,0-0,0,0,1,1,0,0,D
1990-02-27,1989,Southampton,Norwich City,4-1,4,1,1,1,5,3,H
1990-03-03,1989,Charlton Athletic,Norwich City,0-1,0,1,1,1,1,-1,A
1990-03-03,1989,Liverpool,Millwall,1-0,1,0,1,1,1,1,H
1990-03-03,1989,Manchester United,Luton Town,4-1,4,1,1,1,5,3,H
1990-03-03,1989,Nottingham Forest,Manchester City,1-0,1,0,1,1,1,1,H
1990-03-03,1989,Queens Park Rangers,Arsenal,2-0,2,0,1,1,2,2,H
1990-03-03,1989,Sheffield Wednesday,Derby County,1-0,1,0,1,1,1,1,H
1990-03-03,1989,Southampton,Chelsea,2-3,2,3,1,1,5,-1,A
1990-03-03,1989,Tottenham Hotspur,Crystal Palace,0-1,0,1,1,1,1,-1,A
1990-03-03,1989,Wimbledon,Everton,3-1,3,1,1,1,4,2,H
1990-03-04,1989,Coventry City,Aston Villa,2-0,2,0,1,1,2,2,H
1990-03-07,1989,Arsenal,Nottingham Forest,3-0,3,0,1,1,3,3,H
1990-03-07,1989,Luton Town,Coventry City,3-2,3,2,1,1,5,1,H
1990-03-10,1989,Aston Villa,Luton Town,2-0,2,0,1,1,2,2,H
1990-03-10,1989,Chelsea,Norwich City,0-0,0,0,1,1,0,0,D
1990-03-10,1989,Manchester City,Arsenal,1-1,1,1,1,1,2,0,D
1990-03-10,1989,Nottingham Forest,Coventry City,2-4,2,4,1,1,6,-2,A
1990-03-10,1989,Southampton,Derby County,2-1,2,1,1,1,3,1,H
1990-03-10,1989,Tottenham Hotspur,Charlton Athletic,3-0,3,0,1,1,3,3,H
1990-03-14,1989,Manchester United,Everton,0-0,0,0,1,1,0,0,D
1990-03-14,1989,Norwich City,Coventry City,0-0,0,0,1,1,0,0,D
1990-03-17,1989,Arsenal,Chelsea,0-1,0,1,1,1,1,-1,A
1990-03-17,1989,Charlton Athletic,Nottingham Forest,1-1,1,1,1,1,2,0,D
1990-03-17,1989,Coventry City,Sheffield Wednesday,1-4,1,4,1,1,5,-3,A
1990-03-17,1989,Derby County,Aston Villa,0-1,0,1,1,1,1,-1,A
1990-03-17,1989,Everton,Crystal Palace,4-0,4,0,1,1,4,4,H
1990-03-17,1989,Luton Town,Manchester City,1-1,1,1,1,1,2,0,D
1990-03-17,1989,Norwich City,Millwall,1-1,1,1,1,1,2,0,D
1990-03-17,1989,Queens Park Rangers,Tottenham Hotspur,3-1,3,1,1,1,4,2,H
1990-03-17,1989,Wimbledon,Southampton,3-3,3,3,1,1,6,0,D
1990-03-18,1989,Manchester United,Liverpool,1-2,1,2,1,1,3,-1,A
1990-03-20,1989,Crystal Palace,Derby County,1-1,1,1,1,1,2,0,D
1990-03-20,1989,Queens Park Rangers,Aston Villa,1-1,1,1,1,1,2,0,D
1990-03-21,1989,Manchester City,Chelsea,1-1,1,1,1,1,2,0,D
1990-03-21,1989,Millwall,Everton,1-2,1,2,1,1,3,-1,A
1990-03-21,1989,Sheffield Wednesday,Manchester United,1-0,1,0,1,1,1,1,H
1990-03-21,1989,Tottenham Hotspur,Liverpool,1-0,1,0,1,1,1,1,H
1990-03-24,1989,Coventry City,Charlton Athletic,1-2,1,2,1,1,3,-1,A
1990-03-24,1989,Crystal Palace,Aston Villa,1-0,1,0,1,1,1,1,H
1990-03-24,1989,Derby County,Arsenal,1-3,1,3,1,1,4,-2,A
1990-03-24,1989,Everton,Norwich City,3-1,3,1,1,1,4,2,H
1990-03-24,1989,Luton Town,Millwall,2-1,2,1,1,1,3,1,H
1990-03-24,1989,Queens Park Rangers,Nottingham Forest,2-0,2,0,1,1,2,2,H
1990-03-24,1989,Southampton,Manchester United,0-2,0,2,1,1,2,-2,A
1990-03-24,1989,Wimbledon,Sheffield Wednesday,1-1,1,1,1,1,2,0,D
1990-03-31,1989,Arsenal,Everton,1-0,1,0,1,1,1,1,H
1990-03-31,1989,Charlton Athletic,Queens Park Rangers,1-0,1,0,1,1,1,1,H
1990-03-31,1989,Chelsea,Derby County,1-1,1,1,1,1,2,0,D
1990-03-31,1989,Liverpool,Southampton,3-2,3,2,1,1,5,1,H
1990-03-31,1989,Manchester United,Coventry City,3-0,3,0,1,1,3,3,H
1990-03-31,1989,Millwall,Crystal Palace,1-2,1,2,1,1,3,-1,A
1990-03-31,1989,Norwich City,Luton Town,2-0,2,0,1,1,2,2,H
1990-03-31,1989,Nottingham Forest,Wimbledon,0-1,0,1,1,1,1,-1,A
1990-03-31,1989,Sheffield Wednesday,Tottenham Hotspur,2-4,2,4,1,1,6,-2,A
1990-04-01,1989,Aston Villa,Manchester City,1-2,1,2,1,1,3,-1,A
1990-04-03,1989,Liverpool,Wimbledon,2-1,2,1,1,1,3,1,H
1990-04-03,1989,Southampton,Queens Park Rangers,0-2,0,2,1,1,2,-2,A
1990-04-04,1989,Everton,Nottingham Forest,4-0,4,0,1,1,4,4,H
1990-04-04,1989,Norwich City,Crystal Palace,2-0,2,0,1,1,2,2,H
1990-04-07,1989,Chelsea,Luton Town,1-0,1,0,1,1,1,1,H
1990-04-07,1989,Coventry City,Derby County,1-0,1,0,1,1,1,1,H
1990-04-07,1989,Everton,Queens Park Rangers,1-0,1,0,1,1,1,1,H
1990-04-07,1989,Millwall,Manchester City,1-1,1,1,1,1,2,0,D
1990-04-07,1989,Nottingham Forest,Tottenham Hotspur,1-3,1,3,1,1,4,-2,A
1990-04-07,1989,Sheffield Wednesday,Southampton,0-1,0,1,1,1,1,-1,A
1990-04-11,1989,Arsenal,Aston Villa,0-1,0,1,1,1,1,-1,A
1990-04-11,1989,Charlton Athletic,Liverpool,0-4,0,4,1,1,4,-4,A
1990-04-11,1989,Queens Park Rangers,Manchester City,1-3,1,3,1,1,4,-2,A
1990-04-14,1989,Aston Villa,Chelsea,1-0,1,0,1,1,1,1,H
1990-04-14,1989,Crystal Palace,Arsenal,1-1,1,1,1,1,2,0,D
1990-04-14,1989,Derby County,Millwall,2-0,2,0,1,1,2,2,H
1990-04-14,1989,Liverpool,Nottingham Forest,2-2,2,2,1,1,4,0,D
1990-04-14,1989,Luton Town,Everton,2-2,2,2,1,1,4,0,D
1990-04-14,1989,Manchester City,Sheffield Wednesday,2-1,2,1,1,1,3,1,H
1990-04-14,1989,Queens Park Rangers,Manchester United,1-2,1,2,1,1,3,-1,A
1990-04-14,1989,Southampton,Charlton Athletic,3-2,3,2,1,1,5,1,H
1990-04-14,1989,Tottenham Hotspur,Coventry City,3-2,3,2,1,1,5,1,H
1990-04-14,1989,Wimbledon,Norwich City,1-1,1,1,1,1,2,0,D
1990-04-16,1989,Chelsea,Crystal Palace,3-0,3,0,1,1,3,3,H
1990-04-16,1989,Coventry City,Queens Park Rangers,1-1,1,1,1,1,2,0,D
1990-04-16,1989,Everton,Derby County,2-1,2,1,1,1,3,1,H
1990-04-16,1989,Millwall,Tottenham Hotspur,0-1,0,1,1,1,1,-1,A
1990-04-16,1989,Norwich City,Manchester City,0-1,0,1,1,1,1,-1,A
1990-04-16,1989,Nottingham Forest,Luton Town,3-0,3,0,1,1,3,3,H
1990-04-17,1989,Charlton Athletic,Wimbledon,1-2,1,2,1,1,3,-1,A
1990-04-17,1989,Manchester United,Aston Villa,2-0,2,0,1,1,2,2,H
1990-04-18,1989,Arsenal,Liverpool,1-1,1,1,1,1,2,0,D
1990-04-21,1989,Aston Villa,Millwall,1-0,1,0,1,1,1,1,H
1990-04-21,1989,Crystal Palace,Charlton Athletic,2-0,2,0,1,1,2,2,H
1990-04-21,1989,Derby County,Norwich City,0-2,0,2,1,1,2,-2,A
1990-04-21,1989,Liverpool,Chelsea,4-1,4,1,1,1,5,3,H
1990-04-21,1989,Luton Town,Arsenal,2-0,2,0,1,1,2,2,H
1990-04-21,1989,Manchester City,Everton,1-0,1,0,1,1,1,1,H
1990-04-21,1989,Queens Park Rangers,Sheffield Wednesday,1-0,1,0,1,1,1,1,H
1990-04-21,1989,Southampton,Nottingham Forest,2-0,2,0,1,1,2,2,H
1990-04-21,1989,Tottenham Hotspur,Manchester United,2-1,2,1,1,1,3,1,H
1990-04-21,1989,Wimbledon,Coventry City,0-0,0,0,1,1,0,0,D
1990-04-28,1989,Arsenal,Millwall,2-0,2,0,1,1,2,2,H
1990-04-28,1989,Aston Villa,Norwich City,3-3,3,3,1,1,6,0,D
1990-04-28,1989,Charlton Athletic,Sheffield Wednesday,1-2,1,2,1,1,3,-1,A
1990-04-28,1989,Chelsea,Everton,2-1,2,1,1,1,3,1,H
1990-04-28,1989,Liverpool,Queens Park Rangers,2-1,2,1,1,1,3,1,H
1990-04-28,1989,Luton Town,Crystal Palace,1-0,1,0,1,1,1,1,H
1990-04-28,1989,Manchester City,Derby County,0-1,0,1,1,1,1,-1,A
1990-04-28,1989,Southampton,Coventry City,3-0,3,0,1,1,3,3,H
1990-04-28,1989,Wimbledon,Tottenham Hotspur,1-0,1,0,1,1,1,1,H
1990-04-30,1989,Manchester United,Wimbledon,0-0,0,0,1,1,0,0,D
1990-05-01,1989,Liverpool,Derby County,1-0,1,0,1,1,1,1,H
1990-05-02,1989,Arsenal,Southampton,2-1,2,1,1,1,3,1,H
1990-05-02,1989,Nottingham Forest,Manchester United,4-0,4,0,1,1,4,4,H
1990-05-02,1989,Wimbledon,Crystal Palace,0-1,0,1,1,1,1,-1,A
1990-05-05,1989,Coventry City,Liverpool,1-6,1,6,1,1,7,-5,A
1990-05-05,1989,Crystal Palace,Manchester City,2-2,2,2,1,1,4,0,D
1990-05-05,1989,Derby County,Luton Town,2-3,2,3,1,1,5,-1,A
1990-05-05,1989,Everton,Aston Villa,3-3,3,3,1,1,6,0,D
1990-05-05,1989,Manchester United,Charlton Athletic,1-0,1,0,1,1,1,1,H
1990-05-05,1989,Millwall,Chelsea,1-3,1,3,1,1,4,-2,A
1990-05-05,1989,Norwich City,Arsenal,2-2,2,2,1,1,4,0,D
1990-05-05,1989,Queens Park Rangers,Wimbledon,2-3,2,3,1,1,5,-1,A
1990-05-05,1989,Sheffield Wednesday,Nottingham Forest,0-3,0,3,1,1,3,-3,A
1990-05-05,1989,Tottenham Hotspur,Southampton,2-1,2,1,1,1,3,1,H
1990-08-25,1990,Aston Villa,Southampton,1-1,1,1,1,1,2,0,D
1990-08-25,1990,Chelsea,Derby County,2-1,2,1,1,1,3,1,H
1990-08-25,1990,Everton,Leeds United,2-3,2,3,1,1,5,-1,A
1990-08-25,1990,Luton Town,Crystal Palace,1-1,1,1,1,1,2,0,D
1990-08-25,1990,Manchester United,Coventry City,2-0,2,0,1,1,2,2,H
1990-08-25,1990,Norwich City,Sunderland,3-2,3,2,1,1,5,1,H
1990-08-25,1990,Nottingham Forest,Queens Park Rangers,1-1,1,1,1,1,2,0,D
1990-08-25,1990,Sheffield United,Liverpool,1-3,1,3,1,1,4,-2,A
1990-08-25,1990,Tottenham Hotspur,Manchester City,3-1,3,1,1,1,4,2,H
1990-08-25,1990,Wimbledon,Arsenal,0-3,0,3,1,1,3,-3,A
1990-08-28,1990,Crystal Palace,Chelsea,2-1,2,1,1,1,3,1,H
1990-08-28,1990,Leeds United,Manchester United,0-0,0,0,1,1,0,0,D
1990-08-28,1990,Liverpool,Nottingham Forest,2-0,2,0,1,1,2,2,H
1990-08-28,1990,Southampton,Norwich City,1-0,1,0,1,1,1,1,H
1990-08-28,1990,Sunderland,Tottenham Hotspur,0-0,0,0,1,1,0,0,D
1990-08-29,1990,Arsenal,Luton Town,2-1,2,1,1,1,3,1,H
1990-08-29,1990,Coventry City,Everton,3-1,3,1,1,1,4,2,H
1990-08-29,1990,Derby County,Sheffield United,1-1,1,1,1,1,2,0,D
1990-08-29,1990,Queens Park Rangers,Wimbledon,0-1,0,1,1,1,1,-1,A
1990-09-01,1990,Arsenal,Tottenham Hotspur,0-0,0,0,1,1,0,0,D
1990-09-01,1990,Coventry City,Nottingham Forest,2-2,2,2,1,1,4,0,D
1990-09-01,1990,Crystal Palace,Sheffield United,1-0,1,0,1,1,1,1,H
1990-09-01,1990,Derby County,Wimbledon,1-1,1,1,1,1,2,0,D
1990-09-01,1990,Leeds United,Norwich City,3-0,3,0,1,1,3,3,H
1990-09-01,1990,Liverpool,Aston Villa,2-1,2,1,1,1,3,1,H
1990-09-01,1990,Manchester City,Everton,1-0,1,0,1,1,1,1,H
1990-09-01,1990,Queens Park Rangers,Chelsea,1-0,1,0,1,1,1,1,H
1990-09-01,1990,Southampton,Luton Town,1-2,1,2,1,1,3,-1,A
1990-09-01,1990,Sunderland,Manchester United,2-1,2,1,1,1,3,1,H
1990-09-04,1990,Luton Town,Manchester United,0-1,0,1,1,1,1,-1,A
1990-09-05,1990,Manchester City,Aston Villa,2-1,2,1,1,1,3,1,H
1990-09-08,1990,Aston Villa,Coventry City,2-1,2,1,1,1,3,1,H
1990-09-08,1990,Chelsea,Sunderland,3-2,3,2,1,1,5,1,H
1990-09-08,1990,Everton,Arsenal,1-1,1,1,1,1,2,0,D
1990-09-08,1990,Luton Town,Leeds United,1-0,1,0,1,1,1,1,H
1990-09-08,1990,Manchester United,Queens Park Rangers,3-1,3,1,1,1,4,2,H
1990-09-08,1990,Norwich City,Crystal Palace,0-3,0,3,1,1,3,-3,A
1990-09-08,1990,Nottingham Forest,Southampton,3-1,3,1,1,1,4,2,H
1990-09-08,1990,Sheffield United,Manchester City,1-1,1,1,1,1,2,0,D
1990-09-08,1990,Tottenham Hotspur,Derby County,3-0,3,0,1,1,3,3,H
1990-09-08,1990,Wimbledon,Liverpool,1-2,1,2,1,1,3,-1,A
1990-09-15,1990,Arsenal,Chelsea,4-1,4,1,1,1,5,3,H
1990-09-15,1990,Coventry City,Wimbledon,0-0,0,0,1,1,0,0,D
1990-09-15,1990,Crystal Palace,Nottingham Forest,2-2,2,2,1,1,4,0,D
1990-09-15,1990,Derby County,Aston Villa,0-2,0,2,1,1,2,-2,A
1990-09-15,1990,Leeds United,Tottenham Hotspur,0-2,0,2,1,1,2,-2,A
1990-09-15,1990,Manchester City,Norwich City,2-1,2,1,1,1,3,1,H
1990-09-15,1990,Queens Park Rangers,Luton Town,6-1,6,1,1,1,7,5,H
1990-09-15,1990,Southampton,Sheffield United,2-0,2,0,1,1,2,2,H
1990-09-15,1990,Sunderland,Everton,2-2,2,2,1,1,4,0,D
1990-09-16,1990,Liverpool,Manchester United,4-0,4,0,1,1,4,4,H
1990-09-22,1990,Aston Villa,Queens Park Rangers,2-2,2,2,1,1,4,0,D
1990-09-22,1990,Chelsea,Manchester City,1-1,1,1,1,1,2,0,D
1990-09-22,1990,Everton,Liverpool,2-3,2,3,1,1,5,-1,A
1990-09-22,1990,Luton Town,Coventry City,1-0,1,0,1,1,1,1,H
1990-09-22,1990,Manchester United,Southampton,3-2,3,2,1,1,5,1,H
1990-09-22,1990,Norwich City,Derby County,2-1,2,1,1,1,3,1,H
1990-09-22,1990,Nottingham Forest,Arsenal,0-2,0,2,1,1,2,-2,A
1990-09-22,1990,Tottenham Hotspur,Crystal Palace,1-1,1,1,1,1,2,0,D
1990-09-22,1990,Wimbledon,Sunderland,2-2,2,2,1,1,4,0,D
1990-09-23,1990,Sheffield United,Leeds United,0-2,0,2,1,1,2,-2,A
1990-09-29,1990,Chelsea,Sheffield United,2-2,2,2,1,1,4,0,D
1990-09-29,1990,Coventry City,Queens Park Rangers,3-1,3,1,1,1,4,2,H
1990-09-29,1990,Derby County,Crystal Palace,0-2,0,2,1,1,2,-2,A
1990-09-29,1990,Everton,Southampton,3-0,3,0,1,1,3,3,H
1990-09-29,1990,Leeds United,Arsenal,2-2,2,2,1,1,4,0,D
1990-09-29,1990,Manchester United,Nottingham Forest,0-1,0,1,1,1,1,-1,A
1990-09-29,1990,Norwich City,Luton Town,1-3,1,3,1,1,4,-2,A
1990-09-29,1990,Sunderland,Liverpool,0-1,0,1,1,1,1,-1,A
1990-09-29,1990,Tottenham Hotspur,Aston Villa,2-1,2,1,1,1,3,1,H
1990-09-29,1990,Wimbledon,Manchester City,1-1,1,1,1,1,2,0,D
1990-10-06,1990,Arsenal,Norwich City,2-0,2,0,1,1,2,2,H
1990-10-06,1990,Aston Villa,Sunderland,3-0,3,0,1,1,3,3,H
1990-10-06,1990,Crystal Palace,Leeds United,1-1,1,1,1,1,2,0,D
1990-10-06,1990,Liverpool,Derby County,2-0,2,0,1,1,2,2,H
1990-10-06,1990,Manchester City,Coventry City,2-0,2,0,1,1,2,2,H
1990-10-06,1990,Queens Park Rangers,Tottenham Hotspur,0-0,0,0,1,1,0,0,D
1990-10-06,1990,Sheffield United,Wimbledon,1-2,1,2,1,1,3,-1,A
1990-10-06,1990,Southampton,Chelsea,3-3,3,3,1,1,6,0,D
1990-10-07,1990,Nottingham Forest,Everton,3-1,3,1,1,1,4,2,H
1990-10-20,1990,Chelsea,Nottingham Forest,0-0,0,0,1,1,0,0,D
1990-10-20,1990,Coventry City,Southampton,1-2,1,2,1,1,3,-1,A
1990-10-20,1990,Derby County,Manchester City,1-1,1,1,1,1,2,0,D
1990-10-20,1990,Everton,Crystal Palace,0-0,0,0,1,1,0,0,D
1990-10-20,1990,Leeds United,Queens Park Rangers,2-3,2,3,1,1,5,-1,A
1990-10-20,1990,Manchester United,Arsenal,0-1,0,1,1,1,1,-1,A
1990-10-20,1990,Norwich City,Liverpool,1-1,1,1,1,1,2,0,D
1990-10-20,1990,Sunderland,Luton Town,2-0,2,0,1,1,2,2,H
1990-10-20,1990,Tottenham Hotspur,Sheffield United,4-0,4,0,1,1,4,4,H
1990-10-20,1990,Wimbledon,Aston Villa,0-0,0,0,1,1,0,0,D
1990-10-27,1990,Arsenal,Sunderland,1-0,1,0,1,1,1,1,H
1990-10-27,1990,Aston Villa,Leeds United,0-0,0,0,1,1,0,0,D
1990-10-27,1990,Crystal Palace,Wimbledon,4-3,4,3,1,1,7,1,H
1990-10-27,1990,Liverpool,Chelsea,2-0,2,0,1,1,2,2,H
1990-10-27,1990,Luton Town,Everton,1-1,1,1,1,1,2,0,D
1990-10-27,1990,Manchester City,Manchester United,3-3,3,3,1,1,6,0,D
1990-10-27,1990,Nottingham Forest,Tottenham Hotspur,1-2,1,2,1,1,3,-1,A
1990-10-27,1990,Queens Park Rangers,Norwich City,1-3,1,3,1,1,4,-2,A
1990-10-27,1990,Sheffield United,Coventry City,0-1,0,1,1,1,1,-1,A
1990-10-27,1990,Southampton,Derby County,0-1,0,1,1,1,1,-1,A
1990-11-03,1990,Chelsea,Aston Villa,1-0,1,0,1,1,1,1,H
1990-11-03,1990,Coventry City,Arsenal,0-2,0,2,1,1,2,-2,A
1990-11-03,1990,Derby County,Luton Town,2-1,2,1,1,1,3,1,H
1990-11-03,1990,Everton,Queens Park Rangers,3-0,3,0,1,1,3,3,H
1990-11-03,1990,Leeds United,Nottingham Forest,3-1,3,1,1,1,4,2,H
1990-11-03,1990,Manchester United,Crystal Palace,2-0,2,0,1,1,2,2,H
1990-11-03,1990,Norwich City,Sheffield United,3-0,3,0,1,1,3,3,H
1990-11-03,1990,Sunderland,Manchester City,1-1,1,1,1,1,2,0,D
1990-11-03,1990,Wimbledon,Southampton,1-1,1,1,1,1,2,0,D
1990-11-04,1990,Tottenham Hotspur,Liverpool,1-3,1,3,1,1,4,-2,A
1990-11-10,1990,Aston Villa,Nottingham Forest,1-1,1,1,1,1,2,0,D
1990-11-10,1990,Chelsea,Norwich City,1-1,1,1,1,1,2,0,D
1990-11-10,1990,Crystal Palace,Arsenal,0-0,0,0,1,1,0,0,D
1990-11-10,1990,Derby County,Manchester United,0-0,0,0,1,1,0,0,D
1990-11-10,1990,Liverpool,Luton Town,4-0,4,0,1,1,4,4,H
1990-11-10,1990,Sheffield United,Everton,0-0,0,0,1,1,0,0,D
1990-11-10,1990,Southampton,Queens Park Rangers,3-1,3,1,1,1,4,2,H
1990-11-10,1990,Sunderland,Coventry City,0-0,0,0,1,1,0,0,D
1990-11-10,1990,Tottenham Hotspur,Wimbledon,4-2,4,2,1,1,6,2,H
1990-11-11,1990,Manchester City,Leeds United,2-3,2,3,1,1,5,-1,A
1990-11-17,1990,Arsenal,Southampton,4-0,4,0,1,1,4,4,H
1990-11-17,1990,Coventry City,Liverpool,0-1,0,1,1,1,1,-1,A
1990-11-17,1990,Leeds United,Derby County,3-0,3,0,1,1,3,3,H
1990-11-17,1990,Luton Town,Manchester City,2-2,2,2,1,1,4,0,D
1990-11-17,1990,Manchester United,Sheffield United,2-0,2,0,1,1,2,2,H
1990-11-17,1990,Norwich City,Aston Villa,2-0,2,0,1,1,2,2,H
1990-11-17,1990,Nottingham Forest,Sunderland,2-0,2,0,1,1,2,2,H
1990-11-17,1990,Queens Park Rangers,Crystal Palace,1-2,1,2,1,1,3,-1,A
1990-11-17,1990,Wimbledon,Chelsea,2-1,2,1,1,1,3,1,H
1990-11-18,1990,Everton,Tottenham Hotspur,1-1,1,1,1,1,2,0,D
1990-11-24,1990,Coventry City,Leeds United,1-1,1,1,1,1,2,0,D
1990-11-24,1990,Derby County,Nottingham Forest,2-1,2,1,1,1,3,1,H
1990-11-24,1990,Liverpool,Manchester City,2-2,2,2,1,1,4,0,D
1990-11-24,1990,Luton Town,Aston Villa,2-0,2,0,1,1,2,2,H
1990-11-24,1990,Queens Park Rangers,Arsenal,1-3,1,3,1,1,4,-2,A
1990-11-24,1990,Sheffield United,Sunderland,0-2,0,2,1,1,2,-2,A
1990-11-24,1990,Southampton,Crystal Palace,2-3,2,3,1,1,5,-1,A
1990-11-24,1990,Tottenham Hotspur,Norwich City,2-1,2,1,1,1,3,1,H
1990-11-24,1990,Wimbledon,Everton,2-1,2,1,1,1,3,1,H
1990-11-25,1990,Manchester United,Chelsea,2-3,2,3,1,1,5,-1,A
1990-12-01,1990,Aston Villa,Sheffield United,2-1,2,1,1,1,3,1,H
1990-12-01,1990,Chelsea,Tottenham Hotspur,3-2,3,2,1,1,5,1,H
1990-12-01,1990,Crystal Palace,Coventry City,2-1,2,1,1,1,3,1,H
1990-12-01,1990,Everton,Manchester United,0-1,0,1,1,1,1,-1,A
1990-12-01,1990,Leeds United,Southampton,2-1,2,1,1,1,3,1,H
1990-12-01,1990,Manchester City,Queens Park Rangers,2-1,2,1,1,1,3,1,H
1990-12-01,1990,Norwich City,Wimbledon,0-4,0,4,1,1,4,-4,A
1990-12-01,1990,Nottingham Forest,Luton Town,2-2,2,2,1,1,4,0,D
1990-12-01,1990,Sunderland,Derby County,1-2,1,2,1,1,3,-1,A
1990-12-02,1990,Arsenal,Liverpool,3-0,3,0,1,1,3,3,H
1990-12-08,1990,Chelsea,Crystal Palace,2-1,2,1,1,1,3,1,H
1990-12-08,1990,Everton,Coventry City,1-0,1,0,1,1,1,1,H
1990-12-08,1990,Luton Town,Arsenal,1-1,1,1,1,1,2,0,D
1990-12-08,1990,Manchester United,Leeds United,1-1,1,1,1,1,2,0,D
1990-12-08,1990,Norwich City,Southampton,3-1,3,1,1,1,4,2,H
1990-12-08,1990,Tottenham Hotspur,Sunderland,3-3,3,3,1,1,6,0,D
1990-12-08,1990,Wimbledon,Queens Park Rangers,3-0,3,0,1,1,3,3,H
1990-12-15,1990,Arsenal,Wimbledon,2-2,2,2,1,1,4,0,D
1990-12-15,1990,Coventry City,Manchester United,2-2,2,2,1,1,4,0,D
1990-12-15,1990,Derby County,Chelsea,4-6,4,6,1,1,10,-2,A
1990-12-15,1990,Liverpool,Sheffield United,2-0,2,0,1,1,2,2,H
1990-12-15,1990,Manchester City,Tottenham Hotspur,2-1,2,1,1,1,3,1,H
1990-12-15,1990,Queens Park Rangers,Nottingham Forest,1-2,1,2,1,1,3,-1,A
1990-12-15,1990,Southampton,Aston Villa,1-1,1,1,1,1,2,0,D
1990-12-15,1990,Sunderland,Norwich City,1-2,1,2,1,1,3,-1,A
1990-12-16,1990,Crystal Palace,Luton Town,1-0,1,0,1,1,1,1,H
1990-12-16,1990,Leeds United,Everton,2-0,2,0,1,1,2,2,H
1990-12-22,1990,Chelsea,Coventry City,2-1,2,1,1,1,3,1,H
1990-12-22,1990,Liverpool,Southampton,3-2,3,2,1,1,5,1,H
1990-12-22,1990,Manchester City,Crystal Palace,0-2,0,2,1,1,2,-2,A
1990-12-22,1990,Norwich City,Everton,1-0,1,0,1,1,1,1,H
1990-12-22,1990,Sheffield United,Nottingham Forest,3-2,3,2,1,1,5,1,H
1990-12-22,1990,Tottenham Hotspur,Luton Town,2-1,2,1,1,1,3,1,H
1990-12-22,1990,Wimbledon,Manchester United,1-3,1,3,1,1,4,-2,A
1990-12-23,1990,Aston Villa,Arsenal,0-0,0,0,1,1,0,0,D
1990-12-23,1990,Derby County,Queens Park Rangers,1-1,1,1,1,1,2,0,D
1990-12-23,1990,Sunderland,Leeds United,0-1,0,1,1,1,1,-1,A
1990-12-26,1990,Arsenal,Derby County,3-0,3,0,1,1,3,3,H
1990-12-26,1990,Coventry City,Tottenham Hotspur,2-0,2,0,1,1,2,2,H
1990-12-26,1990,Crystal Palace,Sunderland,2-1,2,1,1,1,3,1,H
1990-12-26,1990,Everton,Aston Villa,1-0,1,0,1,1,1,1,H
1990-12-26,1990,Leeds United,Chelsea,4-1,4,1,1,1,5,3,H
1990-12-26,1990,Luton Town,Sheffield United,0-1,0,1,1,1,1,-1,A
1990-12-26,1990,Manchester United,Norwich City,3-0,3,0,1,1,3,3,H
1990-12-26,1990,Nottingham Forest,Wimbledon,2-1,2,1,1,1,3,1,H
1990-12-26,1990,Queens Park Rangers,Liverpool,1-1,1,1,1,1,2,0,D
1990-12-26,1990,Southampton,Manchester City,2-1,2,1,1,1,3,1,H
1990-12-29,1990,Arsenal,Sheffield United,4-1,4,1,1,1,5,3,H
1990-12-29,1990,Coventry City,Norwich City,2-0,2,0,1,1,2,2,H
1990-12-29,1990,Everton,Derby County,2-0,2,0,1,1,2,2,H
1990-12-29,1990,Leeds United,Wimbledon,3-0,3,0,1,1,3,3,H
1990-12-29,1990,Luton Town,Chelsea,2-0,2,0,1,1,2,2,H
1990-12-29,1990,Manchester United,Aston Villa,1-1,1,1,1,1,2,0,D
1990-12-29,1990,Nottingham Forest,Manchester City,1-3,1,3,1,1,4,-2,A
1990-12-29,1990,Queens Park Rangers,Sunderland,3-2,3,2,1,1,5,1,H
1990-12-29,1990,Southampton,Tottenham Hotspur,3-0,3,0,1,1,3,3,H
1990-12-30,1990,Crystal Palace,Liverpool,1-0,1,0,1,1,1,1,H
1991-01-01,1990,Aston Villa,Crystal Palace,2-0,2,0,1,1,2,2,H
1991-01-01,1990,Chelsea,Everton,1-2,1,2,1,1,3,-1,A
1991-01-01,1990,Derby County,Coventry City,1-1,1,1,1,1,2,0,D
1991-01-01,1990,Liverpool,Leeds United,3-0,3,0,1,1,3,3,H
1991-01-01,1990,Manchester City,Arsenal,0-1,0,1,1,1,1,-1,A
1991-01-01,1990,Sheffield United,Queens Park Rangers,1-0,1,0,1,1,1,1,H
1991-01-01,1990,Sunderland,Southampton,1-0,1,0,1,1,1,1,H
1991-01-01,1990,Tottenham Hotspur,Manchester United,1-2,1,2,1,1,3,-1,A
1991-01-01,1990,Wimbledon,Luton Town,2-0,2,0,1,1,2,2,H
1991-01-02,1990,Norwich City,Nottingham Forest,2-6,2,6,1,1,8,-4,A
1991-01-12,1990,Aston Villa,Liverpool,0-0,0,0,1,1,0,0,D
1991-01-12,1990,Chelsea,Queens Park Rangers,2-0,2,0,1,1,2,2,H
1991-01-12,1990,Luton Town,Southampton,3-4,3,4,1,1,7,-1,A
1991-01-12,1990,Manchester United,Sunderland,3-0,3,0,1,1,3,3,H
1991-01-12,1990,Norwich City,Leeds United,2-0,2,0,1,1,2,2,H
1991-01-12,1990,Nottingham Forest,Coventry City,3-0,3,0,1,1,3,3,H
1991-01-12,1990,Sheffield United,Crystal Palace,0-1,0,1,1,1,1,-1,A
1991-01-12,1990,Tottenham Hotspur,Arsenal,0-0,0,0,1,1,0,0,D
1991-01-12,1990,Wimbledon,Derby County,3-1,3,1,1,1,4,2,H
1991-01-13,1990,Everton,Manchester City,2-0,2,0,1,1,2,2,H
1991-01-19,1990,Arsenal,Everton,1-0,1,0,1,1,1,1,H
1991-01-19,1990,Coventry City,Aston Villa,2-1,2,1,1,1,3,1,H
1991-01-19,1990,Crystal Palace,Norwich City,1-3,1,3,1,1,4,-2,A
1991-01-19,1990,Leeds United,Luton Town,2-1,2,1,1,1,3,1,H
1991-01-19,1990,Liverpool,Wimbledon,1-1,1,1,1,1,2,0,D
1991-01-19,1990,Manchester City,Sheffield United,2-0,2,0,1,1,2,2,H
1991-01-19,1990,Queens Park Rangers,Manchester United,1-1,1,1,1,1,2,0,D
1991-01-19,1990,Southampton,Nottingham Forest,1-1,1,1,1,1,2,0,D
1991-01-19,1990,Sunderland,Chelsea,1-0,1,0,1,1,1,1,H
1991-01-20,1990,Derby County,Tottenham Hotspur,0-1,0,1,1,1,1,-1,A
1991-01-26,1990,Sheffield United,Derby County,1-0,1,0,1,1,1,1,H
1991-02-02,1990,Aston Villa,Derby County,3-2,3,2,1,1,5,1,H
1991-02-02,1990,Chelsea,Arsenal,2-1,2,1,1,1,3,1,H
1991-02-02,1990,Everton,Sunderland,2-0,2,0,1,1,2,2,H
1991-02-02,1990,Luton Town,Queens Park Rangers,1-2,1,2,1,1,3,-1,A
1991-02-02,1990,Norwich City,Manchester City,1-2,1,2,1,1,3,-1,A
1991-02-02,1990,Nottingham Forest,Crystal Palace,0-1,0,1,1,1,1,-1,A
1991-02-02,1990,Sheffield United,Southampton,4-1,4,1,1,1,5,3,H
1991-02-02,1990,Tottenham Hotspur,Leeds United,0-0,0,0,1,1,0,0,D
1991-02-02,1990,Wimbledon,Coventry City,1-0,1,0,1,1,1,1,H
1991-02-03,1990,Manchester United,Liverpool,1-1,1,1,1,1,2,0,D
1991-02-09,1990,Liverpool,Everton,3-1,3,1,1,1,4,2,H
1991-02-09,1990,Manchester City,Chelsea,2-1,2,1,1,1,3,1,H
1991-02-16,1990,Chelsea,Wimbledon,0-0,0,0,1,1,0,0,D
1991-02-16,1990,Crystal Palace,Queens Park Rangers,0-0,0,0,1,1,0,0,D
1991-02-16,1990,Sunderland,Nottingham Forest,1-0,1,0,1,1,1,1,H
1991-02-23,1990,Arsenal,Crystal Palace,4-0,4,0,1,1,4,4,H
1991-02-23,1990,Coventry City,Sunderland,0-0,0,0,1,1,0,0,D
1991-02-23,1990,Derby County,Norwich City,0-0,0,0,1,1,0,0,D
1991-02-23,1990,Everton,Sheffield United,1-2,1,2,1,1,3,-1,A
1991-02-23,1990,Luton Town,Liverpool,3-1,3,1,1,1,4,2,H
1991-02-23,1990,Nottingham Forest,Aston Villa,2-2,2,2,1,1,4,0,D
1991-02-23,1990,Queens Park Rangers,Southampton,2-1,2,1,1,1,3,1,H
1991-02-23,1990,Wimbledon,Tottenham Hotspur,5-1,5,1,1,1,6,4,H
1991-02-26,1990,Sheffield United,Manchester United,2-1,2,1,1,1,3,1,H
1991-03-02,1990,Coventry City,Crystal Palace,3-1,3,1,1,1,4,2,H
1991-03-02,1990,Derby County,Sunderland,3-3,3,3,1,1,6,0,D
1991-03-02,1990,Luton Town,Nottingham Forest,1-0,1,0,1,1,1,1,H
1991-03-02,1990,Manchester United,Everton,0-2,0,2,1,1,2,-2,A
1991-03-02,1990,Queens Park Rangers,Manchester City,1-0,1,0,1,1,1,1,H
1991-03-02,1990,Sheffield United,Aston Villa,2-1,2,1,1,1,3,1,H
1991-03-02,1990,Southampton,Leeds United,2-0,2,0,1,1,2,2,H
1991-03-02,1990,Tottenham Hotspur,Chelsea,1-1,1,1,1,1,2,0,D
1991-03-02,1990,Wimbledon,Norwich City,0-0,0,0,1,1,0,0,D
1991-03-03,1990,Liverpool,Arsenal,0-1,0,1,1,1,1,-1,A
1991-03-05,1990,Manchester City,Luton Town,3-0,3,0,1,1,3,3,H
1991-03-09,1990,Aston Villa,Luton Town,1-2,1,2,1,1,3,-1,A
1991-03-09,1990,Chelsea,Manchester United,3-2,3,2,1,1,5,1,H
1991-03-09,1990,Crystal Palace,Southampton,2-1,2,1,1,1,3,1,H
1991-03-09,1990,Leeds United,Coventry City,2-0,2,0,1,1,2,2,H
1991-03-09,1990,Manchester City,Liverpool,0-3,0,3,1,1,3,-3,A
1991-03-09,1990,Sunderland,Sheffield United,0-1,0,1,1,1,1,-1,A
1991-03-13,1990,Coventry City,Luton Town,2-1,2,1,1,1,3,1,H
1991-03-13,1990,Southampton,Manchester United,1-1,1,1,1,1,2,0,D
1991-03-16,1990,Aston Villa,Tottenham Hotspur,3-2,3,2,1,1,5,1,H
1991-03-16,1990,Crystal Palace,Derby County,2-1,2,1,1,1,3,1,H
1991-03-16,1990,Liverpool,Sunderland,2-1,2,1,1,1,3,1,H
1991-03-16,1990,Luton Town,Norwich City,0-1,0,1,1,1,1,-1,A
1991-03-16,1990,Manchester City,Wimbledon,1-1,1,1,1,1,2,0,D
1991-03-16,1990,Nottingham Forest,Manchester United,1-1,1,1,1,1,2,0,D
1991-03-16,1990,Queens Park Rangers,Coventry City,1-0,1,0,1,1,1,1,H
1991-03-16,1990,Sheffield United,Chelsea,1-0,1,0,1,1,1,1,H
1991-03-16,1990,Southampton,Everton,3-4,3,4,1,1,7,-1,A
1991-03-17,1990,Arsenal,Leeds United,2-0,2,0,1,1,2,2,H
1991-03-20,1990,Arsenal,Nottingham Forest,1-1,1,1,1,1,2,0,D
1991-03-23,1990,Chelsea,Southampton,0-2,0,2,1,1,2,-2,A
1991-03-23,1990,Coventry City,Manchester City,3-1,3,1,1,1,4,2,H
1991-03-23,1990,Derby County,Liverpool,1-7,1,7,1,1,8,-6,A
1991-03-23,1990,Everton,Nottingham Forest,0-0,0,0,1,1,0,0,D
1991-03-23,1990,Leeds United,Crystal Palace,1-2,1,2,1,1,3,-1,A
1991-03-23,1990,Manchester United,Luton Town,4-1,4,1,1,1,5,3,H
1991-03-23,1990,Norwich City,Arsenal,0-0,0,0,1,1,0,0,D
1991-03-23,1990,Sunderland,Aston Villa,1-3,1,3,1,1,4,-2,A
1991-03-23,1990,Tottenham Hotspur,Queens Park Rangers,0-0,0,0,1,1,0,0,D
1991-03-23,1990,Wimbledon,Sheffield United,1-1,1,1,1,1,2,0,D
1991-03-30,1990,Aston Villa,Everton,2-2,2,2,1,1,4,0,D
1991-03-30,1990,Chelsea,Leeds United,1-2,1,2,1,1,3,-1,A
1991-03-30,1990,Derby County,Arsenal,0-2,0,2,1,1,2,-2,A
1991-03-30,1990,Liverpool,Queens Park Rangers,1-3,1,3,1,1,4,-2,A
1991-03-30,1990,Manchester City,Southampton,3-3,3,3,1,1,6,0,D
1991-03-30,1990,Norwich City,Manchester United,0-3,0,3,1,1,3,-3,A
1991-03-30,1990,Sheffield United,Luton Town,2-1,2,1,1,1,3,1,H
1991-03-30,1990,Sunderland,Crystal Palace,2-1,2,1,1,1,3,1,H
1991-03-30,1990,Tottenham Hotspur,Coventry City,2-2,2,2,1,1,4,0,D
1991-03-30,1990,Wimbledon,Nottingham Forest,3-1,3,1,1,1,4,2,H
1991-04-01,1990,Coventry City,Chelsea,1-0,1,0,1,1,1,1,H
1991-04-01,1990,Crystal Palace,Manchester City,1-3,1,3,1,1,4,-2,A
1991-04-01,1990,Everton,Norwich City,1-0,1,0,1,1,1,1,H
1991-04-01,1990,Luton Town,Tottenham Hotspur,0-0,0,0,1,1,0,0,D
1991-04-01,1990,Nottingham Forest,Sheffield United,2-0,2,0,1,1,2,2,H
1991-04-01,1990,Queens Park Rangers,Derby County,1-1,1,1,1,1,2,0,D
1991-04-01,1990,Southampton,Liverpool,1-0,1,0,1,1,1,1,H
1991-04-02,1990,Leeds United,Sunderland,5-0,5,0,1,1,5,5,H
1991-04-02,1990,Manchester United,Wimbledon,2-1,2,1,1,1,3,1,H
1991-04-03,1990,Arsenal,Aston Villa,5-0,5,0,1,1,5,5,H
1991-04-06,1990,Aston Villa,Manchester United,1-1,1,1,1,1,2,0,D
1991-04-06,1990,Chelsea,Luton Town,3-3,3,3,1,1,6,0,D
1991-04-06,1990,Manchester City,Nottingham Forest,3-1,3,1,1,1,4,2,H
1991-04-06,1990,Norwich City,Coventry City,2-2,2,2,1,1,4,0,D
1991-04-06,1990,Sheffield United,Arsenal,0-2,0,2,1,1,2,-2,A
1991-04-06,1990,Sunderland,Queens Park Rangers,0-1,0,1,1,1,1,-1,A
1991-04-06,1990,Tottenham Hotspur,Southampton,2-0,2,0,1,1,2,2,H
1991-04-06,1990,Wimbledon,Leeds United,0-1,0,1,1,1,1,-1,A
1991-04-09,1990,Liverpool,Coventry City,1-1,1,1,1,1,2,0,D
1991-04-09,1990,Southampton,Arsenal,1-1,1,1,1,1,2,0,D
1991-04-10,1990,Everton,Wimbledon,1-2,1,2,1,1,3,-1,A
1991-04-10,1990,Leeds United,Manchester City,1-2,1,2,1,1,3,-1,A
1991-04-10,1990,Norwich City,Tottenham Hotspur,2-1,2,1,1,1,3,1,H
1991-04-10,1990,Nottingham Forest,Derby County,1-0,1,0,1,1,1,1,H
1991-04-10,1990,Queens Park Rangers,Aston Villa,2-1,2,1,1,1,3,1,H
1991-04-13,1990,Coventry City,Derby County,3-0,3,0,1,1,3,3,H
1991-04-13,1990,Crystal Palace,Aston Villa,0-0,0,0,1,1,0,0,D
1991-04-13,1990,Everton,Chelsea,2-2,2,2,1,1,4,0,D
1991-04-13,1990,Leeds United,Liverpool,4-5,4,5,1,1,9,-1,A
1991-04-13,1990,Luton Town,Wimbledon,0-1,0,1,1,1,1,-1,A
1991-04-13,1990,Queens Park Rangers,Sheffield United,1-2,1,2,1,1,3,-1,A
1991-04-13,1990,Southampton,Sunderland,3-1,3,1,1,1,4,2,H
1991-04-16,1990,Manchester United,Derby County,3-1,3,1,1,1,4,2,H
1991-04-17,1990,Arsenal,Manchester City,2-2,2,2,1,1,4,0,D
1991-04-17,1990,Crystal Palace,Tottenham Hotspur,1-0,1,0,1,1,1,1,H
1991-04-17,1990,Norwich City,Chelsea,1-3,1,3,1,1,4,-2,A
1991-04-17,1990,Queens Park Rangers,Leeds United,2-0,2,0,1,1,2,2,H
1991-04-20,1990,Aston Villa,Wimbledon,1-2,1,2,1,1,3,-1,A
1991-04-20,1990,Crystal Palace,Everton,0-0,0,0,1,1,0,0,D
1991-04-20,1990,Liverpool,Norwich City,3-0,3,0,1,1,3,3,H
1991-04-20,1990,Luton Town,Sunderland,1-2,1,2,1,1,3,-1,A
1991-04-20,1990,Manchester City,Derby County,2-1,2,1,1,1,3,1,H
1991-04-20,1990,Nottingham Forest,Chelsea,7-0,7,0,1,1,7,7,H
1991-04-20,1990,Sheffield United,Tottenham Hotspur,2-2,2,2,1,1,4,0,D
1991-04-20,1990,Southampton,Coventry City,2-1,2,1,1,1,3,1,H
1991-04-23,1990,Arsenal,Queens Park Rangers,2-0,2,0,1,1,2,2,H
1991-04-23,1990,Aston Villa,Manchester City,1-5,1,5,1,1,6,-4,A
1991-04-23,1990,Derby County,Leeds United,0-1,0,1,1,1,1,-1,A
1991-04-23,1990,Liverpool,Crystal Palace,3-0,3,0,1,1,3,3,H
1991-04-23,1990,Sunderland,Wimbledon,0-0,0,0,1,1,0,0,D
1991-04-24,1990,Nottingham Forest,Norwich City,5-0,5,0,1,1,5,5,H
1991-04-24,1990,Tottenham Hotspur,Everton,3-3,3,3,1,1,6,0,D
1991-05-04,1990,Chelsea,Liverpool,4-2,4,2,1,1,6,2,H
1991-05-04,1990,Coventry City,Sheffield United,0-0,0,0,1,1,0,0,D
1991-05-04,1990,Derby County,Southampton,6-2,6,2,1,1,8,4,H
1991-05-04,1990,Everton,Luton Town,1-0,1,0,1,1,1,1,H
1991-05-04,1990,Leeds United,Aston Villa,5-2,5,2,1,1,7,3,H
1991-05-04,1990,Manchester United,Manchester City,1-0,1,0,1,1,1,1,H
1991-05-04,1990,Norwich City,Queens Park Rangers,1-0,1,0,1,1,1,1,H
1991-05-04,1990,Sunderland,Arsenal,0-0,0,0,1,1,0,0,D
1991-05-04,1990,Tottenham Hotspur,Nottingham Forest,1-1,1,1,1,1,2,0,D
1991-05-04,1990,Wimbledon,Crystal Palace,0-3,0,3,1,1,3,-3,A
1991-05-06,1990,Arsenal,Manchester United,3-1,3,1,1,1,4,2,H
1991-05-06,1990,Nottingham Forest,Liverpool,2-1,2,1,1,1,3,1,H
1991-05-08,1990,Aston Villa,Norwich City,2-1,2,1,1,1,3,1,H
1991-05-08,1990,Derby County,Everton,2-3,2,3,1,1,5,-1,A
1991-05-08,1990,Leeds United,Sheffield United,2-1,2,1,1,1,3,1,H
1991-05-11,1990,Arsenal,Coventry City,6-1,6,1,1,1,7,5,H
1991-05-11,1990,Aston Villa,Chelsea,2-2,2,2,1,1,4,0,D
1991-05-11,1990,Crystal Palace,Manchester United,3-0,3,0,1,1,3,3,H
1991-05-11,1990,Liverpool,Tottenham Hotspur,2-0,2,0,1,1,2,2,H
1991-05-11,1990,Luton Town,Derby County,2-0,2,0,1,1,2,2,H
1991-05-11,1990,Manchester City,Sunderland,3-2,3,2,1,1,5,1,H
1991-05-11,1990,Nottingham Forest,Leeds United,4-3,4,3,1,1,7,1,H
1991-05-11,1990,Queens Park Rangers,Everton,1-1,1,1,1,1,2,0,D
1991-05-11,1990,Sheffield United,Norwich City,2-1,2,1,1,1,3,1,H
1991-05-11,1990,Southampton,Wimbledon,1-1,1,1,1,1,2,0,D
1991-05-20,1990,Manchester United,Tottenham Hotspur,1-1,1,1,1,1,2,0,D
1991-08-17,1991,Arsenal,Queens Park Rangers,1-1,1,1,1,1,2,0,D
1991-08-17,1991,Chelsea,Wimbledon,2-2,2,2,1,1,4,0,D
1991-08-17,1991,Coventry City,Manchester City,0-1,0,1,1,1,1,-1,A
1991-08-17,1991,Liverpool,Oldham Athletic,2-1,2,1,1,1,3,1,H
1991-08-17,1991,Manchester United,Notts County,2-0,2,0,1,1,2,2,H
1991-08-17,1991,Norwich City,Sheffield United,2-2,2,2,1,1,4,0,D
1991-08-17,1991,Nottingham Forest,Everton,2-1,2,1,1,1,3,1,H
1991-08-17,1991,Sheffield Wednesday,Aston Villa,2-3,2,3,1,1,5,-1,A
1991-08-17,1991,Southampton,Tottenham Hotspur,2-3,2,3,1,1,5,-1,A
1991-08-17,1991,West Ham United,Luton Town,0-0,0,0,1,1,0,0,D
1991-08-20,1991,Everton,Arsenal,3-1,3,1,1,1,4,2,H
1991-08-20,1991,Leeds United,Nottingham Forest,1-0,1,0,1,1,1,1,H
1991-08-20,1991,Notts County,Southampton,1-0,1,0,1,1,1,1,H
1991-08-20,1991,Sheffield United,West Ham United,1-1,1,1,1,1,2,0,D
1991-08-21,1991,Aston Villa,Manchester United,0-1,0,1,1,1,1,-1,A
1991-08-21,1991,Coventry City,Luton Town,5-0,5,0,1,1,5,5,H
1991-08-21,1991,Manchester City,Liverpool,2-1,2,1,1,1,3,1,H
1991-08-21,1991,Oldham Athletic,Chelsea,3-0,3,0,1,1,3,3,H
1991-08-21,1991,Queens Park Rangers,Norwich City,0-2,0,2,1,1,2,-2,A
1991-08-24,1991,Aston Villa,Arsenal,3-1,3,1,1,1,4,2,H
1991-08-24,1991,Everton,Manchester United,0-0,0,0,1,1,0,0,D
1991-08-24,1991,Leeds United,Sheffield Wednesday,1-1,1,1,1,1,2,0,D
1991-08-24,1991,Luton Town,Liverpool,0-0,0,0,1,1,0,0,D
1991-08-24,1991,Manchester City,Crystal Palace,3-2,3,2,1,1,5,1,H
1991-08-24,1991,Notts County,Nottingham Forest,0-4,0,4,1,1,4,-4,A
1991-08-24,1991,Oldham Athletic,Norwich City,2-2,2,2,1,1,4,0,D
1991-08-24,1991,Queens Park Rangers,Coventry City,1-1,1,1,1,1,2,0,D
1991-08-24,1991,Sheffield United,Southampton,0-2,0,2,1,1,2,-2,A
1991-08-24,1991,Tottenham Hotspur,Chelsea,1-3,1,3,1,1,4,-2,A
1991-08-24,1991,Wimbledon,West Ham United,2-0,2,0,1,1,2,2,H
1991-08-27,1991,Arsenal,Luton Town,2-0,2,0,1,1,2,2,H
1991-08-27,1991,Crystal Palace,Wimbledon,3-2,3,2,1,1,5,1,H
1991-08-27,1991,Liverpool,Queens Park Rangers,1-0,1,0,1,1,1,1,H
1991-08-28,1991,Chelsea,Notts County,2-2,2,2,1,1,4,0,D
1991-08-28,1991,Coventry City,Sheffield United,3-1,3,1,1,1,4,2,H
1991-08-28,1991,Manchester United,Oldham Athletic,1-0,1,0,1,1,1,1,H
1991-08-28,1991,Norwich City,Manchester City,0-0,0,0,1,1,0,0,D
1991-08-28,1991,Nottingham Forest,Tottenham Hotspur,1-3,1,3,1,1,4,-2,A
1991-08-28,1991,Sheffield Wednesday,Everton,2-1,2,1,1,1,3,1,H
1991-08-28,1991,Southampton,Leeds United,0-4,0,4,1,1,4,-4,A
1991-08-28,1991,West Ham United,Aston Villa,3-1,3,1,1,1,4,2,H
1991-08-31,1991,Arsenal,Manchester City,2-1,2,1,1,1,3,1,H
1991-08-31,1991,Chelsea,Luton Town,4-1,4,1,1,1,5,3,H
1991-08-31,1991,Coventry City,Wimbledon,0-1,0,1,1,1,1,-1,A
1991-08-31,1991,Crystal Palace,Sheffield United,2-1,2,1,1,1,3,1,H
1991-08-31,1991,Liverpool,Everton,3-1,3,1,1,1,4,2,H
1991-08-31,1991,Manchester United,Leeds United,1-1,1,1,1,1,2,0,D
1991-08-31,1991,Norwich City,Tottenham Hotspur,0-1,0,1,1,1,1,-1,A
1991-08-31,1991,Nottingham Forest,Oldham Athletic,3-1,3,1,1,1,4,2,H
1991-08-31,1991,Sheffield Wednesday,Queens Park Rangers,4-1,4,1,1,1,5,3,H
1991-08-31,1991,Southampton,Aston Villa,1-1,1,1,1,1,2,0,D
1991-08-31,1991,West Ham United,Notts County,0-2,0,2,1,1,2,-2,A
1991-09-03,1991,Everton,Norwich City,1-1,1,1,1,1,2,0,D
1991-09-03,1991,Leeds United,Arsenal,2-2,2,2,1,1,4,0,D
1991-09-03,1991,Notts County,Sheffield Wednesday,2-1,2,1,1,1,3,1,H
1991-09-03,1991,Oldham Athletic,Coventry City,2-1,2,1,1,1,3,1,H
1991-09-03,1991,Sheffield United,Chelsea,0-1,0,1,1,1,1,-1,A
1991-09-03,1991,Wimbledon,Manchester United,1-2,1,2,1,1,3,-1,A
1991-09-04,1991,Aston Villa,Crystal Palace,0-1,0,1,1,1,1,-1,A
1991-09-04,1991,Luton Town,Southampton,2-1,2,1,1,1,3,1,H
1991-09-04,1991,Manchester City,Nottingham Forest,2-1,2,1,1,1,3,1,H
1991-09-04,1991,Queens Park Rangers,West Ham United,0-0,0,0,1,1,0,0,D
1991-09-07,1991,Arsenal,Coventry City,1-2,1,2,1,1,3,-1,A
1991-09-07,1991,Aston Villa,Tottenham Hotspur,0-0,0,0,1,1,0,0,D
1991-09-07,1991,Everton,Crystal Palace,2-2,2,2,1,1,4,0,D
1991-09-07,1991,Leeds United,Manchester City,3-0,3,0,1,1,3,3,H
1991-09-07,1991,Manchester United,Norwich City,3-0,3,0,1,1,3,3,H
1991-09-07,1991,Notts County,Liverpool,1-2,1,2,1,1,3,-1,A
1991-09-07,1991,Oldham Athletic,Sheffield United,2-1,2,1,1,1,3,1,H
1991-09-07,1991,Queens Park Rangers,Southampton,2-2,2,2,1,1,4,0,D
1991-09-07,1991,Sheffield Wednesday,Nottingham Forest,2-1,2,1,1,1,3,1,H
1991-09-07,1991,West Ham United,Chelsea,1-1,1,1,1,1,2,0,D
1991-09-07,1991,Wimbledon,Luton Town,3-0,3,0,1,1,3,3,H
1991-09-14,1991,Chelsea,Leeds United,0-1,0,1,1,1,1,-1,A
1991-09-14,1991,Coventry City,Notts County,1-0,1,0,1,1,1,1,H
1991-09-14,1991,Crystal Palace,Arsenal,1-4,1,4,1,1,5,-3,A
1991-09-14,1991,Liverpool,Aston Villa,1-1,1,1,1,1,2,0,D
1991-09-14,1991,Luton Town,Oldham Athletic,2-1,2,1,1,1,3,1,H
1991-09-14,1991,Manchester City,Sheffield Wednesday,0-1,0,1,1,1,1,-1,A
1991-09-14,1991,Norwich City,West Ham United,2-1,2,1,1,1,3,1,H
1991-09-14,1991,Nottingham Forest,Wimbledon,4-2,4,2,1,1,6,2,H
1991-09-14,1991,Sheffield United,Everton,2-1,2,1,1,1,3,1,H
1991-09-14,1991,Southampton,Manchester United,0-1,0,1,1,1,1,-1,A
1991-09-14,1991,Tottenham Hotspur,Queens Park Rangers,2-0,2,0,1,1,2,2,H
1991-09-17,1991,Crystal Palace,West Ham United,2-3,2,3,1,1,5,-1,A
1991-09-17,1991,Luton Town,Queens Park Rangers,0-1,0,1,1,1,1,-1,A
1991-09-17,1991,Manchester City,Everton,0-1,0,1,1,1,1,-1,A
1991-09-17,1991,Sheffield United,Notts County,1-3,1,3,1,1,4,-2,A
1991-09-18,1991,Chelsea,Aston Villa,2-0,2,0,1,1,2,2,H
1991-09-18,1991,Coventry City,Leeds United,0-0,0,0,1,1,0,0,D
1991-09-18,1991,Norwich City,Sheffield Wednesday,1-0,1,0,1,1,1,1,H
1991-09-18,1991,Southampton,Wimbledon,1-0,1,0,1,1,1,1,H
1991-09-21,1991,Arsenal,Sheffield United,5-2,5,2,1,1,7,3,H
1991-09-21,1991,Aston Villa,Nottingham Forest,3-1,3,1,1,1,4,2,H
1991-09-21,1991,Everton,Coventry City,3-0,3,0,1,1,3,3,H
1991-09-21,1991,Leeds United,Liverpool,1-0,1,0,1,1,1,1,H
1991-09-21,1991,Manchester United,Luton Town,5-0,5,0,1,1,5,5,H
1991-09-21,1991,Notts County,Norwich City,2-2,2,2,1,1,4,0,D
1991-09-21,1991,Oldham Athletic,Crystal Palace,2-3,2,3,1,1,5,-1,A
1991-09-21,1991,Queens Park Rangers,Chelsea,2-2,2,2,1,1,4,0,D
1991-09-21,1991,Sheffield Wednesday,Southampton,2-0,2,0,1,1,2,2,H
1991-09-21,1991,West Ham United,Manchester City,1-2,1,2,1,1,3,-1,A
1991-09-21,1991,Wimbledon,Tottenham Hotspur,3-5,3,5,1,1,8,-2,A
1991-09-28,1991,Chelsea,Everton,2-2,2,2,1,1,4,0,D
1991-09-28,1991,Coventry City,Aston Villa,1-0,1,0,1,1,1,1,H
1991-09-28,1991,Crystal Palace,Queens Park Rangers,2-2,2,2,1,1,4,0,D
1991-09-28,1991,Liverpool,Sheffield Wednesday,1-1,1,1,1,1,2,0,D
1991-09-28,1991,Luton Town,Notts County,1-1,1,1,1,1,2,0,D
1991-09-28,1991,Manchester City,Oldham Athletic,1-2,1,2,1,1,3,-1,A
1991-09-28,1991,Norwich City,Leeds United,2-2,2,2,1,1,4,0,D
1991-09-28,1991,Nottingham Forest,West Ham United,2-2,2,2,1,1,4,0,D
1991-09-28,1991,Sheffield United,Wimbledon,0-0,0,0,1,1,0,0,D
1991-09-28,1991,Southampton,Arsenal,0-4,0,4,1,1,4,-4,A
1991-09-28,1991,Tottenham Hotspur,Manchester United,1-2,1,2,1,1,3,-1,A
1991-10-01,1991,Crystal Palace,Leeds United,1-0,1,0,1,1,1,1,H
1991-10-02,1991,Wimbledon,Sheffield Wednesday,2-1,2,1,1,1,3,1,H
1991-10-05,1991,Arsenal,Chelsea,3-2,3,2,1,1,5,1,H
1991-10-05,1991,Aston Villa,Luton Town,4-0,4,0,1,1,4,4,H
1991-10-05,1991,Everton,Tottenham Hotspur,3-1,3,1,1,1,4,2,H
1991-10-05,1991,Leeds United,Sheffield United,4-3,4,3,1,1,7,1,H
1991-10-05,1991,Oldham Athletic,Southampton,1-1,1,1,1,1,2,0,D
1991-10-05,1991,Queens Park Rangers,Nottingham Forest,0-2,0,2,1,1,2,-2,A
1991-10-05,1991,Sheffield Wednesday,Crystal Palace,4-1,4,1,1,1,5,3,H
1991-10-05,1991,West Ham United,Coventry City,0-1,0,1,1,1,1,-1,A
1991-10-05,1991,Wimbledon,Norwich City,3-1,3,1,1,1,4,2,H
1991-10-06,1991,Manchester United,Liverpool,0-0,0,0,1,1,0,0,D
1991-10-06,1991,Notts County,Manchester City,1-3,1,3,1,1,4,-2,A
1991-10-19,1991,Chelsea,Liverpool,2-2,2,2,1,1,4,0,D
1991-10-19,1991,Coventry City,Crystal Palace,1-2,1,2,1,1,3,-1,A
1991-10-19,1991,Everton,Aston Villa,0-2,0,2,1,1,2,-2,A
1991-10-19,1991,Luton Town,Sheffield Wednesday,2-2,2,2,1,1,4,0,D
1991-10-19,1991,Manchester United,Arsenal,1-1,1,1,1,1,2,0,D
1991-10-19,1991,Notts County,Leeds United,2-4,2,4,1,1,6,-2,A
1991-10-19,1991,Oldham Athletic,West Ham United,2-2,2,2,1,1,4,0,D
1991-10-19,1991,Sheffield United,Nottingham Forest,4-2,4,2,1,1,6,2,H
1991-10-19,1991,Southampton,Norwich City,0-0,0,0,1,1,0,0,D
1991-10-19,1991,Tottenham Hotspur,Manchester City,0-1,0,1,1,1,1,-1,A
1991-10-19,1991,Wimbledon,Queens Park Rangers,0-1,0,1,1,1,1,-1,A
1991-10-26,1991,Arsenal,Notts County,2-0,2,0,1,1,2,2,H
1991-10-26,1991,Aston Villa,Wimbledon,2-1,2,1,1,1,3,1,H
1991-10-26,1991,Crystal Palace,Chelsea,0-0,0,0,1,1,0,0,D
1991-10-26,1991,Leeds United,Oldham Athletic,1-0,1,0,1,1,1,1,H
1991-10-26,1991,Liverpool,Coventry City,1-0,1,0,1,1,1,1,H
1991-10-26,1991,Manchester City,Sheffield United,3-2,3,2,1,1,5,1,H
1991-10-26,1991,Norwich City,Luton Town,1-0,1,0,1,1,1,1,H
1991-10-26,1991,Nottingham Forest,Southampton,1-3,1,3,1,1,4,-2,A
1991-10-26,1991,Queens Park Rangers,Everton,3-1,3,1,1,1,4,2,H
1991-10-26,1991,Sheffield Wednesday,Manchester United,3-2,3,2,1,1,5,1,H
1991-10-26,1991,West Ham United,Tottenham Hotspur,2-1,2,1,1,1,3,1,H
1991-11-02,1991,Arsenal,West Ham United,0-1,0,1,1,1,1,-1,A
1991-11-02,1991,Coventry City,Chelsea,0-1,0,1,1,1,1,-1,A
1991-11-02,1991,Liverpool,Crystal Palace,1-2,1,2,1,1,3,-1,A
1991-11-02,1991,Luton Town,Everton,0-1,0,1,1,1,1,-1,A
1991-11-02,1991,Manchester United,Sheffield United,2-0,2,0,1,1,2,2,H
1991-11-02,1991,Norwich City,Nottingham Forest,0-0,0,0,1,1,0,0,D
1991-11-02,1991,Notts County,Oldham Athletic,2-0,2,0,1,1,2,2,H
1991-11-02,1991,Queens Park Rangers,Aston Villa,0-1,0,1,1,1,1,-1,A
1991-11-02,1991,Sheffield Wednesday,Tottenham Hotspur,0-0,0,0,1,1,0,0,D
1991-11-02,1991,Southampton,Manchester City,0-3,0,3,1,1,3,-3,A
1991-11-02,1991,Wimbledon,Leeds United,0-0,0,0,1,1,0,0,D
1991-11-16,1991,Aston Villa,Notts County,1-0,1,0,1,1,1,1,H
1991-11-16,1991,Chelsea,Norwich City,0-3,0,3,1,1,3,-3,A
1991-11-16,1991,Crystal Palace,Southampton,1-0,1,0,1,1,1,1,H
1991-11-16,1991,Everton,Wimbledon,2-0,2,0,1,1,2,2,H
1991-11-16,1991,Leeds United,Queens Park Rangers,2-0,2,0,1,1,2,2,H
1991-11-16,1991,Manchester City,Manchester United,0-0,0,0,1,1,0,0,D
1991-11-16,1991,Nottingham Forest,Coventry City,1-0,1,0,1,1,1,1,H
1991-11-16,1991,Oldham Athletic,Arsenal,1-1,1,1,1,1,2,0,D
1991-11-16,1991,Tottenham Hotspur,Luton Town,4-1,4,1,1,1,5,3,H
1991-11-17,1991,Sheffield United,Sheffield Wednesday,2-0,2,0,1,1,2,2,H
1991-11-17,1991,West Ham United,Liverpool,0-0,0,0,1,1,0,0,D
1991-11-23,1991,Everton,Notts County,1-0,1,0,1,1,1,1,H
1991-11-23,1991,Luton Town,Manchester City,2-2,2,2,1,1,4,0,D
1991-11-23,1991,Manchester United,West Ham United,2-1,2,1,1,1,3,1,H
1991-11-23,1991,Norwich City,Coventry City,3-2,3,2,1,1,5,1,H
1991-11-23,1991,Nottingham Forest,Crystal Palace,5-1,5,1,1,1,6,4,H
1991-11-23,1991,Queens Park Rangers,Oldham Athletic,1-3,1,3,1,1,4,-2,A
1991-11-23,1991,Sheffield Wednesday,Arsenal,1-1,1,1,1,1,2,0,D
1991-11-23,1991,Southampton,Chelsea,1-0,1,0,1,1,1,1,H
1991-11-23,1991,Tottenham Hotspur,Sheffield United,0-1,0,1,1,1,1,-1,A
1991-11-23,1991,Wimbledon,Liverpool,0-0,0,0,1,1,0,0,D
1991-11-24,1991,Aston Villa,Leeds United,1-4,1,4,1,1,5,-3,A
1991-11-30,1991,Chelsea,Nottingham Forest,1-0,1,0,1,1,1,1,H
1991-11-30,1991,Coventry City,Southampton,2-0,2,0,1,1,2,2,H
1991-11-30,1991,Crystal Palace,Manchester United,1-3,1,3,1,1,4,-2,A
1991-11-30,1991,Leeds United,Everton,1-0,1,0,1,1,1,1,H
1991-11-30,1991,Liverpool,Norwich City,2-1,2,1,1,1,3,1,H
1991-11-30,1991,Manchester City,Wimbledon,0-0,0,0,1,1,0,0,D
1991-11-30,1991,Notts County,Queens Park Rangers,0-1,0,1,1,1,1,-1,A
1991-11-30,1991,Oldham Athletic,Aston Villa,3-2,3,2,1,1,5,1,H
1991-11-30,1991,Sheffield United,Luton Town,1-1,1,1,1,1,2,0,D
1991-11-30,1991,West Ham United,Sheffield Wednesday,1-2,1,2,1,1,3,-1,A
1991-12-01,1991,Arsenal,Tottenham Hotspur,2-0,2,0,1,1,2,2,H
1991-12-07,1991,Aston Villa,Manchester City,3-1,3,1,1,1,4,2,H
1991-12-07,1991,Everton,West Ham United,4-0,4,0,1,1,4,4,H
1991-12-07,1991,Luton Town,Leeds United,0-2,0,2,1,1,2,-2,A
1991-12-07,1991,Manchester United,Coventry City,4-0,4,0,1,1,4,4,H
1991-12-07,1991,Norwich City,Crystal Palace,3-3,3,3,1,1,6,0,D
1991-12-07,1991,Queens Park Rangers,Sheffield United,1-0,1,0,1,1,1,1,H
1991-12-07,1991,Sheffield Wednesday,Chelsea,3-0,3,0,1,1,3,3,H
1991-12-07,1991,Southampton,Liverpool,1-1,1,1,1,1,2,0,D
1991-12-07,1991,Tottenham Hotspur,Notts County,2-1,2,1,1,1,3,1,H
1991-12-07,1991,Wimbledon,Oldham Athletic,2-1,2,1,1,1,3,1,H
1991-12-08,1991,Nottingham Forest,Arsenal,3-2,3,2,1,1,5,1,H
1991-12-14,1991,Leeds United,Tottenham Hotspur,1-1,1,1,1,1,2,0,D
1991-12-14,1991,Liverpool,Nottingham Forest,2-0,2,0,1,1,2,2,H
1991-12-14,1991,Manchester City,Queens Park Rangers,2-2,2,2,1,1,4,0,D
1991-12-14,1991,Oldham Athletic,Everton,2-2,2,2,1,1,4,0,D
1991-12-14,1991,Sheffield United,Aston Villa,2-0,2,0,1,1,2,2,H
1991-12-15,1991,Chelsea,Manchester United,1-3,1,3,1,1,4,-2,A
1991-12-18,1991,Tottenham Hotspur,Liverpool,1-2,1,2,1,1,3,-1,A
1991-12-20,1991,Luton Town,Coventry City,1-0,1,0,1,1,1,1,H
1991-12-20,1991,Southampton,Notts County,1-1,1,1,1,1,2,0,D
1991-12-21,1991,Arsenal,Everton,4-2,4,2,1,1,6,2,H
1991-12-21,1991,Chelsea,Oldham Athletic,4-2,4,2,1,1,6,2,H
1991-12-21,1991,Liverpool,Manchester City,2-2,2,2,1,1,4,0,D
1991-12-21,1991,Norwich City,Queens Park Rangers,0-1,0,1,1,1,1,-1,A
1991-12-21,1991,Sheffield Wednesday,Wimbledon,2-0,2,0,1,1,2,2,H
1991-12-21,1991,West Ham United,Sheffield United,1-1,1,1,1,1,2,0,D
1991-12-22,1991,Crystal Palace,Tottenham Hotspur,1-2,1,2,1,1,3,-1,A
1991-12-22,1991,Nottingham Forest,Leeds United,0-0,0,0,1,1,0,0,D
1991-12-26,1991,Aston Villa,West Ham United,3-1,3,1,1,1,4,2,H
1991-12-26,1991,Everton,Sheffield Wednesday,0-1,0,1,1,1,1,-1,A
1991-12-26,1991,Leeds United,Southampton,3-3,3,3,1,1,6,0,D
1991-12-26,1991,Luton Town,Arsenal,1-0,1,0,1,1,1,1,H
1991-12-26,1991,Manchester City,Norwich City,2-1,2,1,1,1,3,1,H
1991-12-26,1991,Notts County,Chelsea,2-0,2,0,1,1,2,2,H
1991-12-26,1991,Oldham Athletic,Manchester United,3-6,3,6,1,1,9,-3,A
1991-12-26,1991,Queens Park Rangers,Liverpool,0-0,0,0,1,1,0,0,D
1991-12-26,1991,Sheffield United,Coventry City,0-3,0,3,1,1,3,-3,A
1991-12-26,1991,Tottenham Hotspur,Nottingham Forest,1-2,1,2,1,1,3,-1,A
1991-12-26,1991,Wimbledon,Crystal Palace,1-1,1,1,1,1,2,0,D
1991-12-28,1991,Aston Villa,Southampton,2-1,2,1,1,1,3,1,H
1991-12-28,1991,Everton,Liverpool,1-1,1,1,1,1,2,0,D
1991-12-28,1991,Luton Town,Chelsea,2-0,2,0,1,1,2,2,H
1991-12-28,1991,Manchester City,Arsenal,1-0,1,0,1,1,1,1,H
1991-12-28,1991,Notts County,West Ham United,3-0,3,0,1,1,3,3,H
1991-12-28,1991,Oldham Athletic,Nottingham Forest,2-1,2,1,1,1,3,1,H
1991-12-28,1991,Queens Park Rangers,Sheffield Wednesday,1-1,1,1,1,1,2,0,D
1991-12-28,1991,Sheffield United,Crystal Palace,1-1,1,1,1,1,2,0,D
1991-12-28,1991,Tottenham Hotspur,Norwich City,3-0,3,0,1,1,3,3,H
1991-12-28,1991,Wimbledon,Coventry City,1-1,1,1,1,1,2,0,D
1991-12-29,1991,Leeds United,Manchester United,1-1,1,1,1,1,2,0,D
1992-01-01,1991,Arsenal,Wimbledon,1-1,1,1,1,1,2,0,D
1992-01-01,1991,Chelsea,Manchester City,1-1,1,1,1,1,2,0,D
1992-01-01,1991,Coventry City,Tottenham Hotspur,1-2,1,2,1,1,3,-1,A
1992-01-01,1991,Crystal Palace,Notts County,1-0,1,0,1,1,1,1,H
1992-01-01,1991,Liverpool,Sheffield United,2-1,2,1,1,1,3,1,H
1992-01-01,1991,Manchester United,Queens Park Rangers,1-4,1,4,1,1,5,-3,A
1992-01-01,1991,Norwich City,Aston Villa,2-1,2,1,1,1,3,1,H
1992-01-01,1991,Nottingham Forest,Luton Town,1-1,1,1,1,1,2,0,D
1992-01-01,1991,Sheffield Wednesday,Oldham Athletic,1-1,1,1,1,1,2,0,D
1992-01-01,1991,Southampton,Everton,1-2,1,2,1,1,3,-1,A
1992-01-01,1991,West Ham United,Leeds United,1-3,1,3,1,1,4,-2,A
1992-01-11,1991,Arsenal,Aston Villa,0-0,0,0,1,1,0,0,D
1992-01-11,1991,Chelsea,Tottenham Hotspur,2-0,2,0,1,1,2,2,H
1992-01-11,1991,Coventry City,Queens Park Rangers,2-2,2,2,1,1,4,0,D
1992-01-11,1991,Crystal Palace,Manchester City,1-1,1,1,1,1,2,0,D
1992-01-11,1991,Liverpool,Luton Town,2-1,2,1,1,1,3,1,H
1992-01-11,1991,Manchester United,Everton,1-0,1,0,1,1,1,1,H
1992-01-11,1991,Norwich City,Oldham Athletic,1-2,1,2,1,1,3,-1,A
1992-01-11,1991,Nottingham Forest,Notts County,1-1,1,1,1,1,2,0,D
1992-01-11,1991,Southampton,Sheffield United,2-4,2,4,1,1,6,-2,A
1992-01-11,1991,West Ham United,Wimbledon,1-1,1,1,1,1,2,0,D
1992-01-12,1991,Sheffield Wednesday,Leeds United,1-6,1,6,1,1,7,-5,A
1992-01-18,1991,Aston Villa,Sheffield Wednesday,0-1,0,1,1,1,1,-1,A
1992-01-18,1991,Leeds United,Crystal Palace,1-1,1,1,1,1,2,0,D
1992-01-18,1991,Luton Town,West Ham United,0-1,0,1,1,1,1,-1,A
1992-01-18,1991,Manchester City,Coventry City,1-0,1,0,1,1,1,1,H
1992-01-18,1991,Notts County,Manchester United,1-1,1,1,1,1,2,0,D
1992-01-18,1991,Oldham Athletic,Liverpool,2-3,2,3,1,1,5,-1,A
1992-01-18,1991,Queens Park Rangers,Arsenal,0-0,0,0,1,1,0,0,D
1992-01-18,1991,Sheffield United,Norwich City,1-0,1,0,1,1,1,1,H
1992-01-18,1991,Tottenham Hotspur,Southampton,1-2,1,2,1,1,3,-1,A
1992-01-18,1991,Wimbledon,Chelsea,1-2,1,2,1,1,3,-1,A
1992-01-19,1991,Everton,Nottingham Forest,1-1,1,1,1,1,2,0,D
1992-01-22,1991,Manchester United,Aston Villa,1-0,1,0,1,1,1,1,H
1992-01-25,1991,Tottenham Hotspur,Oldham Athletic,0-0,0,0,1,1,0,0,D
1992-01-29,1991,Liverpool,Arsenal,2-0,2,0,1,1,2,2,H
1992-02-01,1991,Arsenal,Manchester United,1-1,1,1,1,1,2,0,D
1992-02-01,1991,Crystal Palace,Coventry City,0-1,0,1,1,1,1,-1,A
1992-02-01,1991,Leeds United,Notts County,3-0,3,0,1,1,3,3,H
1992-02-01,1991,Liverpool,Chelsea,1-2,1,2,1,1,3,-1,A
1992-02-01,1991,Manchester City,Tottenham Hotspur,1-0,1,0,1,1,1,1,H
1992-02-01,1991,Norwich City,Southampton,2-1,2,1,1,1,3,1,H
1992-02-01,1991,Nottingham Forest,Sheffield United,2-5,2,5,1,1,7,-3,A
1992-02-01,1991,Queens Park Rangers,Wimbledon,1-1,1,1,1,1,2,0,D
1992-02-01,1991,Sheffield Wednesday,Luton Town,3-2,3,2,1,1,5,1,H
1992-02-01,1991,West Ham United,Oldham Athletic,1-0,1,0,1,1,1,1,H
1992-02-02,1991,Aston Villa,Everton,0-0,0,0,1,1,0,0,D
1992-02-08,1991,Chelsea,Crystal Palace,1-1,1,1,1,1,2,0,D
1992-02-08,1991,Coventry City,Liverpool,0-0,0,0,1,1,0,0,D
1992-02-08,1991,Everton,Queens Park Rangers,0-0,0,0,1,1,0,0,D
1992-02-08,1991,Luton Town,Norwich City,2-0,2,0,1,1,2,2,H
1992-02-08,1991,Manchester United,Sheffield Wednesday,1-1,1,1,1,1,2,0,D
1992-02-08,1991,Notts County,Arsenal,0-1,0,1,1,1,1,-1,A
1992-02-08,1991,Oldham Athletic,Leeds United,2-0,2,0,1,1,2,2,H
1992-02-08,1991,Sheffield United,Manchester City,4-2,4,2,1,1,6,2,H
1992-02-08,1991,Wimbledon,Aston Villa,2-0,2,0,1,1,2,2,H
1992-02-11,1991,Arsenal,Norwich City,1-1,1,1,1,1,2,0,D
1992-02-12,1991,Chelsea,Southampton,1-1,1,1,1,1,2,0,D
1992-02-15,1991,Arsenal,Sheffield Wednesday,7-1,7,1,1,1,8,6,H
1992-02-15,1991,Manchester City,Luton Town,4-0,4,0,1,1,4,4,H
1992-02-15,1991,Oldham Athletic,Queens Park Rangers,2-1,2,1,1,1,3,1,H
1992-02-16,1991,Tottenham Hotspur,Crystal Palace,0-1,0,1,1,1,1,-1,A
1992-02-22,1991,Aston Villa,Oldham Athletic,1-0,1,0,1,1,1,1,H
1992-02-22,1991,Luton Town,Sheffield United,2-1,2,1,1,1,3,1,H
1992-02-22,1991,Manchester United,Crystal Palace,2-0,2,0,1,1,2,2,H
1992-02-22,1991,Norwich City,Liverpool,3-0,3,0,1,1,3,3,H
1992-02-22,1991,Nottingham Forest,Chelsea,1-1,1,1,1,1,2,0,D
1992-02-22,1991,Queens Park Rangers,Notts County,1-1,1,1,1,1,2,0,D
1992-02-22,1991,Sheffield Wednesday,West Ham United,2-1,2,1,1,1,3,1,H
1992-02-22,1991,Southampton,Coventry City,0-0,0,0,1,1,0,0,D
1992-02-22,1991,Tottenham Hotspur,Arsenal,1-1,1,1,1,1,2,0,D
1992-02-22,1991,Wimbledon,Manchester City,2-1,2,1,1,1,3,1,H
1992-02-23,1991,Everton,Leeds United,1-1,1,1,1,1,2,0,D
1992-02-25,1991,Crystal Palace,Luton Town,1-1,1,1,1,1,2,0,D
1992-02-25,1991,Notts County,Wimbledon,1-1,1,1,1,1,2,0,D
1992-02-26,1991,Manchester United,Chelsea,1-1,1,1,1,1,2,0,D
1992-02-29,1991,Chelsea,Sheffield Wednesday,0-3,0,3,1,1,3,-3,A
1992-02-29,1991,Coventry City,Manchester United,0-0,0,0,1,1,0,0,D
1992-02-29,1991,Crystal Palace,Norwich City,3-4,3,4,1,1,7,-1,A
1992-02-29,1991,Leeds United,Luton Town,2-0,2,0,1,1,2,2,H
1992-02-29,1991,Liverpool,Southampton,0-0,0,0,1,1,0,0,D
1992-02-29,1991,Manchester City,Aston Villa,2-0,2,0,1,1,2,2,H
1992-02-29,1991,Oldham Athletic,Wimbledon,0-1,0,1,1,1,1,-1,A
1992-02-29,1991,Sheffield United,Queens Park Rangers,0-0,0,0,1,1,0,0,D
1992-02-29,1991,West Ham United,Everton,0-2,0,2,1,1,2,-2,A
1992-03-03,1991,Crystal Palace,Nottingham Forest,0-0,0,0,1,1,0,0,D
1992-03-03,1991,Leeds United,Aston Villa,0-0,0,0,1,1,0,0,D
1992-03-03,1991,Southampton,West Ham United,1-0,1,0,1,1,1,1,H
1992-03-04,1991,Coventry City,Norwich City,0-0,0,0,1,1,0,0,D
1992-03-07,1991,Everton,Oldham Athletic,2-1,2,1,1,1,3,1,H
1992-03-07,1991,Luton Town,Crystal Palace,1-1,1,1,1,1,2,0,D
1992-03-07,1991,Queens Park Rangers,Manchester City,4-0,4,0,1,1,4,4,H
1992-03-07,1991,Sheffield Wednesday,Coventry City,1-1,1,1,1,1,2,0,D
1992-03-07,1991,Tottenham Hotspur,Leeds United,1-3,1,3,1,1,4,-2,A
1992-03-07,1991,Wimbledon,Notts County,2-0,2,0,1,1,2,2,H
1992-03-10,1991,Arsenal,Oldham Athletic,2-1,2,1,1,1,3,1,H
1992-03-10,1991,Notts County,Aston Villa,0-0,0,0,1,1,0,0,D
1992-03-10,1991,Wimbledon,Everton,0-0,0,0,1,1,0,0,D
1992-03-11,1991,Coventry City,Nottingham Forest,0-2,0,2,1,1,2,-2,A
1992-03-11,1991,Liverpool,West Ham United,1-0,1,0,1,1,1,1,H
1992-03-11,1991,Luton Town,Tottenham Hotspur,0-0,0,0,1,1,0,0,D
1992-03-11,1991,Norwich City,Chelsea,0-1,0,1,1,1,1,-1,A
1992-03-11,1991,Queens Park Rangers,Leeds United,4-1,4,1,1,1,5,3,H
1992-03-11,1991,Sheffield Wednesday,Sheffield United,1-3,1,3,1,1,4,-2,A
1992-03-11,1991,Southampton,Crystal Palace,1-0,1,0,1,1,1,1,H
1992-03-14,1991,Aston Villa,Queens Park Rangers,0-1,0,1,1,1,1,-1,A
1992-03-14,1991,Chelsea,Coventry City,0-1,0,1,1,1,1,-1,A
1992-03-14,1991,Crystal Palace,Liverpool,1-0,1,0,1,1,1,1,H
1992-03-14,1991,Everton,Luton Town,1-1,1,1,1,1,2,0,D
1992-03-14,1991,Leeds United,Wimbledon,5-1,5,1,1,1,6,4,H
1992-03-14,1991,Nottingham Forest,Norwich City,2-0,2,0,1,1,2,2,H
1992-03-14,1991,Oldham Athletic,Notts County,4-3,4,3,1,1,7,1,H
1992-03-14,1991,Sheffield United,Manchester United,1-2,1,2,1,1,3,-1,A
1992-03-14,1991,Tottenham Hotspur,Sheffield Wednesday,0-2,0,2,1,1,2,-2,A
1992-03-14,1991,West Ham United,Arsenal,0-2,0,2,1,1,2,-2,A
1992-03-15,1991,Manchester City,Southampton,0-1,0,1,1,1,1,-1,A
1992-03-17,1991,Notts County,Everton,0-0,0,0,1,1,0,0,D
1992-03-18,1991,Nottingham Forest,Manchester United,1-0,1,0,1,1,1,1,H
1992-03-21,1991,Chelsea,Sheffield United,1-2,1,2,1,1,3,-1,A
1992-03-21,1991,Coventry City,Oldham Athletic,1-1,1,1,1,1,2,0,D
1992-03-21,1991,Crystal Palace,Aston Villa,0-0,0,0,1,1,0,0,D
1992-03-21,1991,Liverpool,Tottenham Hotspur,2-1,2,1,1,1,3,1,H
1992-03-21,1991,Manchester United,Wimbledon,0-0,0,0,1,1,0,0,D
1992-03-21,1991,Norwich City,Everton,4-3,4,3,1,1,7,1,H
1992-03-21,1991,Nottingham Forest,Manchester City,2-0,2,0,1,1,2,2,H
1992-03-21,1991,Sheffield Wednesday,Notts County,1-0,1,0,1,1,1,1,H
1992-03-21,1991,Southampton,Luton Town,2-1,2,1,1,1,3,1,H
1992-03-21,1991,West Ham United,Queens Park Rangers,2-2,2,2,1,1,4,0,D
1992-03-22,1991,Arsenal,Leeds United,1-1,1,1,1,1,2,0,D
1992-03-28,1991,Aston Villa,Norwich City,1-0,1,0,1,1,1,1,H
1992-03-28,1991,Leeds United,West Ham United,0-0,0,0,1,1,0,0,D
1992-03-28,1991,Manchester City,Chelsea,0-0,0,0,1,1,0,0,D
1992-03-28,1991,Notts County,Crystal Palace,2-3,2,3,1,1,5,-1,A
1992-03-28,1991,Oldham Athletic,Sheffield Wednesday,3-0,3,0,1,1,3,3,H
1992-03-28,1991,Queens Park Rangers,Manchester United,0-0,0,0,1,1,0,0,D
1992-03-28,1991,Sheffield United,Liverpool,2-0,2,0,1,1,2,2,H
1992-03-28,1991,Tottenham Hotspur,Coventry City,4-3,4,3,1,1,7,1,H
1992-03-28,1991,Wimbledon,Arsenal,1-3,1,3,1,1,4,-2,A
1992-03-31,1991,Arsenal,Nottingham Forest,3-3,3,3,1,1,6,0,D
1992-03-31,1991,Aston Villa,Sheffield United,1-1,1,1,1,1,2,0,D
1992-03-31,1991,Liverpool,Notts County,4-0,4,0,1,1,4,4,H
1992-03-31,1991,Norwich City,Manchester United,1-3,1,3,1,1,4,-2,A
1992-04-01,1991,Everton,Southampton,0-1,0,1,1,1,1,-1,A
1992-04-01,1991,Tottenham Hotspur,West Ham United,3-0,3,0,1,1,3,3,H
1992-04-02,1991,Wimbledon,Nottingham Forest,3-0,3,0,1,1,3,3,H
1992-04-04,1991,Chelsea,West Ham United,2-1,2,1,1,1,3,1,H
1992-04-04,1991,Coventry City,Arsenal,0-1,0,1,1,1,1,-1,A
1992-04-04,1991,Crystal Palace,Everton,2-0,2,0,1,1,2,2,H
1992-04-04,1991,Luton Town,Wimbledon,2-1,2,1,1,1,3,1,H
1992-04-04,1991,Manchester City,Leeds United,4-0,4,0,1,1,4,4,H
1992-04-04,1991,Nottingham Forest,Sheffield Wednesday,0-2,0,2,1,1,2,-2,A
1992-04-04,1991,Sheffield United,Oldham Athletic,2-0,2,0,1,1,2,2,H
1992-04-04,1991,Southampton,Queens Park Rangers,2-1,2,1,1,1,3,1,H
1992-04-04,1991,Tottenham Hotspur,Aston Villa,2-5,2,5,1,1,7,-3,A
1992-04-07,1991,Manchester United,Manchester City,1-1,1,1,1,1,2,0,D
1992-04-07,1991,Notts County,Tottenham Hotspur,0-2,0,2,1,1,2,-2,A
1992-04-08,1991,Coventry City,Sheffield Wednesday,0-0,0,0,1,1,0,0,D
1992-04-08,1991,Liverpool,Wimbledon,2-3,2,3,1,1,5,-1,A
1992-04-08,1991,Norwich City,Arsenal,1-3,1,3,1,1,4,-2,A
1992-04-08,1991,Southampton,Nottingham Forest,0-1,0,1,1,1,1,-1,A
1992-04-11,1991,Arsenal,Crystal Palace,4-1,4,1,1,1,5,3,H
1992-04-11,1991,Aston Villa,Liverpool,1-0,1,0,1,1,1,1,H
1992-04-11,1991,Everton,Sheffield United,0-2,0,2,1,1,2,-2,A
1992-04-11,1991,Leeds United,Chelsea,3-0,3,0,1,1,3,3,H
1992-04-11,1991,Notts County,Coventry City,1-0,1,0,1,1,1,1,H
1992-04-11,1991,Oldham Athletic,Luton Town,5-1,5,1,1,1,6,4,H
1992-04-11,1991,Queens Park Rangers,Tottenham Hotspur,1-2,1,2,1,1,3,-1,A
1992-04-11,1991,Sheffield Wednesday,Manchester City,2-0,2,0,1,1,2,2,H
1992-04-11,1991,West Ham United,Norwich City,4-0,4,0,1,1,4,4,H
1992-04-14,1991,Luton Town,Nottingham Forest,2-1,2,1,1,1,3,1,H
1992-04-14,1991,Sheffield United,Tottenham Hotspur,2-0,2,0,1,1,2,2,H
1992-04-14,1991,West Ham United,Southampton,0-1,0,1,1,1,1,-1,A
1992-04-16,1991,Manchester United,Southampton,1-0,1,0,1,1,1,1,H
1992-04-18,1991,Chelsea,Queens Park Rangers,2-1,2,1,1,1,3,1,H
1992-04-18,1991,Coventry City,Everton,0-1,0,1,1,1,1,-1,A
1992-04-18,1991,Crystal Palace,Oldham Athletic,0-0,0,0,1,1,0,0,D
1992-04-18,1991,Liverpool,Leeds United,0-0,0,0,1,1,0,0,D
1992-04-18,1991,Luton Town,Manchester United,1-1,1,1,1,1,2,0,D
1992-04-18,1991,Manchester City,West Ham United,2-0,2,0,1,1,2,2,H
1992-04-18,1991,Norwich City,Notts County,0-1,0,1,1,1,1,-1,A
1992-04-18,1991,Nottingham Forest,Aston Villa,2-0,2,0,1,1,2,2,H
1992-04-18,1991,Sheffield United,Arsenal,1-1,1,1,1,1,2,0,D
1992-04-18,1991,Southampton,Sheffield Wednesday,0-1,0,1,1,1,1,-1,A
1992-04-18,1991,Tottenham Hotspur,Wimbledon,3-2,3,2,1,1,5,1,H
1992-04-20,1991,Arsenal,Liverpool,4-0,4,0,1,1,4,4,H
1992-04-20,1991,Aston Villa,Chelsea,3-1,3,1,1,1,4,2,H
1992-04-20,1991,Everton,Manchester City,1-2,1,2,1,1,3,-1,A
1992-04-20,1991,Leeds United,Coventry City,2-0,2,0,1,1,2,2,H
1992-04-20,1991,Manchester United,Nottingham Forest,1-2,1,2,1,1,3,-1,A
1992-04-20,1991,Notts County,Sheffield United,1-3,1,3,1,1,4,-2,A
1992-04-20,1991,Oldham Athletic,Tottenham Hotspur,1-0,1,0,1,1,1,1,H
1992-04-20,1991,Queens Park Rangers,Luton Town,2-1,2,1,1,1,3,1,H
1992-04-20,1991,Sheffield Wednesday,Norwich City,2-0,2,0,1,1,2,2,H
1992-04-20,1991,West Ham United,Crystal Palace,0-2,0,2,1,1,2,-2,A
1992-04-20,1991,Wimbledon,Southampton,0-1,0,1,1,1,1,-1,A
1992-04-22,1991,Nottingham Forest,Liverpool,1-1,1,1,1,1,2,0,D
1992-04-22,1991,West Ham United,Manchester United,1-0,1,0,1,1,1,1,H
1992-04-25,1991,Chelsea,Arsenal,1-1,1,1,1,1,2,0,D
1992-04-25,1991,Coventry City,West Ham United,1-0,1,0,1,1,1,1,H
1992-04-25,1991,Crystal Palace,Sheffield Wednesday,1-1,1,1,1,1,2,0,D
1992-04-25,1991,Luton Town,Aston Villa,2-0,2,0,1,1,2,2,H
1992-04-25,1991,Manchester City,Notts County,2-0,2,0,1,1,2,2,H
1992-04-25,1991,Norwich City,Wimbledon,1-1,1,1,1,1,2,0,D
1992-04-25,1991,Nottingham Forest,Queens Park Rangers,1-1,1,1,1,1,2,0,D
1992-04-25,1991,Southampton,Oldham Athletic,1-0,1,0,1,1,1,1,H
1992-04-25,1991,Tottenham Hotspur,Everton,3-3,3,3,1,1,6,0,D
1992-04-26,1991,Liverpool,Manchester United,2-0,2,0,1,1,2,2,H
1992-04-26,1991,Sheffield United,Leeds United,2-3,2,3,1,1,5,-1,A
1992-05-02,1991,Arsenal,Southampton,5-1,5,1,1,1,6,4,H
1992-05-02,1991,Aston Villa,Coventry City,2-0,2,0,1,1,2,2,H
1992-05-02,1991,Everton,Chelsea,2-1,2,1,1,1,3,1,H
1992-05-02,1991,Leeds United,Norwich City,1-0,1,0,1,1,1,1,H
1992-05-02,1991,Manchester United,Tottenham Hotspur,3-1,3,1,1,1,4,2,H
1992-05-02,1991,Notts County,Luton Town,2-1,2,1,1,1,3,1,H
1992-05-02,1991,Oldham Athletic,Manchester City,2-5,2,5,1,1,7,-3,A
1992-05-02,1991,Queens Park Rangers,Crystal Palace,1-0,1,0,1,1,1,1,H
1992-05-02,1991,Sheffield Wednesday,Liverpool,0-0,0,0,1,1,0,0,D
1992-05-02,1991,West Ham United,Nottingham Forest,3-0,3,0,1,1,3,3,H
1992-05-02,1991,Wimbledon,Sheffield United,3-0,3,0,1,1,3,3,H
1992-08-15,1992,Arsenal,Norwich City,2-4,2,4,1,1,6,-2,A
1992-08-15,1992,Chelsea,Oldham Athletic,1-1,1,1,1,1,2,0,D
1992-08-15,1992,Coventry City,Middlesbrough,2-1,2,1,1,1,3,1,H
1992-08-15,1992,Crystal Palace,Blackburn Rovers,3-3,3,3,1,1,6,0,D
1992-08-15,1992,Everton,Sheffield Wednesday,1-1,1,1,1,1,2,0,D
1992-08-15,1992,Ipswich Town,Aston Villa,1-1,1,1,1,1,2,0,D
1992-08-15,1992,Leeds United,Wimbledon,2-1,2,1,1,1,3,1,H
1992-08-15,1992,Sheffield United,Manchester United,2-1,2,1,1,1,3,1,H
1992-08-15,1992,Southampton,Tottenham Hotspur,0-0,0,0,1,1,0,0,D
1992-08-16,1992,Nottingham Forest,Liverpool,1-0,1,0,1,1,1,1,H
1992-08-17,1992,Manchester City,Queens Park Rangers,1-1,1,1,1,1,2,0,D
1992-08-18,1992,Blackburn Rovers,Arsenal,1-0,1,0,1,1,1,1,H
1992-08-18,1992,Wimbledon,Ipswich Town,0-1,0,1,1,1,1,-1,A
1992-08-19,1992,Aston Villa,Leeds United,1-1,1,1,1,1,2,0,D
1992-08-19,1992,Liverpool,Sheffield United,2-1,2,1,1,1,3,1,H
1992-08-19,1992,Manchester United,Everton,0-3,0,3,1,1,3,-3,A
1992-08-19,1992,Middlesbrough,Manchester City,2-0,2,0,1,1,2,2,H
1992-08-19,1992,Norwich City,Chelsea,2-1,2,1,1,1,3,1,H
1992-08-19,1992,Oldham Athletic,Crystal Palace,1-1,1,1,1,1,2,0,D
1992-08-19,1992,Queens Park Rangers,Southampton,3-1,3,1,1,1,4,2,H
1992-08-19,1992,Sheffield Wednesday,Nottingham Forest,2-0,2,0,1,1,2,2,H
1992-08-19,1992,Tottenham Hotspur,Coventry City,0-2,0,2,1,1,2,-2,A
1992-08-22,1992,Aston Villa,Southampton,1-1,1,1,1,1,2,0,D
1992-08-22,1992,Blackburn Rovers,Manchester City,1-0,1,0,1,1,1,1,H
1992-08-22,1992,Manchester United,Ipswich Town,1-1,1,1,1,1,2,0,D
1992-08-22,1992,Middlesbrough,Leeds United,4-1,4,1,1,1,5,3,H
1992-08-22,1992,Norwich City,Everton,1-1,1,1,1,1,2,0,D
1992-08-22,1992,Oldham Athletic,Nottingham Forest,5-3,5,3,1,1,8,2,H
1992-08-22,1992,Queens Park Rangers,Sheffield United,3-2,3,2,1,1,5,1,H
1992-08-22,1992,Sheffield Wednesday,Chelsea,3-3,3,3,1,1,6,0,D
1992-08-22,1992,Tottenham Hotspur,Crystal Palace,2-2,2,2,1,1,4,0,D
1992-08-22,1992,Wimbledon,Coventry City,1-2,1,2,1,1,3,-1,A
1992-08-23,1992,Liverpool,Arsenal,0-2,0,2,1,1,2,-2,A
1992-08-24,1992,Southampton,Manchester United,0-1,0,1,1,1,1,-1,A
1992-08-25,1992,Crystal Palace,Sheffield Wednesday,1-1,1,1,1,1,2,0,D
1992-08-25,1992,Everton,Aston Villa,1-0,1,0,1,1,1,1,H
1992-08-25,1992,Ipswich Town,Liverpool,2-2,2,2,1,1,4,0,D
1992-08-25,1992,Leeds United,Tottenham Hotspur,5-0,5,0,1,1,5,5,H
1992-08-25,1992,Sheffield United,Wimbledon,2-2,2,2,1,1,4,0,D
1992-08-26,1992,Arsenal,Oldham Athletic,2-0,2,0,1,1,2,2,H
1992-08-26,1992,Chelsea,Blackburn Rovers,0-0,0,0,1,1,0,0,D
1992-08-26,1992,Coventry City,Queens Park Rangers,0-1,0,1,1,1,1,-1,A
1992-08-26,1992,Manchester City,Norwich City,3-1,3,1,1,1,4,2,H
1992-08-29,1992,Arsenal,Sheffield Wednesday,2-1,2,1,1,1,3,1,H
1992-08-29,1992,Chelsea,Queens Park Rangers,1-0,1,0,1,1,1,1,H
1992-08-29,1992,Coventry City,Blackburn Rovers,0-2,0,2,1,1,2,-2,A
1992-08-29,1992,Crystal Palace,Norwich City,1-2,1,2,1,1,3,-1,A
1992-08-29,1992,Everton,Wimbledon,0-0,0,0,1,1,0,0,D
1992-08-29,1992,Leeds United,Liverpool,2-2,2,2,1,1,4,0,D
1992-08-29,1992,Manchester City,Oldham Athletic,3-3,3,3,1,1,6,0,D
1992-08-29,1992,Nottingham Forest,Manchester United,0-2,0,2,1,1,2,-2,A
1992-08-29,1992,Sheffield United,Aston Villa,0-2,0,2,1,1,2,-2,A
1992-08-29,1992,Southampton,Middlesbrough,2-1,2,1,1,1,3,1,H
1992-08-30,1992,Ipswich Town,Tottenham Hotspur,1-1,1,1,1,1,2,0,D
1992-08-31,1992,Norwich City,Nottingham Forest,3-1,3,1,1,1,4,2,H
1992-09-01,1992,Liverpool,Southampton,1-1,1,1,1,1,2,0,D
1992-09-01,1992,Middlesbrough,Ipswich Town,2-2,2,2,1,1,4,0,D
1992-09-01,1992,Oldham Athletic,Leeds United,2-2,2,2,1,1,4,0,D
1992-09-01,1992,Wimbledon,Manchester City,0-1,0,1,1,1,1,-1,A
1992-09-02,1992,Aston Villa,Chelsea,1-3,1,3,1,1,4,-2,A
1992-09-02,1992,Manchester United,Crystal Palace,1-0,1,0,1,1,1,1,H
1992-09-02,1992,Queens Park Rangers,Arsenal,0-0,0,0,1,1,0,0,D
1992-09-02,1992,Sheffield Wednesday,Coventry City,1-2,1,2,1,1,3,-1,A
1992-09-02,1992,Tottenham Hotspur,Sheffield United,2-0,2,0,1,1,2,2,H
1992-09-05,1992,Aston Villa,Crystal Palace,3-0,3,0,1,1,3,3,H
1992-09-05,1992,Blackburn Rovers,Nottingham Forest,4-1,4,1,1,1,5,3,H
1992-09-05,1992,Liverpool,Chelsea,2-1,2,1,1,1,3,1,H
1992-09-05,1992,Middlesbrough,Sheffield United,2-0,2,0,1,1,2,2,H
1992-09-05,1992,Norwich City,Southampton,1-0,1,0,1,1,1,1,H
1992-09-05,1992,Oldham Athletic,Coventry City,0-1,0,1,1,1,1,-1,A
1992-09-05,1992,Queens Park Rangers,Ipswich Town,0-0,0,0,1,1,0,0,D
1992-09-05,1992,Sheffield Wednesday,Manchester City,0-3,0,3,1,1,3,-3,A
1992-09-05,1992,Tottenham Hotspur,Everton,2-1,2,1,1,1,3,1,H
1992-09-05,1992,Wimbledon,Arsenal,3-2,3,2,1,1,5,1,H
1992-09-06,1992,Manchester United,Leeds United,2-0,2,0,1,1,2,2,H
1992-09-12,1992,Arsenal,Blackburn Rovers,0-1,0,1,1,1,1,-1,A
1992-09-12,1992,Chelsea,Norwich City,2-3,2,3,1,1,5,-1,A
1992-09-12,1992,Crystal Palace,Oldham Athletic,2-2,2,2,1,1,4,0,D
1992-09-12,1992,Everton,Manchester United,0-2,0,2,1,1,2,-2,A
1992-09-12,1992,Ipswich Town,Wimbledon,2-1,2,1,1,1,3,1,H
1992-09-12,1992,Manchester City,Middlesbrough,0-1,0,1,1,1,1,-1,A
1992-09-12,1992,Nottingham Forest,Sheffield Wednesday,1-2,1,2,1,1,3,-1,A
1992-09-12,1992,Sheffield United,Liverpool,1-0,1,0,1,1,1,1,H
1992-09-12,1992,Southampton,Queens Park Rangers,1-2,1,2,1,1,3,-1,A
1992-09-13,1992,Leeds United,Aston Villa,1-1,1,1,1,1,2,0,D
1992-09-14,1992,Coventry City,Tottenham Hotspur,1-0,1,0,1,1,1,1,H
1992-09-15,1992,Blackburn Rovers,Everton,2-3,2,3,1,1,5,-1,A
1992-09-19,1992,Aston Villa,Liverpool,4-2,4,2,1,1,6,2,H
1992-09-19,1992,Everton,Crystal Palace,0-2,0,2,1,1,2,-2,A
1992-09-19,1992,Norwich City,Sheffield Wednesday,1-0,1,0,1,1,1,1,H
1992-09-19,1992,Oldham Athletic,Ipswich Town,4-2,4,2,1,1,6,2,H
1992-09-19,1992,Queens Park Rangers,Middlesbrough,3-3,3,3,1,1,6,0,D
1992-09-19,1992,Sheffield United,Arsenal,1-1,1,1,1,1,2,0,D
1992-09-19,1992,Southampton,Leeds United,1-1,1,1,1,1,2,0,D
1992-09-19,1992,Tottenham Hotspur,Manchester United,1-1,1,1,1,1,2,0,D
1992-09-19,1992,Wimbledon,Blackburn Rovers,1-1,1,1,1,1,2,0,D
1992-09-20,1992,Manchester City,Chelsea,0-1,0,1,1,1,1,-1,A
1992-09-21,1992,Nottingham Forest,Coventry City,1-1,1,1,1,1,2,0,D
1992-09-26,1992,Blackburn Rovers,Oldham Athletic,2-0,2,0,1,1,2,2,H
1992-09-26,1992,Chelsea,Nottingham Forest,0-0,0,0,1,1,0,0,D
1992-09-26,1992,Coventry City,Norwich City,1-1,1,1,1,1,2,0,D
1992-09-26,1992,Crystal Palace,Southampton,1-2,1,2,1,1,3,-1,A
1992-09-26,1992,Ipswich Town,Sheffield United,0-0,0,0,1,1,0,0,D
1992-09-26,1992,Leeds United,Everton,2-0,2,0,1,1,2,2,H
1992-09-26,1992,Liverpool,Wimbledon,2-3,2,3,1,1,5,-1,A
1992-09-26,1992,Manchester United,Queens Park Rangers,0-0,0,0,1,1,0,0,D
1992-09-26,1992,Middlesbrough,Aston Villa,2-3,2,3,1,1,5,-1,A
1992-09-27,1992,Sheffield Wednesday,Tottenham Hotspur,2-0,2,0,1,1,2,2,H
1992-09-28,1992,Arsenal,Manchester City,1-0,1,0,1,1,1,1,H
1992-10-03,1992,Arsenal,Chelsea,2-1,2,1,1,1,3,1,H
1992-10-03,1992,Blackburn Rovers,Norwich City,7-1,7,1,1,1,8,6,H
1992-10-03,1992,Coventry City,Crystal Palace,2-2,2,2,1,1,4,0,D
1992-10-03,1992,Ipswich Town,Leeds United,4-2,4,2,1,1,6,2,H
1992-10-03,1992,Liverpool,Sheffield Wednesday,1-0,1,0,1,1,1,1,H
1992-10-03,1992,Manchester City,Nottingham Forest,2-2,2,2,1,1,4,0,D
1992-10-03,1992,Middlesbrough,Manchester United,1-1,1,1,1,1,2,0,D
1992-10-03,1992,Queens Park Rangers,Tottenham Hotspur,4-1,4,1,1,1,5,3,H
1992-10-03,1992,Sheffield United,Southampton,2-0,2,0,1,1,2,2,H
1992-10-03,1992,Wimbledon,Aston Villa,2-3,2,3,1,1,5,-1,A
1992-10-04,1992,Oldham Athletic,Everton,1-0,1,0,1,1,1,1,H
1992-10-17,1992,Chelsea,Ipswich Town,2-1,2,1,1,1,3,1,H
1992-10-17,1992,Crystal Palace,Manchester City,0-0,0,0,1,1,0,0,D
1992-10-17,1992,Everton,Coventry City,1-1,1,1,1,1,2,0,D
1992-10-17,1992,Leeds United,Sheffield United,3-1,3,1,1,1,4,2,H
1992-10-17,1992,Norwich City,Queens Park Rangers,2-1,2,1,1,1,3,1,H
1992-10-17,1992,Nottingham Forest,Arsenal,0-1,0,1,1,1,1,-1,A
1992-10-17,1992,Sheffield Wednesday,Oldham Athletic,2-1,2,1,1,1,3,1,H
1992-10-17,1992,Southampton,Wimbledon,2-2,2,2,1,1,4,0,D
1992-10-17,1992,Tottenham Hotspur,Middlesbrough,2-2,2,2,1,1,4,0,D
1992-10-18,1992,Manchester United,Liverpool,2-2,2,2,1,1,4,0,D
1992-10-19,1992,Aston Villa,Blackburn Rovers,0-0,0,0,1,1,0,0,D
1992-10-21,1992,Nottingham Forest,Middlesbrough,1-0,1,0,1,1,1,1,H
1992-10-24,1992,Arsenal,Everton,2-0,2,0,1,1,2,2,H
1992-10-24,1992,Blackburn Rovers,Manchester United,0-0,0,0,1,1,0,0,D
1992-10-24,1992,Coventry City,Chelsea,1-2,1,2,1,1,3,-1,A
1992-10-24,1992,Ipswich Town,Crystal Palace,2-2,2,2,1,1,4,0,D
1992-10-24,1992,Manchester City,Southampton,1-0,1,0,1,1,1,1,H
1992-10-24,1992,Middlesbrough,Sheffield Wednesday,1-1,1,1,1,1,2,0,D
1992-10-24,1992,Oldham Athletic,Aston Villa,1-1,1,1,1,1,2,0,D
1992-10-24,1992,Queens Park Rangers,Leeds United,2-1,2,1,1,1,3,1,H
1992-10-24,1992,Sheffield United,Nottingham Forest,0-0,0,0,1,1,0,0,D
1992-10-25,1992,Liverpool,Norwich City,4-1,4,1,1,1,5,3,H
1992-10-25,1992,Wimbledon,Tottenham Hotspur,1-1,1,1,1,1,2,0,D
1992-10-31,1992,Chelsea,Sheffield United,1-2,1,2,1,1,3,-1,A
1992-10-31,1992,Everton,Manchester City,1-3,1,3,1,1,4,-2,A
1992-10-31,1992,Leeds United,Coventry City,2-2,2,2,1,1,4,0,D
1992-10-31,1992,Manchester United,Wimbledon,0-1,0,1,1,1,1,-1,A
1992-10-31,1992,Norwich City,Middlesbrough,1-1,1,1,1,1,2,0,D
1992-10-31,1992,Nottingham Forest,Ipswich Town,0-1,0,1,1,1,1,-1,A
1992-10-31,1992,Sheffield Wednesday,Blackburn Rovers,0-0,0,0,1,1,0,0,D
1992-10-31,1992,Southampton,Oldham Athletic,1-0,1,0,1,1,1,1,H
1992-10-31,1992,Tottenham Hotspur,Liverpool,2-0,2,0,1,1,2,2,H
1992-11-01,1992,Aston Villa,Queens Park Rangers,2-0,2,0,1,1,2,2,H
1992-11-02,1992,Crystal Palace,Arsenal,1-2,1,2,1,1,3,-1,A
1992-11-07,1992,Arsenal,Coventry City,3-0,3,0,1,1,3,3,H
1992-11-07,1992,Aston Villa,Manchester United,1-0,1,0,1,1,1,1,H
1992-11-07,1992,Blackburn Rovers,Tottenham Hotspur,0-2,0,2,1,1,2,-2,A
1992-11-07,1992,Chelsea,Crystal Palace,3-1,3,1,1,1,4,2,H
1992-11-07,1992,Ipswich Town,Southampton,0-0,0,0,1,1,0,0,D
1992-11-07,1992,Liverpool,Middlesbrough,4-1,4,1,1,1,5,3,H
1992-11-07,1992,Manchester City,Leeds United,4-0,4,0,1,1,4,4,H
1992-11-07,1992,Nottingham Forest,Everton,0-1,0,1,1,1,1,-1,A
1992-11-07,1992,Wimbledon,Queens Park Rangers,0-2,0,2,1,1,2,-2,A
1992-11-08,1992,Sheffield United,Sheffield Wednesday,1-1,1,1,1,1,2,0,D
1992-11-09,1992,Oldham Athletic,Norwich City,2-3,2,3,1,1,5,-1,A
1992-11-21,1992,Coventry City,Manchester City,2-3,2,3,1,1,5,-1,A
1992-11-21,1992,Crystal Palace,Nottingham Forest,1-1,1,1,1,1,2,0,D
1992-11-21,1992,Everton,Chelsea,0-1,0,1,1,1,1,-1,A
1992-11-21,1992,Leeds United,Arsenal,3-0,3,0,1,1,3,3,H
1992-11-21,1992,Manchester United,Oldham Athletic,3-0,3,0,1,1,3,3,H
1992-11-21,1992,Middlesbrough,Wimbledon,2-0,2,0,1,1,2,2,H
1992-11-21,1992,Norwich City,Sheffield United,2-1,2,1,1,1,3,1,H
1992-11-21,1992,Sheffield Wednesday,Ipswich Town,1-1,1,1,1,1,2,0,D
1992-11-21,1992,Tottenham Hotspur,Aston Villa,0-0,0,0,1,1,0,0,D
1992-11-22,1992,Southampton,Blackburn Rovers,1-1,1,1,1,1,2,0,D
1992-11-23,1992,Queens Park Rangers,Liverpool,0-1,0,1,1,1,1,-1,A
1992-11-28,1992,Arsenal,Manchester United,0-1,0,1,1,1,1,-1,A
1992-11-28,1992,Aston Villa,Norwich City,2-3,2,3,1,1,5,-1,A
1992-11-28,1992,Blackburn Rovers,Queens Park Rangers,1-0,1,0,1,1,1,1,H
1992-11-28,1992,Ipswich Town,Everton,1-0,1,0,1,1,1,1,H
1992-11-28,1992,Liverpool,Crystal Palace,5-0,5,0,1,1,5,5,H
1992-11-28,1992,Manchester City,Tottenham Hotspur,0-1,0,1,1,1,1,-1,A
1992-11-28,1992,Nottingham Forest,Southampton,1-2,1,2,1,1,3,-1,A
1992-11-28,1992,Oldham Athletic,Middlesbrough,4-1,4,1,1,1,5,3,H
1992-11-28,1992,Sheffield United,Coventry City,1-1,1,1,1,1,2,0,D
1992-11-28,1992,Wimbledon,Sheffield Wednesday,1-1,1,1,1,1,2,0,D
1992-11-29,1992,Chelsea,Leeds United,1-0,1,0,1,1,1,1,H
1992-12-05,1992,Coventry City,Ipswich Town,2-2,2,2,1,1,4,0,D
1992-12-05,1992,Crystal Palace,Sheffield United,2-0,2,0,1,1,2,2,H
1992-12-05,1992,Leeds United,Nottingham Forest,1-4,1,4,1,1,5,-3,A
1992-12-05,1992,Middlesbrough,Blackburn Rovers,3-2,3,2,1,1,5,1,H
1992-12-05,1992,Norwich City,Wimbledon,2-1,2,1,1,1,3,1,H
1992-12-05,1992,Queens Park Rangers,Oldham Athletic,3-2,3,2,1,1,5,1,H
1992-12-05,1992,Sheffield Wednesday,Aston Villa,1-2,1,2,1,1,3,-1,A
1992-12-05,1992,Southampton,Arsenal,2-0,2,0,1,1,2,2,H
1992-12-05,1992,Tottenham Hotspur,Chelsea,1-2,1,2,1,1,3,-1,A
1992-12-06,1992,Manchester United,Manchester City,2-1,2,1,1,1,3,1,H
1992-12-07,1992,Everton,Liverpool,2-1,2,1,1,1,3,1,H
1992-12-11,1992,Middlesbrough,Chelsea,0-0,0,0,1,1,0,0,D
1992-12-12,1992,Aston Villa,Nottingham Forest,2-1,2,1,1,1,3,1,H
1992-12-12,1992,Ipswich Town,Manchester City,3-1,3,1,1,1,4,2,H
1992-12-12,1992,Leeds United,Sheffield Wednesday,3-1,3,1,1,1,4,2,H
1992-12-12,1992,Manchester United,Norwich City,1-0,1,0,1,1,1,1,H
1992-12-12,1992,Queens Park Rangers,Crystal Palace,1-3,1,3,1,1,4,-2,A
1992-12-12,1992,Sheffield United,Everton,1-0,1,0,1,1,1,1,H
1992-12-12,1992,Southampton,Coventry City,2-2,2,2,1,1,4,0,D
1992-12-12,1992,Tottenham Hotspur,Arsenal,1-0,1,0,1,1,1,1,H
1992-12-12,1992,Wimbledon,Oldham Athletic,5-2,5,2,1,1,7,3,H
1992-12-13,1992,Liverpool,Blackburn Rovers,2-1,2,1,1,1,3,1,H
1992-12-19,1992,Arsenal,Middlesbrough,1-1,1,1,1,1,2,0,D
1992-12-19,1992,Blackburn Rovers,Sheffield United,1-0,1,0,1,1,1,1,H
1992-12-19,1992,Chelsea,Manchester United,1-1,1,1,1,1,2,0,D
1992-12-19,1992,Coventry City,Liverpool,5-1,5,1,1,1,6,4,H
1992-12-19,1992,Everton,Southampton,2-1,2,1,1,1,3,1,H
1992-12-19,1992,Manchester City,Aston Villa,1-1,1,1,1,1,2,0,D
1992-12-19,1992,Oldham Athletic,Tottenham Hotspur,2-1,2,1,1,1,3,1,H
1992-12-19,1992,Sheffield Wednesday,Queens Park Rangers,1-0,1,0,1,1,1,1,H
1992-12-20,1992,Crystal Palace,Leeds United,1-0,1,0,1,1,1,1,H
1992-12-20,1992,Nottingham Forest,Wimbledon,1-1,1,1,1,1,2,0,D
1992-12-21,1992,Norwich City,Ipswich Town,0-2,0,2,1,1,2,-2,A
1992-12-26,1992,Arsenal,Ipswich Town,0-0,0,0,1,1,0,0,D
1992-12-26,1992,Blackburn Rovers,Leeds United,3-1,3,1,1,1,4,2,H
1992-12-26,1992,Chelsea,Southampton,1-1,1,1,1,1,2,0,D
1992-12-26,1992,Coventry City,Aston Villa,3-0,3,0,1,1,3,3,H
1992-12-26,1992,Crystal Palace,Wimbledon,2-0,2,0,1,1,2,2,H
1992-12-26,1992,Everton,Middlesbrough,2-2,2,2,1,1,4,0,D
1992-12-26,1992,Manchester City,Sheffield United,2-0,2,0,1,1,2,2,H
1992-12-26,1992,Norwich City,Tottenham Hotspur,0-0,0,0,1,1,0,0,D
1992-12-26,1992,Sheffield Wednesday,Manchester United,3-3,3,3,1,1,6,0,D
1992-12-28,1992,Aston Villa,Arsenal,1-0,1,0,1,1,1,1,H
1992-12-28,1992,Ipswich Town,Blackburn Rovers,2-1,2,1,1,1,3,1,H
1992-12-28,1992,Leeds United,Norwich City,0-0,0,0,1,1,0,0,D
1992-12-28,1992,Liverpool,Manchester City,1-1,1,1,1,1,2,0,D
1992-12-28,1992,Manchester United,Coventry City,5-0,5,0,1,1,5,5,H
1992-12-28,1992,Middlesbrough,Crystal Palace,0-1,0,1,1,1,1,-1,A
1992-12-28,1992,Queens Park Rangers,Everton,4-2,4,2,1,1,6,2,H
1992-12-28,1992,Southampton,Sheffield Wednesday,1-2,1,2,1,1,3,-1,A
1992-12-28,1992,Tottenham Hotspur,Nottingham Forest,2-1,2,1,1,1,3,1,H
1992-12-28,1992,Wimbledon,Chelsea,0-0,0,0,1,1,0,0,D
1993-01-09,1992,Arsenal,Sheffield United,1-1,1,1,1,1,2,0,D
1993-01-09,1992,Blackburn Rovers,Wimbledon,0-0,0,0,1,1,0,0,D
1993-01-09,1992,Chelsea,Manchester City,2-4,2,4,1,1,6,-2,A
1993-01-09,1992,Coventry City,Nottingham Forest,0-1,0,1,1,1,1,-1,A
1993-01-09,1992,Crystal Palace,Everton,0-2,0,2,1,1,2,-2,A
1993-01-09,1992,Ipswich Town,Oldham Athletic,1-2,1,2,1,1,3,-1,A
1993-01-09,1992,Leeds United,Southampton,2-1,2,1,1,1,3,1,H
1993-01-09,1992,Liverpool,Aston Villa,1-2,1,2,1,1,3,-1,A
1993-01-09,1992,Manchester United,Tottenham Hotspur,4-1,4,1,1,1,5,3,H
1993-01-09,1992,Middlesbrough,Queens Park Rangers,0-1,0,1,1,1,1,-1,A
1993-01-10,1992,Sheffield Wednesday,Norwich City,1-0,1,0,1,1,1,1,H
1993-01-16,1992,Everton,Leeds United,2-0,2,0,1,1,2,2,H
1993-01-16,1992,Manchester City,Arsenal,0-1,0,1,1,1,1,-1,A
1993-01-16,1992,Norwich City,Coventry City,1-1,1,1,1,1,2,0,D
1993-01-16,1992,Nottingham Forest,Chelsea,3-0,3,0,1,1,3,3,H
1993-01-16,1992,Oldham Athletic,Blackburn Rovers,0-1,0,1,1,1,1,-1,A
1993-01-16,1992,Sheffield United,Ipswich Town,3-0,3,0,1,1,3,3,H
1993-01-16,1992,Southampton,Crystal Palace,1-0,1,0,1,1,1,1,H
1993-01-16,1992,Tottenham Hotspur,Sheffield Wednesday,0-2,0,2,1,1,2,-2,A
1993-01-16,1992,Wimbledon,Liverpool,2-0,2,0,1,1,2,2,H
1993-01-17,1992,Aston Villa,Middlesbrough,5-1,5,1,1,1,6,4,H
1993-01-18,1992,Queens Park Rangers,Manchester United,1-3,1,3,1,1,4,-2,A
1993-01-23,1992,Coventry City,Oldham Athletic,3-0,3,0,1,1,3,3,H
1993-01-26,1992,Blackburn Rovers,Coventry City,2-5,2,5,1,1,7,-3,A
1993-01-26,1992,Middlesbrough,Southampton,2-1,2,1,1,1,3,1,H
1993-01-26,1992,Oldham Athletic,Manchester City,0-1,0,1,1,1,1,-1,A
1993-01-26,1992,Wimbledon,Everton,1-3,1,3,1,1,4,-2,A
1993-01-27,1992,Aston Villa,Sheffield United,3-1,3,1,1,1,4,2,H
1993-01-27,1992,Manchester United,Nottingham Forest,2-0,2,0,1,1,2,2,H
1993-01-27,1992,Norwich City,Crystal Palace,4-2,4,2,1,1,6,2,H
1993-01-27,1992,Queens Park Rangers,Chelsea,1-1,1,1,1,1,2,0,D
1993-01-27,1992,Tottenham Hotspur,Ipswich Town,0-2,0,2,1,1,2,-2,A
1993-01-30,1992,Chelsea,Sheffield Wednesday,0-2,0,2,1,1,2,-2,A
1993-01-30,1992,Coventry City,Wimbledon,0-2,0,2,1,1,2,-2,A
1993-01-30,1992,Crystal Palace,Tottenham Hotspur,1-3,1,3,1,1,4,-2,A
1993-01-30,1992,Everton,Norwich City,0-1,0,1,1,1,1,-1,A
1993-01-30,1992,Ipswich Town,Manchester United,2-1,2,1,1,1,3,1,H
1993-01-30,1992,Leeds United,Middlesbrough,3-0,3,0,1,1,3,3,H
1993-01-30,1992,Manchester City,Blackburn Rovers,3-2,3,2,1,1,5,1,H
1993-01-30,1992,Nottingham Forest,Oldham Athletic,2-0,2,0,1,1,2,2,H
1993-01-30,1992,Sheffield United,Queens Park Rangers,1-2,1,2,1,1,3,-1,A
1993-01-30,1992,Southampton,Aston Villa,2-0,2,0,1,1,2,2,H
1993-01-31,1992,Arsenal,Liverpool,0-1,0,1,1,1,1,-1,A
1993-02-02,1992,Blackburn Rovers,Crystal Palace,1-2,1,2,1,1,3,-1,A
1993-02-06,1992,Aston Villa,Ipswich Town,2-0,2,0,1,1,2,2,H
1993-02-06,1992,Liverpool,Nottingham Forest,0-0,0,0,1,1,0,0,D
1993-02-06,1992,Manchester United,Sheffield United,2-1,2,1,1,1,3,1,H
1993-02-06,1992,Middlesbrough,Coventry City,0-2,0,2,1,1,2,-2,A
1993-02-06,1992,Oldham Athletic,Chelsea,3-1,3,1,1,1,4,2,H
1993-02-06,1992,Queens Park Rangers,Manchester City,1-1,1,1,1,1,2,0,D
1993-02-06,1992,Sheffield Wednesday,Everton,3-1,3,1,1,1,4,2,H
1993-02-06,1992,Wimbledon,Leeds United,1-0,1,0,1,1,1,1,H
1993-02-07,1992,Tottenham Hotspur,Southampton,4-2,4,2,1,1,6,2,H
1993-02-08,1992,Leeds United,Manchester United,0-0,0,0,1,1,0,0,D
1993-02-09,1992,Ipswich Town,Queens Park Rangers,1-1,1,1,1,1,2,0,D
1993-02-09,1992,Sheffield United,Middlesbrough,2-0,2,0,1,1,2,2,H
1993-02-10,1992,Arsenal,Wimbledon,0-1,0,1,1,1,1,-1,A
1993-02-10,1992,Chelsea,Liverpool,0-0,0,0,1,1,0,0,D
1993-02-10,1992,Crystal Palace,Aston Villa,1-0,1,0,1,1,1,1,H
1993-02-10,1992,Everton,Tottenham Hotspur,1-2,1,2,1,1,3,-1,A
1993-02-10,1992,Southampton,Norwich City,3-0,3,0,1,1,3,3,H
1993-02-13,1992,Chelsea,Aston Villa,0-1,0,1,1,1,1,-1,A
1993-02-13,1992,Leeds United,Oldham Athletic,2-0,2,0,1,1,2,2,H
1993-02-13,1992,Southampton,Liverpool,2-1,2,1,1,1,3,1,H
1993-02-20,1992,Aston Villa,Everton,2-1,2,1,1,1,3,1,H
1993-02-20,1992,Liverpool,Ipswich Town,0-0,0,0,1,1,0,0,D
1993-02-20,1992,Manchester United,Southampton,2-1,2,1,1,1,3,1,H
1993-02-20,1992,Middlesbrough,Nottingham Forest,1-2,1,2,1,1,3,-1,A
1993-02-20,1992,Norwich City,Manchester City,2-1,2,1,1,1,3,1,H
1993-02-20,1992,Oldham Athletic,Arsenal,0-1,0,1,1,1,1,-1,A
1993-02-20,1992,Queens Park Rangers,Coventry City,2-0,2,0,1,1,2,2,H
1993-02-20,1992,Sheffield Wednesday,Crystal Palace,2-1,2,1,1,1,3,1,H
1993-02-20,1992,Tottenham Hotspur,Leeds United,4-0,4,0,1,1,4,4,H
1993-02-20,1992,Wimbledon,Sheffield United,2-0,2,0,1,1,2,2,H
1993-02-21,1992,Blackburn Rovers,Chelsea,2-0,2,0,1,1,2,2,H
1993-02-22,1992,Sheffield United,Oldham Athletic,2-0,2,0,1,1,2,2,H
1993-02-23,1992,Manchester City,Sheffield Wednesday,1-2,1,2,1,1,3,-1,A
1993-02-24,1992,Arsenal,Leeds United,0-0,0,0,1,1,0,0,D
1993-02-24,1992,Nottingham Forest,Queens Park Rangers,1-0,1,0,1,1,1,1,H
1993-02-27,1992,Aston Villa,Wimbledon,1-0,1,0,1,1,1,1,H
1993-02-27,1992,Crystal Palace,Coventry City,0-0,0,0,1,1,0,0,D
1993-02-27,1992,Everton,Oldham Athletic,2-2,2,2,1,1,4,0,D
1993-02-27,1992,Leeds United,Ipswich Town,1-0,1,0,1,1,1,1,H
1993-02-27,1992,Manchester United,Middlesbrough,3-0,3,0,1,1,3,3,H
1993-02-27,1992,Nottingham Forest,Manchester City,0-2,0,2,1,1,2,-2,A
1993-02-27,1992,Sheffield Wednesday,Liverpool,1-1,1,1,1,1,2,0,D
1993-02-27,1992,Southampton,Sheffield United,3-2,3,2,1,1,5,1,H
1993-02-27,1992,Tottenham Hotspur,Queens Park Rangers,3-2,3,2,1,1,5,1,H
1993-02-28,1992,Norwich City,Blackburn Rovers,0-0,0,0,1,1,0,0,D
1993-03-01,1992,Chelsea,Arsenal,1-0,1,0,1,1,1,1,H
1993-03-02,1992,Ipswich Town,Middlesbrough,0-1,0,1,1,1,1,-1,A
1993-03-02,1992,Sheffield United,Tottenham Hotspur,6-0,6,0,1,1,6,6,H
1993-03-03,1992,Coventry City,Sheffield Wednesday,1-0,1,0,1,1,1,1,H
1993-03-03,1992,Everton,Blackburn Rovers,2-1,2,1,1,1,3,1,H
1993-03-03,1992,Norwich City,Arsenal,1-1,1,1,1,1,2,0,D
1993-03-03,1992,Nottingham Forest,Crystal Palace,1-1,1,1,1,1,2,0,D
1993-03-06,1992,Liverpool,Manchester United,1-2,1,2,1,1,3,-1,A
1993-03-06,1992,Queens Park Rangers,Norwich City,3-1,3,1,1,1,4,2,H
1993-03-06,1992,Wimbledon,Southampton,1-2,1,2,1,1,3,-1,A
1993-03-07,1992,Coventry City,Everton,0-1,0,1,1,1,1,-1,A
1993-03-09,1992,Blackburn Rovers,Southampton,0-0,0,0,1,1,0,0,D
1993-03-09,1992,Oldham Athletic,Manchester United,1-0,1,0,1,1,1,1,H
1993-03-09,1992,Wimbledon,Middlesbrough,2-0,2,0,1,1,2,2,H
1993-03-10,1992,Aston Villa,Tottenham Hotspur,0-0,0,0,1,1,0,0,D
1993-03-10,1992,Chelsea,Everton,2-1,2,1,1,1,3,1,H
1993-03-10,1992,Ipswich Town,Sheffield Wednesday,0-1,0,1,1,1,1,-1,A
1993-03-10,1992,Liverpool,Queens Park Rangers,1-0,1,0,1,1,1,1,H
1993-03-10,1992,Manchester City,Coventry City,1-0,1,0,1,1,1,1,H
1993-03-10,1992,Sheffield United,Norwich City,0-1,0,1,1,1,1,-1,A
1993-03-13,1992,Coventry City,Arsenal,0-2,0,2,1,1,2,-2,A
1993-03-13,1992,Everton,Nottingham Forest,3-0,3,0,1,1,3,3,H
1993-03-13,1992,Leeds United,Manchester City,1-0,1,0,1,1,1,1,H
1993-03-13,1992,Middlesbrough,Liverpool,1-2,1,2,1,1,3,-1,A
1993-03-13,1992,Norwich City,Oldham Athletic,1-0,1,0,1,1,1,1,H
1993-03-13,1992,Queens Park Rangers,Wimbledon,1-2,1,2,1,1,3,-1,A
1993-03-13,1992,Southampton,Ipswich Town,4-3,4,3,1,1,7,1,H
1993-03-14,1992,Manchester United,Aston Villa,1-1,1,1,1,1,2,0,D
1993-03-15,1992,Crystal Palace,Chelsea,1-1,1,1,1,1,2,0,D
1993-03-17,1992,Nottingham Forest,Norwich City,0-3,0,3,1,1,3,-3,A
1993-03-20,1992,Arsenal,Southampton,4-3,4,3,1,1,7,1,H
1993-03-20,1992,Aston Villa,Sheffield Wednesday,2-0,2,0,1,1,2,2,H
1993-03-20,1992,Blackburn Rovers,Middlesbrough,1-1,1,1,1,1,2,0,D
1993-03-20,1992,Chelsea,Tottenham Hotspur,1-1,1,1,1,1,2,0,D
1993-03-20,1992,Ipswich Town,Coventry City,0-0,0,0,1,1,0,0,D
1993-03-20,1992,Liverpool,Everton,1-0,1,0,1,1,1,1,H
1993-03-20,1992,Manchester City,Manchester United,1-1,1,1,1,1,2,0,D
1993-03-20,1992,Oldham Athletic,Queens Park Rangers,2-2,2,2,1,1,4,0,D
1993-03-20,1992,Sheffield United,Crystal Palace,0-1,0,1,1,1,1,-1,A
1993-03-20,1992,Wimbledon,Norwich City,3-0,3,0,1,1,3,3,H
1993-03-21,1992,Nottingham Forest,Leeds United,1-1,1,1,1,1,2,0,D
1993-03-22,1992,Middlesbrough,Oldham Athletic,2-3,2,3,1,1,5,-1,A
1993-03-23,1992,Crystal Palace,Liverpool,1-1,1,1,1,1,2,0,D
1993-03-24,1992,Coventry City,Sheffield United,1-3,1,3,1,1,4,-2,A
1993-03-24,1992,Everton,Ipswich Town,3-0,3,0,1,1,3,3,H
1993-03-24,1992,Leeds United,Chelsea,1-1,1,1,1,1,2,0,D
1993-03-24,1992,Manchester United,Arsenal,0-0,0,0,1,1,0,0,D
1993-03-24,1992,Norwich City,Aston Villa,1-0,1,0,1,1,1,1,H
1993-03-24,1992,Queens Park Rangers,Blackburn Rovers,0-3,0,3,1,1,3,-3,A
1993-03-24,1992,Sheffield Wednesday,Wimbledon,1-1,1,1,1,1,2,0,D
1993-03-24,1992,Southampton,Nottingham Forest,1-2,1,2,1,1,3,-1,A
1993-03-24,1992,Tottenham Hotspur,Manchester City,3-1,3,1,1,1,4,2,H
1993-04-03,1992,Blackburn Rovers,Liverpool,4-1,4,1,1,1,5,3,H
1993-04-03,1992,Chelsea,Middlesbrough,4-0,4,0,1,1,4,4,H
1993-04-03,1992,Coventry City,Southampton,2-0,2,0,1,1,2,2,H
1993-04-03,1992,Crystal Palace,Queens Park Rangers,1-1,1,1,1,1,2,0,D
1993-04-03,1992,Manchester City,Ipswich Town,3-1,3,1,1,1,4,2,H
1993-04-03,1992,Oldham Athletic,Wimbledon,6-2,6,2,1,1,8,4,H
1993-04-04,1992,Nottingham Forest,Aston Villa,0-1,0,1,1,1,1,-1,A
1993-04-05,1992,Norwich City,Manchester United,1-3,1,3,1,1,4,-2,A
1993-04-06,1992,Ipswich Town,Chelsea,1-1,1,1,1,1,2,0,D
1993-04-06,1992,Middlesbrough,Arsenal,1-0,1,0,1,1,1,1,H
1993-04-06,1992,Sheffield United,Leeds United,2-1,2,1,1,1,3,1,H
1993-04-07,1992,Nottingham Forest,Blackburn Rovers,1-3,1,3,1,1,4,-2,A
1993-04-07,1992,Oldham Athletic,Sheffield Wednesday,1-1,1,1,1,1,2,0,D
1993-04-09,1992,Sheffield United,Manchester City,1-1,1,1,1,1,2,0,D
1993-04-09,1992,Tottenham Hotspur,Norwich City,5-1,5,1,1,1,6,4,H
1993-04-09,1992,Wimbledon,Crystal Palace,4-0,4,0,1,1,4,4,H
1993-04-10,1992,Aston Villa,Coventry City,0-0,0,0,1,1,0,0,D
1993-04-10,1992,Ipswich Town,Arsenal,1-2,1,2,1,1,3,-1,A
1993-04-10,1992,Leeds United,Blackburn Rovers,5-2,5,2,1,1,7,3,H
1993-04-10,1992,Liverpool,Oldham Athletic,1-0,1,0,1,1,1,1,H
1993-04-10,1992,Manchester United,Sheffield Wednesday,2-1,2,1,1,1,3,1,H
1993-04-10,1992,Middlesbrough,Everton,1-2,1,2,1,1,3,-1,A
1993-04-10,1992,Queens Park Rangers,Nottingham Forest,4-3,4,3,1,1,7,1,H
1993-04-10,1992,Southampton,Chelsea,1-0,1,0,1,1,1,1,H
1993-04-12,1992,Arsenal,Aston Villa,0-1,0,1,1,1,1,-1,A
1993-04-12,1992,Blackburn Rovers,Ipswich Town,2-1,2,1,1,1,3,1,H
1993-04-12,1992,Chelsea,Wimbledon,4-2,4,2,1,1,6,2,H
1993-04-12,1992,Coventry City,Manchester United,0-1,0,1,1,1,1,-1,A
1993-04-12,1992,Crystal Palace,Middlesbrough,4-1,4,1,1,1,5,3,H
1993-04-12,1992,Everton,Queens Park Rangers,3-5,3,5,1,1,8,-2,A
1993-04-12,1992,Manchester City,Liverpool,1-1,1,1,1,1,2,0,D
1993-04-12,1992,Nottingham Forest,Tottenham Hotspur,2-1,2,1,1,1,3,1,H
1993-04-12,1992,Sheffield Wednesday,Southampton,5-2,5,2,1,1,7,3,H
1993-04-13,1992,Oldham Athletic,Sheffield United,1-1,1,1,1,1,2,0,D
1993-04-14,1992,Norwich City,Leeds United,4-2,4,2,1,1,6,2,H
1993-04-17,1992,Leeds United,Crystal Palace,0-0,0,0,1,1,0,0,D
1993-04-17,1992,Liverpool,Coventry City,4-0,4,0,1,1,4,4,H
1993-04-17,1992,Manchester United,Chelsea,3-0,3,0,1,1,3,3,H
1993-04-17,1992,Sheffield United,Blackburn Rovers,1-3,1,3,1,1,4,-2,A
1993-04-17,1992,Southampton,Everton,0-0,0,0,1,1,0,0,D
1993-04-17,1992,Tottenham Hotspur,Oldham Athletic,4-1,4,1,1,1,5,3,H
1993-04-17,1992,Wimbledon,Nottingham Forest,1-0,1,0,1,1,1,1,H
1993-04-18,1992,Aston Villa,Manchester City,3-1,3,1,1,1,4,2,H
1993-04-19,1992,Ipswich Town,Norwich City,3-1,3,1,1,1,4,2,H
1993-04-20,1992,Middlesbrough,Tottenham Hotspur,3-0,3,0,1,1,3,3,H
1993-04-21,1992,Arsenal,Nottingham Forest,1-1,1,1,1,1,2,0,D
1993-04-21,1992,Blackburn Rovers,Aston Villa,3-0,3,0,1,1,3,3,H
1993-04-21,1992,Crystal Palace,Manchester United,0-2,0,2,1,1,2,-2,A
1993-04-21,1992,Liverpool,Leeds United,2-0,2,0,1,1,2,2,H
1993-04-21,1992,Manchester City,Wimbledon,1-1,1,1,1,1,2,0,D
1993-04-21,1992,Sheffield Wednesday,Sheffield United,1-1,1,1,1,1,2,0,D
1993-05-01,1992,Chelsea,Coventry City,2-1,2,1,1,1,3,1,H
1993-05-01,1992,Crystal Palace,Ipswich Town,3-1,3,1,1,1,4,2,H
1993-05-01,1992,Everton,Arsenal,0-0,0,0,1,1,0,0,D
1993-05-01,1992,Leeds United,Queens Park Rangers,1-1,1,1,1,1,2,0,D
1993-05-01,1992,Norwich City,Liverpool,1-0,1,0,1,1,1,1,H
1993-05-01,1992,Nottingham Forest,Sheffield United,0-2,0,2,1,1,2,-2,A
1993-05-01,1992,Sheffield Wednesday,Middlesbrough,2-3,2,3,1,1,5,-1,A
1993-05-01,1992,Southampton,Manchester City,0-1,0,1,1,1,1,-1,A
1993-05-01,1992,Tottenham Hotspur,Wimbledon,1-1,1,1,1,1,2,0,D
1993-05-02,1992,Aston Villa,Oldham Athletic,0-1,0,1,1,1,1,-1,A
1993-05-03,1992,Manchester United,Blackburn Rovers,3-1,3,1,1,1,4,2,H
1993-05-04,1992,Arsenal,Queens Park Rangers,0-0,0,0,1,1,0,0,D
1993-05-04,1992,Everton,Sheffield United,0-2,0,2,1,1,2,-2,A
1993-05-04,1992,Sheffield Wednesday,Leeds United,1-1,1,1,1,1,2,0,D
1993-05-05,1992,Manchester City,Crystal Palace,0-0,0,0,1,1,0,0,D
1993-05-05,1992,Oldham Athletic,Liverpool,3-2,3,2,1,1,5,1,H
1993-05-05,1992,Tottenham Hotspur,Blackburn Rovers,1-2,1,2,1,1,3,-1,A
1993-05-06,1992,Sheffield Wednesday,Arsenal,1-0,1,0,1,1,1,1,H
1993-05-08,1992,Arsenal,Crystal Palace,3-0,3,0,1,1,3,3,H
1993-05-08,1992,Blackburn Rovers,Sheffield Wednesday,1-0,1,0,1,1,1,1,H
1993-05-08,1992,Coventry City,Leeds United,3-3,3,3,1,1,6,0,D
1993-05-08,1992,Ipswich Town,Nottingham Forest,2-1,2,1,1,1,3,1,H
1993-05-08,1992,Liverpool,Tottenham Hotspur,6-2,6,2,1,1,8,4,H
1993-05-08,1992,Manchester City,Everton,2-5,2,5,1,1,7,-3,A
1993-05-08,1992,Middlesbrough,Norwich City,3-3,3,3,1,1,6,0,D
1993-05-08,1992,Oldham Athletic,Southampton,4-3,4,3,1,1,7,1,H
1993-05-08,1992,Sheffield United,Chelsea,4-2,4,2,1,1,6,2,H
1993-05-09,1992,Queens Park Rangers,Aston Villa,2-1,2,1,1,1,3,1,H
1993-05-09,1992,Wimbledon,Manchester United,1-2,1,2,1,1,3,-1,A
1993-05-11,1992,Arsenal,Tottenham Hotspur,1-3,1,3,1,1,4,-2,A
1993-05-11,1992,Queens Park Rangers,Sheffield Wednesday,3-1,3,1,1,1,4,2,H
1993-08-14,1993,Arsenal,Coventry City,0-3,0,3,1,1,3,-3,A
1993-08-14,1993,Aston Villa,Queens Park Rangers,4-1,4,1,1,1,5,3,H
1993-08-14,1993,Chelsea,Blackburn Rovers,1-2,1,2,1,1,3,-1,A
1993-08-14,1993,Liverpool,Sheffield Wednesday,2-0,2,0,1,1,2,2,H
1993-08-14,1993,Manchester City,Leeds United,1-1,1,1,1,1,2,0,D
1993-08-14,1993,Newcastle United,Tottenham Hotspur,0-1,0,1,1,1,1,-1,A
1993-08-14,1993,Oldham Athletic,Ipswich Town,0-3,0,3,1,1,3,-3,A
1993-08-14,1993,Sheffield United,Swindon Town,3-1,3,1,1,1,4,2,H
1993-08-14,1993,Southampton,Everton,0-2,0,2,1,1,2,-2,A
1993-08-14,1993,West Ham United,Wimbledon,0-2,0,2,1,1,2,-2,A
1993-08-15,1993,Norwich City,Manchester United,0-2,0,2,1,1,2,-2,A
1993-08-16,1993,Tottenham Hotspur,Arsenal,0-1,0,1,1,1,1,-1,A
1993-08-17,1993,Everton,Manchester City,1-0,1,0,1,1,1,1,H
1993-08-17,1993,Ipswich Town,Southampton,1-0,1,0,1,1,1,1,H
1993-08-17,1993,Leeds United,West Ham United,1-0,1,0,1,1,1,1,H
1993-08-17,1993,Wimbledon,Chelsea,1-1,1,1,1,1,2,0,D
1993-08-18,1993,Blackburn Rovers,Norwich City,2-3,2,3,1,1,5,-1,A
1993-08-18,1993,Coventry City,Newcastle United,2-1,2,1,1,1,3,1,H
1993-08-18,1993,Manchester United,Sheffield United,3-0,3,0,1,1,3,3,H
1993-08-18,1993,Queens Park Rangers,Liverpool,1-3,1,3,1,1,4,-2,A
1993-08-18,1993,Sheffield Wednesday,Aston Villa,0-0,0,0,1,1,0,0,D
1993-08-18,1993,Swindon Town,Oldham Athletic,0-1,0,1,1,1,1,-1,A
1993-08-21,1993,Blackburn Rovers,Oldham Athletic,1-0,1,0,1,1,1,1,H
1993-08-21,1993,Coventry City,West Ham United,1-1,1,1,1,1,2,0,D
1993-08-21,1993,Everton,Sheffield United,4-2,4,2,1,1,6,2,H
1993-08-21,1993,Ipswich Town,Chelsea,1-0,1,0,1,1,1,1,H
1993-08-21,1993,Leeds United,Norwich City,0-4,0,4,1,1,4,-4,A
1993-08-21,1993,Manchester United,Newcastle United,1-1,1,1,1,1,2,0,D
1993-08-21,1993,Queens Park Rangers,Southampton,2-1,2,1,1,1,3,1,H
1993-08-21,1993,Sheffield Wednesday,Arsenal,0-1,0,1,1,1,1,-1,A
1993-08-21,1993,Tottenham Hotspur,Manchester City,1-0,1,0,1,1,1,1,H
1993-08-21,1993,Wimbledon,Aston Villa,2-2,2,2,1,1,4,0,D
1993-08-22,1993,Swindon Town,Liverpool,0-5,0,5,1,1,5,-5,A
1993-08-23,1993,Aston Villa,Manchester United,1-2,1,2,1,1,3,-1,A
1993-08-24,1993,Arsenal,Leeds United,2-1,2,1,1,1,3,1,H
1993-08-24,1993,Manchester City,Blackburn Rovers,0-2,0,2,1,1,2,-2,A
1993-08-24,1993,Oldham Athletic,Coventry City,3-3,3,3,1,1,6,0,D
1993-08-24,1993,Sheffield United,Wimbledon,2-1,2,1,1,1,3,1,H
1993-08-25,1993,Chelsea,Queens Park Rangers,2-0,2,0,1,1,2,2,H
1993-08-25,1993,Liverpool,Tottenham Hotspur,1-2,1,2,1,1,3,-1,A
1993-08-25,1993,Newcastle United,Everton,1-0,1,0,1,1,1,1,H
1993-08-25,1993,Norwich City,Ipswich Town,1-0,1,0,1,1,1,1,H
1993-08-25,1993,Southampton,Swindon Town,5-1,5,1,1,1,6,4,H
1993-08-25,1993,West Ham United,Sheffield Wednesday,2-0,2,0,1,1,2,2,H
1993-08-27,1993,Manchester City,Coventry City,1-1,1,1,1,1,2,0,D
1993-08-28,1993,Arsenal,Everton,2-0,2,0,1,1,2,2,H
1993-08-28,1993,Aston Villa,Tottenham Hotspur,1-0,1,0,1,1,1,1,H
1993-08-28,1993,Chelsea,Sheffield Wednesday,1-1,1,1,1,1,2,0,D
1993-08-28,1993,Liverpool,Leeds United,2-0,2,0,1,1,2,2,H
1993-08-28,1993,Norwich City,Swindon Town,0-0,0,0,1,1,0,0,D
1993-08-28,1993,Oldham Athletic,Wimbledon,1-1,1,1,1,1,2,0,D
1993-08-28,1993,Sheffield United,Ipswich Town,1-1,1,1,1,1,2,0,D
1993-08-28,1993,Southampton,Manchester United,1-3,1,3,1,1,4,-2,A
1993-08-28,1993,West Ham United,Queens Park Rangers,0-4,0,4,1,1,4,-4,A
1993-08-29,1993,Newcastle United,Blackburn Rovers,1-1,1,1,1,1,2,0,D
1993-08-30,1993,Leeds United,Oldham Athletic,1-0,1,0,1,1,1,1,H
1993-08-31,1993,Everton,Aston Villa,0-1,0,1,1,1,1,-1,A
1993-08-31,1993,Ipswich Town,Newcastle United,1-1,1,1,1,1,2,0,D
1993-08-31,1993,Wimbledon,Southampton,1-0,1,0,1,1,1,1,H
1993-09-01,1993,Blackburn Rovers,Arsenal,1-1,1,1,1,1,2,0,D
1993-09-01,1993,Coventry City,Liverpool,1-0,1,0,1,1,1,1,H
1993-09-01,1993,Manchester United,West Ham United,3-0,3,0,1,1,3,3,H
1993-09-01,1993,Queens Park Rangers,Sheffield United,2-1,2,1,1,1,3,1,H
1993-09-01,1993,Sheffield Wednesday,Norwich City,3-3,3,3,1,1,6,0,D
1993-09-01,1993,Swindon Town,Manchester City,1-3,1,3,1,1,4,-2,A
1993-09-01,1993,Tottenham Hotspur,Chelsea,1-1,1,1,1,1,2,0,D
1993-09-11,1993,Arsenal,Ipswich Town,4-0,4,0,1,1,4,4,H
1993-09-11,1993,Aston Villa,Coventry City,0-0,0,0,1,1,0,0,D
1993-09-11,1993,Chelsea,Manchester United,1-0,1,0,1,1,1,1,H
1993-09-11,1993,Manchester City,Queens Park Rangers,3-0,3,0,1,1,3,3,H
1993-09-11,1993,Norwich City,Wimbledon,0-1,0,1,1,1,1,-1,A
1993-09-11,1993,Oldham Athletic,Everton,0-1,0,1,1,1,1,-1,A
1993-09-11,1993,Sheffield United,Tottenham Hotspur,2-2,2,2,1,1,4,0,D
1993-09-11,1993,Southampton,Leeds United,0-2,0,2,1,1,2,-2,A
1993-09-11,1993,West Ham United,Swindon Town,0-0,0,0,1,1,0,0,D
1993-09-12,1993,Liverpool,Blackburn Rovers,0-1,0,1,1,1,1,-1,A
1993-09-13,1993,Newcastle United,Sheffield Wednesday,4-2,4,2,1,1,6,2,H
1993-09-18,1993,Blackburn Rovers,West Ham United,0-2,0,2,1,1,2,-2,A
1993-09-18,1993,Coventry City,Chelsea,1-1,1,1,1,1,2,0,D
1993-09-18,1993,Everton,Liverpool,2-0,2,0,1,1,2,2,H
1993-09-18,1993,Ipswich Town,Aston Villa,1-2,1,2,1,1,3,-1,A
1993-09-18,1993,Leeds United,Sheffield United,2-1,2,1,1,1,3,1,H
1993-09-18,1993,Queens Park Rangers,Norwich City,2-2,2,2,1,1,4,0,D
1993-09-18,1993,Sheffield Wednesday,Southampton,2-0,2,0,1,1,2,2,H
1993-09-18,1993,Swindon Town,Newcastle United,2-2,2,2,1,1,4,0,D
1993-09-18,1993,Tottenham Hotspur,Oldham Athletic,5-0,5,0,1,1,5,5,H
1993-09-19,1993,Manchester United,Arsenal,1-0,1,0,1,1,1,1,H
1993-09-20,1993,Wimbledon,Manchester City,1-0,1,0,1,1,1,1,H
1993-09-25,1993,Arsenal,Southampton,1-0,1,0,1,1,1,1,H
1993-09-25,1993,Blackburn Rovers,Sheffield Wednesday,1-1,1,1,1,1,2,0,D
1993-09-25,1993,Chelsea,Liverpool,1-0,1,0,1,1,1,1,H
1993-09-25,1993,Coventry City,Leeds United,0-2,0,2,1,1,2,-2,A
1993-09-25,1993,Everton,Norwich City,1-5,1,5,1,1,6,-4,A
1993-09-25,1993,Manchester United,Swindon Town,4-2,4,2,1,1,6,2,H
1993-09-25,1993,Newcastle United,West Ham United,2-0,2,0,1,1,2,2,H
1993-09-25,1993,Oldham Athletic,Aston Villa,1-1,1,1,1,1,2,0,D
1993-09-25,1993,Sheffield United,Manchester City,0-1,0,1,1,1,1,-1,A
1993-09-26,1993,Ipswich Town,Tottenham Hotspur,2-2,2,2,1,1,4,0,D
1993-09-27,1993,Wimbledon,Queens Park Rangers,1-1,1,1,1,1,2,0,D
1993-10-02,1993,Aston Villa,Newcastle United,0-2,0,2,1,1,2,-2,A
1993-10-02,1993,Leeds United,Wimbledon,4-0,4,0,1,1,4,4,H
1993-10-02,1993,Liverpool,Arsenal,0-0,0,0,1,1,0,0,D
1993-10-02,1993,Norwich City,Coventry City,1-0,1,0,1,1,1,1,H
1993-10-02,1993,Queens Park Rangers,Ipswich Town,3-0,3,0,1,1,3,3,H
1993-10-02,1993,Sheffield Wednesday,Manchester United,2-3,2,3,1,1,5,-1,A
1993-10-02,1993,Southampton,Sheffield United,3-3,3,3,1,1,6,0,D
1993-10-02,1993,Swindon Town,Blackburn Rovers,1-3,1,3,1,1,4,-2,A
1993-10-02,1993,West Ham United,Chelsea,1-0,1,0,1,1,1,1,H
1993-10-03,1993,Tottenham Hotspur,Everton,3-2,3,2,1,1,5,1,H
1993-10-04,1993,Manchester City,Oldham Athletic,1-1,1,1,1,1,2,0,D
1993-10-16,1993,Arsenal,Manchester City,0-0,0,0,1,1,0,0,D
1993-10-16,1993,Chelsea,Norwich City,1-2,1,2,1,1,3,-1,A
1993-10-16,1993,Coventry City,Southampton,1-1,1,1,1,1,2,0,D
1993-10-16,1993,Liverpool,Oldham Athletic,2-1,2,1,1,1,3,1,H
1993-10-16,1993,Manchester United,Tottenham Hotspur,2-1,2,1,1,1,3,1,H
1993-10-16,1993,Newcastle United,Queens Park Rangers,1-2,1,2,1,1,3,-1,A
1993-10-16,1993,Sheffield Wednesday,Wimbledon,2-2,2,2,1,1,4,0,D
1993-10-16,1993,Swindon Town,Everton,1-1,1,1,1,1,2,0,D
1993-10-16,1993,West Ham United,Aston Villa,0-0,0,0,1,1,0,0,D
1993-10-17,1993,Ipswich Town,Leeds United,0-0,0,0,1,1,0,0,D
1993-10-18,1993,Blackburn Rovers,Sheffield United,0-0,0,0,1,1,0,0,D
1993-10-23,1993,Aston Villa,Chelsea,1-0,1,0,1,1,1,1,H
1993-10-23,1993,Everton,Manchester United,0-1,0,1,1,1,1,-1,A
1993-10-23,1993,Leeds United,Blackburn Rovers,3-3,3,3,1,1,6,0,D
1993-10-23,1993,Manchester City,Liverpool,1-1,1,1,1,1,2,0,D
1993-10-23,1993,Norwich City,West Ham United,0-0,0,0,1,1,0,0,D
1993-10-23,1993,Oldham Athletic,Arsenal,0-0,0,0,1,1,0,0,D
1993-10-23,1993,Queens Park Rangers,Coventry City,5-1,5,1,1,1,6,4,H
1993-10-23,1993,Sheffield United,Sheffield Wednesday,1-1,1,1,1,1,2,0,D
1993-10-23,1993,Tottenham Hotspur,Swindon Town,1-1,1,1,1,1,2,0,D
1993-10-24,1993,Southampton,Newcastle United,2-1,2,1,1,1,3,1,H
1993-10-25,1993,Wimbledon,Ipswich Town,0-2,0,2,1,1,2,-2,A
1993-10-30,1993,Arsenal,Norwich City,0-0,0,0,1,1,0,0,D
1993-10-30,1993,Blackburn Rovers,Tottenham Hotspur,1-0,1,0,1,1,1,1,H
1993-10-30,1993,Chelsea,Oldham Athletic,0-1,0,1,1,1,1,-1,A
1993-10-30,1993,Ipswich Town,Everton,0-2,0,2,1,1,2,-2,A
1993-10-30,1993,Liverpool,Southampton,4-2,4,2,1,1,6,2,H
1993-10-30,1993,Manchester United,Queens Park Rangers,2-1,2,1,1,1,3,1,H
1993-10-30,1993,Newcastle United,Wimbledon,4-0,4,0,1,1,4,4,H
1993-10-30,1993,Sheffield Wednesday,Leeds United,3-3,3,3,1,1,6,0,D
1993-10-30,1993,Swindon Town,Aston Villa,1-2,1,2,1,1,3,-1,A
1993-10-31,1993,Coventry City,Sheffield United,0-0,0,0,1,1,0,0,D
1993-11-01,1993,West Ham United,Manchester City,3-1,3,1,1,1,4,2,H
1993-11-06,1993,Arsenal,Aston Villa,1-2,1,2,1,1,3,-1,A
1993-11-06,1993,Coventry City,Everton,2-1,2,1,1,1,3,1,H
1993-11-06,1993,Ipswich Town,Sheffield Wednesday,1-4,1,4,1,1,5,-3,A
1993-11-06,1993,Leeds United,Chelsea,4-1,4,1,1,1,5,3,H
1993-11-06,1993,Liverpool,West Ham United,2-0,2,0,1,1,2,2,H
1993-11-06,1993,Queens Park Rangers,Blackburn Rovers,1-0,1,0,1,1,1,1,H
1993-11-06,1993,Sheffield United,Norwich City,1-2,1,2,1,1,3,-1,A
1993-11-06,1993,Southampton,Tottenham Hotspur,1-0,1,0,1,1,1,1,H
1993-11-06,1993,Wimbledon,Swindon Town,3-0,3,0,1,1,3,3,H
1993-11-07,1993,Manchester City,Manchester United,2-3,2,3,1,1,5,-1,A
1993-11-08,1993,Oldham Athletic,Newcastle United,1-3,1,3,1,1,4,-2,A
1993-11-20,1993,Aston Villa,Sheffield United,1-0,1,0,1,1,1,1,H
1993-11-20,1993,Blackburn Rovers,Southampton,2-0,2,0,1,1,2,2,H
1993-11-20,1993,Chelsea,Arsenal,0-2,0,2,1,1,2,-2,A
1993-11-20,1993,Everton,Queens Park Rangers,0-3,0,3,1,1,3,-3,A
1993-11-20,1993,Manchester United,Wimbledon,3-1,3,1,1,1,4,2,H
1993-11-20,1993,Norwich City,Manchester City,1-1,1,1,1,1,2,0,D
1993-11-20,1993,Sheffield Wednesday,Coventry City,0-0,0,0,1,1,0,0,D
1993-11-20,1993,Swindon Town,Ipswich Town,2-2,2,2,1,1,4,0,D
1993-11-20,1993,Tottenham Hotspur,Leeds United,1-1,1,1,1,1,2,0,D
1993-11-20,1993,West Ham United,Oldham Athletic,2-0,2,0,1,1,2,2,H
1993-11-21,1993,Newcastle United,Liverpool,3-0,3,0,1,1,3,3,H
1993-11-22,1993,Chelsea,Manchester City,0-0,0,0,1,1,0,0,D
1993-11-23,1993,Blackburn Rovers,Coventry City,2-1,2,1,1,1,3,1,H
1993-11-23,1993,Everton,Leeds United,1-1,1,1,1,1,2,0,D
1993-11-24,1993,Aston Villa,Southampton,0-2,0,2,1,1,2,-2,A
1993-11-24,1993,Manchester United,Ipswich Town,0-0,0,0,1,1,0,0,D
1993-11-24,1993,Newcastle United,Sheffield United,4-0,4,0,1,1,4,4,H
1993-11-24,1993,Sheffield Wednesday,Oldham Athletic,3-0,3,0,1,1,3,3,H
1993-11-24,1993,Swindon Town,Queens Park Rangers,1-0,1,0,1,1,1,1,H
1993-11-24,1993,Tottenham Hotspur,Wimbledon,1-1,1,1,1,1,2,0,D
1993-11-24,1993,West Ham United,Arsenal,0-0,0,0,1,1,0,0,D
1993-11-27,1993,Arsenal,Newcastle United,2-1,2,1,1,1,3,1,H
1993-11-27,1993,Coventry City,Manchester United,0-1,0,1,1,1,1,-1,A
1993-11-27,1993,Ipswich Town,Blackburn Rovers,1-0,1,0,1,1,1,1,H
1993-11-27,1993,Leeds United,Swindon Town,3-0,3,0,1,1,3,3,H
1993-11-27,1993,Manchester City,Sheffield Wednesday,1-3,1,3,1,1,4,-2,A
1993-11-27,1993,Oldham Athletic,Norwich City,2-1,2,1,1,1,3,1,H
1993-11-27,1993,Queens Park Rangers,Tottenham Hotspur,1-1,1,1,1,1,2,0,D
1993-11-27,1993,Sheffield United,Chelsea,1-0,1,0,1,1,1,1,H
1993-11-27,1993,Wimbledon,Everton,1-1,1,1,1,1,2,0,D
1993-11-28,1993,Liverpool,Aston Villa,2-1,2,1,1,1,3,1,H
1993-11-29,1993,Southampton,West Ham United,0-2,0,2,1,1,2,-2,A
1993-12-04,1993,Coventry City,Arsenal,1-0,1,0,1,1,1,1,H
1993-12-04,1993,Everton,Southampton,1-0,1,0,1,1,1,1,H
1993-12-04,1993,Ipswich Town,Oldham Athletic,0-0,0,0,1,1,0,0,D
1993-12-04,1993,Leeds United,Manchester City,3-2,3,2,1,1,5,1,H
1993-12-04,1993,Manchester United,Norwich City,2-2,2,2,1,1,4,0,D
1993-12-04,1993,Queens Park Rangers,Aston Villa,2-2,2,2,1,1,4,0,D
1993-12-04,1993,Sheffield Wednesday,Liverpool,3-1,3,1,1,1,4,2,H
1993-12-04,1993,Swindon Town,Sheffield United,0-0,0,0,1,1,0,0,D
1993-12-04,1993,Tottenham Hotspur,Newcastle United,1-2,1,2,1,1,3,-1,A
1993-12-04,1993,Wimbledon,West Ham United,1-2,1,2,1,1,3,-1,A
1993-12-05,1993,Blackburn Rovers,Chelsea,2-0,2,0,1,1,2,2,H
1993-12-06,1993,Arsenal,Tottenham Hotspur,1-1,1,1,1,1,2,0,D
1993-12-07,1993,Oldham Athletic,Swindon Town,2-1,2,1,1,1,3,1,H
1993-12-07,1993,Sheffield United,Manchester United,0-3,0,3,1,1,3,-3,A
1993-12-08,1993,Aston Villa,Sheffield Wednesday,2-2,2,2,1,1,4,0,D
1993-12-08,1993,Liverpool,Queens Park Rangers,3-2,3,2,1,1,5,1,H
1993-12-08,1993,Manchester City,Everton,1-0,1,0,1,1,1,1,H
1993-12-08,1993,Southampton,Ipswich Town,0-1,0,1,1,1,1,-1,A
1993-12-08,1993,West Ham United,Leeds United,0-1,0,1,1,1,1,-1,A
1993-12-11,1993,Aston Villa,Wimbledon,0-1,0,1,1,1,1,-1,A
1993-12-11,1993,Chelsea,Ipswich Town,1-1,1,1,1,1,2,0,D
1993-12-11,1993,Liverpool,Swindon Town,2-2,2,2,1,1,4,0,D
1993-12-11,1993,Manchester City,Tottenham Hotspur,0-2,0,2,1,1,2,-2,A
1993-12-11,1993,Newcastle United,Manchester United,1-1,1,1,1,1,2,0,D
1993-12-11,1993,Oldham Athletic,Blackburn Rovers,1-2,1,2,1,1,3,-1,A
1993-12-11,1993,Sheffield United,Everton,0-0,0,0,1,1,0,0,D
1993-12-11,1993,Southampton,Queens Park Rangers,0-1,0,1,1,1,1,-1,A
1993-12-11,1993,West Ham United,Coventry City,3-2,3,2,1,1,5,1,H
1993-12-12,1993,Arsenal,Sheffield Wednesday,1-0,1,0,1,1,1,1,H
1993-12-13,1993,Norwich City,Leeds United,2-1,2,1,1,1,3,1,H
1993-12-18,1993,Blackburn Rovers,Manchester City,2-0,2,0,1,1,2,2,H
1993-12-18,1993,Coventry City,Oldham Athletic,1-1,1,1,1,1,2,0,D
1993-12-18,1993,Everton,Newcastle United,0-2,0,2,1,1,2,-2,A
1993-12-18,1993,Ipswich Town,Norwich City,2-1,2,1,1,1,3,1,H
1993-12-18,1993,Leeds United,Arsenal,2-1,2,1,1,1,3,1,H
1993-12-18,1993,Sheffield Wednesday,West Ham United,5-0,5,0,1,1,5,5,H
1993-12-18,1993,Swindon Town,Southampton,2-1,2,1,1,1,3,1,H
1993-12-18,1993,Tottenham Hotspur,Liverpool,3-3,3,3,1,1,6,0,D
1993-12-18,1993,Wimbledon,Sheffield United,2-0,2,0,1,1,2,2,H
1993-12-19,1993,Manchester United,Aston Villa,3-1,3,1,1,1,4,2,H
1993-12-22,1993,Newcastle United,Leeds United,1-1,1,1,1,1,2,0,D
1993-12-26,1993,Manchester United,Blackburn Rovers,1-1,1,1,1,1,2,0,D
1993-12-26,1993,Sheffield United,Liverpool,0-0,0,0,1,1,0,0,D
1993-12-26,1993,Wimbledon,Coventry City,1-2,1,2,1,1,3,-1,A
1993-12-27,1993,Everton,Sheffield Wednesday,0-2,0,2,1,1,2,-2,A
1993-12-27,1993,Ipswich Town,West Ham United,1-1,1,1,1,1,2,0,D
1993-12-27,1993,Queens Park Rangers,Oldham Athletic,2-0,2,0,1,1,2,2,H
1993-12-27,1993,Southampton,Chelsea,3-1,3,1,1,1,4,2,H
1993-12-27,1993,Swindon Town,Arsenal,0-4,0,4,1,1,4,-4,A
1993-12-27,1993,Tottenham Hotspur,Norwich City,1-3,1,3,1,1,4,-2,A
1993-12-28,1993,Chelsea,Newcastle United,1-0,1,0,1,1,1,1,H
1993-12-28,1993,Liverpool,Wimbledon,1-1,1,1,1,1,2,0,D
1993-12-28,1993,Manchester City,Southampton,1-1,1,1,1,1,2,0,D
1993-12-28,1993,West Ham United,Tottenham Hotspur,1-3,1,3,1,1,4,-2,A
1993-12-29,1993,Arsenal,Sheffield United,3-0,3,0,1,1,3,3,H
1993-12-29,1993,Blackburn Rovers,Everton,2-0,2,0,1,1,2,2,H
1993-12-29,1993,Leeds United,Queens Park Rangers,1-1,1,1,1,1,2,0,D
1993-12-29,1993,Norwich City,Aston Villa,1-2,1,2,1,1,3,-1,A
1993-12-29,1993,Oldham Athletic,Manchester United,2-5,2,5,1,1,7,-3,A
1993-12-29,1993,Sheffield Wednesday,Swindon Town,3-3,3,3,1,1,6,0,D
1994-01-01,1993,Aston Villa,Blackburn Rovers,0-1,0,1,1,1,1,-1,A
1994-01-01,1993,Everton,West Ham United,0-1,0,1,1,1,1,-1,A
1994-01-01,1993,Ipswich Town,Liverpool,1-2,1,2,1,1,3,-1,A
1994-01-01,1993,Manchester United,Leeds United,0-0,0,0,1,1,0,0,D
1994-01-01,1993,Newcastle United,Manchester City,2-0,2,0,1,1,2,2,H
1994-01-01,1993,Queens Park Rangers,Sheffield Wednesday,1-2,1,2,1,1,3,-1,A
1994-01-01,1993,Sheffield United,Oldham Athletic,2-1,2,1,1,1,3,1,H
1994-01-01,1993,Southampton,Norwich City,0-1,0,1,1,1,1,-1,A
1994-01-01,1993,Swindon Town,Chelsea,1-3,1,3,1,1,4,-2,A
1994-01-01,1993,Tottenham Hotspur,Coventry City,1-2,1,2,1,1,3,-1,A
1994-01-01,1993,Wimbledon,Arsenal,0-3,0,3,1,1,3,-3,A
1994-01-03,1993,Arsenal,Queens Park Rangers,0-0,0,0,1,1,0,0,D
1994-01-03,1993,Chelsea,Everton,4-2,4,2,1,1,6,2,H
1994-01-03,1993,Coventry City,Swindon Town,1-1,1,1,1,1,2,0,D
1994-01-03,1993,Sheffield Wednesday,Tottenham Hotspur,1-0,1,0,1,1,1,1,H
1994-01-03,1993,West Ham United,Sheffield United,0-0,0,0,1,1,0,0,D
1994-01-04,1993,Liverpool,Manchester United,3-3,3,3,1,1,6,0,D
1994-01-04,1993,Norwich City,Newcastle United,1-2,1,2,1,1,3,-1,A
1994-01-15,1993,Aston Villa,West Ham United,3-1,3,1,1,1,4,2,H
1994-01-15,1993,Everton,Swindon Town,6-2,6,2,1,1,8,4,H
1994-01-15,1993,Leeds United,Ipswich Town,0-0,0,0,1,1,0,0,D
1994-01-15,1993,Manchester City,Arsenal,0-0,0,0,1,1,0,0,D
1994-01-15,1993,Norwich City,Chelsea,1-1,1,1,1,1,2,0,D
1994-01-15,1993,Oldham Athletic,Liverpool,0-3,0,3,1,1,3,-3,A
1994-01-15,1993,Sheffield United,Blackburn Rovers,1-2,1,2,1,1,3,-1,A
1994-01-15,1993,Southampton,Coventry City,1-0,1,0,1,1,1,1,H
1994-01-15,1993,Tottenham Hotspur,Manchester United,0-1,0,1,1,1,1,-1,A
1994-01-15,1993,Wimbledon,Sheffield Wednesday,2-1,2,1,1,1,3,1,H
1994-01-16,1993,Queens Park Rangers,Newcastle United,1-2,1,2,1,1,3,-1,A
1994-01-22,1993,Arsenal,Oldham Athletic,1-1,1,1,1,1,2,0,D
1994-01-22,1993,Chelsea,Aston Villa,1-1,1,1,1,1,2,0,D
1994-01-22,1993,Coventry City,Queens Park Rangers,0-1,0,1,1,1,1,-1,A
1994-01-22,1993,Ipswich Town,Wimbledon,0-0,0,0,1,1,0,0,D
1994-01-22,1993,Liverpool,Manchester City,2-1,2,1,1,1,3,1,H
1994-01-22,1993,Manchester United,Everton,1-0,1,0,1,1,1,1,H
1994-01-22,1993,Newcastle United,Southampton,1-2,1,2,1,1,3,-1,A
1994-01-22,1993,Sheffield Wednesday,Sheffield United,3-1,3,1,1,1,4,2,H
1994-01-22,1993,Swindon Town,Tottenham Hotspur,2-1,2,1,1,1,3,1,H
1994-01-23,1993,Blackburn Rovers,Leeds United,2-1,2,1,1,1,3,1,H
1994-01-24,1993,West Ham United,Norwich City,3-3,3,3,1,1,6,0,D
1994-02-02,1993,Coventry City,Ipswich Town,1-0,1,0,1,1,1,1,H
1994-02-05,1993,Blackburn Rovers,Wimbledon,3-0,3,0,1,1,3,3,H
1994-02-05,1993,Everton,Chelsea,4-2,4,2,1,1,6,2,H
1994-02-05,1993,Manchester City,Ipswich Town,2-1,2,1,1,1,3,1,H
1994-02-05,1993,Norwich City,Liverpool,2-2,2,2,1,1,4,0,D
1994-02-05,1993,Oldham Athletic,Southampton,2-1,2,1,1,1,3,1,H
1994-02-05,1993,Queens Park Rangers,Manchester United,2-3,2,3,1,1,5,-1,A
1994-02-05,1993,Swindon Town,Coventry City,3-1,3,1,1,1,4,2,H
1994-02-05,1993,Tottenham Hotspur,Sheffield Wednesday,1-3,1,3,1,1,4,-2,A
1994-02-06,1993,Aston Villa,Leeds United,1-0,1,0,1,1,1,1,H
1994-02-12,1993,Aston Villa,Swindon Town,5-0,5,0,1,1,5,5,H
1994-02-12,1993,Everton,Ipswich Town,0-0,0,0,1,1,0,0,D
1994-02-12,1993,Manchester City,West Ham United,0-0,0,0,1,1,0,0,D
1994-02-12,1993,Oldham Athletic,Chelsea,2-1,2,1,1,1,3,1,H
1994-02-12,1993,Sheffield United,Coventry City,0-0,0,0,1,1,0,0,D
1994-02-12,1993,Tottenham Hotspur,Blackburn Rovers,0-2,0,2,1,1,2,-2,A
1994-02-12,1993,Wimbledon,Newcastle United,4-2,4,2,1,1,6,2,H
1994-02-13,1993,Norwich City,Arsenal,1-1,1,1,1,1,2,0,D
1994-02-14,1993,Southampton,Liverpool,4-2,4,2,1,1,6,2,H
1994-02-19,1993,Blackburn Rovers,Newcastle United,1-0,1,0,1,1,1,1,H
1994-02-19,1993,Coventry City,Manchester City,4-0,4,0,1,1,4,4,H
1994-02-19,1993,Everton,Arsenal,1-1,1,1,1,1,2,0,D
1994-02-19,1993,Leeds United,Liverpool,2-0,2,0,1,1,2,2,H
1994-02-19,1993,Swindon Town,Norwich City,3-3,3,3,1,1,6,0,D
1994-02-22,1993,Aston Villa,Manchester City,0-0,0,0,1,1,0,0,D
1994-02-22,1993,Norwich City,Blackburn Rovers,2-2,2,2,1,1,4,0,D
1994-02-23,1993,Newcastle United,Coventry City,4-0,4,0,1,1,4,4,H
1994-02-26,1993,Arsenal,Blackburn Rovers,1-0,1,0,1,1,1,1,H
1994-02-26,1993,Ipswich Town,Sheffield United,3-2,3,2,1,1,5,1,H
1994-02-26,1993,Liverpool,Coventry City,1-0,1,0,1,1,1,1,H
1994-02-26,1993,Manchester City,Swindon Town,2-1,2,1,1,1,3,1,H
1994-02-26,1993,Norwich City,Sheffield Wednesday,1-1,1,1,1,1,2,0,D
1994-02-26,1993,Southampton,Wimbledon,1-0,1,0,1,1,1,1,H
1994-02-26,1993,West Ham United,Manchester United,2-2,2,2,1,1,4,0,D
1994-02-27,1993,Chelsea,Tottenham Hotspur,4-3,4,3,1,1,7,1,H
1994-02-28,1993,Oldham Athletic,Leeds United,1-1,1,1,1,1,2,0,D
1994-03-02,1993,Tottenham Hotspur,Aston Villa,1-1,1,1,1,1,2,0,D
1994-03-05,1993,Blackburn Rovers,Liverpool,2-0,2,0,1,1,2,2,H
1994-03-05,1993,Everton,Oldham Athletic,2-1,2,1,1,1,3,1,H
1994-03-05,1993,Ipswich Town,Arsenal,1-5,1,5,1,1,6,-4,A
1994-03-05,1993,Leeds United,Southampton,0-0,0,0,1,1,0,0,D
1994-03-05,1993,Manchester United,Chelsea,0-1,0,1,1,1,1,-1,A
1994-03-05,1993,Queens Park Rangers,Manchester City,1-1,1,1,1,1,2,0,D
1994-03-05,1993,Sheffield Wednesday,Newcastle United,0-1,0,1,1,1,1,-1,A
1994-03-05,1993,Swindon Town,West Ham United,1-1,1,1,1,1,2,0,D
1994-03-05,1993,Tottenham Hotspur,Sheffield United,2-2,2,2,1,1,4,0,D
1994-03-05,1993,Wimbledon,Norwich City,3-1,3,1,1,1,4,2,H
1994-03-06,1993,Coventry City,Aston Villa,0-1,0,1,1,1,1,-1,A
1994-03-12,1993,Aston Villa,Ipswich Town,0-1,0,1,1,1,1,-1,A
1994-03-12,1993,Manchester City,Wimbledon,0-1,0,1,1,1,1,-1,A
1994-03-12,1993,Newcastle United,Swindon Town,7-1,7,1,1,1,8,6,H
1994-03-12,1993,Norwich City,Queens Park Rangers,3-4,3,4,1,1,7,-1,A
1994-03-12,1993,Southampton,Sheffield Wednesday,1-1,1,1,1,1,2,0,D
1994-03-13,1993,Liverpool,Everton,2-1,2,1,1,1,3,1,H
1994-03-13,1993,Sheffield United,Leeds United,2-2,2,2,1,1,4,0,D
1994-03-16,1993,Chelsea,Wimbledon,2-0,2,0,1,1,2,2,H
1994-03-16,1993,Leeds United,Aston Villa,2-0,2,0,1,1,2,2,H
1994-03-16,1993,Manchester United,Sheffield Wednesday,5-0,5,0,1,1,5,5,H
1994-03-16,1993,Sheffield United,Queens Park Rangers,1-1,1,1,1,1,2,0,D
1994-03-19,1993,Aston Villa,Oldham Athletic,1-2,1,2,1,1,3,-1,A
1994-03-19,1993,Leeds United,Coventry City,1-0,1,0,1,1,1,1,H
1994-03-19,1993,Liverpool,Chelsea,2-1,2,1,1,1,3,1,H
1994-03-19,1993,Manchester City,Sheffield United,0-0,0,0,1,1,0,0,D
1994-03-19,1993,Queens Park Rangers,Wimbledon,1-0,1,0,1,1,1,1,H
1994-03-19,1993,Southampton,Arsenal,0-4,0,4,1,1,4,-4,A
1994-03-19,1993,Swindon Town,Manchester United,2-2,2,2,1,1,4,0,D
1994-03-19,1993,Tottenham Hotspur,Ipswich Town,1-1,1,1,1,1,2,0,D
1994-03-19,1993,West Ham United,Newcastle United,2-4,2,4,1,1,6,-2,A
1994-03-20,1993,Sheffield Wednesday,Blackburn Rovers,1-2,1,2,1,1,3,-1,A
1994-03-21,1993,Norwich City,Everton,3-0,3,0,1,1,3,3,H
1994-03-22,1993,Arsenal,Manchester United,2-2,2,2,1,1,4,0,D
1994-03-22,1993,Newcastle United,Ipswich Town,2-0,2,0,1,1,2,2,H
1994-03-26,1993,Arsenal,Liverpool,1-0,1,0,1,1,1,1,H
1994-03-26,1993,Blackburn Rovers,Swindon Town,3-1,3,1,1,1,4,2,H
1994-03-26,1993,Chelsea,West Ham United,2-0,2,0,1,1,2,2,H
1994-03-26,1993,Coventry City,Norwich City,2-1,2,1,1,1,3,1,H
1994-03-26,1993,Everton,Tottenham Hotspur,0-1,0,1,1,1,1,-1,A
1994-03-26,1993,Ipswich Town,Queens Park Rangers,1-3,1,3,1,1,4,-2,A
1994-03-26,1993,Oldham Athletic,Manchester City,0-0,0,0,1,1,0,0,D
1994-03-26,1993,Sheffield United,Southampton,0-0,0,0,1,1,0,0,D
1994-03-27,1993,Wimbledon,Leeds United,1-0,1,0,1,1,1,1,H
1994-03-28,1993,Sheffield United,West Ham United,3-2,3,2,1,1,5,1,H
1994-03-29,1993,Ipswich Town,Manchester City,2-2,2,2,1,1,4,0,D
1994-03-29,1993,Newcastle United,Norwich City,3-0,3,0,1,1,3,3,H
1994-03-29,1993,Wimbledon,Blackburn Rovers,4-1,4,1,1,1,5,3,H
1994-03-30,1993,Aston Villa,Everton,0-0,0,0,1,1,0,0,D
1994-03-30,1993,Manchester United,Liverpool,1-0,1,0,1,1,1,1,H
1994-03-30,1993,Sheffield Wednesday,Chelsea,3-1,3,1,1,1,4,2,H
1994-03-30,1993,Southampton,Oldham Athletic,1-3,1,3,1,1,4,-2,A
1994-04-01,1993,Leeds United,Newcastle United,1-1,1,1,1,1,2,0,D
1994-04-02,1993,Arsenal,Swindon Town,1-1,1,1,1,1,2,0,D
1994-04-02,1993,Blackburn Rovers,Manchester United,2-0,2,0,1,1,2,2,H
1994-04-02,1993,Chelsea,Southampton,2-0,2,0,1,1,2,2,H
1994-04-02,1993,Coventry City,Wimbledon,1-2,1,2,1,1,3,-1,A
1994-04-02,1993,Liverpool,Sheffield United,1-2,1,2,1,1,3,-1,A
1994-04-02,1993,Manchester City,Aston Villa,3-0,3,0,1,1,3,3,H
1994-04-02,1993,Norwich City,Tottenham Hotspur,1-2,1,2,1,1,3,-1,A
1994-04-02,1993,Oldham Athletic,Queens Park Rangers,4-1,4,1,1,1,5,3,H
1994-04-02,1993,Sheffield Wednesday,Everton,5-1,5,1,1,1,6,4,H
1994-04-02,1993,West Ham United,Ipswich Town,2-1,2,1,1,1,3,1,H
1994-04-04,1993,Aston Villa,Norwich City,0-0,0,0,1,1,0,0,D
1994-04-04,1993,Everton,Blackburn Rovers,0-3,0,3,1,1,3,-3,A
1994-04-04,1993,Ipswich Town,Coventry City,0-2,0,2,1,1,2,-2,A
1994-04-04,1993,Manchester United,Oldham Athletic,3-2,3,2,1,1,5,1,H
1994-04-04,1993,Newcastle United,Chelsea,0-0,0,0,1,1,0,0,D
1994-04-04,1993,Queens Park Rangers,Leeds United,0-4,0,4,1,1,4,-4,A
1994-04-04,1993,Sheffield United,Arsenal,1-1,1,1,1,1,2,0,D
1994-04-04,1993,Southampton,Manchester City,0-1,0,1,1,1,1,-1,A
1994-04-04,1993,Swindon Town,Sheffield Wednesday,0-1,0,1,1,1,1,-1,A
1994-04-04,1993,Tottenham Hotspur,West Ham United,1-4,1,4,1,1,5,-3,A
1994-04-04,1993,Wimbledon,Liverpool,1-1,1,1,1,1,2,0,D
1994-04-09,1993,Coventry City,Tottenham Hotspur,1-0,1,0,1,1,1,1,H
1994-04-09,1993,Liverpool,Ipswich Town,1-0,1,0,1,1,1,1,H
1994-04-09,1993,Manchester City,Newcastle United,2-1,2,1,1,1,3,1,H
1994-04-09,1993,Norwich City,Southampton,4-5,4,5,1,1,9,-1,A
1994-04-09,1993,Sheffield Wednesday,Queens Park Rangers,3-1,3,1,1,1,4,2,H
1994-04-09,1993,West Ham United,Everton,0-1,0,1,1,1,1,-1,A
1994-04-11,1993,Blackburn Rovers,Aston Villa,1-0,1,0,1,1,1,1,H
1994-04-13,1993,Queens Park Rangers,Chelsea,1-1,1,1,1,1,2,0,D
1994-04-16,1993,Arsenal,Chelsea,1-0,1,0,1,1,1,1,H
1994-04-16,1993,Coventry City,Sheffield Wednesday,1-1,1,1,1,1,2,0,D
1994-04-16,1993,Ipswich Town,Swindon Town,1-1,1,1,1,1,2,0,D
1994-04-16,1993,Liverpool,Newcastle United,0-2,0,2,1,1,2,-2,A
1994-04-16,1993,Manchester City,Norwich City,1-1,1,1,1,1,2,0,D
1994-04-16,1993,Oldham Athletic,West Ham United,1-2,1,2,1,1,3,-1,A
1994-04-16,1993,Queens Park Rangers,Everton,2-1,2,1,1,1,3,1,H
1994-04-16,1993,Sheffield United,Aston Villa,1-2,1,2,1,1,3,-1,A
1994-04-16,1993,Southampton,Blackburn Rovers,3-1,3,1,1,1,4,2,H
1994-04-16,1993,Wimbledon,Manchester United,1-0,1,0,1,1,1,1,H
1994-04-17,1993,Leeds United,Tottenham Hotspur,2-0,2,0,1,1,2,2,H
1994-04-19,1993,Arsenal,Wimbledon,1-1,1,1,1,1,2,0,D
1994-04-23,1993,Aston Villa,Arsenal,1-2,1,2,1,1,3,-1,A
1994-04-23,1993,Chelsea,Leeds United,1-1,1,1,1,1,2,0,D
1994-04-23,1993,Everton,Coventry City,0-0,0,0,1,1,0,0,D
1994-04-23,1993,Manchester United,Manchester City,2-0,2,0,1,1,2,2,H
1994-04-23,1993,Newcastle United,Oldham Athletic,3-2,3,2,1,1,5,1,H
1994-04-23,1993,Norwich City,Sheffield United,0-1,0,1,1,1,1,-1,A
1994-04-23,1993,Sheffield Wednesday,Ipswich Town,5-0,5,0,1,1,5,5,H
1994-04-23,1993,Swindon Town,Wimbledon,2-4,2,4,1,1,6,-2,A
1994-04-23,1993,Tottenham Hotspur,Southampton,3-0,3,0,1,1,3,3,H
1994-04-23,1993,West Ham United,Liverpool,1-2,1,2,1,1,3,-1,A
1994-04-24,1993,Blackburn Rovers,Queens Park Rangers,1-1,1,1,1,1,2,0,D
1994-04-26,1993,Wimbledon,Oldham Athletic,3-0,3,0,1,1,3,3,H
1994-04-27,1993,Chelsea,Swindon Town,2-0,2,0,1,1,2,2,H
1994-04-27,1993,Leeds United,Manchester United,0-2,0,2,1,1,2,-2,A
1994-04-27,1993,Newcastle United,Aston Villa,5-1,5,1,1,1,6,4,H
1994-04-27,1993,Queens Park Rangers,Arsenal,1-1,1,1,1,1,2,0,D
1994-04-27,1993,West Ham United,Blackburn Rovers,1-2,1,2,1,1,3,-1,A
1994-04-30,1993,Arsenal,West Ham United,0-2,0,2,1,1,2,-2,A
1994-04-30,1993,Leeds United,Everton,3-0,3,0,1,1,3,3,H
1994-04-30,1993,Liverpool,Norwich City,0-1,0,1,1,1,1,-1,A
1994-04-30,1993,Manchester City,Chelsea,2-2,2,2,1,1,4,0,D
1994-04-30,1993,Oldham Athletic,Sheffield Wednesday,0-0,0,0,1,1,0,0,D
1994-04-30,1993,Queens Park Rangers,Swindon Town,1-3,1,3,1,1,4,-2,A
1994-04-30,1993,Sheffield United,Newcastle United,2-0,2,0,1,1,2,2,H
1994-04-30,1993,Southampton,Aston Villa,4-1,4,1,1,1,5,3,H
1994-04-30,1993,Wimbledon,Tottenham Hotspur,2-1,2,1,1,1,3,1,H
1994-05-01,1993,Ipswich Town,Manchester United,1-2,1,2,1,1,3,-1,A
1994-05-02,1993,Coventry City,Blackburn Rovers,2-1,2,1,1,1,3,1,H
1994-05-03,1993,Leeds United,Sheffield Wednesday,2-2,2,2,1,1,4,0,D
1994-05-03,1993,Oldham Athletic,Sheffield United,1-1,1,1,1,1,2,0,D
1994-05-03,1993,Queens Park Rangers,West Ham United,0-0,0,0,1,1,0,0,D
1994-05-04,1993,Chelsea,Coventry City,1-2,1,2,1,1,3,-1,A
1994-05-04,1993,Manchester United,Southampton,2-0,2,0,1,1,2,2,H
1994-05-05,1993,Oldham Athletic,Tottenham Hotspur,0-2,0,2,1,1,2,-2,A
1994-05-07,1993,Aston Villa,Liverpool,2-1,2,1,1,1,3,1,H
1994-05-07,1993,Blackburn Rovers,Ipswich Town,0-0,0,0,1,1,0,0,D
1994-05-07,1993,Chelsea,Sheffield United,3-2,3,2,1,1,5,1,H
1994-05-07,1993,Everton,Wimbledon,3-2,3,2,1,1,5,1,H
1994-05-07,1993,Newcastle United,Arsenal,2-0,2,0,1,1,2,2,H
1994-05-07,1993,Norwich City,Oldham Athletic,1-1,1,1,1,1,2,0,D
1994-05-07,1993,Sheffield Wednesday,Manchester City,1-1,1,1,1,1,2,0,D
1994-05-07,1993,Swindon Town,Leeds United,0-5,0,5,1,1,5,-5,A
1994-05-07,1993,Tottenham Hotspur,Queens Park Rangers,1-2,1,2,1,1,3,-1,A
1994-05-07,1993,West Ham United,Southampton,3-3,3,3,1,1,6,0,D
1994-05-08,1993,Manchester United,Coventry City,0-0,0,0,1,1,0,0,D
1994-08-20,1994,Arsenal,Manchester City,3-0,3,0,1,1,3,3,H
1994-08-20,1994,Chelsea,Norwich City,2-0,2,0,1,1,2,2,H
1994-08-20,1994,Coventry City,Wimbledon,1-1,1,1,1,1,2,0,D
1994-08-20,1994,Crystal Palace,Liverpool,1-6,1,6,1,1,7,-5,A
1994-08-20,1994,Everton,Aston Villa,2-2,2,2,1,1,4,0,D
1994-08-20,1994,Ipswich Town,Nottingham Forest,0-1,0,1,1,1,1,-1,A
1994-08-20,1994,Manchester United,Queens Park Rangers,2-0,2,0,1,1,2,2,H
1994-08-20,1994,Sheffield Wednesday,Tottenham Hotspur,3-4,3,4,1,1,7,-1,A
1994-08-20,1994,Southampton,Blackburn Rovers,1-1,1,1,1,1,2,0,D
1994-08-20,1994,West Ham United,Leeds United,0-0,0,0,1,1,0,0,D
1994-08-21,1994,Leicester City,Newcastle United,1-3,1,3,1,1,4,-2,A
1994-08-22,1994,Nottingham Forest,Manchester United,1-1,1,1,1,1,2,0,D
1994-08-23,1994,Blackburn Rovers,Leicester City,3-0,3,0,1,1,3,3,H
1994-08-23,1994,Leeds United,Arsenal,1-0,1,0,1,1,1,1,H
1994-08-23,1994,Wimbledon,Ipswich Town,1-1,1,1,1,1,2,0,D
1994-08-24,1994,Aston Villa,Southampton,1-1,1,1,1,1,2,0,D
1994-08-24,1994,Manchester City,West Ham United,3-0,3,0,1,1,3,3,H
1994-08-24,1994,Newcastle United,Coventry City,4-0,4,0,1,1,4,4,H
1994-08-24,1994,Norwich City,Crystal Palace,0-0,0,0,1,1,0,0,D
1994-08-24,1994,Queens Park Rangers,Sheffield Wednesday,3-2,3,2,1,1,5,1,H
1994-08-24,1994,Tottenham Hotspur,Everton,2-1,2,1,1,1,3,1,H
1994-08-27,1994,Aston Villa,Crystal Palace,1-1,1,1,1,1,2,0,D
1994-08-27,1994,Blackburn Rovers,Coventry City,4-0,4,0,1,1,4,4,H
1994-08-27,1994,Leeds United,Chelsea,2-3,2,3,1,1,5,-1,A
1994-08-27,1994,Manchester City,Everton,4-0,4,0,1,1,4,4,H
1994-08-27,1994,Newcastle United,Southampton,5-1,5,1,1,1,6,4,H
1994-08-27,1994,Norwich City,West Ham United,1-0,1,0,1,1,1,1,H
1994-08-27,1994,Nottingham Forest,Leicester City,1-0,1,0,1,1,1,1,H
1994-08-27,1994,Queens Park Rangers,Ipswich Town,1-2,1,2,1,1,3,-1,A
1994-08-27,1994,Tottenham Hotspur,Manchester United,0-1,0,1,1,1,1,-1,A
1994-08-27,1994,Wimbledon,Sheffield Wednesday,0-1,0,1,1,1,1,-1,A
1994-08-28,1994,Liverpool,Arsenal,3-0,3,0,1,1,3,3,H
1994-08-29,1994,Coventry City,Aston Villa,0-1,0,1,1,1,1,-1,A
1994-08-30,1994,Crystal Palace,Leeds United,1-2,1,2,1,1,3,-1,A
1994-08-30,1994,Everton,Nottingham Forest,1-2,1,2,1,1,3,-1,A
1994-08-30,1994,Ipswich Town,Tottenham Hotspur,1-3,1,3,1,1,4,-2,A
1994-08-31,1994,Arsenal,Blackburn Rovers,0-0,0,0,1,1,0,0,D
1994-08-31,1994,Chelsea,Manchester City,3-0,3,0,1,1,3,3,H
1994-08-31,1994,Leicester City,Queens Park Rangers,1-1,1,1,1,1,2,0,D
1994-08-31,1994,Manchester United,Wimbledon,3-0,3,0,1,1,3,3,H
1994-08-31,1994,Sheffield Wednesday,Norwich City,0-0,0,0,1,1,0,0,D
1994-08-31,1994,Southampton,Liverpool,0-2,0,2,1,1,2,-2,A
1994-08-31,1994,West Ham United,Newcastle United,1-3,1,3,1,1,4,-2,A
1994-09-10,1994,Aston Villa,Ipswich Town,2-0,2,0,1,1,2,2,H
1994-09-10,1994,Blackburn Rovers,Everton,3-0,3,0,1,1,3,3,H
1994-09-10,1994,Liverpool,West Ham United,0-0,0,0,1,1,0,0,D
1994-09-10,1994,Manchester City,Crystal Palace,1-1,1,1,1,1,2,0,D
1994-09-10,1994,Newcastle United,Chelsea,4-2,4,2,1,1,6,2,H
1994-09-10,1994,Norwich City,Arsenal,0-0,0,0,1,1,0,0,D
1994-09-10,1994,Nottingham Forest,Sheffield Wednesday,4-1,4,1,1,1,5,3,H
1994-09-10,1994,Queens Park Rangers,Coventry City,2-2,2,2,1,1,4,0,D
1994-09-10,1994,Wimbledon,Leicester City,2-1,2,1,1,1,3,1,H
1994-09-11,1994,Leeds United,Manchester United,2-1,2,1,1,1,3,1,H
1994-09-12,1994,Tottenham Hotspur,Southampton,1-2,1,2,1,1,3,-1,A
1994-09-17,1994,Coventry City,Leeds United,2-1,2,1,1,1,3,1,H
1994-09-17,1994,Crystal Palace,Wimbledon,0-0,0,0,1,1,0,0,D
1994-09-17,1994,Everton,Queens Park Rangers,2-2,2,2,1,1,4,0,D
1994-09-17,1994,Leicester City,Tottenham Hotspur,3-1,3,1,1,1,4,2,H
1994-09-17,1994,Manchester United,Liverpool,2-0,2,0,1,1,2,2,H
1994-09-17,1994,Sheffield Wednesday,Manchester City,1-1,1,1,1,1,2,0,D
1994-09-17,1994,Southampton,Nottingham Forest,1-1,1,1,1,1,2,0,D
1994-09-17,1994,West Ham United,Aston Villa,1-0,1,0,1,1,1,1,H
1994-09-18,1994,Arsenal,Newcastle United,2-3,2,3,1,1,5,-1,A
1994-09-18,1994,Chelsea,Blackburn Rovers,1-2,1,2,1,1,3,-1,A
1994-09-19,1994,Ipswich Town,Norwich City,1-2,1,2,1,1,3,-1,A
1994-09-24,1994,Blackburn Rovers,Aston Villa,3-1,3,1,1,1,4,2,H
1994-09-24,1994,Coventry City,Southampton,1-3,1,3,1,1,4,-2,A
1994-09-24,1994,Crystal Palace,Chelsea,0-1,0,1,1,1,1,-1,A
1994-09-24,1994,Everton,Leicester City,1-1,1,1,1,1,2,0,D
1994-09-24,1994,Ipswich Town,Manchester United,3-2,3,2,1,1,5,1,H
1994-09-24,1994,Manchester City,Norwich City,2-0,2,0,1,1,2,2,H
1994-09-24,1994,Newcastle United,Liverpool,1-1,1,1,1,1,2,0,D
1994-09-24,1994,Queens Park Rangers,Wimbledon,0-1,0,1,1,1,1,-1,A
1994-09-24,1994,Tottenham Hotspur,Nottingham Forest,1-4,1,4,1,1,5,-3,A
1994-09-25,1994,West Ham United,Arsenal,0-2,0,2,1,1,2,-2,A
1994-09-26,1994,Sheffield Wednesday,Leeds United,1-1,1,1,1,1,2,0,D
1994-10-01,1994,Arsenal,Crystal Palace,1-2,1,2,1,1,3,-1,A
1994-10-01,1994,Aston Villa,Newcastle United,0-2,0,2,1,1,2,-2,A
1994-10-01,1994,Leeds United,Manchester City,2-0,2,0,1,1,2,2,H
1994-10-01,1994,Liverpool,Sheffield Wednesday,4-1,4,1,1,1,5,3,H
1994-10-01,1994,Manchester United,Everton,2-0,2,0,1,1,2,2,H
1994-10-01,1994,Norwich City,Blackburn Rovers,2-1,2,1,1,1,3,1,H
1994-10-01,1994,Southampton,Ipswich Town,3-1,3,1,1,1,4,2,H
1994-10-01,1994,Wimbledon,Tottenham Hotspur,1-2,1,2,1,1,3,-1,A
1994-10-02,1994,Chelsea,West Ham United,1-2,1,2,1,1,3,-1,A
1994-10-02,1994,Nottingham Forest,Queens Park Rangers,3-2,3,2,1,1,5,1,H
1994-10-03,1994,Leicester City,Coventry City,2-2,2,2,1,1,4,0,D
1994-10-08,1994,Chelsea,Leicester City,4-0,4,0,1,1,4,4,H
1994-10-08,1994,Liverpool,Aston Villa,3-2,3,2,1,1,5,1,H
1994-10-08,1994,Manchester City,Nottingham Forest,3-3,3,3,1,1,6,0,D
1994-10-08,1994,Norwich City,Leeds United,2-1,2,1,1,1,3,1,H
1994-10-08,1994,Sheffield Wednesday,Manchester United,1-0,1,0,1,1,1,1,H
1994-10-08,1994,Southampton,Everton,2-0,2,0,1,1,2,2,H
1994-10-08,1994,Tottenham Hotspur,Queens Park Rangers,1-1,1,1,1,1,2,0,D
1994-10-08,1994,West Ham United,Crystal Palace,1-0,1,0,1,1,1,1,H
1994-10-08,1994,Wimbledon,Arsenal,1-3,1,3,1,1,4,-2,A
1994-10-09,1994,Newcastle United,Blackburn Rovers,1-1,1,1,1,1,2,0,D
1994-10-10,1994,Coventry City,Ipswich Town,2-0,2,0,1,1,2,2,H
1994-10-15,1994,Arsenal,Chelsea,3-1,3,1,1,1,4,2,H
1994-10-15,1994,Aston Villa,Norwich City,1-1,1,1,1,1,2,0,D
1994-10-15,1994,Blackburn Rovers,Liverpool,3-2,3,2,1,1,5,1,H
1994-10-15,1994,Crystal Palace,Newcastle United,0-1,0,1,1,1,1,-1,A
1994-10-15,1994,Everton,Coventry City,0-2,0,2,1,1,2,-2,A
1994-10-15,1994,Leeds United,Tottenham Hotspur,1-1,1,1,1,1,2,0,D
1994-10-15,1994,Leicester City,Southampton,4-3,4,3,1,1,7,1,H
1994-10-15,1994,Manchester United,West Ham United,1-0,1,0,1,1,1,1,H
1994-10-15,1994,Queens Park Rangers,Manchester City,1-2,1,2,1,1,3,-1,A
1994-10-16,1994,Ipswich Town,Sheffield Wednesday,1-2,1,2,1,1,3,-1,A
1994-10-17,1994,Nottingham Forest,Wimbledon,3-1,3,1,1,1,4,2,H
1994-10-22,1994,Aston Villa,Nottingham Forest,0-2,0,2,1,1,2,-2,A
1994-10-22,1994,Crystal Palace,Everton,1-0,1,0,1,1,1,1,H
1994-10-22,1994,Liverpool,Wimbledon,3-0,3,0,1,1,3,3,H
1994-10-22,1994,Manchester City,Tottenham Hotspur,5-2,5,2,1,1,7,3,H
1994-10-22,1994,Newcastle United,Sheffield Wednesday,2-1,2,1,1,1,3,1,H
1994-10-22,1994,Norwich City,Queens Park Rangers,4-2,4,2,1,1,6,2,H
1994-10-22,1994,West Ham United,Southampton,2-0,2,0,1,1,2,2,H
1994-10-23,1994,Arsenal,Coventry City,2-1,2,1,1,1,3,1,H
1994-10-23,1994,Blackburn Rovers,Manchester United,2-4,2,4,1,1,6,-2,A
1994-10-23,1994,Chelsea,Ipswich Town,2-0,2,0,1,1,2,2,H
1994-10-24,1994,Leeds United,Leicester City,2-1,2,1,1,1,3,1,H
1994-10-29,1994,Coventry City,Manchester City,1-0,1,0,1,1,1,1,H
1994-10-29,1994,Everton,Arsenal,1-1,1,1,1,1,2,0,D
1994-10-29,1994,Ipswich Town,Liverpool,1-3,1,3,1,1,4,-2,A
1994-10-29,1994,Leicester City,Crystal Palace,0-1,0,1,1,1,1,-1,A
1994-10-29,1994,Manchester United,Newcastle United,2-0,2,0,1,1,2,2,H
1994-10-29,1994,Nottingham Forest,Blackburn Rovers,0-2,0,2,1,1,2,-2,A
1994-10-29,1994,Queens Park Rangers,Aston Villa,2-0,2,0,1,1,2,2,H
1994-10-29,1994,Sheffield Wednesday,Chelsea,1-1,1,1,1,1,2,0,D
1994-10-29,1994,Southampton,Leeds United,1-3,1,3,1,1,4,-2,A
1994-10-29,1994,Tottenham Hotspur,West Ham United,3-1,3,1,1,1,4,2,H
1994-10-30,1994,Wimbledon,Norwich City,1-0,1,0,1,1,1,1,H
1994-10-31,1994,Queens Park Rangers,Liverpool,2-1,2,1,1,1,3,1,H
1994-11-01,1994,Everton,West Ham United,1-0,1,0,1,1,1,1,H
1994-11-01,1994,Ipswich Town,Leeds United,2-0,2,0,1,1,2,2,H
1994-11-02,1994,Coventry City,Crystal Palace,1-4,1,4,1,1,5,-3,A
1994-11-02,1994,Sheffield Wednesday,Blackburn Rovers,0-1,0,1,1,1,1,-1,A
1994-11-02,1994,Southampton,Norwich City,1-1,1,1,1,1,2,0,D
1994-11-05,1994,Blackburn Rovers,Tottenham Hotspur,2-0,2,0,1,1,2,2,H
1994-11-05,1994,Crystal Palace,Ipswich Town,3-0,3,0,1,1,3,3,H
1994-11-05,1994,Leeds United,Wimbledon,3-1,3,1,1,1,4,2,H
1994-11-05,1994,Liverpool,Nottingham Forest,1-0,1,0,1,1,1,1,H
1994-11-05,1994,Manchester City,Southampton,3-3,3,3,1,1,6,0,D
1994-11-05,1994,Newcastle United,Queens Park Rangers,2-1,2,1,1,1,3,1,H
1994-11-05,1994,Norwich City,Everton,0-0,0,0,1,1,0,0,D
1994-11-05,1994,West Ham United,Leicester City,1-0,1,0,1,1,1,1,H
1994-11-06,1994,Arsenal,Sheffield Wednesday,0-0,0,0,1,1,0,0,D
1994-11-06,1994,Aston Villa,Manchester United,1-2,1,2,1,1,3,-1,A
1994-11-06,1994,Chelsea,Coventry City,2-2,2,2,1,1,4,0,D
1994-11-07,1994,Nottingham Forest,Newcastle United,0-0,0,0,1,1,0,0,D
1994-11-09,1994,Liverpool,Chelsea,3-1,3,1,1,1,4,2,H
1994-11-09,1994,Wimbledon,Aston Villa,4-3,4,3,1,1,7,1,H
1994-11-10,1994,Manchester United,Manchester City,5-0,5,0,1,1,5,5,H
1994-11-19,1994,Coventry City,Norwich City,1-0,1,0,1,1,1,1,H
1994-11-19,1994,Ipswich Town,Blackburn Rovers,1-3,1,3,1,1,4,-2,A
1994-11-19,1994,Manchester United,Crystal Palace,3-0,3,0,1,1,3,3,H
1994-11-19,1994,Nottingham Forest,Chelsea,0-1,0,1,1,1,1,-1,A
1994-11-19,1994,Queens Park Rangers,Leeds United,3-2,3,2,1,1,5,1,H
1994-11-19,1994,Sheffield Wednesday,West Ham United,1-0,1,0,1,1,1,1,H
1994-11-19,1994,Southampton,Arsenal,1-0,1,0,1,1,1,1,H
1994-11-19,1994,Tottenham Hotspur,Aston Villa,3-4,3,4,1,1,7,-1,A
1994-11-19,1994,Wimbledon,Newcastle United,3-2,3,2,1,1,5,1,H
1994-11-20,1994,Leicester City,Manchester City,0-1,0,1,1,1,1,-1,A
1994-11-21,1994,Everton,Liverpool,2-0,2,0,1,1,2,2,H
1994-11-23,1994,Leicester City,Arsenal,2-1,2,1,1,1,3,1,H
1994-11-23,1994,Tottenham Hotspur,Chelsea,0-0,0,0,1,1,0,0,D
1994-11-26,1994,Arsenal,Manchester United,0-0,0,0,1,1,0,0,D
1994-11-26,1994,Blackburn Rovers,Queens Park Rangers,4-0,4,0,1,1,4,4,H
1994-11-26,1994,Chelsea,Everton,0-1,0,1,1,1,1,-1,A
1994-11-26,1994,Crystal Palace,Southampton,0-0,0,0,1,1,0,0,D
1994-11-26,1994,Leeds United,Nottingham Forest,1-0,1,0,1,1,1,1,H
1994-11-26,1994,Liverpool,Tottenham Hotspur,1-1,1,1,1,1,2,0,D
1994-11-26,1994,Manchester City,Wimbledon,2-0,2,0,1,1,2,2,H
1994-11-26,1994,Newcastle United,Ipswich Town,1-1,1,1,1,1,2,0,D
1994-11-26,1994,Norwich City,Leicester City,2-1,2,1,1,1,3,1,H
1994-11-26,1994,West Ham United,Coventry City,0-1,0,1,1,1,1,-1,A
1994-11-27,1994,Aston Villa,Sheffield Wednesday,1-1,1,1,1,1,2,0,D
1994-12-03,1994,Coventry City,Liverpool,1-1,1,1,1,1,2,0,D
1994-12-03,1994,Ipswich Town,Manchester City,1-2,1,2,1,1,3,-1,A
1994-12-03,1994,Leicester City,Aston Villa,1-1,1,1,1,1,2,0,D
1994-12-03,1994,Manchester United,Norwich City,1-0,1,0,1,1,1,1,H
1994-12-03,1994,Nottingham Forest,Arsenal,2-2,2,2,1,1,4,0,D
1994-12-03,1994,Sheffield Wednesday,Crystal Palace,1-0,1,0,1,1,1,1,H
1994-12-03,1994,Southampton,Chelsea,0-1,0,1,1,1,1,-1,A
1994-12-03,1994,Tottenham Hotspur,Newcastle United,4-2,4,2,1,1,6,2,H
1994-12-03,1994,Wimbledon,Blackburn Rovers,0-3,0,3,1,1,3,-3,A
1994-12-04,1994,Everton,Leeds United,3-0,3,0,1,1,3,3,H
1994-12-04,1994,Queens Park Rangers,West Ham United,2-1,2,1,1,1,3,1,H
1994-12-10,1994,Aston Villa,Everton,0-0,0,0,1,1,0,0,D
1994-12-10,1994,Blackburn Rovers,Southampton,3-2,3,2,1,1,5,1,H
1994-12-10,1994,Leeds United,West Ham United,2-2,2,2,1,1,4,0,D
1994-12-10,1994,Newcastle United,Leicester City,3-1,3,1,1,1,4,2,H
1994-12-10,1994,Norwich City,Chelsea,3-0,3,0,1,1,3,3,H
1994-12-10,1994,Nottingham Forest,Ipswich Town,4-1,4,1,1,1,5,3,H
1994-12-10,1994,Queens Park Rangers,Manchester United,2-3,2,3,1,1,5,-1,A
1994-12-10,1994,Tottenham Hotspur,Sheffield Wednesday,3-1,3,1,1,1,4,2,H
1994-12-10,1994,Wimbledon,Coventry City,2-0,2,0,1,1,2,2,H
1994-12-11,1994,Liverpool,Crystal Palace,0-0,0,0,1,1,0,0,D
1994-12-12,1994,Manchester City,Arsenal,1-2,1,2,1,1,3,-1,A
1994-12-16,1994,Ipswich Town,Wimbledon,2-2,2,2,1,1,4,0,D
1994-12-17,1994,Arsenal,Leeds United,1-3,1,3,1,1,4,-2,A
1994-12-17,1994,Coventry City,Newcastle United,0-0,0,0,1,1,0,0,D
1994-12-17,1994,Crystal Palace,Norwich City,0-1,0,1,1,1,1,-1,A
1994-12-17,1994,Everton,Tottenham Hotspur,0-0,0,0,1,1,0,0,D
1994-12-17,1994,Leicester City,Blackburn Rovers,0-0,0,0,1,1,0,0,D
1994-12-17,1994,Manchester United,Nottingham Forest,1-2,1,2,1,1,3,-1,A
1994-12-17,1994,Sheffield Wednesday,Queens Park Rangers,0-2,0,2,1,1,2,-2,A
1994-12-17,1994,West Ham United,Manchester City,3-0,3,0,1,1,3,3,H
1994-12-18,1994,Chelsea,Liverpool,0-0,0,0,1,1,0,0,D
1994-12-19,1994,Southampton,Aston Villa,2-1,2,1,1,1,3,1,H
1994-12-26,1994,Arsenal,Aston Villa,0-0,0,0,1,1,0,0,D
1994-12-26,1994,Chelsea,Manchester United,2-3,2,3,1,1,5,-1,A
1994-12-26,1994,Coventry City,Nottingham Forest,0-0,0,0,1,1,0,0,D
1994-12-26,1994,Crystal Palace,Queens Park Rangers,0-0,0,0,1,1,0,0,D
1994-12-26,1994,Everton,Sheffield Wednesday,1-4,1,4,1,1,5,-3,A
1994-12-26,1994,Leeds United,Newcastle United,0-0,0,0,1,1,0,0,D
1994-12-26,1994,Leicester City,Liverpool,1-2,1,2,1,1,3,-1,A
1994-12-26,1994,Manchester City,Blackburn Rovers,1-3,1,3,1,1,4,-2,A
1994-12-26,1994,Norwich City,Tottenham Hotspur,0-2,0,2,1,1,2,-2,A
1994-12-26,1994,Southampton,Wimbledon,2-3,2,3,1,1,5,-1,A
1994-12-26,1994,West Ham United,Ipswich Town,1-1,1,1,1,1,2,0,D
1994-12-27,1994,Nottingham Forest,Norwich City,1-0,1,0,1,1,1,1,H
1994-12-27,1994,Tottenham Hotspur,Crystal Palace,0-0,0,0,1,1,0,0,D
1994-12-28,1994,Aston Villa,Chelsea,3-0,3,0,1,1,3,3,H
1994-12-28,1994,Ipswich Town,Arsenal,0-2,0,2,1,1,2,-2,A
1994-12-28,1994,Liverpool,Manchester City,2-0,2,0,1,1,2,2,H
1994-12-28,1994,Manchester United,Leicester City,1-1,1,1,1,1,2,0,D
1994-12-28,1994,Queens Park Rangers,Southampton,2-2,2,2,1,1,4,0,D
1994-12-28,1994,Sheffield Wednesday,Coventry City,5-1,5,1,1,1,6,4,H
1994-12-28,1994,Wimbledon,West Ham United,1-0,1,0,1,1,1,1,H
1994-12-31,1994,Arsenal,Queens Park Rangers,1-3,1,3,1,1,4,-2,A
1994-12-31,1994,Chelsea,Wimbledon,1-1,1,1,1,1,2,0,D
1994-12-31,1994,Coventry City,Tottenham Hotspur,0-4,0,4,1,1,4,-4,A
1994-12-31,1994,Crystal Palace,Blackburn Rovers,0-1,0,1,1,1,1,-1,A
1994-12-31,1994,Everton,Ipswich Town,4-1,4,1,1,1,5,3,H
1994-12-31,1994,Leeds United,Liverpool,0-2,0,2,1,1,2,-2,A
1994-12-31,1994,Leicester City,Sheffield Wednesday,0-1,0,1,1,1,1,-1,A
1994-12-31,1994,Manchester City,Aston Villa,2-2,2,2,1,1,4,0,D
1994-12-31,1994,Norwich City,Newcastle United,2-1,2,1,1,1,3,1,H
1994-12-31,1994,Southampton,Manchester United,2-2,2,2,1,1,4,0,D
1994-12-31,1994,West Ham United,Nottingham Forest,3-1,3,1,1,1,4,2,H
1995-01-02,1994,Aston Villa,Leeds United,0-0,0,0,1,1,0,0,D
1995-01-02,1994,Blackburn Rovers,West Ham United,4-2,4,2,1,1,6,2,H
1995-01-02,1994,Ipswich Town,Leicester City,4-1,4,1,1,1,5,3,H
1995-01-02,1994,Liverpool,Norwich City,4-0,4,0,1,1,4,4,H
1995-01-02,1994,Newcastle United,Manchester City,0-0,0,0,1,1,0,0,D
1995-01-02,1994,Nottingham Forest,Crystal Palace,1-0,1,0,1,1,1,1,H
1995-01-02,1994,Sheffield Wednesday,Southampton,1-1,1,1,1,1,2,0,D
1995-01-02,1994,Tottenham Hotspur,Arsenal,1-0,1,0,1,1,1,1,H
1995-01-02,1994,Wimbledon,Everton,2-1,2,1,1,1,3,1,H
1995-01-03,1994,Manchester United,Coventry City,2-0,2,0,1,1,2,2,H
1995-01-14,1994,Arsenal,Everton,1-1,1,1,1,1,2,0,D
1995-01-14,1994,Aston Villa,Queens Park Rangers,2-1,2,1,1,1,3,1,H
1995-01-14,1994,Blackburn Rovers,Nottingham Forest,3-0,3,0,1,1,3,3,H
1995-01-14,1994,Chelsea,Sheffield Wednesday,1-1,1,1,1,1,2,0,D
1995-01-14,1994,Crystal Palace,Leicester City,2-0,2,0,1,1,2,2,H
1995-01-14,1994,Leeds United,Southampton,0-0,0,0,1,1,0,0,D
1995-01-14,1994,Liverpool,Ipswich Town,0-1,0,1,1,1,1,-1,A
1995-01-14,1994,Manchester City,Coventry City,0-0,0,0,1,1,0,0,D
1995-01-14,1994,Norwich City,Wimbledon,1-2,1,2,1,1,3,-1,A
1995-01-14,1994,West Ham United,Tottenham Hotspur,1-2,1,2,1,1,3,-1,A
1995-01-15,1994,Newcastle United,Manchester United,1-1,1,1,1,1,2,0,D
1995-01-21,1994,Coventry City,Arsenal,0-1,0,1,1,1,1,-1,A
1995-01-21,1994,Everton,Crystal Palace,3-1,3,1,1,1,4,2,H
1995-01-21,1994,Ipswich Town,Chelsea,2-2,2,2,1,1,4,0,D
1995-01-21,1994,Nottingham Forest,Aston Villa,1-2,1,2,1,1,3,-1,A
1995-01-21,1994,Sheffield Wednesday,Newcastle United,0-0,0,0,1,1,0,0,D
1995-01-22,1994,Manchester United,Blackburn Rovers,1-0,1,0,1,1,1,1,H
1995-01-23,1994,West Ham United,Sheffield Wednesday,0-2,0,2,1,1,2,-2,A
1995-01-24,1994,Arsenal,Southampton,1-1,1,1,1,1,2,0,D
1995-01-24,1994,Leeds United,Queens Park Rangers,4-0,4,0,1,1,4,4,H
1995-01-24,1994,Liverpool,Everton,0-0,0,0,1,1,0,0,D
1995-01-25,1994,Aston Villa,Tottenham Hotspur,1-0,1,0,1,1,1,1,H
1995-01-25,1994,Chelsea,Nottingham Forest,0-2,0,2,1,1,2,-2,A
1995-01-25,1994,Crystal Palace,Manchester United,1-1,1,1,1,1,2,0,D
1995-01-25,1994,Manchester City,Leicester City,0-1,0,1,1,1,1,-1,A
1995-01-25,1994,Newcastle United,Wimbledon,2-1,2,1,1,1,3,1,H
1995-01-25,1994,Norwich City,Coventry City,2-2,2,2,1,1,4,0,D
1995-01-28,1994,Blackburn Rovers,Ipswich Town,4-1,4,1,1,1,5,3,H
1995-02-01,1994,Blackburn Rovers,Leeds United,1-1,1,1,1,1,2,0,D
1995-02-01,1994,Newcastle United,Everton,2-0,2,0,1,1,2,2,H
1995-02-04,1994,Coventry City,Chelsea,2-2,2,2,1,1,4,0,D
1995-02-04,1994,Everton,Norwich City,2-1,2,1,1,1,3,1,H
1995-02-04,1994,Ipswich Town,Crystal Palace,0-2,0,2,1,1,2,-2,A
1995-02-04,1994,Leicester City,West Ham United,1-2,1,2,1,1,3,-1,A
1995-02-04,1994,Manchester United,Aston Villa,1-0,1,0,1,1,1,1,H
1995-02-04,1994,Nottingham Forest,Liverpool,1-1,1,1,1,1,2,0,D
1995-02-04,1994,Queens Park Rangers,Newcastle United,3-0,3,0,1,1,3,3,H
1995-02-04,1994,Sheffield Wednesday,Arsenal,3-1,3,1,1,1,4,2,H
1995-02-04,1994,Southampton,Manchester City,2-2,2,2,1,1,4,0,D
1995-02-04,1994,Wimbledon,Leeds United,0-0,0,0,1,1,0,0,D
1995-02-05,1994,Tottenham Hotspur,Blackburn Rovers,3-1,3,1,1,1,4,2,H
1995-02-11,1994,Arsenal,Leicester City,1-1,1,1,1,1,2,0,D
1995-02-11,1994,Aston Villa,Wimbledon,7-1,7,1,1,1,8,6,H
1995-02-11,1994,Chelsea,Tottenham Hotspur,1-1,1,1,1,1,2,0,D
1995-02-11,1994,Crystal Palace,Coventry City,0-2,0,2,1,1,2,-2,A
1995-02-11,1994,Liverpool,Queens Park Rangers,1-1,1,1,1,1,2,0,D
1995-02-11,1994,Manchester City,Manchester United,0-3,0,3,1,1,3,-3,A
1995-02-11,1994,Newcastle United,Nottingham Forest,2-1,2,1,1,1,3,1,H
1995-02-11,1994,Norwich City,Southampton,2-2,2,2,1,1,4,0,D
1995-02-12,1994,Blackburn Rovers,Sheffield Wednesday,3-1,3,1,1,1,4,2,H
1995-02-13,1994,West Ham United,Everton,2-2,2,2,1,1,4,0,D
1995-02-18,1994,Coventry City,West Ham United,2-0,2,0,1,1,2,2,H
1995-02-18,1994,Sheffield Wednesday,Aston Villa,1-2,1,2,1,1,3,-1,A
1995-02-21,1994,Arsenal,Nottingham Forest,1-0,1,0,1,1,1,1,H
1995-02-22,1994,Aston Villa,Leicester City,4-4,4,4,1,1,8,0,D
1995-02-22,1994,Blackburn Rovers,Wimbledon,2-1,2,1,1,1,3,1,H
1995-02-22,1994,Leeds United,Everton,1-0,1,0,1,1,1,1,H
1995-02-22,1994,Manchester City,Ipswich Town,2-0,2,0,1,1,2,2,H
1995-02-22,1994,Norwich City,Manchester United,0-2,0,2,1,1,2,-2,A
1995-02-25,1994,Blackburn Rovers,Norwich City,0-0,0,0,1,1,0,0,D
1995-02-25,1994,Coventry City,Leicester City,4-2,4,2,1,1,6,2,H
1995-02-25,1994,Crystal Palace,Arsenal,0-3,0,3,1,1,3,-3,A
1995-02-25,1994,Everton,Manchester United,1-0,1,0,1,1,1,1,H
1995-02-25,1994,Ipswich Town,Southampton,2-1,2,1,1,1,3,1,H
1995-02-25,1994,Manchester City,Leeds United,0-0,0,0,1,1,0,0,D
1995-02-25,1994,Newcastle United,Aston Villa,3-1,3,1,1,1,4,2,H
1995-02-25,1994,Sheffield Wednesday,Liverpool,1-2,1,2,1,1,3,-1,A
1995-02-25,1994,Tottenham Hotspur,Wimbledon,1-2,1,2,1,1,3,-1,A
1995-02-25,1994,West Ham United,Chelsea,1-2,1,2,1,1,3,-1,A
1995-02-26,1994,Queens Park Rangers,Nottingham Forest,1-1,1,1,1,1,2,0,D
1995-02-28,1994,Ipswich Town,Newcastle United,0-2,0,2,1,1,2,-2,A
1995-03-04,1994,Aston Villa,Blackburn Rovers,0-1,0,1,1,1,1,-1,A
1995-03-04,1994,Leeds United,Sheffield Wednesday,0-1,0,1,1,1,1,-1,A
1995-03-04,1994,Leicester City,Everton,2-2,2,2,1,1,4,0,D
1995-03-04,1994,Liverpool,Newcastle United,2-0,2,0,1,1,2,2,H
1995-03-04,1994,Manchester United,Ipswich Town,9-0,9,0,1,1,9,9,H
1995-03-04,1994,Norwich City,Manchester City,1-1,1,1,1,1,2,0,D
1995-03-04,1994,Nottingham Forest,Tottenham Hotspur,2-2,2,2,1,1,4,0,D
1995-03-04,1994,Southampton,Coventry City,0-0,0,0,1,1,0,0,D
1995-03-04,1994,Wimbledon,Queens Park Rangers,1-3,1,3,1,1,4,-2,A
1995-03-05,1994,Arsenal,West Ham United,0-1,0,1,1,1,1,-1,A
1995-03-05,1994,Chelsea,Crystal Palace,0-0,0,0,1,1,0,0,D
1995-03-06,1994,Aston Villa,Coventry City,0-0,0,0,1,1,0,0,D
1995-03-07,1994,Wimbledon,Manchester United,0-1,0,1,1,1,1,-1,A
1995-03-08,1994,Blackburn Rovers,Arsenal,3-1,3,1,1,1,4,2,H
1995-03-08,1994,Manchester City,Chelsea,1-2,1,2,1,1,3,-1,A
1995-03-08,1994,Newcastle United,West Ham United,2-0,2,0,1,1,2,2,H
1995-03-08,1994,Norwich City,Sheffield Wednesday,0-0,0,0,1,1,0,0,D
1995-03-08,1994,Nottingham Forest,Everton,2-1,2,1,1,1,3,1,H
1995-03-08,1994,Queens Park Rangers,Leicester City,2-0,2,0,1,1,2,2,H
1995-03-08,1994,Tottenham Hotspur,Ipswich Town,3-0,3,0,1,1,3,3,H
1995-03-11,1994,Chelsea,Leeds United,0-3,0,3,1,1,3,-3,A
1995-03-11,1994,Coventry City,Blackburn Rovers,1-1,1,1,1,1,2,0,D
1995-03-11,1994,Leicester City,Nottingham Forest,2-4,2,4,1,1,6,-2,A
1995-03-11,1994,Sheffield Wednesday,Wimbledon,0-1,0,1,1,1,1,-1,A
1995-03-11,1994,West Ham United,Norwich City,2-2,2,2,1,1,4,0,D
1995-03-14,1994,Crystal Palace,Sheffield Wednesday,2-1,2,1,1,1,3,1,H
1995-03-14,1994,Liverpool,Coventry City,2-3,2,3,1,1,5,-1,A
1995-03-15,1994,Everton,Manchester City,1-1,1,1,1,1,2,0,D
1995-03-15,1994,Leicester City,Leeds United,1-3,1,3,1,1,4,-2,A
1995-03-15,1994,Manchester United,Tottenham Hotspur,0-0,0,0,1,1,0,0,D
1995-03-15,1994,Queens Park Rangers,Norwich City,2-0,2,0,1,1,2,2,H
1995-03-15,1994,Southampton,West Ham United,1-1,1,1,1,1,2,0,D
1995-03-18,1994,Aston Villa,West Ham United,0-2,0,2,1,1,2,-2,A
1995-03-18,1994,Blackburn Rovers,Chelsea,2-1,2,1,1,1,3,1,H
1995-03-18,1994,Leeds United,Coventry City,3-0,3,0,1,1,3,3,H
1995-03-18,1994,Manchester City,Sheffield Wednesday,3-2,3,2,1,1,5,1,H
1995-03-18,1994,Nottingham Forest,Southampton,3-0,3,0,1,1,3,3,H
1995-03-18,1994,Queens Park Rangers,Everton,2-3,2,3,1,1,5,-1,A
1995-03-18,1994,Tottenham Hotspur,Leicester City,1-0,1,0,1,1,1,1,H
1995-03-18,1994,Wimbledon,Crystal Palace,2-0,2,0,1,1,2,2,H
1995-03-19,1994,Liverpool,Manchester United,2-0,2,0,1,1,2,2,H
1995-03-19,1994,Newcastle United,Arsenal,1-0,1,0,1,1,1,1,H
1995-03-20,1994,Norwich City,Ipswich Town,3-0,3,0,1,1,3,3,H
1995-03-21,1994,Wimbledon,Manchester City,2-0,2,0,1,1,2,2,H
1995-03-22,1994,Manchester United,Arsenal,3-0,3,0,1,1,3,3,H
1995-03-22,1994,Nottingham Forest,Leeds United,3-0,3,0,1,1,3,3,H
1995-03-22,1994,Queens Park Rangers,Chelsea,1-0,1,0,1,1,1,1,H
1995-03-22,1994,Southampton,Newcastle United,3-1,3,1,1,1,4,2,H
1995-03-22,1994,Tottenham Hotspur,Liverpool,0-0,0,0,1,1,0,0,D
1995-04-01,1994,Arsenal,Norwich City,5-1,5,1,1,1,6,4,H
1995-04-01,1994,Chelsea,Newcastle United,1-1,1,1,1,1,2,0,D
1995-04-01,1994,Coventry City,Queens Park Rangers,0-1,0,1,1,1,1,-1,A
1995-04-01,1994,Crystal Palace,Manchester City,2-1,2,1,1,1,3,1,H
1995-04-01,1994,Everton,Blackburn Rovers,1-2,1,2,1,1,3,-1,A
1995-04-01,1994,Ipswich Town,Aston Villa,0-1,0,1,1,1,1,-1,A
1995-04-01,1994,Leicester City,Wimbledon,3-4,3,4,1,1,7,-1,A
1995-04-01,1994,Sheffield Wednesday,Nottingham Forest,1-7,1,7,1,1,8,-6,A
1995-04-02,1994,Manchester United,Leeds United,0-0,0,0,1,1,0,0,D
1995-04-02,1994,Southampton,Tottenham Hotspur,4-3,4,3,1,1,7,1,H
1995-04-04,1994,Crystal Palace,Aston Villa,0-0,0,0,1,1,0,0,D
1995-04-04,1994,Queens Park Rangers,Blackburn Rovers,0-1,0,1,1,1,1,-1,A
1995-04-05,1994,Leeds United,Ipswich Town,4-0,4,0,1,1,4,4,H
1995-04-05,1994,Leicester City,Norwich City,1-0,1,0,1,1,1,1,H
1995-04-05,1994,Liverpool,Southampton,3-1,3,1,1,1,4,2,H
1995-04-08,1994,Newcastle United,Norwich City,3-0,3,0,1,1,3,3,H
1995-04-08,1994,Nottingham Forest,West Ham United,1-1,1,1,1,1,2,0,D
1995-04-08,1994,Queens Park Rangers,Arsenal,3-1,3,1,1,1,4,2,H
1995-04-08,1994,Sheffield Wednesday,Leicester City,1-0,1,0,1,1,1,1,H
1995-04-09,1994,Liverpool,Leeds United,0-1,0,1,1,1,1,-1,A
1995-04-10,1994,Wimbledon,Chelsea,1-1,1,1,1,1,2,0,D
1995-04-11,1994,Ipswich Town,Queens Park Rangers,0-1,0,1,1,1,1,-1,A
1995-04-11,1994,Tottenham Hotspur,Manchester City,2-1,2,1,1,1,3,1,H
1995-04-12,1994,Arsenal,Liverpool,0-1,0,1,1,1,1,-1,A
1995-04-12,1994,Chelsea,Southampton,0-2,0,2,1,1,2,-2,A
1995-04-12,1994,Norwich City,Nottingham Forest,0-1,0,1,1,1,1,-1,A
1995-04-13,1994,West Ham United,Wimbledon,3-0,3,0,1,1,3,3,H
1995-04-14,1994,Crystal Palace,Tottenham Hotspur,1-1,1,1,1,1,2,0,D
1995-04-14,1994,Everton,Newcastle United,2-0,2,0,1,1,2,2,H
1995-04-14,1994,Manchester City,Liverpool,2-1,2,1,1,1,3,1,H
1995-04-15,1994,Arsenal,Ipswich Town,4-1,4,1,1,1,5,3,H
1995-04-15,1994,Chelsea,Aston Villa,1-0,1,0,1,1,1,1,H
1995-04-15,1994,Coventry City,Sheffield Wednesday,2-0,2,0,1,1,2,2,H
1995-04-15,1994,Leeds United,Blackburn Rovers,1-1,1,1,1,1,2,0,D
1995-04-15,1994,Leicester City,Manchester United,0-4,0,4,1,1,4,-4,A
1995-04-15,1994,Southampton,Queens Park Rangers,2-1,2,1,1,1,3,1,H
1995-04-17,1994,Aston Villa,Arsenal,0-4,0,4,1,1,4,-4,A
1995-04-17,1994,Blackburn Rovers,Manchester City,2-3,2,3,1,1,5,-1,A
1995-04-17,1994,Ipswich Town,West Ham United,1-1,1,1,1,1,2,0,D
1995-04-17,1994,Liverpool,Leicester City,2-0,2,0,1,1,2,2,H
1995-04-17,1994,Manchester United,Chelsea,0-0,0,0,1,1,0,0,D
1995-04-17,1994,Newcastle United,Leeds United,1-2,1,2,1,1,3,-1,A
1995-04-17,1994,Nottingham Forest,Coventry City,2-0,2,0,1,1,2,2,H
1995-04-17,1994,Queens Park Rangers,Crystal Palace,0-1,0,1,1,1,1,-1,A
1995-04-17,1994,Sheffield Wednesday,Everton,0-0,0,0,1,1,0,0,D
1995-04-17,1994,Tottenham Hotspur,Norwich City,1-0,1,0,1,1,1,1,H
1995-04-17,1994,Wimbledon,Southampton,0-2,0,2,1,1,2,-2,A
1995-04-19,1994,Blackburn Rovers,Crystal Palace,2-1,2,1,1,1,3,1,H
1995-04-29,1994,Arsenal,Tottenham Hotspur,1-1,1,1,1,1,2,0,D
1995-04-29,1994,Chelsea,Queens Park Rangers,1-0,1,0,1,1,1,1,H
1995-04-29,1994,Crystal Palace,Nottingham Forest,1-2,1,2,1,1,3,-1,A
1995-04-29,1994,Everton,Wimbledon,0-0,0,0,1,1,0,0,D
1995-04-29,1994,Leeds United,Aston Villa,1-0,1,0,1,1,1,1,H
1995-04-29,1994,Leicester City,Ipswich Town,2-0,2,0,1,1,2,2,H
1995-04-29,1994,Manchester City,Newcastle United,0-0,0,0,1,1,0,0,D
1995-04-29,1994,Norwich City,Liverpool,1-2,1,2,1,1,3,-1,A
1995-04-29,1994,Southampton,Sheffield Wednesday,0-0,0,0,1,1,0,0,D
1995-04-30,1994,West Ham United,Blackburn Rovers,2-0,2,0,1,1,2,2,H
1995-05-01,1994,Coventry City,Manchester United,2-3,2,3,1,1,5,-1,A
1995-05-02,1994,Wimbledon,Liverpool,0-0,0,0,1,1,0,0,D
1995-05-03,1994,Aston Villa,Manchester City,1-1,1,1,1,1,2,0,D
1995-05-03,1994,Everton,Chelsea,3-3,3,3,1,1,6,0,D
1995-05-03,1994,Newcastle United,Tottenham Hotspur,3-3,3,3,1,1,6,0,D
1995-05-03,1994,Southampton,Crystal Palace,3-1,3,1,1,1,4,2,H
1995-05-03,1994,West Ham United,Queens Park Rangers,0-0,0,0,1,1,0,0,D
1995-05-04,1994,Arsenal,Wimbledon,0-0,0,0,1,1,0,0,D
1995-05-06,1994,Aston Villa,Liverpool,2-0,2,0,1,1,2,2,H
1995-05-06,1994,Crystal Palace,West Ham United,1-0,1,0,1,1,1,1,H
1995-05-06,1994,Everton,Southampton,0-0,0,0,1,1,0,0,D
1995-05-06,1994,Ipswich Town,Coventry City,2-0,2,0,1,1,2,2,H
1995-05-06,1994,Leeds United,Norwich City,2-1,2,1,1,1,3,1,H
1995-05-06,1994,Leicester City,Chelsea,1-1,1,1,1,1,2,0,D
1995-05-06,1994,Nottingham Forest,Manchester City,1-0,1,0,1,1,1,1,H
1995-05-06,1994,Queens Park Rangers,Tottenham Hotspur,2-1,2,1,1,1,3,1,H
1995-05-07,1994,Manchester United,Sheffield Wednesday,1-0,1,0,1,1,1,1,H
1995-05-08,1994,Blackburn Rovers,Newcastle United,1-0,1,0,1,1,1,1,H
1995-05-09,1994,Ipswich Town,Everton,0-1,0,1,1,1,1,-1,A
1995-05-09,1994,Leeds United,Crystal Palace,3-1,3,1,1,1,4,2,H
1995-05-09,1994,Tottenham Hotspur,Coventry City,1-3,1,3,1,1,4,-2,A
1995-05-10,1994,Manchester United,Southampton,2-1,2,1,1,1,3,1,H
1995-05-10,1994,West Ham United,Liverpool,3-0,3,0,1,1,3,3,H
1995-05-13,1994,Wimbledon,Nottingham Forest,2-2,2,2,1,1,4,0,D
1995-05-14,1994,Chelsea,Arsenal,2-1,2,1,1,1,3,1,H
1995-05-14,1994,Coventry City,Everton,0-0,0,0,1,1,0,0,D
1995-05-14,1994,Liverpool,Blackburn Rovers,2-1,2,1,1,1,3,1,H
1995-05-14,1994,Manchester City,Queens Park Rangers,2-3,2,3,1,1,5,-1,A
1995-05-14,1994,Newcastle United,Crystal Palace,3-2,3,2,1,1,5,1,H
1995-05-14,1994,Norwich City,Aston Villa,1-1,1,1,1,1,2,0,D
1995-05-14,1994,Sheffield Wednesday,Ipswich Town,4-1,4,1,1,1,5,3,H
1995-05-14,1994,Southampton,Leicester City,2-2,2,2,1,1,4,0,D
1995-05-14,1994,Tottenham Hotspur,Leeds United,1-1,1,1,1,1,2,0,D
1995-05-14,1994,West Ham United,Manchester United,1-1,1,1,1,1,2,0,D
1995-08-19,1995,Aston Villa,Manchester United,3-1,3,1,1,1,4,2,H
1995-08-19,1995,Blackburn Rovers,Queens Park Rangers,1-0,1,0,1,1,1,1,H
1995-08-19,1995,Chelsea,Everton,0-0,0,0,1,1,0,0,D
1995-08-19,1995,Liverpool,Sheffield Wednesday,1-0,1,0,1,1,1,1,H
1995-08-19,1995,Manchester City,Tottenham Hotspur,1-1,1,1,1,1,2,0,D
1995-08-19,1995,Newcastle United,Coventry City,3-0,3,0,1,1,3,3,H
1995-08-19,1995,Southampton,Nottingham Forest,3-4,3,4,1,1,7,-1,A
1995-08-19,1995,West Ham United,Leeds United,1-2,1,2,1,1,3,-1,A
1995-08-19,1995,Wimbledon,Bolton Wanderers,3-2,3,2,1,1,5,1,H
1995-08-20,1995,Arsenal,Middlesbrough,1-1,1,1,1,1,2,0,D
1995-08-21,1995,Leeds United,Liverpool,1-0,1,0,1,1,1,1,H
1995-08-22,1995,Bolton Wanderers,Newcastle United,1-3,1,3,1,1,4,-2,A
1995-08-23,1995,Coventry City,Manchester City,2-1,2,1,1,1,3,1,H
1995-08-23,1995,Everton,Arsenal,0-2,0,2,1,1,2,-2,A
1995-08-23,1995,Manchester United,West Ham United,2-1,2,1,1,1,3,1,H
1995-08-23,1995,Nottingham Forest,Chelsea,0-0,0,0,1,1,0,0,D
1995-08-23,1995,Queens Park Rangers,Wimbledon,0-3,0,3,1,1,3,-3,A
1995-08-23,1995,Sheffield Wednesday,Blackburn Rovers,2-1,2,1,1,1,3,1,H
1995-08-23,1995,Tottenham Hotspur,Aston Villa,0-1,0,1,1,1,1,-1,A
1995-08-26,1995,Bolton Wanderers,Blackburn Rovers,2-1,2,1,1,1,3,1,H
1995-08-26,1995,Coventry City,Arsenal,0-0,0,0,1,1,0,0,D
1995-08-26,1995,Everton,Southampton,2-0,2,0,1,1,2,2,H
1995-08-26,1995,Leeds United,Aston Villa,2-0,2,0,1,1,2,2,H
1995-08-26,1995,Manchester United,Wimbledon,3-1,3,1,1,1,4,2,H
1995-08-26,1995,Middlesbrough,Chelsea,2-0,2,0,1,1,2,2,H
1995-08-26,1995,Nottingham Forest,West Ham United,1-1,1,1,1,1,2,0,D
1995-08-26,1995,Queens Park Rangers,Manchester City,1-0,1,0,1,1,1,1,H
1995-08-26,1995,Tottenham Hotspur,Liverpool,1-3,1,3,1,1,4,-2,A
1995-08-27,1995,Sheffield Wednesday,Newcastle United,0-2,0,2,1,1,2,-2,A
1995-08-28,1995,Blackburn Rovers,Manchester United,1-2,1,2,1,1,3,-1,A
1995-08-29,1995,Arsenal,Nottingham Forest,1-1,1,1,1,1,2,0,D
1995-08-30,1995,Aston Villa,Bolton Wanderers,1-0,1,0,1,1,1,1,H
1995-08-30,1995,Chelsea,Coventry City,2-2,2,2,1,1,4,0,D
1995-08-30,1995,Liverpool,Queens Park Rangers,1-0,1,0,1,1,1,1,H
1995-08-30,1995,Manchester City,Everton,0-2,0,2,1,1,2,-2,A
1995-08-30,1995,Newcastle United,Middlesbrough,1-0,1,0,1,1,1,1,H
1995-08-30,1995,Southampton,Leeds United,1-1,1,1,1,1,2,0,D
1995-08-30,1995,West Ham United,Tottenham Hotspur,1-1,1,1,1,1,2,0,D
1995-08-30,1995,Wimbledon,Sheffield Wednesday,2-2,2,2,1,1,4,0,D
1995-09-09,1995,Blackburn Rovers,Aston Villa,1-1,1,1,1,1,2,0,D
1995-09-09,1995,Bolton Wanderers,Middlesbrough,1-1,1,1,1,1,2,0,D
1995-09-09,1995,Coventry City,Nottingham Forest,1-1,1,1,1,1,2,0,D
1995-09-09,1995,Everton,Manchester United,2-3,2,3,1,1,5,-1,A
1995-09-09,1995,Queens Park Rangers,Sheffield Wednesday,0-3,0,3,1,1,3,-3,A
1995-09-09,1995,Southampton,Newcastle United,1-0,1,0,1,1,1,1,H
1995-09-09,1995,Tottenham Hotspur,Leeds United,2-1,2,1,1,1,3,1,H
1995-09-09,1995,Wimbledon,Liverpool,1-0,1,0,1,1,1,1,H
1995-09-10,1995,Manchester City,Arsenal,0-1,0,1,1,1,1,-1,A
1995-09-11,1995,West Ham United,Chelsea,1-3,1,3,1,1,4,-2,A
1995-09-12,1995,Middlesbrough,Southampton,0-0,0,0,1,1,0,0,D
1995-09-16,1995,Arsenal,West Ham United,1-0,1,0,1,1,1,1,H
1995-09-16,1995,Aston Villa,Wimbledon,2-0,2,0,1,1,2,2,H
1995-09-16,1995,Chelsea,Southampton,3-0,3,0,1,1,3,3,H
1995-09-16,1995,Leeds United,Queens Park Rangers,1-3,1,3,1,1,4,-2,A
1995-09-16,1995,Liverpool,Blackburn Rovers,3-0,3,0,1,1,3,3,H
1995-09-16,1995,Manchester United,Bolton Wanderers,3-0,3,0,1,1,3,3,H
1995-09-16,1995,Middlesbrough,Coventry City,2-1,2,1,1,1,3,1,H
1995-09-16,1995,Newcastle United,Manchester City,3-1,3,1,1,1,4,2,H
1995-09-16,1995,Sheffield Wednesday,Tottenham Hotspur,1-3,1,3,1,1,4,-2,A
1995-09-17,1995,Nottingham Forest,Everton,3-2,3,2,1,1,5,1,H
1995-09-23,1995,Arsenal,Southampton,4-2,4,2,1,1,6,2,H
1995-09-23,1995,Aston Villa,Nottingham Forest,1-1,1,1,1,1,2,0,D
1995-09-23,1995,Blackburn Rovers,Coventry City,5-1,5,1,1,1,6,4,H
1995-09-23,1995,Liverpool,Bolton Wanderers,5-2,5,2,1,1,7,3,H
1995-09-23,1995,Manchester City,Middlesbrough,0-1,0,1,1,1,1,-1,A
1995-09-23,1995,Sheffield Wednesday,Manchester United,0-0,0,0,1,1,0,0,D
1995-09-23,1995,West Ham United,Everton,2-1,2,1,1,1,3,1,H
1995-09-23,1995,Wimbledon,Leeds United,2-4,2,4,1,1,6,-2,A
1995-09-24,1995,Newcastle United,Chelsea,2-0,2,0,1,1,2,2,H
1995-09-25,1995,Queens Park Rangers,Tottenham Hotspur,2-3,2,3,1,1,5,-1,A
1995-09-30,1995,Bolton Wanderers,Queens Park Rangers,0-1,0,1,1,1,1,-1,A
1995-09-30,1995,Chelsea,Arsenal,1-0,1,0,1,1,1,1,H
1995-09-30,1995,Coventry City,Aston Villa,0-3,0,3,1,1,3,-3,A
1995-09-30,1995,Leeds United,Sheffield Wednesday,2-0,2,0,1,1,2,2,H
1995-09-30,1995,Middlesbrough,Blackburn Rovers,2-0,2,0,1,1,2,2,H
1995-09-30,1995,Nottingham Forest,Manchester City,3-0,3,0,1,1,3,3,H
1995-09-30,1995,Tottenham Hotspur,Wimbledon,3-1,3,1,1,1,4,2,H
1995-10-01,1995,Everton,Newcastle United,1-3,1,3,1,1,4,-2,A
1995-10-01,1995,Manchester United,Liverpool,2-2,2,2,1,1,4,0,D
1995-10-02,1995,Southampton,West Ham United,0-0,0,0,1,1,0,0,D
1995-10-14,1995,Aston Villa,Chelsea,0-1,0,1,1,1,1,-1,A
1995-10-14,1995,Blackburn Rovers,Southampton,2-1,2,1,1,1,3,1,H
1995-10-14,1995,Bolton Wanderers,Everton,1-1,1,1,1,1,2,0,D
1995-10-14,1995,Leeds United,Arsenal,0-3,0,3,1,1,3,-3,A
1995-10-14,1995,Liverpool,Coventry City,0-0,0,0,1,1,0,0,D
1995-10-14,1995,Manchester United,Manchester City,1-0,1,0,1,1,1,1,H
1995-10-14,1995,Queens Park Rangers,Newcastle United,2-3,2,3,1,1,5,-1,A
1995-10-14,1995,Tottenham Hotspur,Nottingham Forest,0-1,0,1,1,1,1,-1,A
1995-10-15,1995,Sheffield Wednesday,Middlesbrough,0-1,0,1,1,1,1,-1,A
1995-10-16,1995,Wimbledon,West Ham United,0-1,0,1,1,1,1,-1,A
1995-10-21,1995,Arsenal,Aston Villa,2-0,2,0,1,1,2,2,H
1995-10-21,1995,Chelsea,Manchester United,1-4,1,4,1,1,5,-3,A
1995-10-21,1995,Coventry City,Sheffield Wednesday,0-1,0,1,1,1,1,-1,A
1995-10-21,1995,Manchester City,Leeds United,0-0,0,0,1,1,0,0,D
1995-10-21,1995,Middlesbrough,Queens Park Rangers,1-0,1,0,1,1,1,1,H
1995-10-21,1995,Newcastle United,Wimbledon,6-1,6,1,1,1,7,5,H
1995-10-21,1995,Nottingham Forest,Bolton Wanderers,3-2,3,2,1,1,5,1,H
1995-10-21,1995,West Ham United,Blackburn Rovers,1-1,1,1,1,1,2,0,D
1995-10-22,1995,Everton,Tottenham Hotspur,1-1,1,1,1,1,2,0,D
1995-10-22,1995,Southampton,Liverpool,1-3,1,3,1,1,4,-2,A
1995-10-28,1995,Aston Villa,Everton,1-0,1,0,1,1,1,1,H
1995-10-28,1995,Blackburn Rovers,Chelsea,3-0,3,0,1,1,3,3,H
1995-10-28,1995,Leeds United,Coventry City,3-1,3,1,1,1,4,2,H
1995-10-28,1995,Liverpool,Manchester City,6-0,6,0,1,1,6,6,H
1995-10-28,1995,Manchester United,Middlesbrough,2-0,2,0,1,1,2,2,H
1995-10-28,1995,Queens Park Rangers,Nottingham Forest,1-1,1,1,1,1,2,0,D
1995-10-28,1995,Sheffield Wednesday,West Ham United,0-1,0,1,1,1,1,-1,A
1995-10-28,1995,Wimbledon,Southampton,1-2,1,2,1,1,3,-1,A
1995-10-29,1995,Tottenham Hotspur,Newcastle United,1-1,1,1,1,1,2,0,D
1995-10-30,1995,Bolton Wanderers,Arsenal,1-0,1,0,1,1,1,1,H
1995-11-04,1995,Arsenal,Manchester United,1-0,1,0,1,1,1,1,H
1995-11-04,1995,Chelsea,Sheffield Wednesday,0-0,0,0,1,1,0,0,D
1995-11-04,1995,Coventry City,Tottenham Hotspur,2-3,2,3,1,1,5,-1,A
1995-11-04,1995,Manchester City,Bolton Wanderers,1-0,1,0,1,1,1,1,H
1995-11-04,1995,Middlesbrough,Leeds United,1-1,1,1,1,1,2,0,D
1995-11-04,1995,Newcastle United,Liverpool,2-1,2,1,1,1,3,1,H
1995-11-04,1995,Southampton,Queens Park Rangers,2-0,2,0,1,1,2,2,H
1995-11-04,1995,West Ham United,Aston Villa,1-4,1,4,1,1,5,-3,A
1995-11-05,1995,Everton,Blackburn Rovers,1-0,1,0,1,1,1,1,H
1995-11-06,1995,Nottingham Forest,Wimbledon,4-1,4,1,1,1,5,3,H
1995-11-08,1995,Newcastle United,Blackburn Rovers,1-0,1,0,1,1,1,1,H
1995-11-18,1995,Aston Villa,Newcastle United,1-1,1,1,1,1,2,0,D
1995-11-18,1995,Blackburn Rovers,Nottingham Forest,7-0,7,0,1,1,7,7,H
1995-11-18,1995,Bolton Wanderers,West Ham United,0-3,0,3,1,1,3,-3,A
1995-11-18,1995,Leeds United,Chelsea,1-0,1,0,1,1,1,1,H
1995-11-18,1995,Liverpool,Everton,1-2,1,2,1,1,3,-1,A
1995-11-18,1995,Manchester United,Southampton,4-1,4,1,1,1,5,3,H
1995-11-18,1995,Sheffield Wednesday,Manchester City,1-1,1,1,1,1,2,0,D
1995-11-18,1995,Tottenham Hotspur,Arsenal,2-1,2,1,1,1,3,1,H
1995-11-18,1995,Wimbledon,Middlesbrough,0-0,0,0,1,1,0,0,D
1995-11-19,1995,Queens Park Rangers,Coventry City,1-1,1,1,1,1,2,0,D
1995-11-20,1995,Southampton,Aston Villa,0-1,0,1,1,1,1,-1,A
1995-11-21,1995,Arsenal,Sheffield Wednesday,4-2,4,2,1,1,6,2,H
1995-11-21,1995,Middlesbrough,Tottenham Hotspur,0-1,0,1,1,1,1,-1,A
1995-11-22,1995,Chelsea,Bolton Wanderers,3-2,3,2,1,1,5,1,H
1995-11-22,1995,Coventry City,Manchester United,0-4,0,4,1,1,4,-4,A
1995-11-22,1995,Everton,Queens Park Rangers,2-0,2,0,1,1,2,2,H
1995-11-22,1995,Manchester City,Wimbledon,1-0,1,0,1,1,1,1,H
1995-11-22,1995,West Ham United,Liverpool,0-0,0,0,1,1,0,0,D
1995-11-25,1995,Chelsea,Tottenham Hotspur,0-0,0,0,1,1,0,0,D
1995-11-25,1995,Coventry City,Wimbledon,3-3,3,3,1,1,6,0,D
1995-11-25,1995,Everton,Sheffield Wednesday,2-2,2,2,1,1,4,0,D
1995-11-25,1995,Manchester City,Aston Villa,1-0,1,0,1,1,1,1,H
1995-11-25,1995,Middlesbrough,Liverpool,2-1,2,1,1,1,3,1,H
1995-11-25,1995,Newcastle United,Leeds United,2-1,2,1,1,1,3,1,H
1995-11-25,1995,Southampton,Bolton Wanderers,1-0,1,0,1,1,1,1,H
1995-11-25,1995,West Ham United,Queens Park Rangers,1-0,1,0,1,1,1,1,H
1995-11-26,1995,Arsenal,Blackburn Rovers,0-0,0,0,1,1,0,0,D
1995-11-27,1995,Nottingham Forest,Manchester United,1-1,1,1,1,1,2,0,D
1995-12-02,1995,Aston Villa,Arsenal,1-1,1,1,1,1,2,0,D
1995-12-02,1995,Blackburn Rovers,West Ham United,4-2,4,2,1,1,6,2,H
1995-12-02,1995,Bolton Wanderers,Nottingham Forest,1-1,1,1,1,1,2,0,D
1995-12-02,1995,Leeds United,Manchester City,0-1,0,1,1,1,1,-1,A
1995-12-02,1995,Liverpool,Southampton,1-1,1,1,1,1,2,0,D
1995-12-02,1995,Manchester United,Chelsea,1-1,1,1,1,1,2,0,D
1995-12-02,1995,Queens Park Rangers,Middlesbrough,1-1,1,1,1,1,2,0,D
1995-12-02,1995,Tottenham Hotspur,Everton,0-0,0,0,1,1,0,0,D
1995-12-03,1995,Wimbledon,Newcastle United,3-3,3,3,1,1,6,0,D
1995-12-04,1995,Sheffield Wednesday,Coventry City,4-3,4,3,1,1,7,1,H
1995-12-09,1995,Bolton Wanderers,Liverpool,0-1,0,1,1,1,1,-1,A
1995-12-09,1995,Chelsea,Newcastle United,1-0,1,0,1,1,1,1,H
1995-12-09,1995,Coventry City,Blackburn Rovers,5-0,5,0,1,1,5,5,H
1995-12-09,1995,Leeds United,Wimbledon,1-1,1,1,1,1,2,0,D
1995-12-09,1995,Manchester United,Sheffield Wednesday,2-2,2,2,1,1,4,0,D
1995-12-09,1995,Middlesbrough,Manchester City,4-1,4,1,1,1,5,3,H
1995-12-09,1995,Southampton,Arsenal,0-0,0,0,1,1,0,0,D
1995-12-09,1995,Tottenham Hotspur,Queens Park Rangers,1-0,1,0,1,1,1,1,H
1995-12-10,1995,Nottingham Forest,Aston Villa,1-1,1,1,1,1,2,0,D
1995-12-11,1995,Everton,West Ham United,3-0,3,0,1,1,3,3,H
1995-12-16,1995,Arsenal,Chelsea,1-1,1,1,1,1,2,0,D
1995-12-16,1995,Aston Villa,Coventry City,4-1,4,1,1,1,5,3,H
1995-12-16,1995,Blackburn Rovers,Middlesbrough,1-0,1,0,1,1,1,1,H
1995-12-16,1995,Newcastle United,Everton,1-0,1,0,1,1,1,1,H
1995-12-16,1995,Queens Park Rangers,Bolton Wanderers,2-1,2,1,1,1,3,1,H
1995-12-16,1995,Sheffield Wednesday,Leeds United,6-2,6,2,1,1,8,4,H
1995-12-16,1995,West Ham United,Southampton,2-1,2,1,1,1,3,1,H
1995-12-16,1995,Wimbledon,Tottenham Hotspur,0-1,0,1,1,1,1,-1,A
1995-12-17,1995,Liverpool,Manchester United,2-0,2,0,1,1,2,2,H
1995-12-18,1995,Manchester City,Nottingham Forest,1-1,1,1,1,1,2,0,D
1995-12-23,1995,Coventry City,Everton,2-1,2,1,1,1,3,1,H
1995-12-23,1995,Liverpool,Arsenal,3-1,3,1,1,1,4,2,H
1995-12-23,1995,Manchester City,Chelsea,0-1,0,1,1,1,1,-1,A
1995-12-23,1995,Middlesbrough,West Ham United,4-2,4,2,1,1,6,2,H
1995-12-23,1995,Newcastle United,Nottingham Forest,3-1,3,1,1,1,4,2,H
1995-12-23,1995,Queens Park Rangers,Aston Villa,1-0,1,0,1,1,1,1,H
1995-12-23,1995,Sheffield Wednesday,Southampton,2-2,2,2,1,1,4,0,D
1995-12-23,1995,Tottenham Hotspur,Bolton Wanderers,2-2,2,2,1,1,4,0,D
1995-12-23,1995,Wimbledon,Blackburn Rovers,1-1,1,1,1,1,2,0,D
1995-12-24,1995,Leeds United,Manchester United,3-1,3,1,1,1,4,2,H
1995-12-26,1995,Arsenal,Queens Park Rangers,3-0,3,0,1,1,3,3,H
1995-12-26,1995,Blackburn Rovers,Manchester City,2-0,2,0,1,1,2,2,H
1995-12-26,1995,Chelsea,Wimbledon,1-2,1,2,1,1,3,-1,A
1995-12-26,1995,Everton,Middlesbrough,4-0,4,0,1,1,4,4,H
1995-12-26,1995,Nottingham Forest,Sheffield Wednesday,1-0,1,0,1,1,1,1,H
1995-12-26,1995,Southampton,Tottenham Hotspur,0-0,0,0,1,1,0,0,D
1995-12-27,1995,Bolton Wanderers,Leeds United,0-2,0,2,1,1,2,-2,A
1995-12-27,1995,Manchester United,Newcastle United,2-0,2,0,1,1,2,2,H
1995-12-30,1995,Arsenal,Wimbledon,1-3,1,3,1,1,4,-2,A
1995-12-30,1995,Blackburn Rovers,Tottenham Hotspur,2-1,2,1,1,1,3,1,H
1995-12-30,1995,Bolton Wanderers,Coventry City,1-2,1,2,1,1,3,-1,A
1995-12-30,1995,Chelsea,Liverpool,2-2,2,2,1,1,4,0,D
1995-12-30,1995,Everton,Leeds United,2-0,2,0,1,1,2,2,H
1995-12-30,1995,Manchester United,Queens Park Rangers,2-1,2,1,1,1,3,1,H
1995-12-30,1995,Nottingham Forest,Middlesbrough,1-0,1,0,1,1,1,1,H
1996-01-01,1995,Coventry City,Southampton,1-1,1,1,1,1,2,0,D
1996-01-01,1995,Leeds United,Blackburn Rovers,0-0,0,0,1,1,0,0,D
1996-01-01,1995,Liverpool,Nottingham Forest,4-2,4,2,1,1,6,2,H
1996-01-01,1995,Manchester City,West Ham United,2-1,2,1,1,1,3,1,H
1996-01-01,1995,Middlesbrough,Aston Villa,0-2,0,2,1,1,2,-2,A
1996-01-01,1995,Sheffield Wednesday,Bolton Wanderers,4-2,4,2,1,1,6,2,H
1996-01-01,1995,Tottenham Hotspur,Manchester United,4-1,4,1,1,1,5,3,H
1996-01-01,1995,Wimbledon,Everton,2-3,2,3,1,1,5,-1,A
1996-01-02,1995,Newcastle United,Arsenal,2-0,2,0,1,1,2,2,H
1996-01-02,1995,Queens Park Rangers,Chelsea,1-2,1,2,1,1,3,-1,A
1996-01-13,1995,Bolton Wanderers,Wimbledon,1-0,1,0,1,1,1,1,H
1996-01-13,1995,Everton,Chelsea,1-1,1,1,1,1,2,0,D
1996-01-13,1995,Leeds United,West Ham United,2-0,2,0,1,1,2,2,H
1996-01-13,1995,Manchester United,Aston Villa,0-0,0,0,1,1,0,0,D
1996-01-13,1995,Middlesbrough,Arsenal,2-3,2,3,1,1,5,-1,A
1996-01-13,1995,Nottingham Forest,Southampton,1-0,1,0,1,1,1,1,H
1996-01-13,1995,Queens Park Rangers,Blackburn Rovers,0-1,0,1,1,1,1,-1,A
1996-01-13,1995,Sheffield Wednesday,Liverpool,1-1,1,1,1,1,2,0,D
1996-01-13,1995,Tottenham Hotspur,Manchester City,1-0,1,0,1,1,1,1,H
1996-01-14,1995,Coventry City,Newcastle United,0-1,0,1,1,1,1,-1,A
1996-01-20,1995,Arsenal,Everton,1-2,1,2,1,1,3,-1,A
1996-01-20,1995,Blackburn Rovers,Sheffield Wednesday,3-0,3,0,1,1,3,3,H
1996-01-20,1995,Chelsea,Nottingham Forest,1-0,1,0,1,1,1,1,H
1996-01-20,1995,Liverpool,Leeds United,5-0,5,0,1,1,5,5,H
1996-01-20,1995,Manchester City,Coventry City,1-1,1,1,1,1,2,0,D
1996-01-20,1995,Newcastle United,Bolton Wanderers,2-1,2,1,1,1,3,1,H
1996-01-20,1995,Southampton,Middlesbrough,2-1,2,1,1,1,3,1,H
1996-01-20,1995,Wimbledon,Queens Park Rangers,2-1,2,1,1,1,3,1,H
1996-01-21,1995,Aston Villa,Tottenham Hotspur,2-1,2,1,1,1,3,1,H
1996-01-23,1995,West Ham United,Manchester United,0-1,0,1,1,1,1,-1,A
1996-01-31,1995,Aston Villa,Liverpool,0-2,0,2,1,1,2,-2,A
1996-01-31,1995,Nottingham Forest,Leeds United,2-1,2,1,1,1,3,1,H
1996-01-31,1995,Southampton,Manchester City,1-1,1,1,1,1,2,0,D
1996-01-31,1995,West Ham United,Coventry City,3-2,3,2,1,1,5,1,H
1996-02-03,1995,Arsenal,Coventry City,1-1,1,1,1,1,2,0,D
1996-02-03,1995,Aston Villa,Leeds United,3-0,3,0,1,1,3,3,H
1996-02-03,1995,Blackburn Rovers,Bolton Wanderers,3-1,3,1,1,1,4,2,H
1996-02-03,1995,Liverpool,Tottenham Hotspur,0-0,0,0,1,1,0,0,D
1996-02-03,1995,Manchester City,Queens Park Rangers,2-0,2,0,1,1,2,2,H
1996-02-03,1995,Newcastle United,Sheffield Wednesday,2-0,2,0,1,1,2,2,H
1996-02-03,1995,Southampton,Everton,2-2,2,2,1,1,4,0,D
1996-02-03,1995,West Ham United,Nottingham Forest,1-0,1,0,1,1,1,1,H
1996-02-03,1995,Wimbledon,Manchester United,2-4,2,4,1,1,6,-2,A
1996-02-04,1995,Chelsea,Middlesbrough,5-0,5,0,1,1,5,5,H
1996-02-10,1995,Bolton Wanderers,Aston Villa,0-2,0,2,1,1,2,-2,A
1996-02-10,1995,Coventry City,Chelsea,1-0,1,0,1,1,1,1,H
1996-02-10,1995,Everton,Manchester City,2-0,2,0,1,1,2,2,H
1996-02-10,1995,Manchester United,Blackburn Rovers,1-0,1,0,1,1,1,1,H
1996-02-10,1995,Middlesbrough,Newcastle United,1-2,1,2,1,1,3,-1,A
1996-02-10,1995,Nottingham Forest,Arsenal,0-1,0,1,1,1,1,-1,A
1996-02-10,1995,Sheffield Wednesday,Wimbledon,2-1,2,1,1,1,3,1,H
1996-02-11,1995,Queens Park Rangers,Liverpool,1-2,1,2,1,1,3,-1,A
1996-02-12,1995,Tottenham Hotspur,West Ham United,0-1,0,1,1,1,1,-1,A
1996-02-17,1995,Chelsea,West Ham United,1-2,1,2,1,1,3,-1,A
1996-02-17,1995,Middlesbrough,Bolton Wanderers,1-4,1,4,1,1,5,-3,A
1996-02-17,1995,Sheffield Wednesday,Queens Park Rangers,1-3,1,3,1,1,4,-2,A
1996-02-21,1995,Manchester United,Everton,2-0,2,0,1,1,2,2,H
1996-02-21,1995,West Ham United,Newcastle United,2-0,2,0,1,1,2,2,H
1996-02-24,1995,Blackburn Rovers,Liverpool,2-3,2,3,1,1,5,-1,A
1996-02-24,1995,Coventry City,Middlesbrough,0-0,0,0,1,1,0,0,D
1996-02-24,1995,Everton,Nottingham Forest,3-0,3,0,1,1,3,3,H
1996-02-24,1995,Manchester City,Newcastle United,3-3,3,3,1,1,6,0,D
1996-02-24,1995,Southampton,Chelsea,2-3,2,3,1,1,5,-1,A
1996-02-24,1995,Tottenham Hotspur,Sheffield Wednesday,1-0,1,0,1,1,1,1,H
1996-02-24,1995,West Ham United,Arsenal,0-1,0,1,1,1,1,-1,A
1996-02-24,1995,Wimbledon,Aston Villa,3-3,3,3,1,1,6,0,D
1996-02-25,1995,Bolton Wanderers,Manchester United,0-6,0,6,1,1,6,-6,A
1996-02-28,1995,Aston Villa,Blackburn Rovers,2-0,2,0,1,1,2,2,H
1996-03-02,1995,Coventry City,West Ham United,2-2,2,2,1,1,4,0,D
1996-03-02,1995,Leeds United,Bolton Wanderers,0-1,0,1,1,1,1,-1,A
1996-03-02,1995,Manchester City,Blackburn Rovers,1-1,1,1,1,1,2,0,D
1996-03-02,1995,Middlesbrough,Everton,0-2,0,2,1,1,2,-2,A
1996-03-02,1995,Queens Park Rangers,Arsenal,1-1,1,1,1,1,2,0,D
1996-03-02,1995,Sheffield Wednesday,Nottingham Forest,1-3,1,3,1,1,4,-2,A
1996-03-02,1995,Tottenham Hotspur,Southampton,1-0,1,0,1,1,1,1,H
1996-03-02,1995,Wimbledon,Chelsea,1-1,1,1,1,1,2,0,D
1996-03-03,1995,Liverpool,Aston Villa,3-0,3,0,1,1,3,3,H
1996-03-04,1995,Newcastle United,Manchester United,0-1,0,1,1,1,1,-1,A
1996-03-05,1995,Arsenal,Manchester City,3-1,3,1,1,1,4,2,H
1996-03-06,1995,Aston Villa,Sheffield Wednesday,3-2,3,2,1,1,5,1,H
1996-03-06,1995,Queens Park Rangers,Leeds United,1-2,1,2,1,1,3,-1,A
1996-03-09,1995,Aston Villa,Queens Park Rangers,4-2,4,2,1,1,6,2,H
1996-03-09,1995,Everton,Coventry City,2-2,2,2,1,1,4,0,D
1996-03-09,1995,West Ham United,Middlesbrough,2-0,2,0,1,1,2,2,H
1996-03-12,1995,Chelsea,Manchester City,1-1,1,1,1,1,2,0,D
1996-03-13,1995,Blackburn Rovers,Leeds United,1-0,1,0,1,1,1,1,H
1996-03-13,1995,Liverpool,Wimbledon,2-2,2,2,1,1,4,0,D
1996-03-16,1995,Coventry City,Bolton Wanderers,0-2,0,2,1,1,2,-2,A
1996-03-16,1995,Liverpool,Chelsea,2-0,2,0,1,1,2,2,H
1996-03-16,1995,Manchester City,Southampton,2-1,2,1,1,1,3,1,H
1996-03-16,1995,Middlesbrough,Nottingham Forest,1-1,1,1,1,1,2,0,D
1996-03-16,1995,Queens Park Rangers,Manchester United,1-1,1,1,1,1,2,0,D
1996-03-16,1995,Sheffield Wednesday,Aston Villa,2-0,2,0,1,1,2,2,H
1996-03-16,1995,Tottenham Hotspur,Blackburn Rovers,2-3,2,3,1,1,5,-1,A
1996-03-16,1995,Wimbledon,Arsenal,0-3,0,3,1,1,3,-3,A
1996-03-17,1995,Leeds United,Everton,2-2,2,2,1,1,4,0,D
1996-03-18,1995,Newcastle United,West Ham United,3-0,3,0,1,1,3,3,H
1996-03-19,1995,Aston Villa,Middlesbrough,0-0,0,0,1,1,0,0,D
1996-03-20,1995,Bolton Wanderers,Tottenham Hotspur,2-3,2,3,1,1,5,-1,A
1996-03-20,1995,Manchester United,Arsenal,1-0,1,0,1,1,1,1,H
1996-03-20,1995,Southampton,Sheffield Wednesday,0-1,0,1,1,1,1,-1,A
1996-03-23,1995,Arsenal,Newcastle United,2-0,2,0,1,1,2,2,H
1996-03-23,1995,Bolton Wanderers,Sheffield Wednesday,2-1,2,1,1,1,3,1,H
1996-03-23,1995,Chelsea,Queens Park Rangers,1-1,1,1,1,1,2,0,D
1996-03-23,1995,Everton,Wimbledon,2-4,2,4,1,1,6,-2,A
1996-03-23,1995,Nottingham Forest,Liverpool,1-0,1,0,1,1,1,1,H
1996-03-23,1995,West Ham United,Manchester City,4-2,4,2,1,1,6,2,H
1996-03-24,1995,Manchester United,Tottenham Hotspur,1-0,1,0,1,1,1,1,H
1996-03-25,1995,Southampton,Coventry City,1-0,1,0,1,1,1,1,H
1996-03-30,1995,Blackburn Rovers,Everton,0-3,0,3,1,1,3,-3,A
1996-03-30,1995,Bolton Wanderers,Manchester City,1-1,1,1,1,1,2,0,D
1996-03-30,1995,Leeds United,Middlesbrough,0-1,0,1,1,1,1,-1,A
1996-03-30,1995,Queens Park Rangers,Southampton,3-0,3,0,1,1,3,3,H
1996-03-30,1995,Tottenham Hotspur,Coventry City,3-1,3,1,1,1,4,2,H
1996-03-30,1995,Wimbledon,Nottingham Forest,1-0,1,0,1,1,1,1,H
1996-04-03,1995,Leeds United,Southampton,1-0,1,0,1,1,1,1,H
1996-04-03,1995,Liverpool,Newcastle United,4-3,4,3,1,1,7,1,H
1996-04-05,1995,Middlesbrough,Sheffield Wednesday,3-1,3,1,1,1,4,2,H
1996-04-06,1995,Arsenal,Leeds United,2-1,2,1,1,1,3,1,H
1996-04-06,1995,Chelsea,Aston Villa,1-2,1,2,1,1,3,-1,A
1996-04-06,1995,Coventry City,Liverpool,1-0,1,0,1,1,1,1,H
1996-04-06,1995,Everton,Bolton Wanderers,3-0,3,0,1,1,3,3,H
1996-04-06,1995,Manchester City,Manchester United,2-3,2,3,1,1,5,-1,A
1996-04-06,1995,Newcastle United,Queens Park Rangers,2-1,2,1,1,1,3,1,H
1996-04-06,1995,Nottingham Forest,Tottenham Hotspur,2-1,2,1,1,1,3,1,H
1996-04-06,1995,Southampton,Blackburn Rovers,1-0,1,0,1,1,1,1,H
1996-04-06,1995,West Ham United,Wimbledon,1-1,1,1,1,1,2,0,D
1996-04-08,1995,Aston Villa,Southampton,3-0,3,0,1,1,3,3,H
1996-04-08,1995,Blackburn Rovers,Newcastle United,2-1,2,1,1,1,3,1,H
1996-04-08,1995,Bolton Wanderers,Chelsea,2-1,2,1,1,1,3,1,H
1996-04-08,1995,Leeds United,Nottingham Forest,1-3,1,3,1,1,4,-2,A
1996-04-08,1995,Liverpool,West Ham United,2-0,2,0,1,1,2,2,H
1996-04-08,1995,Manchester United,Coventry City,1-0,1,0,1,1,1,1,H
1996-04-08,1995,Queens Park Rangers,Everton,3-1,3,1,1,1,4,2,H
1996-04-08,1995,Sheffield Wednesday,Arsenal,1-0,1,0,1,1,1,1,H
1996-04-08,1995,Tottenham Hotspur,Middlesbrough,1-1,1,1,1,1,2,0,D
1996-04-08,1995,Wimbledon,Manchester City,3-0,3,0,1,1,3,3,H
1996-04-13,1995,Chelsea,Leeds United,4-1,4,1,1,1,5,3,H
1996-04-13,1995,Coventry City,Queens Park Rangers,1-0,1,0,1,1,1,1,H
1996-04-13,1995,Manchester City,Sheffield Wednesday,1-0,1,0,1,1,1,1,H
1996-04-13,1995,Middlesbrough,Wimbledon,1-2,1,2,1,1,3,-1,A
1996-04-13,1995,Nottingham Forest,Blackburn Rovers,1-5,1,5,1,1,6,-4,A
1996-04-13,1995,Southampton,Manchester United,3-1,3,1,1,1,4,2,H
1996-04-13,1995,West Ham United,Bolton Wanderers,1-0,1,0,1,1,1,1,H
1996-04-14,1995,Newcastle United,Aston Villa,1-0,1,0,1,1,1,1,H
1996-04-15,1995,Arsenal,Tottenham Hotspur,0-0,0,0,1,1,0,0,D
1996-04-16,1995,Everton,Liverpool,1-1,1,1,1,1,2,0,D
1996-04-17,1995,Aston Villa,West Ham United,1-1,1,1,1,1,2,0,D
1996-04-17,1995,Blackburn Rovers,Wimbledon,3-2,3,2,1,1,5,1,H
1996-04-17,1995,Manchester United,Leeds United,1-0,1,0,1,1,1,1,H
1996-04-17,1995,Newcastle United,Southampton,1-0,1,0,1,1,1,1,H
1996-04-17,1995,Nottingham Forest,Coventry City,0-0,0,0,1,1,0,0,D
1996-04-17,1995,Sheffield Wednesday,Chelsea,0-0,0,0,1,1,0,0,D
1996-04-27,1995,Aston Villa,Manchester City,0-1,0,1,1,1,1,-1,A
1996-04-27,1995,Blackburn Rovers,Arsenal,1-1,1,1,1,1,2,0,D
1996-04-27,1995,Bolton Wanderers,Southampton,0-1,0,1,1,1,1,-1,A
1996-04-27,1995,Liverpool,Middlesbrough,1-0,1,0,1,1,1,1,H
1996-04-27,1995,Queens Park Rangers,West Ham United,3-0,3,0,1,1,3,3,H
1996-04-27,1995,Sheffield Wednesday,Everton,2-5,2,5,1,1,7,-3,A
1996-04-27,1995,Tottenham Hotspur,Chelsea,1-1,1,1,1,1,2,0,D
1996-04-27,1995,Wimbledon,Coventry City,0-2,0,2,1,1,2,-2,A
1996-04-28,1995,Manchester United,Nottingham Forest,5-0,5,0,1,1,5,5,H
1996-04-29,1995,Leeds United,Newcastle United,0-1,0,1,1,1,1,-1,A
1996-05-01,1995,Arsenal,Liverpool,0-0,0,0,1,1,0,0,D
1996-05-02,1995,Leeds United,Tottenham Hotspur,1-3,1,3,1,1,4,-2,A
1996-05-02,1995,Nottingham Forest,Newcastle United,1-1,1,1,1,1,2,0,D
1996-05-04,1995,Arsenal,Bolton Wanderers,2-1,2,1,1,1,3,1,H
1996-05-04,1995,Chelsea,Blackburn Rovers,2-3,2,3,1,1,5,-1,A
1996-05-04,1995,Coventry City,Leeds United,0-0,0,0,1,1,0,0,D
1996-05-04,1995,Everton,Aston Villa,1-0,1,0,1,1,1,1,H
1996-05-04,1995,Manchester City,Liverpool,2-2,2,2,1,1,4,0,D
1996-05-04,1995,Middlesbrough,Manchester United,0-3,0,3,1,1,3,-3,A
1996-05-04,1995,Newcastle United,Tottenham Hotspur,1-1,1,1,1,1,2,0,D
1996-05-04,1995,Nottingham Forest,Queens Park Rangers,3-0,3,0,1,1,3,3,H
1996-05-04,1995,Southampton,Wimbledon,0-0,0,0,1,1,0,0,D
1996-05-04,1995,West Ham United,Sheffield Wednesday,1-1,1,1,1,1,2,0,D
1996-08-17,1996,Arsenal,West Ham United,2-0,2,0,1,1,2,2,H
1996-08-17,1996,Blackburn Rovers,Tottenham Hotspur,0-2,0,2,1,1,2,-2,A
1996-08-17,1996,Coventry City,Nottingham Forest,0-3,0,3,1,1,3,-3,A
1996-08-17,1996,Derby County,Leeds United,3-3,3,3,1,1,6,0,D
1996-08-17,1996,Everton,Newcastle United,2-0,2,0,1,1,2,2,H
1996-08-17,1996,Middlesbrough,Liverpool,3-3,3,3,1,1,6,0,D
1996-08-17,1996,Sheffield Wednesday,Aston Villa,2-1,2,1,1,1,3,1,H
1996-08-17,1996,Sunderland,Leicester City,0-0,0,0,1,1,0,0,D
1996-08-17,1996,Wimbledon,Manchester United,0-3,0,3,1,1,3,-3,A
1996-08-18,1996,Southampton,Chelsea,0-0,0,0,1,1,0,0,D
1996-08-19,1996,Liverpool,Arsenal,2-0,2,0,1,1,2,2,H
1996-08-20,1996,Leeds United,Sheffield Wednesday,0-2,0,2,1,1,2,-2,A
1996-08-21,1996,Aston Villa,Blackburn Rovers,1-0,1,0,1,1,1,1,H
1996-08-21,1996,Chelsea,Middlesbrough,1-0,1,0,1,1,1,1,H
1996-08-21,1996,Leicester City,Southampton,2-1,2,1,1,1,3,1,H
1996-08-21,1996,Manchester United,Everton,2-2,2,2,1,1,4,0,D
1996-08-21,1996,Newcastle United,Wimbledon,2-0,2,0,1,1,2,2,H
1996-08-21,1996,Nottingham Forest,Sunderland,1-4,1,4,1,1,5,-3,A
1996-08-21,1996,Tottenham Hotspur,Derby County,1-1,1,1,1,1,2,0,D
1996-08-21,1996,West Ham United,Coventry City,1-1,1,1,1,1,2,0,D
1996-08-24,1996,Aston Villa,Derby County,2-0,2,0,1,1,2,2,H
1996-08-24,1996,Chelsea,Coventry City,2-0,2,0,1,1,2,2,H
1996-08-24,1996,Leicester City,Arsenal,0-2,0,2,1,1,2,-2,A
1996-08-24,1996,Liverpool,Sunderland,0-0,0,0,1,1,0,0,D
1996-08-24,1996,Newcastle United,Sheffield Wednesday,1-2,1,2,1,1,3,-1,A
1996-08-24,1996,Nottingham Forest,Middlesbrough,1-1,1,1,1,1,2,0,D
1996-08-24,1996,Tottenham Hotspur,Everton,0-0,0,0,1,1,0,0,D
1996-08-24,1996,West Ham United,Southampton,2-1,2,1,1,1,3,1,H
1996-08-25,1996,Manchester United,Blackburn Rovers,2-2,2,2,1,1,4,0,D
1996-08-26,1996,Leeds United,Wimbledon,1-0,1,0,1,1,1,1,H
1996-09-02,1996,Sheffield Wednesday,Leicester City,2-1,2,1,1,1,3,1,H
1996-09-04,1996,Arsenal,Chelsea,3-3,3,3,1,1,6,0,D
1996-09-04,1996,Blackburn Rovers,Leeds United,0-1,0,1,1,1,1,-1,A
1996-09-04,1996,Coventry City,Liverpool,0-1,0,1,1,1,1,-1,A
1996-09-04,1996,Derby County,Manchester United,1-1,1,1,1,1,2,0,D
1996-09-04,1996,Everton,Aston Villa,0-1,0,1,1,1,1,-1,A
1996-09-04,1996,Middlesbrough,West Ham United,4-1,4,1,1,1,5,3,H
1996-09-04,1996,Southampton,Nottingham Forest,2-2,2,2,1,1,4,0,D
1996-09-04,1996,Sunderland,Newcastle United,1-2,1,2,1,1,3,-1,A
1996-09-04,1996,Wimbledon,Tottenham Hotspur,1-0,1,0,1,1,1,1,H
1996-09-07,1996,Aston Villa,Arsenal,2-2,2,2,1,1,4,0,D
1996-09-07,1996,Leeds United,Manchester United,0-4,0,4,1,1,4,-4,A
1996-09-07,1996,Liverpool,Southampton,2-1,2,1,1,1,3,1,H
1996-09-07,1996,Middlesbrough,Coventry City,4-0,4,0,1,1,4,4,H
1996-09-07,1996,Nottingham Forest,Leicester City,0-0,0,0,1,1,0,0,D
1996-09-07,1996,Sheffield Wednesday,Chelsea,0-2,0,2,1,1,2,-2,A
1996-09-07,1996,Tottenham Hotspur,Newcastle United,1-2,1,2,1,1,3,-1,A
1996-09-07,1996,Wimbledon,Everton,4-0,4,0,1,1,4,4,H
1996-09-08,1996,Sunderland,West Ham United,0-0,0,0,1,1,0,0,D
1996-09-09,1996,Blackburn Rovers,Derby County,1-2,1,2,1,1,3,-1,A
1996-09-14,1996,Coventry City,Leeds United,2-1,2,1,1,1,3,1,H
1996-09-14,1996,Derby County,Sunderland,1-0,1,0,1,1,1,1,H
1996-09-14,1996,Everton,Middlesbrough,1-2,1,2,1,1,3,-1,A
1996-09-14,1996,Manchester United,Nottingham Forest,4-1,4,1,1,1,5,3,H
1996-09-14,1996,Newcastle United,Blackburn Rovers,2-1,2,1,1,1,3,1,H
1996-09-14,1996,Southampton,Tottenham Hotspur,0-1,0,1,1,1,1,-1,A
1996-09-14,1996,West Ham United,Wimbledon,0-2,0,2,1,1,2,-2,A
1996-09-15,1996,Chelsea,Aston Villa,1-1,1,1,1,1,2,0,D
1996-09-15,1996,Leicester City,Liverpool,0-3,0,3,1,1,3,-3,A
1996-09-16,1996,Arsenal,Sheffield Wednesday,4-1,4,1,1,1,5,3,H
1996-09-21,1996,Aston Villa,Manchester United,0-0,0,0,1,1,0,0,D
1996-09-21,1996,Blackburn Rovers,Everton,1-1,1,1,1,1,2,0,D
1996-09-21,1996,Leeds United,Newcastle United,0-1,0,1,1,1,1,-1,A
1996-09-21,1996,Liverpool,Chelsea,5-1,5,1,1,1,6,4,H
1996-09-21,1996,Middlesbrough,Arsenal,0-2,0,2,1,1,2,-2,A
1996-09-21,1996,Nottingham Forest,West Ham United,0-2,0,2,1,1,2,-2,A
1996-09-21,1996,Sheffield Wednesday,Derby County,0-0,0,0,1,1,0,0,D
1996-09-21,1996,Sunderland,Coventry City,1-0,1,0,1,1,1,1,H
1996-09-22,1996,Tottenham Hotspur,Leicester City,1-2,1,2,1,1,3,-1,A
1996-09-23,1996,Wimbledon,Southampton,3-1,3,1,1,1,4,2,H
1996-09-28,1996,Arsenal,Sunderland,2-0,2,0,1,1,2,2,H
1996-09-28,1996,Chelsea,Nottingham Forest,1-1,1,1,1,1,2,0,D
1996-09-28,1996,Coventry City,Blackburn Rovers,0-0,0,0,1,1,0,0,D
1996-09-28,1996,Derby County,Wimbledon,0-2,0,2,1,1,2,-2,A
1996-09-28,1996,Everton,Sheffield Wednesday,2-0,2,0,1,1,2,2,H
1996-09-28,1996,Leicester City,Leeds United,1-0,1,0,1,1,1,1,H
1996-09-28,1996,Southampton,Middlesbrough,4-0,4,0,1,1,4,4,H
1996-09-29,1996,Manchester United,Tottenham Hotspur,2-0,2,0,1,1,2,2,H
1996-09-29,1996,West Ham United,Liverpool,1-2,1,2,1,1,3,-1,A
1996-09-30,1996,Newcastle United,Aston Villa,4-3,4,3,1,1,7,1,H
1996-10-12,1996,Blackburn Rovers,Arsenal,0-2,0,2,1,1,2,-2,A
1996-10-12,1996,Derby County,Newcastle United,0-1,0,1,1,1,1,-1,A
1996-10-12,1996,Everton,West Ham United,2-1,2,1,1,1,3,1,H
1996-10-12,1996,Leeds United,Nottingham Forest,2-0,2,0,1,1,2,2,H
1996-10-12,1996,Leicester City,Chelsea,1-3,1,3,1,1,4,-2,A
1996-10-12,1996,Manchester United,Liverpool,1-0,1,0,1,1,1,1,H
1996-10-12,1996,Tottenham Hotspur,Aston Villa,1-0,1,0,1,1,1,1,H
1996-10-12,1996,Wimbledon,Sheffield Wednesday,4-2,4,2,1,1,6,2,H
1996-10-13,1996,Coventry City,Southampton,1-1,1,1,1,1,2,0,D
1996-10-14,1996,Sunderland,Middlesbrough,2-2,2,2,1,1,4,0,D
1996-10-19,1996,Arsenal,Coventry City,0-0,0,0,1,1,0,0,D
1996-10-19,1996,Aston Villa,Leeds United,2-0,2,0,1,1,2,2,H
1996-10-19,1996,Chelsea,Wimbledon,2-4,2,4,1,1,6,-2,A
1996-10-19,1996,Middlesbrough,Tottenham Hotspur,0-3,0,3,1,1,3,-3,A
1996-10-19,1996,Nottingham Forest,Derby County,1-1,1,1,1,1,2,0,D
1996-10-19,1996,Sheffield Wednesday,Blackburn Rovers,1-1,1,1,1,1,2,0,D
1996-10-19,1996,Southampton,Sunderland,3-0,3,0,1,1,3,3,H
1996-10-19,1996,West Ham United,Leicester City,1-0,1,0,1,1,1,1,H
1996-10-20,1996,Newcastle United,Manchester United,5-0,5,0,1,1,5,5,H
1996-10-26,1996,Arsenal,Leeds United,3-0,3,0,1,1,3,3,H
1996-10-26,1996,Chelsea,Tottenham Hotspur,3-1,3,1,1,1,4,2,H
1996-10-26,1996,Coventry City,Sheffield Wednesday,0-0,0,0,1,1,0,0,D
1996-10-26,1996,Leicester City,Newcastle United,2-0,2,0,1,1,2,2,H
1996-10-26,1996,Middlesbrough,Wimbledon,0-0,0,0,1,1,0,0,D
1996-10-26,1996,Southampton,Manchester United,6-3,6,3,1,1,9,3,H
1996-10-26,1996,Sunderland,Aston Villa,1-0,1,0,1,1,1,1,H
1996-10-26,1996,West Ham United,Blackburn Rovers,2-1,2,1,1,1,3,1,H
1996-10-27,1996,Liverpool,Derby County,2-1,2,1,1,1,3,1,H
1996-10-28,1996,Nottingham Forest,Everton,0-1,0,1,1,1,1,-1,A
1996-11-02,1996,Aston Villa,Nottingham Forest,2-0,2,0,1,1,2,2,H
1996-11-02,1996,Derby County,Leicester City,2-0,2,0,1,1,2,2,H
1996-11-02,1996,Leeds United,Sunderland,3-0,3,0,1,1,3,3,H
1996-11-02,1996,Manchester United,Chelsea,1-2,1,2,1,1,3,-1,A
1996-11-02,1996,Sheffield Wednesday,Southampton,1-1,1,1,1,1,2,0,D
1996-11-02,1996,Tottenham Hotspur,West Ham United,1-0,1,0,1,1,1,1,H
1996-11-02,1996,Wimbledon,Arsenal,2-2,2,2,1,1,4,0,D
1996-11-03,1996,Blackburn Rovers,Liverpool,3-0,3,0,1,1,3,3,H
1996-11-03,1996,Newcastle United,Middlesbrough,3-1,3,1,1,1,4,2,H
1996-11-04,1996,Everton,Coventry City,1-1,1,1,1,1,2,0,D
1996-11-16,1996,Aston Villa,Leicester City,1-3,1,3,1,1,4,-2,A
1996-11-16,1996,Blackburn Rovers,Chelsea,1-1,1,1,1,1,2,0,D
1996-11-16,1996,Everton,Southampton,7-1,7,1,1,1,8,6,H
1996-11-16,1996,Leeds United,Liverpool,0-2,0,2,1,1,2,-2,A
1996-11-16,1996,Manchester United,Arsenal,1-0,1,0,1,1,1,1,H
1996-11-16,1996,Newcastle United,West Ham United,1-1,1,1,1,1,2,0,D
1996-11-16,1996,Tottenham Hotspur,Sunderland,2-0,2,0,1,1,2,2,H
1996-11-16,1996,Wimbledon,Coventry City,2-2,2,2,1,1,4,0,D
1996-11-17,1996,Derby County,Middlesbrough,2-1,2,1,1,1,3,1,H
1996-11-18,1996,Sheffield Wednesday,Nottingham Forest,2-0,2,0,1,1,2,2,H
1996-11-20,1996,Liverpool,Everton,1-1,1,1,1,1,2,0,D
1996-11-23,1996,Chelsea,Newcastle United,1-1,1,1,1,1,2,0,D
1996-11-23,1996,Coventry City,Aston Villa,1-2,1,2,1,1,3,-1,A
1996-11-23,1996,Leicester City,Everton,1-2,1,2,1,1,3,-1,A
1996-11-23,1996,Liverpool,Wimbledon,1-1,1,1,1,1,2,0,D
1996-11-23,1996,Middlesbrough,Manchester United,2-2,2,2,1,1,4,0,D
1996-11-23,1996,Southampton,Leeds United,0-2,0,2,1,1,2,-2,A
1996-11-23,1996,Sunderland,Sheffield Wednesday,1-1,1,1,1,1,2,0,D
1996-11-23,1996,West Ham United,Derby County,1-1,1,1,1,1,2,0,D
1996-11-24,1996,Arsenal,Tottenham Hotspur,3-1,3,1,1,1,4,2,H
1996-11-25,1996,Nottingham Forest,Blackburn Rovers,2-2,2,2,1,1,4,0,D
1996-11-30,1996,Aston Villa,Middlesbrough,1-0,1,0,1,1,1,1,H
1996-11-30,1996,Blackburn Rovers,Southampton,2-1,2,1,1,1,3,1,H
1996-11-30,1996,Derby County,Coventry City,2-1,2,1,1,1,3,1,H
1996-11-30,1996,Everton,Sunderland,1-3,1,3,1,1,4,-2,A
1996-11-30,1996,Manchester United,Leicester City,3-1,3,1,1,1,4,2,H
1996-11-30,1996,Newcastle United,Arsenal,1-2,1,2,1,1,3,-1,A
1996-11-30,1996,Sheffield Wednesday,West Ham United,0-0,0,0,1,1,0,0,D
1996-11-30,1996,Wimbledon,Nottingham Forest,1-0,1,0,1,1,1,1,H
1996-12-01,1996,Leeds United,Chelsea,2-0,2,0,1,1,2,2,H
1996-12-02,1996,Tottenham Hotspur,Liverpool,0-2,0,2,1,1,2,-2,A
1996-12-03,1996,Middlesbrough,Leicester City,0-2,0,2,1,1,2,-2,A
1996-12-04,1996,Arsenal,Southampton,3-1,3,1,1,1,4,2,H
1996-12-04,1996,West Ham United,Aston Villa,0-2,0,2,1,1,2,-2,A
1996-12-07,1996,Arsenal,Derby County,2-2,2,2,1,1,4,0,D
1996-12-07,1996,Chelsea,Everton,2-2,2,2,1,1,4,0,D
1996-12-07,1996,Coventry City,Tottenham Hotspur,1-2,1,2,1,1,3,-1,A
1996-12-07,1996,Leicester City,Blackburn Rovers,1-1,1,1,1,1,2,0,D
1996-12-07,1996,Liverpool,Sheffield Wednesday,0-1,0,1,1,1,1,-1,A
1996-12-07,1996,Middlesbrough,Leeds United,0-0,0,0,1,1,0,0,D
1996-12-07,1996,Southampton,Aston Villa,0-1,0,1,1,1,1,-1,A
1996-12-07,1996,Sunderland,Wimbledon,1-3,1,3,1,1,4,-2,A
1996-12-08,1996,West Ham United,Manchester United,2-2,2,2,1,1,4,0,D
1996-12-09,1996,Nottingham Forest,Newcastle United,0-0,0,0,1,1,0,0,D
1996-12-14,1996,Leeds United,Tottenham Hotspur,0-0,0,0,1,1,0,0,D
1996-12-14,1996,Liverpool,Middlesbrough,5-1,5,1,1,1,6,4,H
1996-12-14,1996,Wimbledon,Blackburn Rovers,1-0,1,0,1,1,1,1,H
1996-12-15,1996,Sunderland,Chelsea,3-0,3,0,1,1,3,3,H
1996-12-16,1996,Derby County,Everton,0-1,0,1,1,1,1,-1,A
1996-12-17,1996,Coventry City,Newcastle United,2-1,2,1,1,1,3,1,H
1996-12-17,1996,Liverpool,Nottingham Forest,4-2,4,2,1,1,6,2,H
1996-12-18,1996,Sheffield Wednesday,Manchester United,1-1,1,1,1,1,2,0,D
1996-12-21,1996,Chelsea,West Ham United,3-1,3,1,1,1,4,2,H
1996-12-21,1996,Everton,Leeds United,0-0,0,0,1,1,0,0,D
1996-12-21,1996,Leicester City,Coventry City,0-2,0,2,1,1,2,-2,A
1996-12-21,1996,Manchester United,Sunderland,5-0,5,0,1,1,5,5,H
1996-12-21,1996,Nottingham Forest,Arsenal,2-1,2,1,1,1,3,1,H
1996-12-21,1996,Southampton,Derby County,3-1,3,1,1,1,4,2,H
1996-12-21,1996,Tottenham Hotspur,Sheffield Wednesday,1-1,1,1,1,1,2,0,D
1996-12-22,1996,Aston Villa,Wimbledon,5-0,5,0,1,1,5,5,H
1996-12-23,1996,Newcastle United,Liverpool,1-1,1,1,1,1,2,0,D
1996-12-26,1996,Aston Villa,Chelsea,0-2,0,2,1,1,2,-2,A
1996-12-26,1996,Blackburn Rovers,Newcastle United,1-0,1,0,1,1,1,1,H
1996-12-26,1996,Leeds United,Coventry City,1-3,1,3,1,1,4,-2,A
1996-12-26,1996,Liverpool,Leicester City,1-1,1,1,1,1,2,0,D
1996-12-26,1996,Middlesbrough,Everton,4-2,4,2,1,1,6,2,H
1996-12-26,1996,Nottingham Forest,Manchester United,0-4,0,4,1,1,4,-4,A
1996-12-26,1996,Sheffield Wednesday,Arsenal,0-0,0,0,1,1,0,0,D
1996-12-26,1996,Sunderland,Derby County,2-0,2,0,1,1,2,2,H
1996-12-26,1996,Tottenham Hotspur,Southampton,3-1,3,1,1,1,4,2,H
1996-12-28,1996,Arsenal,Aston Villa,2-2,2,2,1,1,4,0,D
1996-12-28,1996,Chelsea,Sheffield Wednesday,2-2,2,2,1,1,4,0,D
1996-12-28,1996,Coventry City,Middlesbrough,3-0,3,0,1,1,3,3,H
1996-12-28,1996,Derby County,Blackburn Rovers,0-0,0,0,1,1,0,0,D
1996-12-28,1996,Everton,Wimbledon,1-3,1,3,1,1,4,-2,A
1996-12-28,1996,Leicester City,Nottingham Forest,2-2,2,2,1,1,4,0,D
1996-12-28,1996,Manchester United,Leeds United,1-0,1,0,1,1,1,1,H
1996-12-28,1996,Newcastle United,Tottenham Hotspur,7-1,7,1,1,1,8,6,H
1996-12-28,1996,West Ham United,Sunderland,2-0,2,0,1,1,2,2,H
1996-12-29,1996,Southampton,Liverpool,0-1,0,1,1,1,1,-1,A
1997-01-01,1996,Arsenal,Middlesbrough,2-0,2,0,1,1,2,2,H
1997-01-01,1996,Chelsea,Liverpool,1-0,1,0,1,1,1,1,H
1997-01-01,1996,Coventry City,Sunderland,2-2,2,2,1,1,4,0,D
1997-01-01,1996,Everton,Blackburn Rovers,0-2,0,2,1,1,2,-2,A
1997-01-01,1996,Manchester United,Aston Villa,0-0,0,0,1,1,0,0,D
1997-01-01,1996,Newcastle United,Leeds United,3-0,3,0,1,1,3,3,H
1997-01-01,1996,West Ham United,Nottingham Forest,0-1,0,1,1,1,1,-1,A
1997-01-11,1996,Aston Villa,Newcastle United,2-2,2,2,1,1,4,0,D
1997-01-11,1996,Blackburn Rovers,Coventry City,4-0,4,0,1,1,4,4,H
1997-01-11,1996,Leeds United,Leicester City,3-0,3,0,1,1,3,3,H
1997-01-11,1996,Liverpool,West Ham United,0-0,0,0,1,1,0,0,D
1997-01-11,1996,Middlesbrough,Southampton,0-1,0,1,1,1,1,-1,A
1997-01-11,1996,Nottingham Forest,Chelsea,2-0,2,0,1,1,2,2,H
1997-01-11,1996,Sheffield Wednesday,Everton,2-1,2,1,1,1,3,1,H
1997-01-11,1996,Sunderland,Arsenal,1-0,1,0,1,1,1,1,H
1997-01-11,1996,Wimbledon,Derby County,1-1,1,1,1,1,2,0,D
1997-01-12,1996,Tottenham Hotspur,Manchester United,1-2,1,2,1,1,3,-1,A
1997-01-18,1996,Chelsea,Derby County,3-1,3,1,1,1,4,2,H
1997-01-18,1996,Coventry City,Manchester United,0-2,0,2,1,1,2,-2,A
1997-01-18,1996,Leicester City,Wimbledon,1-0,1,0,1,1,1,1,H
1997-01-18,1996,Liverpool,Aston Villa,3-0,3,0,1,1,3,3,H
1997-01-18,1996,Middlesbrough,Sheffield Wednesday,4-2,4,2,1,1,6,2,H
1997-01-18,1996,Southampton,Newcastle United,2-2,2,2,1,1,4,0,D
1997-01-18,1996,Sunderland,Blackburn Rovers,0-0,0,0,1,1,0,0,D
1997-01-19,1996,Arsenal,Everton,3-1,3,1,1,1,4,2,H
1997-01-19,1996,Nottingham Forest,Tottenham Hotspur,2-1,2,1,1,1,3,1,H
1997-01-20,1996,West Ham United,Leeds United,0-2,0,2,1,1,2,-2,A
1997-01-29,1996,Aston Villa,Sheffield Wednesday,0-1,0,1,1,1,1,-1,A
1997-01-29,1996,Leeds United,Derby County,0-0,0,0,1,1,0,0,D
1997-01-29,1996,Leicester City,Sunderland,1-1,1,1,1,1,2,0,D
1997-01-29,1996,Manchester United,Wimbledon,2-1,2,1,1,1,3,1,H
1997-01-29,1996,Newcastle United,Everton,4-1,4,1,1,1,5,3,H
1997-01-29,1996,Nottingham Forest,Coventry City,0-1,0,1,1,1,1,-1,A
1997-01-29,1996,Tottenham Hotspur,Blackburn Rovers,2-1,2,1,1,1,3,1,H
1997-01-29,1996,West Ham United,Arsenal,1-2,1,2,1,1,3,-1,A
1997-02-01,1996,Aston Villa,Sunderland,1-0,1,0,1,1,1,1,H
1997-02-01,1996,Blackburn Rovers,West Ham United,2-1,2,1,1,1,3,1,H
1997-02-01,1996,Derby County,Liverpool,0-1,0,1,1,1,1,-1,A
1997-02-01,1996,Everton,Nottingham Forest,2-0,2,0,1,1,2,2,H
1997-02-01,1996,Leeds United,Arsenal,0-0,0,0,1,1,0,0,D
1997-02-01,1996,Manchester United,Southampton,2-1,2,1,1,1,3,1,H
1997-02-01,1996,Sheffield Wednesday,Coventry City,0-0,0,0,1,1,0,0,D
1997-02-01,1996,Tottenham Hotspur,Chelsea,1-2,1,2,1,1,3,-1,A
1997-02-01,1996,Wimbledon,Middlesbrough,1-1,1,1,1,1,2,0,D
1997-02-02,1996,Newcastle United,Leicester City,4-3,4,3,1,1,7,1,H
1997-02-15,1996,Derby County,West Ham United,1-0,1,0,1,1,1,1,H
1997-02-15,1996,Tottenham Hotspur,Arsenal,0-0,0,0,1,1,0,0,D
1997-02-19,1996,Arsenal,Manchester United,1-2,1,2,1,1,3,-1,A
1997-02-19,1996,Aston Villa,Coventry City,2-1,2,1,1,1,3,1,H
1997-02-19,1996,Derby County,Sheffield Wednesday,2-2,2,2,1,1,4,0,D
1997-02-19,1996,Liverpool,Leeds United,4-0,4,0,1,1,4,4,H
1997-02-22,1996,Chelsea,Manchester United,1-1,1,1,1,1,2,0,D
1997-02-22,1996,Coventry City,Everton,0-0,0,0,1,1,0,0,D
1997-02-22,1996,Leicester City,Derby County,4-2,4,2,1,1,6,2,H
1997-02-22,1996,Liverpool,Blackburn Rovers,0-0,0,0,1,1,0,0,D
1997-02-22,1996,Middlesbrough,Newcastle United,0-1,0,1,1,1,1,-1,A
1997-02-22,1996,Nottingham Forest,Aston Villa,0-0,0,0,1,1,0,0,D
1997-02-22,1996,Southampton,Sheffield Wednesday,2-3,2,3,1,1,5,-1,A
1997-02-22,1996,Sunderland,Leeds United,0-1,0,1,1,1,1,-1,A
1997-02-23,1996,Arsenal,Wimbledon,0-1,0,1,1,1,1,-1,A
1997-02-24,1996,West Ham United,Tottenham Hotspur,4-3,4,3,1,1,7,1,H
1997-02-26,1996,Southampton,Wimbledon,0-0,0,0,1,1,0,0,D
1997-03-01,1996,Blackburn Rovers,Sunderland,1-0,1,0,1,1,1,1,H
1997-03-01,1996,Derby County,Chelsea,3-2,3,2,1,1,5,1,H
1997-03-01,1996,Everton,Arsenal,0-2,0,2,1,1,2,-2,A
1997-03-01,1996,Leeds United,West Ham United,1-0,1,0,1,1,1,1,H
1997-03-01,1996,Manchester United,Coventry City,3-1,3,1,1,1,4,2,H
1997-03-01,1996,Newcastle United,Southampton,0-1,0,1,1,1,1,-1,A
1997-03-01,1996,Sheffield Wednesday,Middlesbrough,3-1,3,1,1,1,4,2,H
1997-03-01,1996,Tottenham Hotspur,Nottingham Forest,0-1,0,1,1,1,1,-1,A
1997-03-01,1996,Wimbledon,Leicester City,1-3,1,3,1,1,4,-2,A
1997-03-02,1996,Aston Villa,Liverpool,1-0,1,0,1,1,1,1,H
1997-03-03,1996,Coventry City,Wimbledon,1-1,1,1,1,1,2,0,D
1997-03-04,1996,Sunderland,Tottenham Hotspur,0-4,0,4,1,1,4,-4,A
1997-03-05,1996,Chelsea,Blackburn Rovers,1-1,1,1,1,1,2,0,D
1997-03-05,1996,Leicester City,Aston Villa,1-0,1,0,1,1,1,1,H
1997-03-05,1996,Middlesbrough,Derby County,6-1,6,1,1,1,7,5,H
1997-03-05,1996,Nottingham Forest,Sheffield Wednesday,0-3,0,3,1,1,3,-3,A
1997-03-05,1996,Southampton,Everton,2-2,2,2,1,1,4,0,D
1997-03-08,1996,Arsenal,Nottingham Forest,2-0,2,0,1,1,2,2,H
1997-03-08,1996,Coventry City,Leicester City,0-0,0,0,1,1,0,0,D
1997-03-08,1996,Leeds United,Everton,1-0,1,0,1,1,1,1,H
1997-03-08,1996,Sunderland,Manchester United,2-1,2,1,1,1,3,1,H
1997-03-10,1996,Liverpool,Newcastle United,4-3,4,3,1,1,7,1,H
1997-03-11,1996,Blackburn Rovers,Nottingham Forest,1-1,1,1,1,1,2,0,D
1997-03-12,1996,Leeds United,Southampton,0-0,0,0,1,1,0,0,D
1997-03-12,1996,Sheffield Wednesday,Sunderland,2-1,2,1,1,1,3,1,H
1997-03-12,1996,West Ham United,Chelsea,3-2,3,2,1,1,5,1,H
1997-03-15,1996,Aston Villa,West Ham United,0-0,0,0,1,1,0,0,D
1997-03-15,1996,Blackburn Rovers,Wimbledon,3-1,3,1,1,1,4,2,H
1997-03-15,1996,Everton,Derby County,1-0,1,0,1,1,1,1,H
1997-03-15,1996,Leicester City,Middlesbrough,1-3,1,3,1,1,4,-2,A
1997-03-15,1996,Manchester United,Sheffield Wednesday,2-0,2,0,1,1,2,2,H
1997-03-15,1996,Newcastle United,Coventry City,4-0,4,0,1,1,4,4,H
1997-03-15,1996,Nottingham Forest,Liverpool,1-1,1,1,1,1,2,0,D
1997-03-15,1996,Southampton,Arsenal,0-2,0,2,1,1,2,-2,A
1997-03-15,1996,Tottenham Hotspur,Leeds United,1-0,1,0,1,1,1,1,H
1997-03-16,1996,Chelsea,Sunderland,6-2,6,2,1,1,8,4,H
1997-03-18,1996,Wimbledon,West Ham United,1-1,1,1,1,1,2,0,D
1997-03-19,1996,Chelsea,Southampton,1-0,1,0,1,1,1,1,H
1997-03-19,1996,Leicester City,Tottenham Hotspur,1-1,1,1,1,1,2,0,D
1997-03-19,1996,Middlesbrough,Blackburn Rovers,2-1,2,1,1,1,3,1,H
1997-03-22,1996,Blackburn Rovers,Aston Villa,0-2,0,2,1,1,2,-2,A
1997-03-22,1996,Coventry City,West Ham United,1-3,1,3,1,1,4,-2,A
1997-03-22,1996,Derby County,Tottenham Hotspur,4-2,4,2,1,1,6,2,H
1997-03-22,1996,Everton,Manchester United,0-2,0,2,1,1,2,-2,A
1997-03-22,1996,Middlesbrough,Chelsea,1-0,1,0,1,1,1,1,H
1997-03-22,1996,Sheffield Wednesday,Leeds United,2-2,2,2,1,1,4,0,D
1997-03-22,1996,Southampton,Leicester City,2-2,2,2,1,1,4,0,D
1997-03-22,1996,Sunderland,Nottingham Forest,1-1,1,1,1,1,2,0,D
1997-03-23,1996,Wimbledon,Newcastle United,1-1,1,1,1,1,2,0,D
1997-03-24,1996,Arsenal,Liverpool,1-2,1,2,1,1,3,-1,A
1997-03-24,1996,Middlesbrough,Nottingham Forest,1-1,1,1,1,1,2,0,D
1997-04-05,1996,Aston Villa,Everton,3-1,3,1,1,1,4,2,H
1997-04-05,1996,Chelsea,Arsenal,0-3,0,3,1,1,3,-3,A
1997-04-05,1996,Manchester United,Derby County,2-3,2,3,1,1,5,-1,A
1997-04-05,1996,Newcastle United,Sunderland,1-1,1,1,1,1,2,0,D
1997-04-05,1996,Nottingham Forest,Southampton,1-3,1,3,1,1,4,-2,A
1997-04-05,1996,Tottenham Hotspur,Wimbledon,1-0,1,0,1,1,1,1,H
1997-04-06,1996,Liverpool,Coventry City,1-2,1,2,1,1,3,-1,A
1997-04-07,1996,Leeds United,Blackburn Rovers,0-0,0,0,1,1,0,0,D
1997-04-09,1996,Coventry City,Chelsea,3-1,3,1,1,1,4,2,H
1997-04-09,1996,Derby County,Southampton,1-1,1,1,1,1,2,0,D
1997-04-09,1996,Everton,Leicester City,1-1,1,1,1,1,2,0,D
1997-04-09,1996,Sheffield Wednesday,Tottenham Hotspur,2-1,2,1,1,1,3,1,H
1997-04-09,1996,West Ham United,Middlesbrough,0-0,0,0,1,1,0,0,D
1997-04-09,1996,Wimbledon,Aston Villa,0-2,0,2,1,1,2,-2,A
1997-04-12,1996,Arsenal,Leicester City,2-0,2,0,1,1,2,2,H
1997-04-12,1996,Blackburn Rovers,Manchester United,2-3,2,3,1,1,5,-1,A
1997-04-12,1996,Derby County,Aston Villa,2-1,2,1,1,1,3,1,H
1997-04-12,1996,Everton,Tottenham Hotspur,1-0,1,0,1,1,1,1,H
1997-04-12,1996,Southampton,West Ham United,2-0,2,0,1,1,2,2,H
1997-04-13,1996,Sheffield Wednesday,Newcastle United,1-1,1,1,1,1,2,0,D
1997-04-13,1996,Sunderland,Liverpool,1-2,1,2,1,1,3,-1,A
1997-04-16,1996,Everton,Liverpool,1-1,1,1,1,1,2,0,D
1997-04-16,1996,Newcastle United,Chelsea,3-1,3,1,1,1,4,2,H
1997-04-16,1996,Wimbledon,Leeds United,2-0,2,0,1,1,2,2,H
1997-04-19,1996,Arsenal,Blackburn Rovers,1-1,1,1,1,1,2,0,D
1997-04-19,1996,Aston Villa,Tottenham Hotspur,1-1,1,1,1,1,2,0,D
1997-04-19,1996,Chelsea,Leicester City,2-1,2,1,1,1,3,1,H
1997-04-19,1996,Liverpool,Manchester United,1-3,1,3,1,1,4,-2,A
1997-04-19,1996,Middlesbrough,Sunderland,0-1,0,1,1,1,1,-1,A
1997-04-19,1996,Newcastle United,Derby County,3-1,3,1,1,1,4,2,H
1997-04-19,1996,Nottingham Forest,Leeds United,1-1,1,1,1,1,2,0,D
1997-04-19,1996,Sheffield Wednesday,Wimbledon,3-1,3,1,1,1,4,2,H
1997-04-19,1996,Southampton,Coventry City,2-2,2,2,1,1,4,0,D
1997-04-19,1996,West Ham United,Everton,2-2,2,2,1,1,4,0,D
1997-04-21,1996,Coventry City,Arsenal,1-1,1,1,1,1,2,0,D
1997-04-22,1996,Blackburn Rovers,Sheffield Wednesday,4-1,4,1,1,1,5,3,H
1997-04-22,1996,Leeds United,Aston Villa,0-0,0,0,1,1,0,0,D
1997-04-22,1996,Sunderland,Southampton,0-1,0,1,1,1,1,-1,A
1997-04-22,1996,Wimbledon,Chelsea,0-1,0,1,1,1,1,-1,A
1997-04-23,1996,Derby County,Nottingham Forest,0-0,0,0,1,1,0,0,D
1997-04-23,1996,Leicester City,West Ham United,0-1,0,1,1,1,1,-1,A
1997-04-24,1996,Tottenham Hotspur,Middlesbrough,1-0,1,0,1,1,1,1,H
1997-05-03,1996,Arsenal,Newcastle United,0-1,0,1,1,1,1,-1,A
1997-05-03,1996,Chelsea,Leeds United,0-0,0,0,1,1,0,0,D
1997-05-03,1996,Coventry City,Derby County,1-2,1,2,1,1,3,-1,A
1997-05-03,1996,Leicester City,Manchester United,2-2,2,2,1,1,4,0,D
1997-05-03,1996,Liverpool,Tottenham Hotspur,2-1,2,1,1,1,3,1,H
1997-05-03,1996,Middlesbrough,Aston Villa,3-2,3,2,1,1,5,1,H
1997-05-03,1996,Nottingham Forest,Wimbledon,1-1,1,1,1,1,2,0,D
1997-05-03,1996,Southampton,Blackburn Rovers,2-0,2,0,1,1,2,2,H
1997-05-03,1996,Sunderland,Everton,3-0,3,0,1,1,3,3,H
1997-05-03,1996,West Ham United,Sheffield Wednesday,5-1,5,1,1,1,6,4,H
1997-05-05,1996,Manchester United,Middlesbrough,3-3,3,3,1,1,6,0,D
1997-05-06,1996,West Ham United,Newcastle United,0-0,0,0,1,1,0,0,D
1997-05-06,1996,Wimbledon,Liverpool,2-1,2,1,1,1,3,1,H
1997-05-07,1996,Leicester City,Sheffield Wednesday,1-0,1,0,1,1,1,1,H
1997-05-08,1996,Blackburn Rovers,Middlesbrough,0-0,0,0,1,1,0,0,D
1997-05-08,1996,Manchester United,Newcastle United,0-0,0,0,1,1,0,0,D
1997-05-11,1996,Aston Villa,Southampton,1-0,1,0,1,1,1,1,H
1997-05-11,1996,Blackburn Rovers,Leicester City,2-4,2,4,1,1,6,-2,A
1997-05-11,1996,Derby County,Arsenal,1-3,1,3,1,1,4,-2,A
1997-05-11,1996,Everton,Chelsea,1-2,1,2,1,1,3,-1,A
1997-05-11,1996,Leeds United,Middlesbrough,1-1,1,1,1,1,2,0,D
1997-05-11,1996,Manchester United,West Ham United,2-0,2,0,1,1,2,2,H
1997-05-11,1996,Newcastle United,Nottingham Forest,5-0,5,0,1,1,5,5,H
1997-05-11,1996,Sheffield Wednesday,Liverpool,1-1,1,1,1,1,2,0,D
1997-05-11,1996,Tottenham Hotspur,Coventry City,1-2,1,2,1,1,3,-1,A
1997-05-11,1996,Wimbledon,Sunderland,1-0,1,0,1,1,1,1,H
1997-08-09,1997,Barnsley,West Ham United,1-2,1,2,1,1,3,-1,A
1997-08-09,1997,Blackburn Rovers,Derby County,1-0,1,0,1,1,1,1,H
1997-08-09,1997,Coventry City,Chelsea,3-2,3,2,1,1,5,1,H
1997-08-09,1997,Everton,Crystal Palace,1-2,1,2,1,1,3,-1,A
1997-08-09,1997,Leeds United,Arsenal,1-1,1,1,1,1,2,0,D
1997-08-09,1997,Leicester City,Aston Villa,1-0,1,0,1,1,1,1,H
1997-08-09,1997,Newcastle United,Sheffield Wednesday,2-1,2,1,1,1,3,1,H
1997-08-09,1997,Southampton,Bolton Wanderers,0-1,0,1,1,1,1,-1,A
1997-08-09,1997,Wimbledon,Liverpool,1-1,1,1,1,1,2,0,D
1997-08-10,1997,Tottenham Hotspur,Manchester United,0-2,0,2,1,1,2,-2,A
1997-08-11,1997,Arsenal,Coventry City,2-0,2,0,1,1,2,2,H
1997-08-12,1997,Crystal Palace,Barnsley,0-1,0,1,1,1,1,-1,A
1997-08-13,1997,Aston Villa,Blackburn Rovers,0-4,0,4,1,1,4,-4,A
1997-08-13,1997,Liverpool,Leicester City,1-2,1,2,1,1,3,-1,A
1997-08-13,1997,Manchester United,Southampton,1-0,1,0,1,1,1,1,H
1997-08-13,1997,Sheffield Wednesday,Leeds United,1-3,1,3,1,1,4,-2,A
1997-08-13,1997,West Ham United,Tottenham Hotspur,2-1,2,1,1,1,3,1,H
1997-08-23,1997,Blackburn Rovers,Liverpool,1-1,1,1,1,1,2,0,D
1997-08-23,1997,Coventry City,Bolton Wanderers,2-2,2,2,1,1,4,0,D
1997-08-23,1997,Everton,West Ham United,2-1,2,1,1,1,3,1,H
1997-08-23,1997,Leeds United,Crystal Palace,0-2,0,2,1,1,2,-2,A
1997-08-23,1997,Leicester City,Manchester United,0-0,0,0,1,1,0,0,D
1997-08-23,1997,Newcastle United,Aston Villa,1-0,1,0,1,1,1,1,H
1997-08-23,1997,Southampton,Arsenal,1-3,1,3,1,1,4,-2,A
1997-08-23,1997,Tottenham Hotspur,Derby County,1-0,1,0,1,1,1,1,H
1997-08-23,1997,Wimbledon,Sheffield Wednesday,1-1,1,1,1,1,2,0,D
1997-08-24,1997,Barnsley,Chelsea,0-6,0,6,1,1,6,-6,A
1997-08-25,1997,Blackburn Rovers,Sheffield Wednesday,7-2,7,2,1,1,9,5,H
1997-08-26,1997,Leeds United,Liverpool,0-2,0,2,1,1,2,-2,A
1997-08-27,1997,Barnsley,Bolton Wanderers,2-1,2,1,1,1,3,1,H
1997-08-27,1997,Coventry City,West Ham United,1-1,1,1,1,1,2,0,D
1997-08-27,1997,Everton,Manchester United,0-2,0,2,1,1,2,-2,A
1997-08-27,1997,Leicester City,Arsenal,3-3,3,3,1,1,6,0,D
1997-08-27,1997,Southampton,Crystal Palace,1-0,1,0,1,1,1,1,H
1997-08-27,1997,Tottenham Hotspur,Aston Villa,3-2,3,2,1,1,5,1,H
1997-08-27,1997,Wimbledon,Chelsea,0-2,0,2,1,1,2,-2,A
1997-08-30,1997,Arsenal,Tottenham Hotspur,0-0,0,0,1,1,0,0,D
1997-08-30,1997,Aston Villa,Leeds United,1-0,1,0,1,1,1,1,H
1997-08-30,1997,Chelsea,Southampton,4-2,4,2,1,1,6,2,H
1997-08-30,1997,Crystal Palace,Blackburn Rovers,1-2,1,2,1,1,3,-1,A
1997-08-30,1997,Derby County,Barnsley,1-0,1,0,1,1,1,1,H
1997-08-30,1997,Manchester United,Coventry City,3-0,3,0,1,1,3,3,H
1997-08-30,1997,Sheffield Wednesday,Leicester City,1-0,1,0,1,1,1,1,H
1997-08-30,1997,West Ham United,Wimbledon,3-1,3,1,1,1,4,2,H
1997-09-01,1997,Bolton Wanderers,Everton,0-0,0,0,1,1,0,0,D
1997-09-13,1997,Arsenal,Bolton Wanderers,4-1,4,1,1,1,5,3,H
1997-09-13,1997,Barnsley,Aston Villa,0-3,0,3,1,1,3,-3,A
1997-09-13,1997,Coventry City,Southampton,1-0,1,0,1,1,1,1,H
1997-09-13,1997,Crystal Palace,Chelsea,0-3,0,3,1,1,3,-3,A
1997-09-13,1997,Derby County,Everton,3-1,3,1,1,1,4,2,H
1997-09-13,1997,Leicester City,Tottenham Hotspur,3-0,3,0,1,1,3,3,H
1997-09-13,1997,Liverpool,Sheffield Wednesday,2-1,2,1,1,1,3,1,H
1997-09-13,1997,Manchester United,West Ham United,2-1,2,1,1,1,3,1,H
1997-09-13,1997,Newcastle United,Wimbledon,1-3,1,3,1,1,4,-2,A
1997-09-14,1997,Blackburn Rovers,Leeds United,3-4,3,4,1,1,7,-1,A
1997-09-20,1997,Aston Villa,Derby County,2-1,2,1,1,1,3,1,H
1997-09-20,1997,Bolton Wanderers,Manchester United,0-0,0,0,1,1,0,0,D
1997-09-20,1997,Everton,Barnsley,4-2,4,2,1,1,6,2,H
1997-09-20,1997,Leeds United,Leicester City,0-1,0,1,1,1,1,-1,A
1997-09-20,1997,Sheffield Wednesday,Coventry City,0-0,0,0,1,1,0,0,D
1997-09-20,1997,Southampton,Liverpool,1-1,1,1,1,1,2,0,D
1997-09-20,1997,Tottenham Hotspur,Blackburn Rovers,0-0,0,0,1,1,0,0,D
1997-09-20,1997,West Ham United,Newcastle United,0-1,0,1,1,1,1,-1,A
1997-09-20,1997,Wimbledon,Crystal Palace,0-1,0,1,1,1,1,-1,A
1997-09-21,1997,Chelsea,Arsenal,2-3,2,3,1,1,5,-1,A
1997-09-22,1997,Liverpool,Aston Villa,3-0,3,0,1,1,3,3,H
1997-09-23,1997,Bolton Wanderers,Tottenham Hotspur,1-1,1,1,1,1,2,0,D
1997-09-23,1997,Wimbledon,Barnsley,4-1,4,1,1,1,5,3,H
1997-09-24,1997,Arsenal,West Ham United,4-0,4,0,1,1,4,4,H
1997-09-24,1997,Coventry City,Crystal Palace,1-1,1,1,1,1,2,0,D
1997-09-24,1997,Leicester City,Blackburn Rovers,1-1,1,1,1,1,2,0,D
1997-09-24,1997,Manchester United,Chelsea,2-2,2,2,1,1,4,0,D
1997-09-24,1997,Newcastle United,Everton,1-0,1,0,1,1,1,1,H
1997-09-24,1997,Sheffield Wednesday,Derby County,2-5,2,5,1,1,7,-3,A
1997-09-24,1997,Southampton,Leeds United,0-2,0,2,1,1,2,-2,A
1997-09-27,1997,Aston Villa,Sheffield Wednesday,2-2,2,2,1,1,4,0,D
1997-09-27,1997,Barnsley,Leicester City,0-2,0,2,1,1,2,-2,A
1997-09-27,1997,Chelsea,Newcastle United,1-0,1,0,1,1,1,1,H
1997-09-27,1997,Crystal Palace,Bolton Wanderers,2-2,2,2,1,1,4,0,D
1997-09-27,1997,Derby County,Southampton,4-0,4,0,1,1,4,4,H
1997-09-27,1997,Everton,Arsenal,2-2,2,2,1,1,4,0,D
1997-09-27,1997,Leeds United,Manchester United,1-0,1,0,1,1,1,1,H
1997-09-27,1997,Tottenham Hotspur,Wimbledon,0-0,0,0,1,1,0,0,D
1997-09-27,1997,West Ham United,Liverpool,2-1,2,1,1,1,3,1,H
1997-09-28,1997,Blackburn Rovers,Coventry City,0-0,0,0,1,1,0,0,D
1997-10-04,1997,Arsenal,Barnsley,5-0,5,0,1,1,5,5,H
1997-10-04,1997,Bolton Wanderers,Aston Villa,0-1,0,1,1,1,1,-1,A
1997-10-04,1997,Coventry City,Leeds United,0-0,0,0,1,1,0,0,D
1997-10-04,1997,Manchester United,Crystal Palace,2-0,2,0,1,1,2,2,H
1997-10-04,1997,Newcastle United,Tottenham Hotspur,1-0,1,0,1,1,1,1,H
1997-10-04,1997,Sheffield Wednesday,Everton,3-1,3,1,1,1,4,2,H
1997-10-04,1997,Southampton,West Ham United,3-0,3,0,1,1,3,3,H
1997-10-04,1997,Wimbledon,Blackburn Rovers,0-1,0,1,1,1,1,-1,A
1997-10-05,1997,Liverpool,Chelsea,4-2,4,2,1,1,6,2,H
1997-10-06,1997,Leicester City,Derby County,1-2,1,2,1,1,3,-1,A
1997-10-18,1997,Aston Villa,Wimbledon,1-2,1,2,1,1,3,-1,A
1997-10-18,1997,Blackburn Rovers,Southampton,1-0,1,0,1,1,1,1,H
1997-10-18,1997,Chelsea,Leicester City,1-0,1,0,1,1,1,1,H
1997-10-18,1997,Crystal Palace,Arsenal,0-0,0,0,1,1,0,0,D
1997-10-18,1997,Derby County,Manchester United,2-2,2,2,1,1,4,0,D
1997-10-18,1997,Everton,Liverpool,2-0,2,0,1,1,2,2,H
1997-10-18,1997,Leeds United,Newcastle United,4-1,4,1,1,1,5,3,H
1997-10-18,1997,West Ham United,Bolton Wanderers,3-0,3,0,1,1,3,3,H
1997-10-19,1997,Tottenham Hotspur,Sheffield Wednesday,3-2,3,2,1,1,5,1,H
1997-10-20,1997,Barnsley,Coventry City,2-0,2,0,1,1,2,2,H
1997-10-22,1997,Derby County,Wimbledon,1-1,1,1,1,1,2,0,D
1997-10-25,1997,Coventry City,Everton,0-0,0,0,1,1,0,0,D
1997-10-25,1997,Liverpool,Derby County,4-0,4,0,1,1,4,4,H
1997-10-25,1997,Manchester United,Barnsley,7-0,7,0,1,1,7,7,H
1997-10-25,1997,Newcastle United,Blackburn Rovers,1-1,1,1,1,1,2,0,D
1997-10-25,1997,Sheffield Wednesday,Crystal Palace,1-3,1,3,1,1,4,-2,A
1997-10-25,1997,Southampton,Tottenham Hotspur,3-2,3,2,1,1,5,1,H
1997-10-25,1997,Wimbledon,Leeds United,1-0,1,0,1,1,1,1,H
1997-10-26,1997,Arsenal,Aston Villa,0-0,0,0,1,1,0,0,D
1997-10-26,1997,Bolton Wanderers,Chelsea,1-0,1,0,1,1,1,1,H
1997-10-27,1997,Leicester City,West Ham United,2-1,2,1,1,1,3,1,H
1997-11-01,1997,Aston Villa,Chelsea,0-2,0,2,1,1,2,-2,A
1997-11-01,1997,Barnsley,Blackburn Rovers,1-1,1,1,1,1,2,0,D
1997-11-01,1997,Bolton Wanderers,Liverpool,1-1,1,1,1,1,2,0,D
1997-11-01,1997,Derby County,Arsenal,3-0,3,0,1,1,3,3,H
1997-11-01,1997,Manchester United,Sheffield Wednesday,6-1,6,1,1,1,7,5,H
1997-11-01,1997,Newcastle United,Leicester City,3-3,3,3,1,1,6,0,D
1997-11-01,1997,Tottenham Hotspur,Leeds United,0-1,0,1,1,1,1,-1,A
1997-11-01,1997,Wimbledon,Coventry City,1-2,1,2,1,1,3,-1,A
1997-11-02,1997,Everton,Southampton,0-2,0,2,1,1,2,-2,A
1997-11-08,1997,Blackburn Rovers,Everton,3-2,3,2,1,1,5,1,H
1997-11-08,1997,Coventry City,Newcastle United,2-2,2,2,1,1,4,0,D
1997-11-08,1997,Crystal Palace,Aston Villa,1-1,1,1,1,1,2,0,D
1997-11-08,1997,Leeds United,Derby County,4-3,4,3,1,1,7,1,H
1997-11-08,1997,Liverpool,Tottenham Hotspur,4-0,4,0,1,1,4,4,H
1997-11-08,1997,Sheffield Wednesday,Bolton Wanderers,5-0,5,0,1,1,5,5,H
1997-11-08,1997,Southampton,Barnsley,4-1,4,1,1,1,5,3,H
1997-11-09,1997,Arsenal,Manchester United,3-2,3,2,1,1,5,1,H
1997-11-09,1997,Chelsea,West Ham United,2-1,2,1,1,1,3,1,H
1997-11-10,1997,Leicester City,Wimbledon,0-1,0,1,1,1,1,-1,A
1997-11-22,1997,Aston Villa,Everton,2-1,2,1,1,1,3,1,H
1997-11-22,1997,Blackburn Rovers,Chelsea,1-0,1,0,1,1,1,1,H
1997-11-22,1997,Derby County,Coventry City,3-1,3,1,1,1,4,2,H
1997-11-22,1997,Leicester City,Bolton Wanderers,0-0,0,0,1,1,0,0,D
1997-11-22,1997,Liverpool,Barnsley,0-1,0,1,1,1,1,-1,A
1997-11-22,1997,Newcastle United,Southampton,2-1,2,1,1,1,3,1,H
1997-11-22,1997,Sheffield Wednesday,Arsenal,2-0,2,0,1,1,2,2,H
1997-11-22,1997,Wimbledon,Manchester United,2-5,2,5,1,1,7,-3,A
1997-11-23,1997,Leeds United,West Ham United,3-1,3,1,1,1,4,2,H
1997-11-24,1997,Tottenham Hotspur,Crystal Palace,0-1,0,1,1,1,1,-1,A
1997-11-26,1997,Chelsea,Everton,2-0,2,0,1,1,2,2,H
1997-11-29,1997,Barnsley,Leeds United,2-3,2,3,1,1,5,-1,A
1997-11-29,1997,Bolton Wanderers,Wimbledon,1-0,1,0,1,1,1,1,H
1997-11-29,1997,Chelsea,Derby County,4-0,4,0,1,1,4,4,H
1997-11-29,1997,Coventry City,Leicester City,0-2,0,2,1,1,2,-2,A
1997-11-29,1997,Crystal Palace,Newcastle United,1-2,1,2,1,1,3,-1,A
1997-11-29,1997,Everton,Tottenham Hotspur,0-2,0,2,1,1,2,-2,A
1997-11-29,1997,Southampton,Sheffield Wednesday,2-3,2,3,1,1,5,-1,A
1997-11-29,1997,West Ham United,Aston Villa,2-1,2,1,1,1,3,1,H
1997-11-30,1997,Arsenal,Liverpool,0-1,0,1,1,1,1,-1,A
1997-11-30,1997,Manchester United,Blackburn Rovers,4-0,4,0,1,1,4,4,H
1997-12-01,1997,Bolton Wanderers,Newcastle United,1-0,1,0,1,1,1,1,H
1997-12-03,1997,West Ham United,Crystal Palace,4-1,4,1,1,1,5,3,H
1997-12-06,1997,Aston Villa,Coventry City,3-0,3,0,1,1,3,3,H
1997-12-06,1997,Blackburn Rovers,Bolton Wanderers,3-1,3,1,1,1,4,2,H
1997-12-06,1997,Derby County,West Ham United,2-0,2,0,1,1,2,2,H
1997-12-06,1997,Leeds United,Everton,0-0,0,0,1,1,0,0,D
1997-12-06,1997,Leicester City,Crystal Palace,1-1,1,1,1,1,2,0,D
1997-12-06,1997,Liverpool,Manchester United,1-3,1,3,1,1,4,-2,A
1997-12-06,1997,Newcastle United,Arsenal,0-1,0,1,1,1,1,-1,A
1997-12-06,1997,Tottenham Hotspur,Chelsea,1-6,1,6,1,1,7,-5,A
1997-12-07,1997,Wimbledon,Southampton,1-0,1,0,1,1,1,1,H
1997-12-08,1997,Sheffield Wednesday,Barnsley,2-1,2,1,1,1,3,1,H
1997-12-13,1997,Arsenal,Blackburn Rovers,1-3,1,3,1,1,4,-2,A
1997-12-13,1997,Barnsley,Newcastle United,2-2,2,2,1,1,4,0,D
1997-12-13,1997,Chelsea,Leeds United,0-0,0,0,1,1,0,0,D
1997-12-13,1997,Coventry City,Tottenham Hotspur,4-0,4,0,1,1,4,4,H
1997-12-13,1997,Crystal Palace,Liverpool,0-3,0,3,1,1,3,-3,A
1997-12-13,1997,Everton,Wimbledon,0-0,0,0,1,1,0,0,D
1997-12-13,1997,Southampton,Leicester City,2-1,2,1,1,1,3,1,H
1997-12-13,1997,West Ham United,Sheffield Wednesday,1-0,1,0,1,1,1,1,H
1997-12-14,1997,Bolton Wanderers,Derby County,3-3,3,3,1,1,6,0,D
1997-12-15,1997,Manchester United,Aston Villa,1-0,1,0,1,1,1,1,H
1997-12-17,1997,Newcastle United,Derby County,0-0,0,0,1,1,0,0,D
1997-12-20,1997,Aston Villa,Southampton,1-1,1,1,1,1,2,0,D
1997-12-20,1997,Blackburn Rovers,West Ham United,3-0,3,0,1,1,3,3,H
1997-12-20,1997,Derby County,Crystal Palace,0-0,0,0,1,1,0,0,D
1997-12-20,1997,Leeds United,Bolton Wanderers,2-0,2,0,1,1,2,2,H
1997-12-20,1997,Leicester City,Everton,0-1,0,1,1,1,1,-1,A
1997-12-20,1997,Liverpool,Coventry City,1-0,1,0,1,1,1,1,H
1997-12-20,1997,Sheffield Wednesday,Chelsea,1-4,1,4,1,1,5,-3,A
1997-12-20,1997,Tottenham Hotspur,Barnsley,3-0,3,0,1,1,3,3,H
1997-12-21,1997,Newcastle United,Manchester United,0-1,0,1,1,1,1,-1,A
1997-12-26,1997,Arsenal,Leicester City,2-1,2,1,1,1,3,1,H
1997-12-26,1997,Aston Villa,Tottenham Hotspur,4-1,4,1,1,1,5,3,H
1997-12-26,1997,Bolton Wanderers,Barnsley,1-1,1,1,1,1,2,0,D
1997-12-26,1997,Chelsea,Wimbledon,1-1,1,1,1,1,2,0,D
1997-12-26,1997,Crystal Palace,Southampton,1-1,1,1,1,1,2,0,D
1997-12-26,1997,Derby County,Newcastle United,1-0,1,0,1,1,1,1,H
1997-12-26,1997,Liverpool,Leeds United,3-1,3,1,1,1,4,2,H
1997-12-26,1997,Manchester United,Everton,2-0,2,0,1,1,2,2,H
1997-12-26,1997,Sheffield Wednesday,Blackburn Rovers,0-0,0,0,1,1,0,0,D
1997-12-26,1997,West Ham United,Coventry City,1-0,1,0,1,1,1,1,H
1997-12-28,1997,Barnsley,Derby County,1-0,1,0,1,1,1,1,H
1997-12-28,1997,Blackburn Rovers,Crystal Palace,2-2,2,2,1,1,4,0,D
1997-12-28,1997,Coventry City,Manchester United,3-2,3,2,1,1,5,1,H
1997-12-28,1997,Everton,Bolton Wanderers,3-2,3,2,1,1,5,1,H
1997-12-28,1997,Leeds United,Aston Villa,1-1,1,1,1,1,2,0,D
1997-12-28,1997,Leicester City,Sheffield Wednesday,1-1,1,1,1,1,2,0,D
1997-12-28,1997,Newcastle United,Liverpool,1-2,1,2,1,1,3,-1,A
1997-12-28,1997,Tottenham Hotspur,Arsenal,1-1,1,1,1,1,2,0,D
1997-12-28,1997,Wimbledon,West Ham United,1-2,1,2,1,1,3,-1,A
1997-12-29,1997,Southampton,Chelsea,1-0,1,0,1,1,1,1,H
1998-01-10,1997,Arsenal,Leeds United,2-1,2,1,1,1,3,1,H
1998-01-10,1997,Aston Villa,Leicester City,1-1,1,1,1,1,2,0,D
1998-01-10,1997,Bolton Wanderers,Southampton,0-0,0,0,1,1,0,0,D
1998-01-10,1997,Chelsea,Coventry City,3-1,3,1,1,1,4,2,H
1998-01-10,1997,Crystal Palace,Everton,1-3,1,3,1,1,4,-2,A
1998-01-10,1997,Liverpool,Wimbledon,2-0,2,0,1,1,2,2,H
1998-01-10,1997,Manchester United,Tottenham Hotspur,2-0,2,0,1,1,2,2,H
1998-01-10,1997,Sheffield Wednesday,Newcastle United,2-1,2,1,1,1,3,1,H
1998-01-10,1997,West Ham United,Barnsley,6-0,6,0,1,1,6,6,H
1998-01-11,1997,Derby County,Blackburn Rovers,3-1,3,1,1,1,4,2,H
1998-01-17,1997,Barnsley,Crystal Palace,1-0,1,0,1,1,1,1,H
1998-01-17,1997,Blackburn Rovers,Aston Villa,5-0,5,0,1,1,5,5,H
1998-01-17,1997,Coventry City,Arsenal,2-2,2,2,1,1,4,0,D
1998-01-17,1997,Leeds United,Sheffield Wednesday,1-2,1,2,1,1,3,-1,A
1998-01-17,1997,Leicester City,Liverpool,0-0,0,0,1,1,0,0,D
1998-01-17,1997,Newcastle United,Bolton Wanderers,2-1,2,1,1,1,3,1,H
1998-01-17,1997,Tottenham Hotspur,West Ham United,1-0,1,0,1,1,1,1,H
1998-01-17,1997,Wimbledon,Derby County,0-0,0,0,1,1,0,0,D
1998-01-18,1997,Everton,Chelsea,3-1,3,1,1,1,4,2,H
1998-01-19,1997,Southampton,Manchester United,1-0,1,0,1,1,1,1,H
1998-01-20,1997,Liverpool,Newcastle United,1-0,1,0,1,1,1,1,H
1998-01-31,1997,Arsenal,Southampton,3-0,3,0,1,1,3,3,H
1998-01-31,1997,Bolton Wanderers,Coventry City,1-5,1,5,1,1,6,-4,A
1998-01-31,1997,Chelsea,Barnsley,2-0,2,0,1,1,2,2,H
1998-01-31,1997,Crystal Palace,Leeds United,0-2,0,2,1,1,2,-2,A
1998-01-31,1997,Derby County,Tottenham Hotspur,2-1,2,1,1,1,3,1,H
1998-01-31,1997,Liverpool,Blackburn Rovers,0-0,0,0,1,1,0,0,D
1998-01-31,1997,Manchester United,Leicester City,0-1,0,1,1,1,1,-1,A
1998-01-31,1997,Sheffield Wednesday,Wimbledon,1-1,1,1,1,1,2,0,D
1998-01-31,1997,West Ham United,Everton,2-2,2,2,1,1,4,0,D
1998-02-01,1997,Aston Villa,Newcastle United,0-1,0,1,1,1,1,-1,A
1998-02-07,1997,Barnsley,Everton,2-2,2,2,1,1,4,0,D
1998-02-07,1997,Blackburn Rovers,Tottenham Hotspur,0-3,0,3,1,1,3,-3,A
1998-02-07,1997,Coventry City,Sheffield Wednesday,1-0,1,0,1,1,1,1,H
1998-02-07,1997,Derby County,Aston Villa,0-1,0,1,1,1,1,-1,A
1998-02-07,1997,Leicester City,Leeds United,1-0,1,0,1,1,1,1,H
1998-02-07,1997,Liverpool,Southampton,2-3,2,3,1,1,5,-1,A
1998-02-07,1997,Manchester United,Bolton Wanderers,1-1,1,1,1,1,2,0,D
1998-02-07,1997,Newcastle United,West Ham United,0-1,0,1,1,1,1,-1,A
1998-02-08,1997,Arsenal,Chelsea,2-0,2,0,1,1,2,2,H
1998-02-09,1997,Crystal Palace,Wimbledon,0-3,0,3,1,1,3,-3,A
1998-02-14,1997,Everton,Derby County,1-2,1,2,1,1,3,-1,A
1998-02-14,1997,Sheffield Wednesday,Liverpool,3-3,3,3,1,1,6,0,D
1998-02-14,1997,Tottenham Hotspur,Leicester City,1-1,1,1,1,1,2,0,D
1998-02-18,1997,Aston Villa,Manchester United,0-2,0,2,1,1,2,-2,A
1998-02-18,1997,Southampton,Coventry City,1-2,1,2,1,1,3,-1,A
1998-02-21,1997,Arsenal,Crystal Palace,1-0,1,0,1,1,1,1,H
1998-02-21,1997,Bolton Wanderers,West Ham United,1-1,1,1,1,1,2,0,D
1998-02-21,1997,Coventry City,Barnsley,1-0,1,0,1,1,1,1,H
1998-02-21,1997,Leicester City,Chelsea,2-0,2,0,1,1,2,2,H
1998-02-21,1997,Manchester United,Derby County,2-0,2,0,1,1,2,2,H
1998-02-21,1997,Sheffield Wednesday,Tottenham Hotspur,1-0,1,0,1,1,1,1,H
1998-02-21,1997,Southampton,Blackburn Rovers,3-0,3,0,1,1,3,3,H
1998-02-21,1997,Wimbledon,Aston Villa,2-1,2,1,1,1,3,1,H
1998-02-22,1997,Newcastle United,Leeds United,1-1,1,1,1,1,2,0,D
1998-02-23,1997,Liverpool,Everton,1-1,1,1,1,1,2,0,D
1998-02-28,1997,Aston Villa,Liverpool,2-1,2,1,1,1,3,1,H
1998-02-28,1997,Barnsley,Wimbledon,2-1,2,1,1,1,3,1,H
1998-02-28,1997,Blackburn Rovers,Leicester City,5-3,5,3,1,1,8,2,H
1998-02-28,1997,Chelsea,Manchester United,0-1,0,1,1,1,1,-1,A
1998-02-28,1997,Crystal Palace,Coventry City,0-3,0,3,1,1,3,-3,A
1998-02-28,1997,Derby County,Sheffield Wednesday,3-0,3,0,1,1,3,3,H
1998-02-28,1997,Everton,Newcastle United,0-0,0,0,1,1,0,0,D
1998-02-28,1997,Leeds United,Southampton,0-1,0,1,1,1,1,-1,A
1998-03-01,1997,Tottenham Hotspur,Bolton Wanderers,1-0,1,0,1,1,1,1,H
1998-03-02,1997,West Ham United,Arsenal,0-0,0,0,1,1,0,0,D
1998-03-04,1997,Leeds United,Tottenham Hotspur,1-0,1,0,1,1,1,1,H
1998-03-07,1997,Liverpool,Bolton Wanderers,2-1,2,1,1,1,3,1,H
1998-03-07,1997,Sheffield Wednesday,Manchester United,2-0,2,0,1,1,2,2,H
1998-03-07,1997,Southampton,Everton,2-1,2,1,1,1,3,1,H
1998-03-08,1997,Chelsea,Aston Villa,0-1,0,1,1,1,1,-1,A
1998-03-11,1997,Aston Villa,Barnsley,0-1,0,1,1,1,1,-1,A
1998-03-11,1997,Chelsea,Crystal Palace,6-2,6,2,1,1,8,4,H
1998-03-11,1997,Leeds United,Blackburn Rovers,4-0,4,0,1,1,4,4,H
1998-03-11,1997,West Ham United,Manchester United,1-1,1,1,1,1,2,0,D
1998-03-11,1997,Wimbledon,Arsenal,0-1,0,1,1,1,1,-1,A
1998-03-14,1997,Aston Villa,Crystal Palace,3-1,3,1,1,1,4,2,H
1998-03-14,1997,Barnsley,Southampton,4-3,4,3,1,1,7,1,H
1998-03-14,1997,Bolton Wanderers,Sheffield Wednesday,3-2,3,2,1,1,5,1,H
1998-03-14,1997,Everton,Blackburn Rovers,1-0,1,0,1,1,1,1,H
1998-03-14,1997,Manchester United,Arsenal,0-1,0,1,1,1,1,-1,A
1998-03-14,1997,Newcastle United,Coventry City,0-0,0,0,1,1,0,0,D
1998-03-14,1997,Tottenham Hotspur,Liverpool,3-3,3,3,1,1,6,0,D
1998-03-14,1997,West Ham United,Chelsea,2-1,2,1,1,1,3,1,H
1998-03-14,1997,Wimbledon,Leicester City,2-1,2,1,1,1,3,1,H
1998-03-15,1997,Derby County,Leeds United,0-5,0,5,1,1,5,-5,A
1998-03-18,1997,Newcastle United,Crystal Palace,1-2,1,2,1,1,3,-1,A
1998-03-28,1997,Arsenal,Sheffield Wednesday,1-0,1,0,1,1,1,1,H
1998-03-28,1997,Barnsley,Liverpool,2-3,2,3,1,1,5,-1,A
1998-03-28,1997,Bolton Wanderers,Leicester City,2-0,2,0,1,1,2,2,H
1998-03-28,1997,Coventry City,Derby County,1-0,1,0,1,1,1,1,H
1998-03-28,1997,Crystal Palace,Tottenham Hotspur,1-3,1,3,1,1,4,-2,A
1998-03-28,1997,Everton,Aston Villa,1-4,1,4,1,1,5,-3,A
1998-03-28,1997,Manchester United,Wimbledon,2-0,2,0,1,1,2,2,H
1998-03-28,1997,Southampton,Newcastle United,2-1,2,1,1,1,3,1,H
1998-03-30,1997,West Ham United,Leeds United,3-0,3,0,1,1,3,3,H
1998-03-31,1997,Blackburn Rovers,Barnsley,2-1,2,1,1,1,3,1,H
1998-03-31,1997,Bolton Wanderers,Arsenal,0-1,0,1,1,1,1,-1,A
1998-03-31,1997,Wimbledon,Newcastle United,0-0,0,0,1,1,0,0,D
1998-04-04,1997,Aston Villa,West Ham United,2-0,2,0,1,1,2,2,H
1998-04-04,1997,Leeds United,Barnsley,2-1,2,1,1,1,3,1,H
1998-04-04,1997,Leicester City,Coventry City,1-1,1,1,1,1,2,0,D
1998-04-04,1997,Sheffield Wednesday,Southampton,1-0,1,0,1,1,1,1,H
1998-04-04,1997,Tottenham Hotspur,Everton,1-1,1,1,1,1,2,0,D
1998-04-04,1997,Wimbledon,Bolton Wanderers,0-0,0,0,1,1,0,0,D
1998-04-05,1997,Derby County,Chelsea,0-1,0,1,1,1,1,-1,A
1998-04-06,1997,Blackburn Rovers,Manchester United,1-3,1,3,1,1,4,-2,A
1998-04-08,1997,Leeds United,Chelsea,3-1,3,1,1,1,4,2,H
1998-04-10,1997,Manchester United,Liverpool,1-1,1,1,1,1,2,0,D
1998-04-11,1997,Arsenal,Newcastle United,3-1,3,1,1,1,4,2,H
1998-04-11,1997,Barnsley,Sheffield Wednesday,2-1,2,1,1,1,3,1,H
1998-04-11,1997,Bolton Wanderers,Blackburn Rovers,2-1,2,1,1,1,3,1,H
1998-04-11,1997,Chelsea,Tottenham Hotspur,2-0,2,0,1,1,2,2,H
1998-04-11,1997,Coventry City,Aston Villa,1-2,1,2,1,1,3,-1,A
1998-04-11,1997,Crystal Palace,Leicester City,0-3,0,3,1,1,3,-3,A
1998-04-11,1997,Everton,Leeds United,2-0,2,0,1,1,2,2,H
1998-04-11,1997,Southampton,Wimbledon,0-1,0,1,1,1,1,-1,A
1998-04-11,1997,West Ham United,Derby County,0-0,0,0,1,1,0,0,D
1998-04-13,1997,Blackburn Rovers,Arsenal,1-4,1,4,1,1,5,-3,A
1998-04-13,1997,Derby County,Bolton Wanderers,4-0,4,0,1,1,4,4,H
1998-04-13,1997,Liverpool,Crystal Palace,2-1,2,1,1,1,3,1,H
1998-04-13,1997,Newcastle United,Barnsley,2-1,2,1,1,1,3,1,H
1998-04-13,1997,Sheffield Wednesday,West Ham United,1-1,1,1,1,1,2,0,D
1998-04-13,1997,Tottenham Hotspur,Coventry City,1-1,1,1,1,1,2,0,D
1998-04-13,1997,Wimbledon,Everton,0-0,0,0,1,1,0,0,D
1998-04-14,1997,Leicester City,Southampton,3-3,3,3,1,1,6,0,D
1998-04-18,1997,Arsenal,Wimbledon,5-0,5,0,1,1,5,5,H
1998-04-18,1997,Barnsley,Tottenham Hotspur,1-1,1,1,1,1,2,0,D
1998-04-18,1997,Bolton Wanderers,Leeds United,2-3,2,3,1,1,5,-1,A
1998-04-18,1997,Crystal Palace,Derby County,3-1,3,1,1,1,4,2,H
1998-04-18,1997,Everton,Leicester City,1-1,1,1,1,1,2,0,D
1998-04-18,1997,Manchester United,Newcastle United,1-1,1,1,1,1,2,0,D
1998-04-18,1997,Southampton,Aston Villa,1-2,1,2,1,1,3,-1,A
1998-04-18,1997,West Ham United,Blackburn Rovers,2-1,2,1,1,1,3,1,H
1998-04-19,1997,Chelsea,Sheffield Wednesday,1-0,1,0,1,1,1,1,H
1998-04-19,1997,Coventry City,Liverpool,1-1,1,1,1,1,2,0,D
1998-04-25,1997,Aston Villa,Bolton Wanderers,1-3,1,3,1,1,4,-2,A
1998-04-25,1997,Barnsley,Arsenal,0-2,0,2,1,1,2,-2,A
1998-04-25,1997,Blackburn Rovers,Wimbledon,0-0,0,0,1,1,0,0,D
1998-04-25,1997,Chelsea,Liverpool,4-1,4,1,1,1,5,3,H
1998-04-25,1997,Everton,Sheffield Wednesday,1-3,1,3,1,1,4,-2,A
1998-04-25,1997,Leeds United,Coventry City,3-3,3,3,1,1,6,0,D
1998-04-25,1997,Tottenham Hotspur,Newcastle United,2-0,2,0,1,1,2,2,H
1998-04-25,1997,West Ham United,Southampton,2-4,2,4,1,1,6,-2,A
1998-04-26,1997,Derby County,Leicester City,0-4,0,4,1,1,4,-4,A
1998-04-27,1997,Crystal Palace,Manchester United,0-3,0,3,1,1,3,-3,A
1998-04-29,1997,Arsenal,Derby County,1-0,1,0,1,1,1,1,H
1998-04-29,1997,Chelsea,Blackburn Rovers,0-1,0,1,1,1,1,-1,A
1998-04-29,1997,Coventry City,Wimbledon,0-0,0,0,1,1,0,0,D
1998-04-29,1997,Leicester City,Newcastle United,0-0,0,0,1,1,0,0,D
1998-05-02,1997,Bolton Wanderers,Crystal Palace,5-2,5,2,1,1,7,3,H
1998-05-02,1997,Coventry City,Blackburn Rovers,2-0,2,0,1,1,2,2,H
1998-05-02,1997,Leicester City,Barnsley,1-0,1,0,1,1,1,1,H
1998-05-02,1997,Liverpool,West Ham United,5-0,5,0,1,1,5,5,H
1998-05-02,1997,Newcastle United,Chelsea,3-1,3,1,1,1,4,2,H
1998-05-02,1997,Sheffield Wednesday,Aston Villa,1-3,1,3,1,1,4,-2,A
1998-05-02,1997,Southampton,Derby County,0-2,0,2,1,1,2,-2,A
1998-05-02,1997,Wimbledon,Tottenham Hotspur,2-6,2,6,1,1,8,-4,A
1998-05-03,1997,Arsenal,Everton,4-0,4,0,1,1,4,4,H
1998-05-04,1997,Manchester United,Leeds United,3-0,3,0,1,1,3,3,H
1998-05-05,1997,Crystal Palace,West Ham United,3-3,3,3,1,1,6,0,D
1998-05-06,1997,Liverpool,Arsenal,4-0,4,0,1,1,4,4,H
1998-05-10,1997,Aston Villa,Arsenal,1-0,1,0,1,1,1,1,H
1998-05-10,1997,Barnsley,Manchester United,0-2,0,2,1,1,2,-2,A
1998-05-10,1997,Blackburn Rovers,Newcastle United,1-0,1,0,1,1,1,1,H
1998-05-10,1997,Chelsea,Bolton Wanderers,2-0,2,0,1,1,2,2,H
1998-05-10,1997,Crystal Palace,Sheffield Wednesday,1-0,1,0,1,1,1,1,H
1998-05-10,1997,Derby County,Liverpool,1-0,1,0,1,1,1,1,H
1998-05-10,1997,Everton,Coventry City,1-1,1,1,1,1,2,0,D
1998-05-10,1997,Leeds United,Wimbledon,1-1,1,1,1,1,2,0,D
1998-05-10,1997,Tottenham Hotspur,Southampton,1-1,1,1,1,1,2,0,D
1998-05-10,1997,West Ham United,Leicester City,4-3,4,3,1,1,7,1,H
1998-08-15,1998,Blackburn Rovers,Derby County,0-0,0,0,1,1,0,0,D
1998-08-15,1998,Coventry City,Chelsea,2-1,2,1,1,1,3,1,H
1998-08-15,1998,Everton,Aston Villa,0-0,0,0,1,1,0,0,D
1998-08-15,1998,Manchester United,Leicester City,2-2,2,2,1,1,4,0,D
1998-08-15,1998,Middlesbrough,Leeds United,0-0,0,0,1,1,0,0,D
1998-08-15,1998,Newcastle United,Charlton Athletic,0-0,0,0,1,1,0,0,D
1998-08-15,1998,Sheffield Wednesday,West Ham United,0-1,0,1,1,1,1,-1,A
1998-08-15,1998,Wimbledon,Tottenham Hotspur,3-1,3,1,1,1,4,2,H
1998-08-16,1998,Southampton,Liverpool,1-2,1,2,1,1,3,-1,A
1998-08-17,1998,Arsenal,Nottingham Forest,2-1,2,1,1,1,3,1,H
1998-08-22,1998,Charlton Athletic,Southampton,5-0,5,0,1,1,5,5,H
1998-08-22,1998,Chelsea,Newcastle United,1-1,1,1,1,1,2,0,D
1998-08-22,1998,Derby County,Wimbledon,0-0,0,0,1,1,0,0,D
1998-08-22,1998,Leicester City,Everton,2-0,2,0,1,1,2,2,H
1998-08-22,1998,Liverpool,Arsenal,0-0,0,0,1,1,0,0,D
1998-08-22,1998,Nottingham Forest,Coventry City,1-0,1,0,1,1,1,1,H
1998-08-22,1998,Tottenham Hotspur,Sheffield Wednesday,0-3,0,3,1,1,3,-3,A
1998-08-22,1998,West Ham United,Manchester United,0-0,0,0,1,1,0,0,D
1998-08-23,1998,Aston Villa,Middlesbrough,3-1,3,1,1,1,4,2,H
1998-08-24,1998,Leeds United,Blackburn Rovers,1-0,1,0,1,1,1,1,H
1998-08-29,1998,Arsenal,Charlton Athletic,0-0,0,0,1,1,0,0,D
1998-08-29,1998,Blackburn Rovers,Leicester City,1-0,1,0,1,1,1,1,H
1998-08-29,1998,Coventry City,West Ham United,0-0,0,0,1,1,0,0,D
1998-08-29,1998,Everton,Tottenham Hotspur,0-1,0,1,1,1,1,-1,A
1998-08-29,1998,Middlesbrough,Derby County,1-1,1,1,1,1,2,0,D
1998-08-29,1998,Sheffield Wednesday,Aston Villa,0-1,0,1,1,1,1,-1,A
1998-08-29,1998,Southampton,Nottingham Forest,1-2,1,2,1,1,3,-1,A
1998-08-29,1998,Wimbledon,Leeds United,1-1,1,1,1,1,2,0,D
1998-08-30,1998,Newcastle United,Liverpool,1-4,1,4,1,1,5,-3,A
1998-09-08,1998,Leeds United,Southampton,3-0,3,0,1,1,3,3,H
1998-09-08,1998,Nottingham Forest,Everton,0-2,0,2,1,1,2,-2,A
1998-09-09,1998,Aston Villa,Newcastle United,1-0,1,0,1,1,1,1,H
1998-09-09,1998,Chelsea,Arsenal,0-0,0,0,1,1,0,0,D
1998-09-09,1998,Derby County,Sheffield Wednesday,1-0,1,0,1,1,1,1,H
1998-09-09,1998,Leicester City,Middlesbrough,0-1,0,1,1,1,1,-1,A
1998-09-09,1998,Liverpool,Coventry City,2-0,2,0,1,1,2,2,H
1998-09-09,1998,Manchester United,Charlton Athletic,4-1,4,1,1,1,5,3,H
1998-09-09,1998,Tottenham Hotspur,Blackburn Rovers,2-1,2,1,1,1,3,1,H
1998-09-09,1998,West Ham United,Wimbledon,3-4,3,4,1,1,7,-1,A
1998-09-12,1998,Aston Villa,Wimbledon,2-0,2,0,1,1,2,2,H
1998-09-12,1998,Charlton Athletic,Derby County,1-2,1,2,1,1,3,-1,A
1998-09-12,1998,Chelsea,Nottingham Forest,2-1,2,1,1,1,3,1,H
1998-09-12,1998,Everton,Leeds United,0-0,0,0,1,1,0,0,D
1998-09-12,1998,Leicester City,Arsenal,1-1,1,1,1,1,2,0,D
1998-09-12,1998,Manchester United,Coventry City,2-0,2,0,1,1,2,2,H
1998-09-12,1998,Newcastle United,Southampton,4-0,4,0,1,1,4,4,H
1998-09-12,1998,Sheffield Wednesday,Blackburn Rovers,3-0,3,0,1,1,3,3,H
1998-09-12,1998,West Ham United,Liverpool,2-1,2,1,1,1,3,1,H
1998-09-13,1998,Tottenham Hotspur,Middlesbrough,0-3,0,3,1,1,3,-3,A
1998-09-19,1998,Coventry City,Newcastle United,1-5,1,5,1,1,6,-4,A
1998-09-19,1998,Derby County,Leicester City,2-0,2,0,1,1,2,2,H
1998-09-19,1998,Leeds United,Aston Villa,0-0,0,0,1,1,0,0,D
1998-09-19,1998,Liverpool,Charlton Athletic,3-3,3,3,1,1,6,0,D
1998-09-19,1998,Middlesbrough,Everton,2-2,2,2,1,1,4,0,D
1998-09-19,1998,Nottingham Forest,West Ham United,0-0,0,0,1,1,0,0,D
1998-09-19,1998,Southampton,Tottenham Hotspur,1-1,1,1,1,1,2,0,D
1998-09-19,1998,Wimbledon,Sheffield Wednesday,2-1,2,1,1,1,3,1,H
1998-09-20,1998,Arsenal,Manchester United,3-0,3,0,1,1,3,3,H
1998-09-21,1998,Blackburn Rovers,Chelsea,3-4,3,4,1,1,7,-1,A
1998-09-24,1998,Manchester United,Liverpool,2-0,2,0,1,1,2,2,H
1998-09-26,1998,Aston Villa,Derby County,1-0,1,0,1,1,1,1,H
1998-09-26,1998,Charlton Athletic,Coventry City,1-1,1,1,1,1,2,0,D
1998-09-26,1998,Chelsea,Middlesbrough,2-0,2,0,1,1,2,2,H
1998-09-26,1998,Everton,Blackburn Rovers,0-0,0,0,1,1,0,0,D
1998-09-26,1998,Newcastle United,Nottingham Forest,2-0,2,0,1,1,2,2,H
1998-09-26,1998,Sheffield Wednesday,Arsenal,1-0,1,0,1,1,1,1,H
1998-09-26,1998,Tottenham Hotspur,Leeds United,3-3,3,3,1,1,6,0,D
1998-09-27,1998,Leicester City,Wimbledon,1-1,1,1,1,1,2,0,D
1998-09-28,1998,West Ham United,Southampton,1-0,1,0,1,1,1,1,H
1998-10-03,1998,Blackburn Rovers,West Ham United,3-0,3,0,1,1,3,3,H
1998-10-03,1998,Coventry City,Aston Villa,1-2,1,2,1,1,3,-1,A
1998-10-03,1998,Derby County,Tottenham Hotspur,0-1,0,1,1,1,1,-1,A
1998-10-03,1998,Leeds United,Leicester City,0-1,0,1,1,1,1,-1,A
1998-10-03,1998,Middlesbrough,Sheffield Wednesday,4-0,4,0,1,1,4,4,H
1998-10-03,1998,Nottingham Forest,Charlton Athletic,0-1,0,1,1,1,1,-1,A
1998-10-03,1998,Southampton,Manchester United,0-3,0,3,1,1,3,-3,A
1998-10-03,1998,Wimbledon,Everton,1-2,1,2,1,1,3,-1,A
1998-10-04,1998,Arsenal,Newcastle United,3-0,3,0,1,1,3,3,H
1998-10-04,1998,Liverpool,Chelsea,1-1,1,1,1,1,2,0,D
1998-10-17,1998,Arsenal,Southampton,1-1,1,1,1,1,2,0,D
1998-10-17,1998,Chelsea,Charlton Athletic,2-1,2,1,1,1,3,1,H
1998-10-17,1998,Everton,Liverpool,0-0,0,0,1,1,0,0,D
1998-10-17,1998,Manchester United,Wimbledon,5-1,5,1,1,1,6,4,H
1998-10-17,1998,Middlesbrough,Blackburn Rovers,2-1,2,1,1,1,3,1,H
1998-10-17,1998,Newcastle United,Derby County,2-1,2,1,1,1,3,1,H
1998-10-17,1998,Nottingham Forest,Leeds United,1-1,1,1,1,1,2,0,D
1998-10-17,1998,West Ham United,Aston Villa,0-0,0,0,1,1,0,0,D
1998-10-18,1998,Coventry City,Sheffield Wednesday,1-0,1,0,1,1,1,1,H
1998-10-19,1998,Leicester City,Tottenham Hotspur,2-1,2,1,1,1,3,1,H
1998-10-24,1998,Aston Villa,Leicester City,1-1,1,1,1,1,2,0,D
1998-10-24,1998,Charlton Athletic,West Ham United,4-2,4,2,1,1,6,2,H
1998-10-24,1998,Derby County,Manchester United,1-1,1,1,1,1,2,0,D
1998-10-24,1998,Liverpool,Nottingham Forest,5-1,5,1,1,1,6,4,H
1998-10-24,1998,Sheffield Wednesday,Everton,0-0,0,0,1,1,0,0,D
1998-10-24,1998,Southampton,Coventry City,2-1,2,1,1,1,3,1,H
1998-10-24,1998,Tottenham Hotspur,Newcastle United,2-0,2,0,1,1,2,2,H
1998-10-24,1998,Wimbledon,Middlesbrough,2-2,2,2,1,1,4,0,D
1998-10-25,1998,Blackburn Rovers,Arsenal,1-2,1,2,1,1,3,-1,A
1998-10-25,1998,Leeds United,Chelsea,0-0,0,0,1,1,0,0,D
1998-10-31,1998,Coventry City,Arsenal,0-1,0,1,1,1,1,-1,A
1998-10-31,1998,Derby County,Leeds United,2-2,2,2,1,1,4,0,D
1998-10-31,1998,Everton,Manchester United,1-4,1,4,1,1,5,-3,A
1998-10-31,1998,Leicester City,Liverpool,1-0,1,0,1,1,1,1,H
1998-10-31,1998,Newcastle United,West Ham United,0-3,0,3,1,1,3,-3,A
1998-10-31,1998,Sheffield Wednesday,Southampton,0-0,0,0,1,1,0,0,D
1998-10-31,1998,Wimbledon,Blackburn Rovers,1-1,1,1,1,1,2,0,D
1998-11-01,1998,Middlesbrough,Nottingham Forest,1-1,1,1,1,1,2,0,D
1998-11-02,1998,Tottenham Hotspur,Charlton Athletic,2-2,2,2,1,1,4,0,D
1998-11-07,1998,Aston Villa,Tottenham Hotspur,3-2,3,2,1,1,5,1,H
1998-11-07,1998,Blackburn Rovers,Coventry City,1-2,1,2,1,1,3,-1,A
1998-11-07,1998,Charlton Athletic,Leicester City,0-0,0,0,1,1,0,0,D
1998-11-07,1998,Liverpool,Derby County,1-2,1,2,1,1,3,-1,A
1998-11-07,1998,Nottingham Forest,Wimbledon,0-1,0,1,1,1,1,-1,A
1998-11-07,1998,Southampton,Middlesbrough,3-3,3,3,1,1,6,0,D
1998-11-08,1998,Arsenal,Everton,1-0,1,0,1,1,1,1,H
1998-11-08,1998,Leeds United,Sheffield Wednesday,2-1,2,1,1,1,3,1,H
1998-11-08,1998,Manchester United,Newcastle United,0-0,0,0,1,1,0,0,D
1998-11-08,1998,West Ham United,Chelsea,1-1,1,1,1,1,2,0,D
1998-11-14,1998,Arsenal,Tottenham Hotspur,0-0,0,0,1,1,0,0,D
1998-11-14,1998,Charlton Athletic,Middlesbrough,1-1,1,1,1,1,2,0,D
1998-11-14,1998,Chelsea,Wimbledon,3-0,3,0,1,1,3,3,H
1998-11-14,1998,Liverpool,Leeds United,1-3,1,3,1,1,4,-2,A
1998-11-14,1998,Manchester United,Blackburn Rovers,3-2,3,2,1,1,5,1,H
1998-11-14,1998,Newcastle United,Sheffield Wednesday,1-1,1,1,1,1,2,0,D
1998-11-14,1998,Southampton,Aston Villa,1-4,1,4,1,1,5,-3,A
1998-11-14,1998,West Ham United,Leicester City,3-2,3,2,1,1,5,1,H
1998-11-15,1998,Coventry City,Everton,3-0,3,0,1,1,3,3,H
1998-11-16,1998,Nottingham Forest,Derby County,2-2,2,2,1,1,4,0,D
1998-11-21,1998,Aston Villa,Liverpool,2-4,2,4,1,1,6,-2,A
1998-11-21,1998,Blackburn Rovers,Southampton,0-2,0,2,1,1,2,-2,A
1998-11-21,1998,Leeds United,Charlton Athletic,4-1,4,1,1,1,5,3,H
1998-11-21,1998,Leicester City,Chelsea,2-4,2,4,1,1,6,-2,A
1998-11-21,1998,Middlesbrough,Coventry City,2-0,2,0,1,1,2,2,H
1998-11-21,1998,Sheffield Wednesday,Manchester United,3-1,3,1,1,1,4,2,H
1998-11-21,1998,Tottenham Hotspur,Nottingham Forest,2-0,2,0,1,1,2,2,H
1998-11-21,1998,Wimbledon,Arsenal,1-0,1,0,1,1,1,1,H
1998-11-22,1998,Derby County,West Ham United,0-2,0,2,1,1,2,-2,A
1998-11-23,1998,Everton,Newcastle United,1-0,1,0,1,1,1,1,H
1998-11-28,1998,Charlton Athletic,Everton,1-2,1,2,1,1,3,-1,A
1998-11-28,1998,Chelsea,Sheffield Wednesday,1-1,1,1,1,1,2,0,D
1998-11-28,1998,Coventry City,Leicester City,1-1,1,1,1,1,2,0,D
1998-11-28,1998,Newcastle United,Wimbledon,3-1,3,1,1,1,4,2,H
1998-11-28,1998,Nottingham Forest,Aston Villa,2-2,2,2,1,1,4,0,D
1998-11-28,1998,Southampton,Derby County,0-1,0,1,1,1,1,-1,A
1998-11-28,1998,West Ham United,Tottenham Hotspur,2-1,2,1,1,1,3,1,H
1998-11-29,1998,Arsenal,Middlesbrough,1-1,1,1,1,1,2,0,D
1998-11-29,1998,Liverpool,Blackburn Rovers,2-0,2,0,1,1,2,2,H
1998-11-29,1998,Manchester United,Leeds United,3-2,3,2,1,1,5,1,H
1998-12-05,1998,Aston Villa,Manchester United,1-1,1,1,1,1,2,0,D
1998-12-05,1998,Blackburn Rovers,Charlton Athletic,1-0,1,0,1,1,1,1,H
1998-12-05,1998,Derby County,Arsenal,0-0,0,0,1,1,0,0,D
1998-12-05,1998,Everton,Chelsea,0-0,0,0,1,1,0,0,D
1998-12-05,1998,Leeds United,West Ham United,4-0,4,0,1,1,4,4,H
1998-12-05,1998,Leicester City,Southampton,2-0,2,0,1,1,2,2,H
1998-12-05,1998,Tottenham Hotspur,Liverpool,2-1,2,1,1,1,3,1,H
1998-12-05,1998,Wimbledon,Coventry City,2-1,2,1,1,1,3,1,H
1998-12-06,1998,Middlesbrough,Newcastle United,2-2,2,2,1,1,4,0,D
1998-12-07,1998,Sheffield Wednesday,Nottingham Forest,3-2,3,2,1,1,5,1,H
1998-12-09,1998,Chelsea,Aston Villa,2-1,2,1,1,1,3,1,H
1998-12-12,1998,Blackburn Rovers,Newcastle United,0-0,0,0,1,1,0,0,D
1998-12-12,1998,Derby County,Chelsea,2-2,2,2,1,1,4,0,D
1998-12-12,1998,Everton,Southampton,1-0,1,0,1,1,1,1,H
1998-12-12,1998,Leicester City,Nottingham Forest,3-1,3,1,1,1,4,2,H
1998-12-12,1998,Middlesbrough,West Ham United,1-0,1,0,1,1,1,1,H
1998-12-12,1998,Sheffield Wednesday,Charlton Athletic,3-0,3,0,1,1,3,3,H
1998-12-12,1998,Tottenham Hotspur,Manchester United,2-2,2,2,1,1,4,0,D
1998-12-13,1998,Aston Villa,Arsenal,3-2,3,2,1,1,5,1,H
1998-12-13,1998,Wimbledon,Liverpool,1-0,1,0,1,1,1,1,H
1998-12-14,1998,Leeds United,Coventry City,2-0,2,0,1,1,2,2,H
1998-12-16,1998,Manchester United,Chelsea,1-1,1,1,1,1,2,0,D
1998-12-19,1998,Chelsea,Tottenham Hotspur,2-0,2,0,1,1,2,2,H
1998-12-19,1998,Coventry City,Derby County,1-1,1,1,1,1,2,0,D
1998-12-19,1998,Liverpool,Sheffield Wednesday,2-0,2,0,1,1,2,2,H
1998-12-19,1998,Manchester United,Middlesbrough,2-3,2,3,1,1,5,-1,A
1998-12-19,1998,Newcastle United,Leicester City,1-0,1,0,1,1,1,1,H
1998-12-19,1998,Nottingham Forest,Blackburn Rovers,2-2,2,2,1,1,4,0,D
1998-12-19,1998,Southampton,Wimbledon,3-1,3,1,1,1,4,2,H
1998-12-19,1998,West Ham United,Everton,2-1,2,1,1,1,3,1,H
1998-12-20,1998,Arsenal,Leeds United,3-1,3,1,1,1,4,2,H
1998-12-21,1998,Charlton Athletic,Aston Villa,0-1,0,1,1,1,1,-1,A
1998-12-26,1998,Arsenal,West Ham United,1-0,1,0,1,1,1,1,H
1998-12-26,1998,Blackburn Rovers,Aston Villa,2-1,2,1,1,1,3,1,H
1998-12-26,1998,Coventry City,Tottenham Hotspur,1-1,1,1,1,1,2,0,D
1998-12-26,1998,Everton,Derby County,0-0,0,0,1,1,0,0,D
1998-12-26,1998,Manchester United,Nottingham Forest,3-0,3,0,1,1,3,3,H
1998-12-26,1998,Middlesbrough,Liverpool,1-3,1,3,1,1,4,-2,A
1998-12-26,1998,Newcastle United,Leeds United,0-3,0,3,1,1,3,-3,A
1998-12-26,1998,Sheffield Wednesday,Leicester City,0-1,0,1,1,1,1,-1,A
1998-12-26,1998,Southampton,Chelsea,0-2,0,2,1,1,2,-2,A
1998-12-26,1998,Wimbledon,Charlton Athletic,2-1,2,1,1,1,3,1,H
1998-12-28,1998,Aston Villa,Sheffield Wednesday,2-1,2,1,1,1,3,1,H
1998-12-28,1998,Charlton Athletic,Arsenal,0-1,0,1,1,1,1,-1,A
1998-12-28,1998,Derby County,Middlesbrough,2-1,2,1,1,1,3,1,H
1998-12-28,1998,Leicester City,Blackburn Rovers,1-1,1,1,1,1,2,0,D
1998-12-28,1998,Liverpool,Newcastle United,4-2,4,2,1,1,6,2,H
1998-12-28,1998,Nottingham Forest,Southampton,1-1,1,1,1,1,2,0,D
1998-12-28,1998,Tottenham Hotspur,Everton,4-1,4,1,1,1,5,3,H
1998-12-28,1998,West Ham United,Coventry City,2-0,2,0,1,1,2,2,H
1998-12-29,1998,Chelsea,Manchester United,0-0,0,0,1,1,0,0,D
1998-12-29,1998,Leeds United,Wimbledon,2-2,2,2,1,1,4,0,D
1999-01-09,1998,Arsenal,Liverpool,0-0,0,0,1,1,0,0,D
1999-01-09,1998,Blackburn Rovers,Leeds United,1-0,1,0,1,1,1,1,H
1999-01-09,1998,Coventry City,Nottingham Forest,4-0,4,0,1,1,4,4,H
1999-01-09,1998,Everton,Leicester City,0-0,0,0,1,1,0,0,D
1999-01-09,1998,Middlesbrough,Aston Villa,0-0,0,0,1,1,0,0,D
1999-01-09,1998,Newcastle United,Chelsea,0-1,0,1,1,1,1,-1,A
1999-01-09,1998,Sheffield Wednesday,Tottenham Hotspur,0-0,0,0,1,1,0,0,D
1999-01-09,1998,Southampton,Charlton Athletic,3-1,3,1,1,1,4,2,H
1999-01-09,1998,Wimbledon,Derby County,2-1,2,1,1,1,3,1,H
1999-01-10,1998,Manchester United,West Ham United,4-1,4,1,1,1,5,3,H
1999-01-16,1998,Chelsea,Coventry City,2-1,2,1,1,1,3,1,H
1999-01-16,1998,Derby County,Blackburn Rovers,1-0,1,0,1,1,1,1,H
1999-01-16,1998,Leeds United,Middlesbrough,2-0,2,0,1,1,2,2,H
1999-01-16,1998,Leicester City,Manchester United,2-6,2,6,1,1,8,-4,A
1999-01-16,1998,Liverpool,Southampton,7-1,7,1,1,1,8,6,H
1999-01-16,1998,Nottingham Forest,Arsenal,0-1,0,1,1,1,1,-1,A
1999-01-16,1998,Tottenham Hotspur,Wimbledon,0-0,0,0,1,1,0,0,D
1999-01-16,1998,West Ham United,Sheffield Wednesday,0-4,0,4,1,1,4,-4,A
1999-01-17,1998,Charlton Athletic,Newcastle United,2-2,2,2,1,1,4,0,D
1999-01-18,1998,Aston Villa,Everton,3-0,3,0,1,1,3,3,H
1999-01-30,1998,Blackburn Rovers,Tottenham Hotspur,1-1,1,1,1,1,2,0,D
1999-01-30,1998,Coventry City,Liverpool,2-1,2,1,1,1,3,1,H
1999-01-30,1998,Everton,Nottingham Forest,0-1,0,1,1,1,1,-1,A
1999-01-30,1998,Middlesbrough,Leicester City,0-0,0,0,1,1,0,0,D
1999-01-30,1998,Newcastle United,Aston Villa,2-1,2,1,1,1,3,1,H
1999-01-30,1998,Sheffield Wednesday,Derby County,0-1,0,1,1,1,1,-1,A
1999-01-30,1998,Southampton,Leeds United,3-0,3,0,1,1,3,3,H
1999-01-30,1998,Wimbledon,West Ham United,0-0,0,0,1,1,0,0,D
1999-01-31,1998,Arsenal,Chelsea,1-0,1,0,1,1,1,1,H
1999-01-31,1998,Charlton Athletic,Manchester United,0-1,0,1,1,1,1,-1,A
1999-02-02,1998,Manchester United,Derby County,1-0,1,0,1,1,1,1,H
1999-02-06,1998,Aston Villa,Blackburn Rovers,1-3,1,3,1,1,4,-2,A
1999-02-06,1998,Chelsea,Southampton,1-0,1,0,1,1,1,1,H
1999-02-06,1998,Leeds United,Newcastle United,0-1,0,1,1,1,1,-1,A
1999-02-06,1998,Leicester City,Sheffield Wednesday,0-2,0,2,1,1,2,-2,A
1999-02-06,1998,Liverpool,Middlesbrough,3-1,3,1,1,1,4,2,H
1999-02-06,1998,Nottingham Forest,Manchester United,1-8,1,8,1,1,9,-7,A
1999-02-06,1998,Tottenham Hotspur,Coventry City,0-0,0,0,1,1,0,0,D
1999-02-06,1998,West Ham United,Arsenal,0-4,0,4,1,1,4,-4,A
1999-02-07,1998,Derby County,Everton,2-1,2,1,1,1,3,1,H
1999-02-08,1998,Charlton Athletic,Wimbledon,2-0,2,0,1,1,2,2,H
1999-02-13,1998,Charlton Athletic,Liverpool,1-0,1,0,1,1,1,1,H
1999-02-13,1998,West Ham United,Nottingham Forest,2-1,2,1,1,1,3,1,H
1999-02-17,1998,Aston Villa,Leeds United,1-2,1,2,1,1,3,-1,A
1999-02-17,1998,Chelsea,Blackburn Rovers,1-1,1,1,1,1,2,0,D
1999-02-17,1998,Everton,Middlesbrough,5-0,5,0,1,1,5,5,H
1999-02-17,1998,Manchester United,Arsenal,1-1,1,1,1,1,2,0,D
1999-02-17,1998,Newcastle United,Coventry City,4-1,4,1,1,1,5,3,H
1999-02-20,1998,Arsenal,Leicester City,5-0,5,0,1,1,5,5,H
1999-02-20,1998,Blackburn Rovers,Sheffield Wednesday,1-4,1,4,1,1,5,-3,A
1999-02-20,1998,Coventry City,Manchester United,0-1,0,1,1,1,1,-1,A
1999-02-20,1998,Derby County,Charlton Athletic,0-2,0,2,1,1,2,-2,A
1999-02-20,1998,Leeds United,Everton,1-0,1,0,1,1,1,1,H
1999-02-20,1998,Liverpool,West Ham United,2-2,2,2,1,1,4,0,D
1999-02-20,1998,Middlesbrough,Tottenham Hotspur,0-0,0,0,1,1,0,0,D
1999-02-20,1998,Nottingham Forest,Chelsea,1-3,1,3,1,1,4,-2,A
1999-02-20,1998,Southampton,Newcastle United,2-1,2,1,1,1,3,1,H
1999-02-21,1998,Wimbledon,Aston Villa,0-0,0,0,1,1,0,0,D
1999-02-27,1998,Aston Villa,Coventry City,1-4,1,4,1,1,5,-3,A
1999-02-27,1998,Charlton Athletic,Nottingham Forest,0-0,0,0,1,1,0,0,D
1999-02-27,1998,Chelsea,Liverpool,2-1,2,1,1,1,3,1,H
1999-02-27,1998,Everton,Wimbledon,1-1,1,1,1,1,2,0,D
1999-02-27,1998,Manchester United,Southampton,2-1,2,1,1,1,3,1,H
1999-02-27,1998,Sheffield Wednesday,Middlesbrough,3-1,3,1,1,1,4,2,H
1999-02-27,1998,Tottenham Hotspur,Derby County,1-1,1,1,1,1,2,0,D
1999-02-27,1998,West Ham United,Blackburn Rovers,2-0,2,0,1,1,2,2,H
1999-02-28,1998,Newcastle United,Arsenal,1-1,1,1,1,1,2,0,D
1999-03-01,1998,Leicester City,Leeds United,1-2,1,2,1,1,3,-1,A
1999-03-02,1998,Tottenham Hotspur,Southampton,3-0,3,0,1,1,3,3,H
1999-03-03,1998,Sheffield Wednesday,Wimbledon,1-2,1,2,1,1,3,-1,A
1999-03-06,1998,Coventry City,Charlton Athletic,2-1,2,1,1,1,3,1,H
1999-03-06,1998,Southampton,West Ham United,1-0,1,0,1,1,1,1,H
1999-03-06,1998,Wimbledon,Leicester City,0-1,0,1,1,1,1,-1,A
1999-03-09,1998,Arsenal,Sheffield Wednesday,3-0,3,0,1,1,3,3,H
1999-03-10,1998,Blackburn Rovers,Everton,1-2,1,2,1,1,3,-1,A
1999-03-10,1998,Derby County,Aston Villa,2-1,2,1,1,1,3,1,H
1999-03-10,1998,Leeds United,Tottenham Hotspur,2-0,2,0,1,1,2,2,H
1999-03-10,1998,Nottingham Forest,Newcastle United,1-2,1,2,1,1,3,-1,A
1999-03-13,1998,Chelsea,West Ham United,0-1,0,1,1,1,1,-1,A
1999-03-13,1998,Coventry City,Blackburn Rovers,1-1,1,1,1,1,2,0,D
1999-03-13,1998,Derby County,Liverpool,3-2,3,2,1,1,5,1,H
1999-03-13,1998,Everton,Arsenal,0-2,0,2,1,1,2,-2,A
1999-03-13,1998,Leicester City,Charlton Athletic,1-1,1,1,1,1,2,0,D
1999-03-13,1998,Newcastle United,Manchester United,1-2,1,2,1,1,3,-1,A
1999-03-13,1998,Sheffield Wednesday,Leeds United,0-2,0,2,1,1,2,-2,A
1999-03-13,1998,Tottenham Hotspur,Aston Villa,1-0,1,0,1,1,1,1,H
1999-03-13,1998,Wimbledon,Nottingham Forest,1-3,1,3,1,1,4,-2,A
1999-03-14,1998,Middlesbrough,Southampton,3-0,3,0,1,1,3,3,H
1999-03-20,1998,Arsenal,Coventry City,2-0,2,0,1,1,2,2,H
1999-03-20,1998,Blackburn Rovers,Wimbledon,3-1,3,1,1,1,4,2,H
1999-03-20,1998,Leeds United,Derby County,4-1,4,1,1,1,5,3,H
1999-03-20,1998,Nottingham Forest,Middlesbrough,1-2,1,2,1,1,3,-1,A
1999-03-20,1998,Southampton,Sheffield Wednesday,1-0,1,0,1,1,1,1,H
1999-03-20,1998,West Ham United,Newcastle United,2-0,2,0,1,1,2,2,H
1999-03-21,1998,Aston Villa,Chelsea,0-3,0,3,1,1,3,-3,A
1999-03-21,1998,Manchester United,Everton,3-1,3,1,1,1,4,2,H
1999-04-02,1998,Aston Villa,West Ham United,0-0,0,0,1,1,0,0,D
1999-04-03,1998,Blackburn Rovers,Middlesbrough,0-0,0,0,1,1,0,0,D
1999-04-03,1998,Charlton Athletic,Chelsea,0-1,0,1,1,1,1,-1,A
1999-04-03,1998,Derby County,Newcastle United,3-4,3,4,1,1,7,-1,A
1999-04-03,1998,Leeds United,Nottingham Forest,3-1,3,1,1,1,4,2,H
1999-04-03,1998,Liverpool,Everton,3-2,3,2,1,1,5,1,H
1999-04-03,1998,Sheffield Wednesday,Coventry City,1-2,1,2,1,1,3,-1,A
1999-04-03,1998,Southampton,Arsenal,0-0,0,0,1,1,0,0,D
1999-04-03,1998,Tottenham Hotspur,Leicester City,0-2,0,2,1,1,2,-2,A
1999-04-03,1998,Wimbledon,Manchester United,1-1,1,1,1,1,2,0,D
1999-04-05,1998,Coventry City,Southampton,1-0,1,0,1,1,1,1,H
1999-04-05,1998,Everton,Sheffield Wednesday,1-2,1,2,1,1,3,-1,A
1999-04-05,1998,Middlesbrough,Wimbledon,3-1,3,1,1,1,4,2,H
1999-04-05,1998,Newcastle United,Tottenham Hotspur,1-1,1,1,1,1,2,0,D
1999-04-05,1998,Nottingham Forest,Liverpool,2-2,2,2,1,1,4,0,D
1999-04-05,1998,West Ham United,Charlton Athletic,0-1,0,1,1,1,1,-1,A
1999-04-06,1998,Arsenal,Blackburn Rovers,1-0,1,0,1,1,1,1,H
1999-04-06,1998,Leicester City,Aston Villa,2-2,2,2,1,1,4,0,D
1999-04-10,1998,Aston Villa,Southampton,3-0,3,0,1,1,3,3,H
1999-04-10,1998,Derby County,Nottingham Forest,1-0,1,0,1,1,1,1,H
1999-04-10,1998,Leicester City,West Ham United,0-0,0,0,1,1,0,0,D
1999-04-10,1998,Middlesbrough,Charlton Athletic,2-0,2,0,1,1,2,2,H
1999-04-11,1998,Everton,Coventry City,2-0,2,0,1,1,2,2,H
1999-04-11,1998,Wimbledon,Chelsea,1-2,1,2,1,1,3,-1,A
1999-04-12,1998,Leeds United,Liverpool,0-0,0,0,1,1,0,0,D
1999-04-14,1998,Middlesbrough,Chelsea,0-0,0,0,1,1,0,0,D
1999-04-17,1998,Charlton Athletic,Leeds United,1-1,1,1,1,1,2,0,D
1999-04-17,1998,Coventry City,Middlesbrough,1-2,1,2,1,1,3,-1,A
1999-04-17,1998,Liverpool,Aston Villa,0-1,0,1,1,1,1,-1,A
1999-04-17,1998,Manchester United,Sheffield Wednesday,3-0,3,0,1,1,3,3,H
1999-04-17,1998,Newcastle United,Everton,1-3,1,3,1,1,4,-2,A
1999-04-17,1998,Nottingham Forest,Tottenham Hotspur,0-1,0,1,1,1,1,-1,A
1999-04-17,1998,Southampton,Blackburn Rovers,3-3,3,3,1,1,6,0,D
1999-04-17,1998,West Ham United,Derby County,5-1,5,1,1,1,6,4,H
1999-04-18,1998,Chelsea,Leicester City,2-2,2,2,1,1,4,0,D
1999-04-19,1998,Arsenal,Wimbledon,5-1,5,1,1,1,6,4,H
1999-04-20,1998,Charlton Athletic,Tottenham Hotspur,1-4,1,4,1,1,5,-3,A
1999-04-21,1998,Liverpool,Leicester City,0-1,0,1,1,1,1,-1,A
1999-04-21,1998,Sheffield Wednesday,Newcastle United,1-1,1,1,1,1,2,0,D
1999-04-24,1998,Aston Villa,Nottingham Forest,2-0,2,0,1,1,2,2,H
1999-04-24,1998,Blackburn Rovers,Liverpool,1-3,1,3,1,1,4,-2,A
1999-04-24,1998,Derby County,Southampton,0-0,0,0,1,1,0,0,D
1999-04-24,1998,Everton,Charlton Athletic,4-1,4,1,1,1,5,3,H
1999-04-24,1998,Leicester City,Coventry City,1-0,1,0,1,1,1,1,H
1999-04-24,1998,Middlesbrough,Arsenal,1-6,1,6,1,1,7,-5,A
1999-04-24,1998,Tottenham Hotspur,West Ham United,1-2,1,2,1,1,3,-1,A
1999-04-24,1998,Wimbledon,Newcastle United,1-1,1,1,1,1,2,0,D
1999-04-25,1998,Leeds United,Manchester United,1-1,1,1,1,1,2,0,D
1999-04-25,1998,Sheffield Wednesday,Chelsea,0-0,0,0,1,1,0,0,D
1999-05-01,1998,Charlton Athletic,Blackburn Rovers,0-0,0,0,1,1,0,0,D
1999-05-01,1998,Chelsea,Everton,3-1,3,1,1,1,4,2,H
1999-05-01,1998,Coventry City,Wimbledon,2-1,2,1,1,1,3,1,H
1999-05-01,1998,Liverpool,Tottenham Hotspur,3-2,3,2,1,1,5,1,H
1999-05-01,1998,Manchester United,Aston Villa,2-1,2,1,1,1,3,1,H
1999-05-01,1998,Newcastle United,Middlesbrough,1-1,1,1,1,1,2,0,D
1999-05-01,1998,Nottingham Forest,Sheffield Wednesday,2-0,2,0,1,1,2,2,H
1999-05-01,1998,Southampton,Leicester City,2-1,2,1,1,1,3,1,H
1999-05-01,1998,West Ham United,Leeds United,1-5,1,5,1,1,6,-4,A
1999-05-02,1998,Arsenal,Derby County,1-0,1,0,1,1,1,1,H
1999-05-05,1998,Chelsea,Leeds United,1-0,1,0,1,1,1,1,H
1999-05-05,1998,Leicester City,Derby County,1-2,1,2,1,1,3,-1,A
1999-05-05,1998,Liverpool,Manchester United,2-2,2,2,1,1,4,0,D
1999-05-05,1998,Tottenham Hotspur,Arsenal,1-3,1,3,1,1,4,-2,A
1999-05-08,1998,Aston Villa,Charlton Athletic,3-4,3,4,1,1,7,-1,A
1999-05-08,1998,Blackburn Rovers,Nottingham Forest,1-2,1,2,1,1,3,-1,A
1999-05-08,1998,Derby County,Coventry City,0-0,0,0,1,1,0,0,D
1999-05-08,1998,Everton,West Ham United,6-0,6,0,1,1,6,6,H
1999-05-08,1998,Leicester City,Newcastle United,2-0,2,0,1,1,2,2,H
1999-05-08,1998,Sheffield Wednesday,Liverpool,1-0,1,0,1,1,1,1,H
1999-05-08,1998,Wimbledon,Southampton,0-2,0,2,1,1,2,-2,A
1999-05-09,1998,Middlesbrough,Manchester United,0-1,0,1,1,1,1,-1,A
1999-05-10,1998,Tottenham Hotspur,Chelsea,2-2,2,2,1,1,4,0,D
1999-05-11,1998,Leeds United,Arsenal,1-0,1,0,1,1,1,1,H
1999-05-12,1998,Blackburn Rovers,Manchester United,0-0,0,0,1,1,0,0,D
1999-05-16,1998,Arsenal,Aston Villa,1-0,1,0,1,1,1,1,H
1999-05-16,1998,Charlton Athletic,Sheffield Wednesday,0-1,0,1,1,1,1,-1,A
1999-05-16,1998,Chelsea,Derby County,2-1,2,1,1,1,3,1,H
1999-05-16,1998,Coventry City,Leeds United,2-2,2,2,1,1,4,0,D
1999-05-16,1998,Liverpool,Wimbledon,3-0,3,0,1,1,3,3,H
1999-05-16,1998,Manchester United,Tottenham Hotspur,2-1,2,1,1,1,3,1,H
1999-05-16,1998,Newcastle United,Blackburn Rovers,1-1,1,1,1,1,2,0,D
1999-05-16,1998,Nottingham Forest,Leicester City,1-0,1,0,1,1,1,1,H
1999-05-16,1998,Southampton,Everton,2-0,2,0,1,1,2,2,H
1999-05-16,1998,West Ham United,Middlesbrough,4-0,4,0,1,1,4,4,H
1999-08-07,1999,Arsenal,Leicester City,2-1,2,1,1,1,3,1,H
1999-08-07,1999,Chelsea,Sunderland,4-0,4,0,1,1,4,4,H
1999-08-07,1999,Coventry City,Southampton,0-1,0,1,1,1,1,-1,A
1999-08-07,1999,Leeds United,Derby County,0-0,0,0,1,1,0,0,D
1999-08-07,1999,Middlesbrough,Bradford City,0-1,0,1,1,1,1,-1,A
1999-08-07,1999,Newcastle United,Aston Villa,0-1,0,1,1,1,1,-1,A
1999-08-07,1999,Sheffield Wednesday,Liverpool,1-2,1,2,1,1,3,-1,A
1999-08-07,1999,Watford,Wimbledon,2-3,2,3,1,1,5,-1,A
1999-08-07,1999,West Ham United,Tottenham Hotspur,1-0,1,0,1,1,1,1,H
1999-08-08,1999,Everton,Manchester United,1-1,1,1,1,1,2,0,D
1999-08-09,1999,Tottenham Hotspur,Newcastle United,3-1,3,1,1,1,4,2,H
1999-08-10,1999,Derby County,Arsenal,1-2,1,2,1,1,3,-1,A
1999-08-10,1999,Sunderland,Watford,2-0,2,0,1,1,2,2,H
1999-08-10,1999,Wimbledon,Middlesbrough,2-3,2,3,1,1,5,-1,A
1999-08-11,1999,Aston Villa,Everton,3-0,3,0,1,1,3,3,H
1999-08-11,1999,Leicester City,Coventry City,1-0,1,0,1,1,1,1,H
1999-08-11,1999,Manchester United,Sheffield Wednesday,4-0,4,0,1,1,4,4,H
1999-08-11,1999,Southampton,Leeds United,0-3,0,3,1,1,3,-3,A
1999-08-14,1999,Bradford City,Sheffield Wednesday,1-1,1,1,1,1,2,0,D
1999-08-14,1999,Derby County,Middlesbrough,1-3,1,3,1,1,4,-2,A
1999-08-14,1999,Leicester City,Chelsea,2-2,2,2,1,1,4,0,D
1999-08-14,1999,Liverpool,Watford,0-1,0,1,1,1,1,-1,A
1999-08-14,1999,Manchester United,Leeds United,2-0,2,0,1,1,2,2,H
1999-08-14,1999,Sunderland,Arsenal,0-0,0,0,1,1,0,0,D
1999-08-14,1999,Tottenham Hotspur,Everton,3-2,3,2,1,1,5,1,H
1999-08-14,1999,Wimbledon,Coventry City,1-1,1,1,1,1,2,0,D
1999-08-15,1999,Southampton,Newcastle United,4-2,4,2,1,1,6,2,H
1999-08-16,1999,Aston Villa,West Ham United,2-2,2,2,1,1,4,0,D
1999-08-21,1999,Chelsea,Aston Villa,1-0,1,0,1,1,1,1,H
1999-08-21,1999,Coventry City,Derby County,2-0,2,0,1,1,2,2,H
1999-08-21,1999,Everton,Southampton,4-1,4,1,1,1,5,3,H
1999-08-21,1999,Leeds United,Sunderland,2-1,2,1,1,1,3,1,H
1999-08-21,1999,Middlesbrough,Liverpool,1-0,1,0,1,1,1,1,H
1999-08-21,1999,Newcastle United,Wimbledon,3-3,3,3,1,1,6,0,D
1999-08-21,1999,Sheffield Wednesday,Tottenham Hotspur,1-2,1,2,1,1,3,-1,A
1999-08-21,1999,Watford,Bradford City,1-0,1,0,1,1,1,1,H
1999-08-21,1999,West Ham United,Leicester City,2-1,2,1,1,1,3,1,H
1999-08-22,1999,Arsenal,Manchester United,1-2,1,2,1,1,3,-1,A
1999-08-23,1999,Leeds United,Liverpool,1-2,1,2,1,1,3,-1,A
1999-08-24,1999,Middlesbrough,Leicester City,0-3,0,3,1,1,3,-3,A
1999-08-24,1999,Watford,Aston Villa,0-1,0,1,1,1,1,-1,A
1999-08-25,1999,Arsenal,Bradford City,2-0,2,0,1,1,2,2,H
1999-08-25,1999,Coventry City,Manchester United,1-2,1,2,1,1,3,-1,A
1999-08-25,1999,Everton,Wimbledon,4-0,4,0,1,1,4,4,H
1999-08-25,1999,Newcastle United,Sunderland,1-2,1,2,1,1,3,-1,A
1999-08-25,1999,Sheffield Wednesday,Derby County,0-2,0,2,1,1,2,-2,A
1999-08-28,1999,Aston Villa,Middlesbrough,1-0,1,0,1,1,1,1,H
1999-08-28,1999,Bradford City,West Ham United,0-3,0,3,1,1,3,-3,A
1999-08-28,1999,Derby County,Everton,1-0,1,0,1,1,1,1,H
1999-08-28,1999,Liverpool,Arsenal,2-0,2,0,1,1,2,2,H
1999-08-28,1999,Southampton,Sheffield Wednesday,2-0,2,0,1,1,2,2,H
1999-08-28,1999,Tottenham Hotspur,Leeds United,1-2,1,2,1,1,3,-1,A
1999-08-28,1999,Wimbledon,Chelsea,0-1,0,1,1,1,1,-1,A
1999-08-29,1999,Sunderland,Coventry City,1-1,1,1,1,1,2,0,D
1999-08-30,1999,Leicester City,Watford,1-0,1,0,1,1,1,1,H
1999-08-30,1999,Manchester United,Newcastle United,5-1,5,1,1,1,6,4,H
1999-09-11,1999,Arsenal,Aston Villa,3-1,3,1,1,1,4,2,H
1999-09-11,1999,Chelsea,Newcastle United,1-0,1,0,1,1,1,1,H
1999-09-11,1999,Coventry City,Leeds United,3-4,3,4,1,1,7,-1,A
1999-09-11,1999,Liverpool,Manchester United,2-3,2,3,1,1,5,-1,A
1999-09-11,1999,Middlesbrough,Southampton,3-2,3,2,1,1,5,1,H
1999-09-11,1999,Sheffield Wednesday,Everton,0-2,0,2,1,1,2,-2,A
1999-09-11,1999,Sunderland,Leicester City,2-0,2,0,1,1,2,2,H
1999-09-11,1999,West Ham United,Watford,1-0,1,0,1,1,1,1,H
1999-09-11,1999,Wimbledon,Derby County,2-2,2,2,1,1,4,0,D
1999-09-12,1999,Bradford City,Tottenham Hotspur,1-1,1,1,1,1,2,0,D
1999-09-18,1999,Aston Villa,Bradford City,1-0,1,0,1,1,1,1,H
1999-09-18,1999,Derby County,Sunderland,0-5,0,5,1,1,5,-5,A
1999-09-18,1999,Leicester City,Liverpool,2-2,2,2,1,1,4,0,D
1999-09-18,1999,Manchester United,Wimbledon,1-1,1,1,1,1,2,0,D
1999-09-18,1999,Southampton,Arsenal,0-1,0,1,1,1,1,-1,A
1999-09-18,1999,Watford,Chelsea,1-0,1,0,1,1,1,1,H
1999-09-19,1999,Everton,West Ham United,1-0,1,0,1,1,1,1,H
1999-09-19,1999,Leeds United,Middlesbrough,2-0,2,0,1,1,2,2,H
1999-09-19,1999,Newcastle United,Sheffield Wednesday,8-0,8,0,1,1,8,8,H
1999-09-19,1999,Tottenham Hotspur,Coventry City,3-2,3,2,1,1,5,1,H
1999-09-25,1999,Arsenal,Watford,1-0,1,0,1,1,1,1,H
1999-09-25,1999,Coventry City,West Ham United,1-0,1,0,1,1,1,1,H
1999-09-25,1999,Derby County,Bradford City,0-1,0,1,1,1,1,-1,A
1999-09-25,1999,Leeds United,Newcastle United,3-2,3,2,1,1,5,1,H
1999-09-25,1999,Leicester City,Aston Villa,3-1,3,1,1,1,4,2,H
1999-09-25,1999,Manchester United,Southampton,3-3,3,3,1,1,6,0,D
1999-09-25,1999,Middlesbrough,Chelsea,0-1,0,1,1,1,1,-1,A
1999-09-25,1999,Sunderland,Sheffield Wednesday,1-0,1,0,1,1,1,1,H
1999-09-26,1999,Wimbledon,Tottenham Hotspur,1-1,1,1,1,1,2,0,D
1999-09-27,1999,Liverpool,Everton,0-1,0,1,1,1,1,-1,A
1999-10-02,1999,Aston Villa,Liverpool,0-0,0,0,1,1,0,0,D
1999-10-02,1999,Bradford City,Sunderland,0-4,0,4,1,1,4,-4,A
1999-10-02,1999,Everton,Coventry City,1-1,1,1,1,1,2,0,D
1999-10-02,1999,Sheffield Wednesday,Wimbledon,5-1,5,1,1,1,6,4,H
1999-10-03,1999,Chelsea,Manchester United,5-0,5,0,1,1,5,5,H
1999-10-03,1999,Newcastle United,Middlesbrough,2-1,2,1,1,1,3,1,H
1999-10-03,1999,Tottenham Hotspur,Leicester City,2-3,2,3,1,1,5,-1,A
1999-10-03,1999,Watford,Leeds United,1-2,1,2,1,1,3,-1,A
1999-10-03,1999,West Ham United,Arsenal,2-1,2,1,1,1,3,1,H
1999-10-04,1999,Southampton,Derby County,3-3,3,3,1,1,6,0,D
1999-10-16,1999,Arsenal,Everton,4-1,4,1,1,1,5,3,H
1999-10-16,1999,Coventry City,Newcastle United,4-1,4,1,1,1,5,3,H
1999-10-16,1999,Derby County,Tottenham Hotspur,0-1,0,1,1,1,1,-1,A
1999-10-16,1999,Leeds United,Sheffield Wednesday,2-0,2,0,1,1,2,2,H
1999-10-16,1999,Leicester City,Southampton,2-1,2,1,1,1,3,1,H
1999-10-16,1999,Liverpool,Chelsea,1-0,1,0,1,1,1,1,H
1999-10-16,1999,Manchester United,Watford,4-1,4,1,1,1,5,3,H
1999-10-16,1999,Wimbledon,Bradford City,3-2,3,2,1,1,5,1,H
1999-10-17,1999,Middlesbrough,West Ham United,2-0,2,0,1,1,2,2,H
1999-10-18,1999,Sunderland,Aston Villa,2-1,2,1,1,1,3,1,H
1999-10-23,1999,Aston Villa,Wimbledon,1-1,1,1,1,1,2,0,D
1999-10-23,1999,Bradford City,Leicester City,3-1,3,1,1,1,4,2,H
1999-10-23,1999,Chelsea,Arsenal,2-3,2,3,1,1,5,-1,A
1999-10-23,1999,Sheffield Wednesday,Coventry City,0-0,0,0,1,1,0,0,D
1999-10-23,1999,Southampton,Liverpool,1-1,1,1,1,1,2,0,D
1999-10-23,1999,Tottenham Hotspur,Manchester United,3-1,3,1,1,1,4,2,H
1999-10-24,1999,Everton,Leeds United,4-4,4,4,1,1,8,0,D
1999-10-24,1999,Watford,Middlesbrough,1-3,1,3,1,1,4,-2,A
1999-10-24,1999,West Ham United,Sunderland,1-1,1,1,1,1,2,0,D
1999-10-25,1999,Newcastle United,Derby County,2-0,2,0,1,1,2,2,H
1999-10-27,1999,Liverpool,West Ham United,1-0,1,0,1,1,1,1,H
1999-10-30,1999,Arsenal,Newcastle United,0-0,0,0,1,1,0,0,D
1999-10-30,1999,Derby County,Chelsea,3-1,3,1,1,1,4,2,H
1999-10-30,1999,Leeds United,West Ham United,1-0,1,0,1,1,1,1,H
1999-10-30,1999,Leicester City,Sheffield Wednesday,3-0,3,0,1,1,3,3,H
1999-10-30,1999,Manchester United,Aston Villa,3-0,3,0,1,1,3,3,H
1999-10-30,1999,Middlesbrough,Everton,2-1,2,1,1,1,3,1,H
1999-10-30,1999,Wimbledon,Southampton,1-1,1,1,1,1,2,0,D
1999-10-31,1999,Coventry City,Watford,4-0,4,0,1,1,4,4,H
1999-10-31,1999,Sunderland,Tottenham Hotspur,2-1,2,1,1,1,3,1,H
1999-11-01,1999,Liverpool,Bradford City,3-1,3,1,1,1,4,2,H
1999-11-06,1999,Aston Villa,Southampton,0-1,0,1,1,1,1,-1,A
1999-11-06,1999,Bradford City,Coventry City,1-1,1,1,1,1,2,0,D
1999-11-06,1999,Liverpool,Derby County,2-0,2,0,1,1,2,2,H
1999-11-06,1999,Manchester United,Leicester City,2-0,2,0,1,1,2,2,H
1999-11-06,1999,Middlesbrough,Sunderland,1-1,1,1,1,1,2,0,D
1999-11-06,1999,Sheffield Wednesday,Watford,2-2,2,2,1,1,4,0,D
1999-11-07,1999,Chelsea,West Ham United,0-0,0,0,1,1,0,0,D
1999-11-07,1999,Newcastle United,Everton,1-1,1,1,1,1,2,0,D
1999-11-07,1999,Tottenham Hotspur,Arsenal,2-1,2,1,1,1,3,1,H
1999-11-07,1999,Wimbledon,Leeds United,2-0,2,0,1,1,2,2,H
1999-11-20,1999,Arsenal,Middlesbrough,5-1,5,1,1,1,6,4,H
1999-11-20,1999,Derby County,Manchester United,1-2,1,2,1,1,3,-1,A
1999-11-20,1999,Everton,Chelsea,1-1,1,1,1,1,2,0,D
1999-11-20,1999,Leeds United,Bradford City,2-1,2,1,1,1,3,1,H
1999-11-20,1999,Leicester City,Wimbledon,2-1,2,1,1,1,3,1,H
1999-11-20,1999,Southampton,Tottenham Hotspur,0-1,0,1,1,1,1,-1,A
1999-11-20,1999,Sunderland,Liverpool,0-2,0,2,1,1,2,-2,A
1999-11-20,1999,Watford,Newcastle United,1-1,1,1,1,1,2,0,D
1999-11-21,1999,West Ham United,Sheffield Wednesday,4-3,4,3,1,1,7,1,H
1999-11-22,1999,Coventry City,Aston Villa,2-1,2,1,1,1,3,1,H
1999-11-27,1999,Coventry City,Leicester City,0-1,0,1,1,1,1,-1,A
1999-11-27,1999,Everton,Aston Villa,0-0,0,0,1,1,0,0,D
1999-11-27,1999,Middlesbrough,Wimbledon,0-0,0,0,1,1,0,0,D
1999-11-27,1999,Watford,Sunderland,2-3,2,3,1,1,5,-1,A
1999-11-27,1999,West Ham United,Liverpool,1-0,1,0,1,1,1,1,H
1999-11-28,1999,Arsenal,Derby County,2-1,2,1,1,1,3,1,H
1999-11-28,1999,Chelsea,Bradford City,1-0,1,0,1,1,1,1,H
1999-11-28,1999,Leeds United,Southampton,1-0,1,0,1,1,1,1,H
1999-11-28,1999,Newcastle United,Tottenham Hotspur,2-1,2,1,1,1,3,1,H
1999-12-04,1999,Aston Villa,Newcastle United,0-1,0,1,1,1,1,-1,A
1999-12-04,1999,Bradford City,Middlesbrough,1-1,1,1,1,1,2,0,D
1999-12-04,1999,Leicester City,Arsenal,0-3,0,3,1,1,3,-3,A
1999-12-04,1999,Manchester United,Everton,5-1,5,1,1,1,6,4,H
1999-12-04,1999,Southampton,Coventry City,0-0,0,0,1,1,0,0,D
1999-12-04,1999,Sunderland,Chelsea,4-1,4,1,1,1,5,3,H
1999-12-04,1999,Wimbledon,Watford,5-0,5,0,1,1,5,5,H
1999-12-05,1999,Derby County,Leeds United,0-1,0,1,1,1,1,-1,A
1999-12-05,1999,Liverpool,Sheffield Wednesday,4-1,4,1,1,1,5,3,H
1999-12-06,1999,Tottenham Hotspur,West Ham United,0-0,0,0,1,1,0,0,D
1999-12-18,1999,Arsenal,Wimbledon,1-1,1,1,1,1,2,0,D
1999-12-18,1999,Aston Villa,Sheffield Wednesday,2-1,2,1,1,1,3,1,H
1999-12-18,1999,Bradford City,Newcastle United,2-0,2,0,1,1,2,2,H
1999-12-18,1999,Leicester City,Derby County,0-1,0,1,1,1,1,-1,A
1999-12-18,1999,Liverpool,Coventry City,2-0,2,0,1,1,2,2,H
1999-12-18,1999,Middlesbrough,Tottenham Hotspur,2-1,2,1,1,1,3,1,H
1999-12-18,1999,Sunderland,Southampton,2-0,2,0,1,1,2,2,H
1999-12-18,1999,Watford,Everton,1-3,1,3,1,1,4,-2,A
1999-12-18,1999,West Ham United,Manchester United,2-4,2,4,1,1,6,-2,A
1999-12-19,1999,Chelsea,Leeds United,0-2,0,2,1,1,2,-2,A
1999-12-26,1999,Coventry City,Arsenal,3-2,3,2,1,1,5,1,H
1999-12-26,1999,Derby County,Aston Villa,0-2,0,2,1,1,2,-2,A
1999-12-26,1999,Everton,Sunderland,5-0,5,0,1,1,5,5,H
1999-12-26,1999,Leeds United,Leicester City,2-1,2,1,1,1,3,1,H
1999-12-26,1999,Manchester United,Bradford City,4-0,4,0,1,1,4,4,H
1999-12-26,1999,Newcastle United,Liverpool,2-2,2,2,1,1,4,0,D
1999-12-26,1999,Sheffield Wednesday,Middlesbrough,1-0,1,0,1,1,1,1,H
1999-12-26,1999,Southampton,Chelsea,1-2,1,2,1,1,3,-1,A
1999-12-26,1999,Tottenham Hotspur,Watford,4-0,4,0,1,1,4,4,H
1999-12-26,1999,Wimbledon,West Ham United,2-2,2,2,1,1,4,0,D
1999-12-28,1999,Arsenal,Leeds United,2-0,2,0,1,1,2,2,H
1999-12-28,1999,Bradford City,Everton,0-0,0,0,1,1,0,0,D
1999-12-28,1999,Leicester City,Newcastle United,1-2,1,2,1,1,3,-1,A
1999-12-28,1999,Liverpool,Wimbledon,3-1,3,1,1,1,4,2,H
1999-12-28,1999,Sunderland,Manchester United,2-2,2,2,1,1,4,0,D
1999-12-28,1999,Watford,Southampton,3-2,3,2,1,1,5,1,H
1999-12-28,1999,West Ham United,Derby County,1-1,1,1,1,1,2,0,D
1999-12-29,1999,Aston Villa,Tottenham Hotspur,1-1,1,1,1,1,2,0,D
1999-12-29,1999,Chelsea,Sheffield Wednesday,3-0,3,0,1,1,3,3,H
2000-01-03,1999,Derby County,Watford,2-0,2,0,1,1,2,2,H
2000-01-03,1999,Everton,Leicester City,2-2,2,2,1,1,4,0,D
2000-01-03,1999,Leeds United,Aston Villa,1-2,1,2,1,1,3,-1,A
2000-01-03,1999,Newcastle United,West Ham United,2-2,2,2,1,1,4,0,D
2000-01-03,1999,Sheffield Wednesday,Arsenal,1-1,1,1,1,1,2,0,D
2000-01-03,1999,Southampton,Bradford City,1-0,1,0,1,1,1,1,H
2000-01-03,1999,Tottenham Hotspur,Liverpool,1-0,1,0,1,1,1,1,H
2000-01-03,1999,Wimbledon,Sunderland,1-0,1,0,1,1,1,1,H
2000-01-04,1999,Coventry City,Chelsea,2-2,2,2,1,1,4,0,D
2000-01-08,1999,Bradford City,Chelsea,1-1,1,1,1,1,2,0,D
2000-01-12,1999,Chelsea,Tottenham Hotspur,1-0,1,0,1,1,1,1,H
2000-01-15,1999,Arsenal,Sunderland,4-1,4,1,1,1,5,3,H
2000-01-15,1999,Chelsea,Leicester City,1-1,1,1,1,1,2,0,D
2000-01-15,1999,Coventry City,Wimbledon,2-0,2,0,1,1,2,2,H
2000-01-15,1999,Everton,Tottenham Hotspur,2-2,2,2,1,1,4,0,D
2000-01-15,1999,Middlesbrough,Derby County,1-4,1,4,1,1,5,-3,A
2000-01-15,1999,Sheffield Wednesday,Bradford City,2-0,2,0,1,1,2,2,H
2000-01-15,1999,Watford,Liverpool,2-3,2,3,1,1,5,-1,A
2000-01-15,1999,West Ham United,Aston Villa,1-1,1,1,1,1,2,0,D
2000-01-16,1999,Newcastle United,Southampton,5-0,5,0,1,1,5,5,H
2000-01-22,1999,Aston Villa,Chelsea,0-0,0,0,1,1,0,0,D
2000-01-22,1999,Bradford City,Watford,3-2,3,2,1,1,5,1,H
2000-01-22,1999,Derby County,Coventry City,0-0,0,0,1,1,0,0,D
2000-01-22,1999,Leicester City,West Ham United,1-3,1,3,1,1,4,-2,A
2000-01-22,1999,Liverpool,Middlesbrough,0-0,0,0,1,1,0,0,D
2000-01-22,1999,Southampton,Everton,2-0,2,0,1,1,2,2,H
2000-01-22,1999,Tottenham Hotspur,Sheffield Wednesday,0-1,0,1,1,1,1,-1,A
2000-01-22,1999,Wimbledon,Newcastle United,2-0,2,0,1,1,2,2,H
2000-01-23,1999,Sunderland,Leeds United,1-2,1,2,1,1,3,-1,A
2000-01-24,1999,Manchester United,Arsenal,1-1,1,1,1,1,2,0,D
2000-01-29,1999,Manchester United,Middlesbrough,1-0,1,0,1,1,1,1,H
2000-02-02,1999,Sheffield Wednesday,Manchester United,0-1,0,1,1,1,1,-1,A
2000-02-05,1999,Aston Villa,Watford,4-0,4,0,1,1,4,4,H
2000-02-05,1999,Bradford City,Arsenal,2-1,2,1,1,1,3,1,H
2000-02-05,1999,Derby County,Sheffield Wednesday,3-3,3,3,1,1,6,0,D
2000-02-05,1999,Leicester City,Middlesbrough,2-1,2,1,1,1,3,1,H
2000-02-05,1999,Liverpool,Leeds United,3-1,3,1,1,1,4,2,H
2000-02-05,1999,Manchester United,Coventry City,3-2,3,2,1,1,5,1,H
2000-02-05,1999,Southampton,West Ham United,2-1,2,1,1,1,3,1,H
2000-02-05,1999,Sunderland,Newcastle United,2-2,2,2,1,1,4,0,D
2000-02-05,1999,Tottenham Hotspur,Chelsea,0-1,0,1,1,1,1,-1,A
2000-02-06,1999,Wimbledon,Everton,0-3,0,3,1,1,3,-3,A
2000-02-12,1999,Chelsea,Wimbledon,3-1,3,1,1,1,4,2,H
2000-02-12,1999,Coventry City,Sunderland,3-2,3,2,1,1,5,1,H
2000-02-12,1999,Everton,Derby County,2-1,2,1,1,1,3,1,H
2000-02-12,1999,Leeds United,Tottenham Hotspur,1-0,1,0,1,1,1,1,H
2000-02-12,1999,Newcastle United,Manchester United,3-0,3,0,1,1,3,3,H
2000-02-12,1999,Sheffield Wednesday,Southampton,0-1,0,1,1,1,1,-1,A
2000-02-12,1999,Watford,Leicester City,1-1,1,1,1,1,2,0,D
2000-02-12,1999,West Ham United,Bradford City,5-4,5,4,1,1,9,1,H
2000-02-13,1999,Arsenal,Liverpool,0-1,0,1,1,1,1,-1,A
2000-02-14,1999,Middlesbrough,Aston Villa,0-4,0,4,1,1,4,-4,A
2000-02-19,1999,Middlesbrough,Coventry City,2-0,2,0,1,1,2,2,H
2000-02-20,1999,Leeds United,Manchester United,0-1,0,1,1,1,1,-1,A
2000-02-26,1999,Arsenal,Southampton,3-1,3,1,1,1,4,2,H
2000-02-26,1999,Bradford City,Aston Villa,1-1,1,1,1,1,2,0,D
2000-02-26,1999,Chelsea,Watford,2-1,2,1,1,1,3,1,H
2000-02-26,1999,Coventry City,Tottenham Hotspur,0-1,0,1,1,1,1,-1,A
2000-02-26,1999,Middlesbrough,Leeds United,0-0,0,0,1,1,0,0,D
2000-02-26,1999,Sheffield Wednesday,Newcastle United,0-2,0,2,1,1,2,-2,A
2000-02-26,1999,Sunderland,Derby County,1-1,1,1,1,1,2,0,D
2000-02-26,1999,West Ham United,Everton,0-4,0,4,1,1,4,-4,A
2000-02-26,1999,Wimbledon,Manchester United,2-2,2,2,1,1,4,0,D
2000-03-04,1999,Derby County,Wimbledon,4-0,4,0,1,1,4,4,H
2000-03-04,1999,Everton,Sheffield Wednesday,1-1,1,1,1,1,2,0,D
2000-03-04,1999,Manchester United,Liverpool,1-1,1,1,1,1,2,0,D
2000-03-04,1999,Newcastle United,Chelsea,0-1,0,1,1,1,1,-1,A
2000-03-04,1999,Southampton,Middlesbrough,1-1,1,1,1,1,2,0,D
2000-03-04,1999,Tottenham Hotspur,Bradford City,1-1,1,1,1,1,2,0,D
2000-03-04,1999,Watford,West Ham United,1-2,1,2,1,1,3,-1,A
2000-03-05,1999,Aston Villa,Arsenal,1-1,1,1,1,1,2,0,D
2000-03-05,1999,Leeds United,Coventry City,3-0,3,0,1,1,3,3,H
2000-03-05,1999,Leicester City,Sunderland,5-2,5,2,1,1,7,3,H
2000-03-08,1999,West Ham United,Southampton,2-0,2,0,1,1,2,2,H
2000-03-11,1999,Aston Villa,Coventry City,1-0,1,0,1,1,1,1,H
2000-03-11,1999,Chelsea,Everton,1-1,1,1,1,1,2,0,D
2000-03-11,1999,Liverpool,Sunderland,1-1,1,1,1,1,2,0,D
2000-03-11,1999,Manchester United,Derby County,3-1,3,1,1,1,4,2,H
2000-03-11,1999,Newcastle United,Watford,1-0,1,0,1,1,1,1,H
2000-03-11,1999,Sheffield Wednesday,West Ham United,3-1,3,1,1,1,4,2,H
2000-03-11,1999,Tottenham Hotspur,Southampton,7-2,7,2,1,1,9,5,H
2000-03-11,1999,Wimbledon,Leicester City,2-1,2,1,1,1,3,1,H
2000-03-12,1999,Bradford City,Leeds United,1-2,1,2,1,1,3,-1,A
2000-03-12,1999,Middlesbrough,Arsenal,2-1,2,1,1,1,3,1,H
2000-03-15,1999,Coventry City,Everton,1-0,1,0,1,1,1,1,H
2000-03-15,1999,Liverpool,Aston Villa,0-0,0,0,1,1,0,0,D
2000-03-18,1999,Coventry City,Bradford City,4-0,4,0,1,1,4,4,H
2000-03-18,1999,Derby County,Liverpool,0-2,0,2,1,1,2,-2,A
2000-03-18,1999,Leicester City,Manchester United,0-2,0,2,1,1,2,-2,A
2000-03-18,1999,Southampton,Aston Villa,2-0,2,0,1,1,2,2,H
2000-03-18,1999,Sunderland,Middlesbrough,1-1,1,1,1,1,2,0,D
2000-03-18,1999,Watford,Sheffield Wednesday,1-0,1,0,1,1,1,1,H
2000-03-18,1999,West Ham United,Chelsea,0-0,0,0,1,1,0,0,D
2000-03-19,1999,Arsenal,Tottenham Hotspur,2-1,2,1,1,1,3,1,H
2000-03-19,1999,Everton,Newcastle United,0-2,0,2,1,1,2,-2,A
2000-03-19,1999,Leeds United,Wimbledon,4-1,4,1,1,1,5,3,H
2000-03-25,1999,Aston Villa,Derby County,2-0,2,0,1,1,2,2,H
2000-03-25,1999,Bradford City,Manchester United,0-4,0,4,1,1,4,-4,A
2000-03-25,1999,Chelsea,Southampton,1-1,1,1,1,1,2,0,D
2000-03-25,1999,Liverpool,Newcastle United,2-1,2,1,1,1,3,1,H
2000-03-25,1999,Middlesbrough,Sheffield Wednesday,1-0,1,0,1,1,1,1,H
2000-03-25,1999,Sunderland,Everton,2-1,2,1,1,1,3,1,H
2000-03-25,1999,Watford,Tottenham Hotspur,1-1,1,1,1,1,2,0,D
2000-03-26,1999,Arsenal,Coventry City,3-0,3,0,1,1,3,3,H
2000-03-26,1999,Leicester City,Leeds United,2-1,2,1,1,1,3,1,H
2000-03-26,1999,West Ham United,Wimbledon,2-1,2,1,1,1,3,1,H
2000-04-01,1999,Coventry City,Liverpool,0-3,0,3,1,1,3,-3,A
2000-04-01,1999,Everton,Watford,4-2,4,2,1,1,6,2,H
2000-04-01,1999,Leeds United,Chelsea,0-1,0,1,1,1,1,-1,A
2000-04-01,1999,Manchester United,West Ham United,7-1,7,1,1,1,8,6,H
2000-04-01,1999,Newcastle United,Bradford City,2-0,2,0,1,1,2,2,H
2000-04-01,1999,Southampton,Sunderland,1-2,1,2,1,1,3,-1,A
2000-04-01,1999,Wimbledon,Arsenal,1-3,1,3,1,1,4,-2,A
2000-04-02,1999,Derby County,Leicester City,3-0,3,0,1,1,3,3,H
2000-04-03,1999,Tottenham Hotspur,Middlesbrough,2-3,2,3,1,1,5,-1,A
2000-04-05,1999,Sheffield Wednesday,Aston Villa,0-1,0,1,1,1,1,-1,A
2000-04-08,1999,Bradford City,Southampton,1-2,1,2,1,1,3,-1,A
2000-04-08,1999,Leicester City,Everton,1-1,1,1,1,1,2,0,D
2000-04-08,1999,Sunderland,Wimbledon,2-1,2,1,1,1,3,1,H
2000-04-08,1999,Watford,Derby County,0-0,0,0,1,1,0,0,D
2000-04-09,1999,Aston Villa,Leeds United,1-0,1,0,1,1,1,1,H
2000-04-09,1999,Liverpool,Tottenham Hotspur,2-0,2,0,1,1,2,2,H
2000-04-10,1999,Middlesbrough,Manchester United,3-4,3,4,1,1,7,-1,A
2000-04-12,1999,Chelsea,Coventry City,2-1,2,1,1,1,3,1,H
2000-04-12,1999,West Ham United,Newcastle United,2-1,2,1,1,1,3,1,H
2000-04-12,1999,Wimbledon,Sheffield Wednesday,0-2,0,2,1,1,2,-2,A
2000-04-15,1999,Coventry City,Middlesbrough,2-1,2,1,1,1,3,1,H
2000-04-15,1999,Derby County,West Ham United,1-2,1,2,1,1,3,-1,A
2000-04-15,1999,Everton,Bradford City,4-0,4,0,1,1,4,4,H
2000-04-15,1999,Manchester United,Sunderland,4-0,4,0,1,1,4,4,H
2000-04-15,1999,Newcastle United,Leicester City,0-2,0,2,1,1,2,-2,A
2000-04-15,1999,Sheffield Wednesday,Chelsea,1-0,1,0,1,1,1,1,H
2000-04-15,1999,Southampton,Watford,2-0,2,0,1,1,2,2,H
2000-04-15,1999,Tottenham Hotspur,Aston Villa,2-4,2,4,1,1,6,-2,A
2000-04-16,1999,Leeds United,Arsenal,0-4,0,4,1,1,4,-4,A
2000-04-16,1999,Wimbledon,Liverpool,1-2,1,2,1,1,3,-1,A
2000-04-19,1999,Leicester City,Tottenham Hotspur,0-1,0,1,1,1,1,-1,A
2000-04-21,1999,Bradford City,Derby County,4-4,4,4,1,1,8,0,D
2000-04-21,1999,Everton,Liverpool,0-0,0,0,1,1,0,0,D
2000-04-22,1999,Aston Villa,Leicester City,2-2,2,2,1,1,4,0,D
2000-04-22,1999,Chelsea,Middlesbrough,1-1,1,1,1,1,2,0,D
2000-04-22,1999,Sheffield Wednesday,Sunderland,0-2,0,2,1,1,2,-2,A
2000-04-22,1999,Southampton,Manchester United,1-3,1,3,1,1,4,-2,A
2000-04-22,1999,Tottenham Hotspur,Wimbledon,2-0,2,0,1,1,2,2,H
2000-04-22,1999,West Ham United,Coventry City,5-0,5,0,1,1,5,5,H
2000-04-23,1999,Newcastle United,Leeds United,2-2,2,2,1,1,4,0,D
2000-04-23,1999,Watford,Arsenal,2-3,2,3,1,1,5,-1,A
2000-04-24,1999,Derby County,Southampton,2-0,2,0,1,1,2,2,H
2000-04-24,1999,Manchester United,Chelsea,3-2,3,2,1,1,5,1,H
2000-04-24,1999,Sunderland,Bradford City,0-1,0,1,1,1,1,-1,A
2000-04-29,1999,Aston Villa,Sunderland,1-1,1,1,1,1,2,0,D
2000-04-29,1999,Chelsea,Liverpool,2-0,2,0,1,1,2,2,H
2000-04-29,1999,Everton,Arsenal,0-1,0,1,1,1,1,-1,A
2000-04-29,1999,Newcastle United,Coventry City,2-0,2,0,1,1,2,2,H
2000-04-29,1999,Southampton,Leicester City,1-2,1,2,1,1,3,-1,A
2000-04-29,1999,Tottenham Hotspur,Derby County,1-1,1,1,1,1,2,0,D
2000-04-29,1999,Watford,Manchester United,2-3,2,3,1,1,5,-1,A
2000-04-29,1999,West Ham United,Middlesbrough,0-1,0,1,1,1,1,-1,A
2000-04-30,1999,Bradford City,Wimbledon,3-0,3,0,1,1,3,3,H
2000-04-30,1999,Sheffield Wednesday,Leeds United,0-3,0,3,1,1,3,-3,A
2000-05-02,1999,Arsenal,West Ham United,2-1,2,1,1,1,3,1,H
2000-05-02,1999,Middlesbrough,Newcastle United,2-2,2,2,1,1,4,0,D
2000-05-03,1999,Leeds United,Watford,3-1,3,1,1,1,4,2,H
2000-05-03,1999,Liverpool,Leicester City,0-2,0,2,1,1,2,-2,A
2000-05-06,1999,Arsenal,Chelsea,2-1,2,1,1,1,3,1,H
2000-05-06,1999,Coventry City,Sheffield Wednesday,4-1,4,1,1,1,5,3,H
2000-05-06,1999,Derby County,Newcastle United,0-0,0,0,1,1,0,0,D
2000-05-06,1999,Leicester City,Bradford City,3-0,3,0,1,1,3,3,H
2000-05-06,1999,Manchester United,Tottenham Hotspur,3-1,3,1,1,1,4,2,H
2000-05-06,1999,Middlesbrough,Watford,1-1,1,1,1,1,2,0,D
2000-05-06,1999,Sunderland,West Ham United,1-0,1,0,1,1,1,1,H
2000-05-06,1999,Wimbledon,Aston Villa,2-2,2,2,1,1,4,0,D
2000-05-07,1999,Liverpool,Southampton,0-0,0,0,1,1,0,0,D
2000-05-08,1999,Leeds United,Everton,1-1,1,1,1,1,2,0,D
2000-05-09,1999,Arsenal,Sheffield Wednesday,3-3,3,3,1,1,6,0,D
2000-05-14,1999,Aston Villa,Manchester United,0-1,0,1,1,1,1,-1,A
2000-05-14,1999,Bradford City,Liverpool,1-0,1,0,1,1,1,1,H
2000-05-14,1999,Chelsea,Derby County,4-0,4,0,1,1,4,4,H
2000-05-14,1999,Everton,Middlesbrough,0-2,0,2,1,1,2,-2,A
2000-05-14,1999,Newcastle United,Arsenal,4-2,4,2,1,1,6,2,H
2000-05-14,1999,Sheffield Wednesday,Leicester City,4-0,4,0,1,1,4,4,H
2000-05-14,1999,Southampton,Wimbledon,2-0,2,0,1,1,2,2,H
2000-05-14,1999,Tottenham Hotspur,Sunderland,3-1,3,1,1,1,4,2,H
2000-05-14,1999,Watford,Coventry City,1-0,1,0,1,1,1,1,H
2000-05-14,1999,West Ham United,Leeds United,0-0,0,0,1,1,0,0,D
2000-08-19,2000,Charlton Athletic,Manchester City,4-0,4,0,1,1,4,4,H
2000-08-19,2000,Chelsea,West Ham United,4-2,4,2,1,1,6,2,H
2000-08-19,2000,Coventry City,Middlesbrough,1-3,1,3,1,1,4,-2,A
2000-08-19,2000,Derby County,Southampton,2-2,2,2,1,1,4,0,D
2000-08-19,2000,Leeds United,Everton,2-0,2,0,1,1,2,2,H
2000-08-19,2000,Leicester City,Aston Villa,0-0,0,0,1,1,0,0,D
2000-08-19,2000,Liverpool,Bradford City,1-0,1,0,1,1,1,1,H
2000-08-19,2000,Sunderland,Arsenal,1-0,1,0,1,1,1,1,H
2000-08-19,2000,Tottenham Hotspur,Ipswich Town,3-1,3,1,1,1,4,2,H
2000-08-20,2000,Manchester United,Newcastle United,2-0,2,0,1,1,2,2,H
2000-08-21,2000,Arsenal,Liverpool,2-0,2,0,1,1,2,2,H
2000-08-22,2000,Bradford City,Chelsea,2-0,2,0,1,1,2,2,H
2000-08-22,2000,Ipswich Town,Manchester United,1-1,1,1,1,1,2,0,D
2000-08-22,2000,Middlesbrough,Tottenham Hotspur,1-1,1,1,1,1,2,0,D
2000-08-23,2000,Everton,Charlton Athletic,3-0,3,0,1,1,3,3,H
2000-08-23,2000,Manchester City,Sunderland,4-2,4,2,1,1,6,2,H
2000-08-23,2000,Newcastle United,Derby County,3-2,3,2,1,1,5,1,H
2000-08-23,2000,Southampton,Coventry City,1-2,1,2,1,1,3,-1,A
2000-08-23,2000,West Ham United,Leicester City,0-1,0,1,1,1,1,-1,A
2000-08-26,2000,Arsenal,Charlton Athletic,5-3,5,3,1,1,8,2,H
2000-08-26,2000,Bradford City,Leicester City,0-0,0,0,1,1,0,0,D
2000-08-26,2000,Everton,Derby County,2-2,2,2,1,1,4,0,D
2000-08-26,2000,Ipswich Town,Sunderland,1-0,1,0,1,1,1,1,H
2000-08-26,2000,Manchester City,Coventry City,1-2,1,2,1,1,3,-1,A
2000-08-26,2000,Middlesbrough,Leeds United,1-2,1,2,1,1,3,-1,A
2000-08-26,2000,Newcastle United,Tottenham Hotspur,2-0,2,0,1,1,2,2,H
2000-08-26,2000,Southampton,Liverpool,3-3,3,3,1,1,6,0,D
2000-08-26,2000,West Ham United,Manchester United,2-2,2,2,1,1,4,0,D
2000-08-27,2000,Aston Villa,Chelsea,1-1,1,1,1,1,2,0,D
2000-09-05,2000,Leeds United,Manchester City,1-2,1,2,1,1,3,-1,A
2000-09-05,2000,Manchester United,Bradford City,6-0,6,0,1,1,6,6,H
2000-09-05,2000,Sunderland,West Ham United,1-1,1,1,1,1,2,0,D
2000-09-05,2000,Tottenham Hotspur,Everton,3-2,3,2,1,1,5,1,H
2000-09-06,2000,Charlton Athletic,Southampton,1-1,1,1,1,1,2,0,D
2000-09-06,2000,Chelsea,Arsenal,2-2,2,2,1,1,4,0,D
2000-09-06,2000,Coventry City,Newcastle United,0-2,0,2,1,1,2,-2,A
2000-09-06,2000,Derby County,Middlesbrough,3-3,3,3,1,1,6,0,D
2000-09-06,2000,Leicester City,Ipswich Town,2-1,2,1,1,1,3,1,H
2000-09-06,2000,Liverpool,Aston Villa,3-1,3,1,1,1,4,2,H
2000-09-09,2000,Bradford City,Arsenal,1-1,1,1,1,1,2,0,D
2000-09-09,2000,Coventry City,Leeds United,0-0,0,0,1,1,0,0,D
2000-09-09,2000,Ipswich Town,Aston Villa,1-2,1,2,1,1,3,-1,A
2000-09-09,2000,Leicester City,Southampton,1-0,1,0,1,1,1,1,H
2000-09-09,2000,Liverpool,Manchester City,3-2,3,2,1,1,5,1,H
2000-09-09,2000,Manchester United,Sunderland,3-0,3,0,1,1,3,3,H
2000-09-09,2000,Middlesbrough,Everton,1-2,1,2,1,1,3,-1,A
2000-09-09,2000,Newcastle United,Chelsea,0-0,0,0,1,1,0,0,D
2000-09-10,2000,Derby County,Charlton Athletic,2-2,2,2,1,1,4,0,D
2000-09-11,2000,Tottenham Hotspur,West Ham United,1-0,1,0,1,1,1,1,H
2000-09-16,2000,Arsenal,Coventry City,2-1,2,1,1,1,3,1,H
2000-09-16,2000,Aston Villa,Bradford City,2-0,2,0,1,1,2,2,H
2000-09-16,2000,Charlton Athletic,Tottenham Hotspur,1-0,1,0,1,1,1,1,H
2000-09-16,2000,Everton,Manchester United,1-3,1,3,1,1,4,-2,A
2000-09-16,2000,Leeds United,Ipswich Town,1-2,1,2,1,1,3,-1,A
2000-09-16,2000,Southampton,Newcastle United,2-0,2,0,1,1,2,2,H
2000-09-16,2000,Sunderland,Derby County,2-1,2,1,1,1,3,1,H
2000-09-17,2000,Chelsea,Leicester City,0-2,0,2,1,1,2,-2,A
2000-09-17,2000,Manchester City,Middlesbrough,1-1,1,1,1,1,2,0,D
2000-09-17,2000,West Ham United,Liverpool,1-1,1,1,1,1,2,0,D
2000-09-23,2000,Bradford City,Southampton,0-1,0,1,1,1,1,-1,A
2000-09-23,2000,Coventry City,West Ham United,0-3,0,3,1,1,3,-3,A
2000-09-23,2000,Derby County,Leeds United,1-1,1,1,1,1,2,0,D
2000-09-23,2000,Ipswich Town,Arsenal,1-1,1,1,1,1,2,0,D
2000-09-23,2000,Liverpool,Sunderland,1-1,1,1,1,1,2,0,D
2000-09-23,2000,Manchester United,Chelsea,3-3,3,3,1,1,6,0,D
2000-09-23,2000,Middlesbrough,Aston Villa,1-1,1,1,1,1,2,0,D
2000-09-23,2000,Newcastle United,Charlton Athletic,0-1,0,1,1,1,1,-1,A
2000-09-23,2000,Tottenham Hotspur,Manchester City,0-0,0,0,1,1,0,0,D
2000-09-24,2000,Leicester City,Everton,1-1,1,1,1,1,2,0,D
2000-09-30,2000,Aston Villa,Derby County,4-1,4,1,1,1,5,3,H
2000-09-30,2000,Charlton Athletic,Coventry City,2-2,2,2,1,1,4,0,D
2000-09-30,2000,Everton,Ipswich Town,0-3,0,3,1,1,3,-3,A
2000-09-30,2000,Leeds United,Tottenham Hotspur,4-3,4,3,1,1,7,1,H
2000-09-30,2000,Manchester City,Newcastle United,0-1,0,1,1,1,1,-1,A
2000-09-30,2000,Southampton,Middlesbrough,1-3,1,3,1,1,4,-2,A
2000-09-30,2000,West Ham United,Bradford City,1-1,1,1,1,1,2,0,D
2000-10-01,2000,Arsenal,Manchester United,1-0,1,0,1,1,1,1,H
2000-10-01,2000,Chelsea,Liverpool,3-0,3,0,1,1,3,3,H
2000-10-01,2000,Sunderland,Leicester City,0-0,0,0,1,1,0,0,D
2000-10-14,2000,Arsenal,Aston Villa,1-0,1,0,1,1,1,1,H
2000-10-14,2000,Coventry City,Tottenham Hotspur,2-1,2,1,1,1,3,1,H
2000-10-14,2000,Everton,Southampton,1-1,1,1,1,1,2,0,D
2000-10-14,2000,Ipswich Town,West Ham United,1-1,1,1,1,1,2,0,D
2000-10-14,2000,Leeds United,Charlton Athletic,3-1,3,1,1,1,4,2,H
2000-10-14,2000,Leicester City,Manchester United,0-3,0,3,1,1,3,-3,A
2000-10-14,2000,Manchester City,Bradford City,2-0,2,0,1,1,2,2,H
2000-10-14,2000,Sunderland,Chelsea,1-0,1,0,1,1,1,1,H
2000-10-15,2000,Derby County,Liverpool,0-4,0,4,1,1,4,-4,A
2000-10-16,2000,Middlesbrough,Newcastle United,1-3,1,3,1,1,4,-2,A
2000-10-21,2000,Bradford City,Ipswich Town,0-2,0,2,1,1,2,-2,A
2000-10-21,2000,Charlton Athletic,Middlesbrough,1-0,1,0,1,1,1,1,H
2000-10-21,2000,Chelsea,Coventry City,6-1,6,1,1,1,7,5,H
2000-10-21,2000,Liverpool,Leicester City,1-0,1,0,1,1,1,1,H
2000-10-21,2000,Manchester United,Leeds United,3-0,3,0,1,1,3,3,H
2000-10-21,2000,Newcastle United,Everton,0-1,0,1,1,1,1,-1,A
2000-10-21,2000,Tottenham Hotspur,Derby County,3-1,3,1,1,1,4,2,H
2000-10-21,2000,West Ham United,Arsenal,1-2,1,2,1,1,3,-1,A
2000-10-22,2000,Aston Villa,Sunderland,0-0,0,0,1,1,0,0,D
2000-10-23,2000,Southampton,Manchester City,0-2,0,2,1,1,2,-2,A
2000-10-28,2000,Arsenal,Manchester City,5-0,5,0,1,1,5,5,H
2000-10-28,2000,Aston Villa,Charlton Athletic,2-1,2,1,1,1,3,1,H
2000-10-28,2000,Chelsea,Tottenham Hotspur,3-0,3,0,1,1,3,3,H
2000-10-28,2000,Ipswich Town,Middlesbrough,2-1,2,1,1,1,3,1,H
2000-10-28,2000,Leicester City,Derby County,2-1,2,1,1,1,3,1,H
2000-10-28,2000,Manchester United,Southampton,5-0,5,0,1,1,5,5,H
2000-10-28,2000,Sunderland,Coventry City,1-0,1,0,1,1,1,1,H
2000-10-28,2000,West Ham United,Newcastle United,1-0,1,0,1,1,1,1,H
2000-10-29,2000,Bradford City,Leeds United,1-1,1,1,1,1,2,0,D
2000-10-29,2000,Liverpool,Everton,3-1,3,1,1,1,4,2,H
2000-11-04,2000,Charlton Athletic,Bradford City,2-0,2,0,1,1,2,2,H
2000-11-04,2000,Coventry City,Manchester United,1-2,1,2,1,1,3,-1,A
2000-11-04,2000,Leeds United,Liverpool,4-3,4,3,1,1,7,1,H
2000-11-04,2000,Manchester City,Leicester City,0-1,0,1,1,1,1,-1,A
2000-11-04,2000,Middlesbrough,Arsenal,0-1,0,1,1,1,1,-1,A
2000-11-04,2000,Newcastle United,Ipswich Town,2-1,2,1,1,1,3,1,H
2000-11-04,2000,Southampton,Chelsea,3-2,3,2,1,1,5,1,H
2000-11-04,2000,Tottenham Hotspur,Sunderland,2-1,2,1,1,1,3,1,H
2000-11-05,2000,Everton,Aston Villa,0-1,0,1,1,1,1,-1,A
2000-11-06,2000,Derby County,West Ham United,0-0,0,0,1,1,0,0,D
2000-11-11,2000,Arsenal,Derby County,0-0,0,0,1,1,0,0,D
2000-11-11,2000,Aston Villa,Tottenham Hotspur,2-0,2,0,1,1,2,2,H
2000-11-11,2000,Bradford City,Everton,0-1,0,1,1,1,1,-1,A
2000-11-11,2000,Ipswich Town,Charlton Athletic,2-0,2,0,1,1,2,2,H
2000-11-11,2000,Leicester City,Newcastle United,1-1,1,1,1,1,2,0,D
2000-11-11,2000,Manchester United,Middlesbrough,2-1,2,1,1,1,3,1,H
2000-11-11,2000,Sunderland,Southampton,2-2,2,2,1,1,4,0,D
2000-11-11,2000,West Ham United,Manchester City,4-1,4,1,1,1,5,3,H
2000-11-12,2000,Chelsea,Leeds United,1-1,1,1,1,1,2,0,D
2000-11-12,2000,Liverpool,Coventry City,4-1,4,1,1,1,5,3,H
2000-11-18,2000,Charlton Athletic,Chelsea,2-0,2,0,1,1,2,2,H
2000-11-18,2000,Derby County,Bradford City,2-0,2,0,1,1,2,2,H
2000-11-18,2000,Everton,Arsenal,2-0,2,0,1,1,2,2,H
2000-11-18,2000,Leeds United,West Ham United,0-1,0,1,1,1,1,-1,A
2000-11-18,2000,Manchester City,Manchester United,0-1,0,1,1,1,1,-1,A
2000-11-18,2000,Middlesbrough,Leicester City,0-3,0,3,1,1,3,-3,A
2000-11-18,2000,Newcastle United,Sunderland,1-2,1,2,1,1,3,-1,A
2000-11-18,2000,Southampton,Aston Villa,2-0,2,0,1,1,2,2,H
2000-11-19,2000,Tottenham Hotspur,Liverpool,2-1,2,1,1,1,3,1,H
2000-11-20,2000,Coventry City,Ipswich Town,0-1,0,1,1,1,1,-1,A
2000-11-25,2000,Charlton Athletic,Sunderland,0-1,0,1,1,1,1,-1,A
2000-11-25,2000,Coventry City,Aston Villa,1-1,1,1,1,1,2,0,D
2000-11-25,2000,Derby County,Manchester United,0-3,0,3,1,1,3,-3,A
2000-11-25,2000,Everton,Chelsea,2-1,2,1,1,1,3,1,H
2000-11-25,2000,Manchester City,Ipswich Town,2-3,2,3,1,1,5,-1,A
2000-11-25,2000,Middlesbrough,Bradford City,2-2,2,2,1,1,4,0,D
2000-11-25,2000,Southampton,West Ham United,2-3,2,3,1,1,5,-1,A
2000-11-25,2000,Tottenham Hotspur,Leicester City,3-0,3,0,1,1,3,3,H
2000-11-26,2000,Leeds United,Arsenal,1-0,1,0,1,1,1,1,H
2000-11-26,2000,Newcastle United,Liverpool,2-1,2,1,1,1,3,1,H
2000-12-02,2000,Arsenal,Southampton,1-0,1,0,1,1,1,1,H
2000-12-02,2000,Aston Villa,Newcastle United,1-1,1,1,1,1,2,0,D
2000-12-02,2000,Bradford City,Coventry City,2-1,2,1,1,1,3,1,H
2000-12-02,2000,Ipswich Town,Derby County,0-1,0,1,1,1,1,-1,A
2000-12-02,2000,Leicester City,Leeds United,3-1,3,1,1,1,4,2,H
2000-12-02,2000,Liverpool,Charlton Athletic,3-0,3,0,1,1,3,3,H
2000-12-02,2000,Manchester United,Tottenham Hotspur,2-0,2,0,1,1,2,2,H
2000-12-02,2000,West Ham United,Middlesbrough,1-0,1,0,1,1,1,1,H
2000-12-03,2000,Chelsea,Manchester City,2-1,2,1,1,1,3,1,H
2000-12-04,2000,Sunderland,Everton,2-0,2,0,1,1,2,2,H
2000-12-09,2000,Arsenal,Newcastle United,5-0,5,0,1,1,5,5,H
2000-12-09,2000,Bradford City,Tottenham Hotspur,3-3,3,3,1,1,6,0,D
2000-12-09,2000,Charlton Athletic,Manchester United,3-3,3,3,1,1,6,0,D
2000-12-09,2000,Chelsea,Derby County,4-1,4,1,1,1,5,3,H
2000-12-09,2000,Manchester City,Everton,5-0,5,0,1,1,5,5,H
2000-12-09,2000,Southampton,Leeds United,1-0,1,0,1,1,1,1,H
2000-12-09,2000,Sunderland,Middlesbrough,1-0,1,0,1,1,1,1,H
2000-12-09,2000,West Ham United,Aston Villa,1-1,1,1,1,1,2,0,D
2000-12-10,2000,Coventry City,Leicester City,1-0,1,0,1,1,1,1,H
2000-12-10,2000,Liverpool,Ipswich Town,0-1,0,1,1,1,1,-1,A
2000-12-16,2000,Aston Villa,Manchester City,2-2,2,2,1,1,4,0,D
2000-12-16,2000,Derby County,Coventry City,1-0,1,0,1,1,1,1,H
2000-12-16,2000,Everton,West Ham United,1-1,1,1,1,1,2,0,D
2000-12-16,2000,Ipswich Town,Southampton,3-1,3,1,1,1,4,2,H
2000-12-16,2000,Leeds United,Sunderland,2-0,2,0,1,1,2,2,H
2000-12-16,2000,Leicester City,Charlton Athletic,3-1,3,1,1,1,4,2,H
2000-12-16,2000,Middlesbrough,Chelsea,1-0,1,0,1,1,1,1,H
2000-12-16,2000,Newcastle United,Bradford City,2-1,2,1,1,1,3,1,H
2000-12-17,2000,Manchester United,Liverpool,0-1,0,1,1,1,1,-1,A
2000-12-18,2000,Tottenham Hotspur,Arsenal,1-1,1,1,1,1,2,0,D
2000-12-22,2000,Coventry City,Southampton,1-1,1,1,1,1,2,0,D
2000-12-23,2000,Charlton Athletic,Everton,1-0,1,0,1,1,1,1,H
2000-12-23,2000,Chelsea,Bradford City,3-0,3,0,1,1,3,3,H
2000-12-23,2000,Derby County,Newcastle United,2-0,2,0,1,1,2,2,H
2000-12-23,2000,Leeds United,Aston Villa,1-2,1,2,1,1,3,-1,A
2000-12-23,2000,Leicester City,West Ham United,2-1,2,1,1,1,3,1,H
2000-12-23,2000,Liverpool,Arsenal,4-0,4,0,1,1,4,4,H
2000-12-23,2000,Manchester United,Ipswich Town,2-0,2,0,1,1,2,2,H
2000-12-23,2000,Sunderland,Manchester City,1-0,1,0,1,1,1,1,H
2000-12-23,2000,Tottenham Hotspur,Middlesbrough,0-0,0,0,1,1,0,0,D
2000-12-26,2000,Arsenal,Leicester City,6-1,6,1,1,1,7,5,H
2000-12-26,2000,Aston Villa,Manchester United,0-1,0,1,1,1,1,-1,A
2000-12-26,2000,Bradford City,Sunderland,1-4,1,4,1,1,5,-3,A
2000-12-26,2000,Everton,Coventry City,1-2,1,2,1,1,3,-1,A
2000-12-26,2000,Ipswich Town,Chelsea,2-2,2,2,1,1,4,0,D
2000-12-26,2000,Manchester City,Derby County,0-0,0,0,1,1,0,0,D
2000-12-26,2000,Middlesbrough,Liverpool,1-0,1,0,1,1,1,1,H
2000-12-26,2000,Newcastle United,Leeds United,2-1,2,1,1,1,3,1,H
2000-12-26,2000,West Ham United,Charlton Athletic,5-0,5,0,1,1,5,5,H
2000-12-27,2000,Southampton,Tottenham Hotspur,2-0,2,0,1,1,2,2,H
2000-12-30,2000,Arsenal,Sunderland,2-2,2,2,1,1,4,0,D
2000-12-30,2000,Ipswich Town,Tottenham Hotspur,3-0,3,0,1,1,3,3,H
2000-12-30,2000,Manchester City,Charlton Athletic,1-4,1,4,1,1,5,-3,A
2000-12-30,2000,Middlesbrough,Coventry City,1-1,1,1,1,1,2,0,D
2000-12-30,2000,Newcastle United,Manchester United,1-1,1,1,1,1,2,0,D
2000-12-30,2000,Southampton,Derby County,1-0,1,0,1,1,1,1,H
2001-01-01,2000,Charlton Athletic,Arsenal,1-0,1,0,1,1,1,1,H
2001-01-01,2000,Chelsea,Aston Villa,1-0,1,0,1,1,1,1,H
2001-01-01,2000,Coventry City,Manchester City,1-1,1,1,1,1,2,0,D
2001-01-01,2000,Derby County,Everton,1-0,1,0,1,1,1,1,H
2001-01-01,2000,Leeds United,Middlesbrough,1-1,1,1,1,1,2,0,D
2001-01-01,2000,Leicester City,Bradford City,1-2,1,2,1,1,3,-1,A
2001-01-01,2000,Liverpool,Southampton,2-1,2,1,1,1,3,1,H
2001-01-01,2000,Manchester United,West Ham United,3-1,3,1,1,1,4,2,H
2001-01-01,2000,Sunderland,Ipswich Town,4-1,4,1,1,1,5,3,H
2001-01-02,2000,Tottenham Hotspur,Newcastle United,4-2,4,2,1,1,6,2,H
2001-01-13,2000,Arsenal,Chelsea,1-1,1,1,1,1,2,0,D
2001-01-13,2000,Aston Villa,Liverpool,0-3,0,3,1,1,3,-3,A
2001-01-13,2000,Bradford City,Manchester United,0-3,0,3,1,1,3,-3,A
2001-01-13,2000,Everton,Tottenham Hotspur,0-0,0,0,1,1,0,0,D
2001-01-13,2000,Manchester City,Leeds United,0-4,0,4,1,1,4,-4,A
2001-01-13,2000,Middlesbrough,Derby County,4-0,4,0,1,1,4,4,H
2001-01-13,2000,Newcastle United,Coventry City,3-1,3,1,1,1,4,2,H
2001-01-13,2000,Southampton,Charlton Athletic,0-0,0,0,1,1,0,0,D
2001-01-13,2000,West Ham United,Sunderland,0-2,0,2,1,1,2,-2,A
2001-01-14,2000,Ipswich Town,Leicester City,2-0,2,0,1,1,2,2,H
2001-01-20,2000,Chelsea,Ipswich Town,4-1,4,1,1,1,5,3,H
2001-01-20,2000,Coventry City,Everton,1-3,1,3,1,1,4,-2,A
2001-01-20,2000,Derby County,Manchester City,1-1,1,1,1,1,2,0,D
2001-01-20,2000,Leeds United,Newcastle United,1-3,1,3,1,1,4,-2,A
2001-01-20,2000,Leicester City,Arsenal,0-0,0,0,1,1,0,0,D
2001-01-20,2000,Liverpool,Middlesbrough,0-0,0,0,1,1,0,0,D
2001-01-20,2000,Manchester United,Aston Villa,2-0,2,0,1,1,2,2,H
2001-01-20,2000,Tottenham Hotspur,Southampton,0-0,0,0,1,1,0,0,D
2001-01-21,2000,Sunderland,Bradford City,0-0,0,0,1,1,0,0,D
2001-01-22,2000,Charlton Athletic,West Ham United,1-1,1,1,1,1,2,0,D
2001-01-24,2000,Aston Villa,Leeds United,1-2,1,2,1,1,3,-1,A
2001-01-30,2000,Arsenal,Bradford City,2-0,2,0,1,1,2,2,H
2001-01-30,2000,Charlton Athletic,Derby County,2-1,2,1,1,1,3,1,H
2001-01-31,2000,Chelsea,Newcastle United,3-1,3,1,1,1,4,2,H
2001-01-31,2000,Everton,Middlesbrough,2-2,2,2,1,1,4,0,D
2001-01-31,2000,Leeds United,Coventry City,1-0,1,0,1,1,1,1,H
2001-01-31,2000,Manchester City,Liverpool,1-1,1,1,1,1,2,0,D
2001-01-31,2000,Southampton,Leicester City,1-0,1,0,1,1,1,1,H
2001-01-31,2000,Sunderland,Manchester United,0-1,0,1,1,1,1,-1,A
2001-01-31,2000,West Ham United,Tottenham Hotspur,0-0,0,0,1,1,0,0,D
2001-02-03,2000,Bradford City,Aston Villa,0-3,0,3,1,1,3,-3,A
2001-02-03,2000,Coventry City,Arsenal,0-1,0,1,1,1,1,-1,A
2001-02-03,2000,Derby County,Sunderland,1-0,1,0,1,1,1,1,H
2001-02-03,2000,Ipswich Town,Leeds United,1-2,1,2,1,1,3,-1,A
2001-02-03,2000,Leicester City,Chelsea,2-1,2,1,1,1,3,1,H
2001-02-03,2000,Liverpool,West Ham United,3-0,3,0,1,1,3,3,H
2001-02-03,2000,Manchester United,Everton,1-0,1,0,1,1,1,1,H
2001-02-03,2000,Middlesbrough,Manchester City,1-1,1,1,1,1,2,0,D
2001-02-03,2000,Tottenham Hotspur,Charlton Athletic,0-0,0,0,1,1,0,0,D
2001-02-07,2000,Everton,Leeds United,2-2,2,2,1,1,4,0,D
2001-02-10,2000,Arsenal,Ipswich Town,1-0,1,0,1,1,1,1,H
2001-02-10,2000,Aston Villa,Middlesbrough,1-1,1,1,1,1,2,0,D
2001-02-10,2000,Chelsea,Manchester United,1-1,1,1,1,1,2,0,D
2001-02-10,2000,Everton,Leicester City,2-1,2,1,1,1,3,1,H
2001-02-10,2000,Leeds United,Derby County,0-0,0,0,1,1,0,0,D
2001-02-10,2000,Manchester City,Tottenham Hotspur,0-1,0,1,1,1,1,-1,A
2001-02-10,2000,Southampton,Bradford City,2-0,2,0,1,1,2,2,H
2001-02-10,2000,Sunderland,Liverpool,1-1,1,1,1,1,2,0,D
2001-02-11,2000,Charlton Athletic,Newcastle United,2-0,2,0,1,1,2,2,H
2001-02-12,2000,West Ham United,Coventry City,1-1,1,1,1,1,2,0,D
2001-02-24,2000,Bradford City,West Ham United,1-2,1,2,1,1,3,-1,A
2001-02-24,2000,Coventry City,Charlton Athletic,2-2,2,2,1,1,4,0,D
2001-02-24,2000,Derby County,Aston Villa,1-0,1,0,1,1,1,1,H
2001-02-24,2000,Ipswich Town,Everton,2-0,2,0,1,1,2,2,H
2001-02-24,2000,Leicester City,Sunderland,2-0,2,0,1,1,2,2,H
2001-02-24,2000,Middlesbrough,Southampton,0-1,0,1,1,1,1,-1,A
2001-02-24,2000,Newcastle United,Manchester City,0-1,0,1,1,1,1,-1,A
2001-02-24,2000,Tottenham Hotspur,Leeds United,1-2,1,2,1,1,3,-1,A
2001-02-25,2000,Manchester United,Arsenal,6-1,6,1,1,1,7,5,H
2001-03-03,2000,Arsenal,West Ham United,3-0,3,0,1,1,3,3,H
2001-03-03,2000,Coventry City,Chelsea,0-0,0,0,1,1,0,0,D
2001-03-03,2000,Derby County,Tottenham Hotspur,2-1,2,1,1,1,3,1,H
2001-03-03,2000,Everton,Newcastle United,1-1,1,1,1,1,2,0,D
2001-03-03,2000,Leeds United,Manchester United,1-1,1,1,1,1,2,0,D
2001-03-03,2000,Leicester City,Liverpool,2-0,2,0,1,1,2,2,H
2001-03-03,2000,Manchester City,Southampton,0-1,0,1,1,1,1,-1,A
2001-03-03,2000,Middlesbrough,Charlton Athletic,0-0,0,0,1,1,0,0,D
2001-03-04,2000,Ipswich Town,Bradford City,3-1,3,1,1,1,4,2,H
2001-03-05,2000,Sunderland,Aston Villa,1-1,1,1,1,1,2,0,D
2001-03-07,2000,West Ham United,Chelsea,0-2,0,2,1,1,2,-2,A
2001-03-10,2000,Aston Villa,Ipswich Town,2-1,2,1,1,1,3,1,H
2001-03-17,2000,Bradford City,Manchester City,2-2,2,2,1,1,4,0,D
2001-03-17,2000,Charlton Athletic,Leeds United,1-2,1,2,1,1,3,-1,A
2001-03-17,2000,Chelsea,Sunderland,2-4,2,4,1,1,6,-2,A
2001-03-17,2000,Manchester United,Leicester City,2-0,2,0,1,1,2,2,H
2001-03-17,2000,Newcastle United,Middlesbrough,1-2,1,2,1,1,3,-1,A
2001-03-17,2000,Southampton,Everton,1-0,1,0,1,1,1,1,H
2001-03-17,2000,Tottenham Hotspur,Coventry City,3-0,3,0,1,1,3,3,H
2001-03-17,2000,West Ham United,Ipswich Town,0-1,0,1,1,1,1,-1,A
2001-03-18,2000,Aston Villa,Arsenal,0-0,0,0,1,1,0,0,D
2001-03-18,2000,Liverpool,Derby County,1-1,1,1,1,1,2,0,D
2001-03-31,2000,Arsenal,Tottenham Hotspur,2-0,2,0,1,1,2,2,H
2001-03-31,2000,Bradford City,Newcastle United,2-2,2,2,1,1,4,0,D
2001-03-31,2000,Chelsea,Middlesbrough,2-1,2,1,1,1,3,1,H
2001-03-31,2000,Coventry City,Derby County,2-0,2,0,1,1,2,2,H
2001-03-31,2000,Liverpool,Manchester United,2-0,2,0,1,1,2,2,H
2001-03-31,2000,Manchester City,Aston Villa,1-3,1,3,1,1,4,-2,A
2001-03-31,2000,Sunderland,Leeds United,0-2,0,2,1,1,2,-2,A
2001-03-31,2000,West Ham United,Everton,0-2,0,2,1,1,2,-2,A
2001-04-01,2000,Charlton Athletic,Leicester City,2-0,2,0,1,1,2,2,H
2001-04-02,2000,Southampton,Ipswich Town,0-3,0,3,1,1,3,-3,A
2001-04-04,2000,Aston Villa,Leicester City,2-1,2,1,1,1,3,1,H
2001-04-07,2000,Aston Villa,West Ham United,2-2,2,2,1,1,4,0,D
2001-04-07,2000,Derby County,Chelsea,0-4,0,4,1,1,4,-4,A
2001-04-07,2000,Leeds United,Southampton,2-0,2,0,1,1,2,2,H
2001-04-07,2000,Leicester City,Coventry City,1-3,1,3,1,1,4,-2,A
2001-04-08,2000,Everton,Manchester City,3-1,3,1,1,1,4,2,H
2001-04-09,2000,Middlesbrough,Sunderland,0-0,0,0,1,1,0,0,D
2001-04-10,2000,Ipswich Town,Liverpool,1-1,1,1,1,1,2,0,D
2001-04-10,2000,Manchester United,Charlton Athletic,2-1,2,1,1,1,3,1,H
2001-04-10,2000,Tottenham Hotspur,Bradford City,2-1,2,1,1,1,3,1,H
2001-04-11,2000,Manchester City,Arsenal,0-4,0,4,1,1,4,-4,A
2001-04-13,2000,Bradford City,Charlton Athletic,2-0,2,0,1,1,2,2,H
2001-04-13,2000,Liverpool,Leeds United,1-2,1,2,1,1,3,-1,A
2001-04-14,2000,Arsenal,Middlesbrough,0-3,0,3,1,1,3,-3,A
2001-04-14,2000,Aston Villa,Everton,2-1,2,1,1,1,3,1,H
2001-04-14,2000,Chelsea,Southampton,1-0,1,0,1,1,1,1,H
2001-04-14,2000,Ipswich Town,Newcastle United,1-0,1,0,1,1,1,1,H
2001-04-14,2000,Leicester City,Manchester City,1-2,1,2,1,1,3,-1,A
2001-04-14,2000,Manchester United,Coventry City,4-2,4,2,1,1,6,2,H
2001-04-14,2000,Sunderland,Tottenham Hotspur,2-3,2,3,1,1,5,-1,A
2001-04-14,2000,West Ham United,Derby County,3-1,3,1,1,1,4,2,H
2001-04-16,2000,Coventry City,Sunderland,1-0,1,0,1,1,1,1,H
2001-04-16,2000,Derby County,Leicester City,2-0,2,0,1,1,2,2,H
2001-04-16,2000,Everton,Liverpool,2-3,2,3,1,1,5,-1,A
2001-04-16,2000,Middlesbrough,Ipswich Town,1-2,1,2,1,1,3,-1,A
2001-04-16,2000,Newcastle United,West Ham United,2-1,2,1,1,1,3,1,H
2001-04-17,2000,Charlton Athletic,Aston Villa,3-3,3,3,1,1,6,0,D
2001-04-17,2000,Tottenham Hotspur,Chelsea,0-3,0,3,1,1,3,-3,A
2001-04-21,2000,Arsenal,Everton,4-1,4,1,1,1,5,3,H
2001-04-21,2000,Aston Villa,Southampton,0-0,0,0,1,1,0,0,D
2001-04-21,2000,Bradford City,Derby County,2-0,2,0,1,1,2,2,H
2001-04-21,2000,Chelsea,Charlton Athletic,0-1,0,1,1,1,1,-1,A
2001-04-21,2000,Ipswich Town,Coventry City,2-0,2,0,1,1,2,2,H
2001-04-21,2000,Leicester City,Middlesbrough,0-3,0,3,1,1,3,-3,A
2001-04-21,2000,Manchester United,Manchester City,1-1,1,1,1,1,2,0,D
2001-04-21,2000,Sunderland,Newcastle United,1-1,1,1,1,1,2,0,D
2001-04-21,2000,West Ham United,Leeds United,0-2,0,2,1,1,2,-2,A
2001-04-22,2000,Liverpool,Tottenham Hotspur,3-1,3,1,1,1,4,2,H
2001-04-28,2000,Coventry City,Liverpool,0-2,0,2,1,1,2,-2,A
2001-04-28,2000,Derby County,Arsenal,1-2,1,2,1,1,3,-1,A
2001-04-28,2000,Everton,Bradford City,2-1,2,1,1,1,3,1,H
2001-04-28,2000,Leeds United,Chelsea,2-0,2,0,1,1,2,2,H
2001-04-28,2000,Manchester City,West Ham United,1-0,1,0,1,1,1,1,H
2001-04-28,2000,Middlesbrough,Manchester United,0-2,0,2,1,1,2,-2,A
2001-04-28,2000,Newcastle United,Leicester City,1-0,1,0,1,1,1,1,H
2001-04-28,2000,Southampton,Sunderland,0-1,0,1,1,1,1,-1,A
2001-04-28,2000,Tottenham Hotspur,Aston Villa,0-0,0,0,1,1,0,0,D
2001-04-30,2000,Charlton Athletic,Ipswich Town,2-1,2,1,1,1,3,1,H
2001-05-01,2000,Bradford City,Liverpool,0-2,0,2,1,1,2,-2,A
2001-05-01,2000,Newcastle United,Southampton,1-1,1,1,1,1,2,0,D
2001-05-05,2000,Arsenal,Leeds United,2-1,2,1,1,1,3,1,H
2001-05-05,2000,Aston Villa,Coventry City,3-2,3,2,1,1,5,1,H
2001-05-05,2000,Bradford City,Middlesbrough,1-1,1,1,1,1,2,0,D
2001-05-05,2000,Chelsea,Everton,2-1,2,1,1,1,3,1,H
2001-05-05,2000,Leicester City,Tottenham Hotspur,4-2,4,2,1,1,6,2,H
2001-05-05,2000,Liverpool,Newcastle United,3-0,3,0,1,1,3,3,H
2001-05-05,2000,Manchester United,Derby County,0-1,0,1,1,1,1,-1,A
2001-05-05,2000,Sunderland,Charlton Athletic,3-2,3,2,1,1,5,1,H
2001-05-05,2000,West Ham United,Southampton,3-0,3,0,1,1,3,3,H
2001-05-07,2000,Ipswich Town,Manchester City,2-1,2,1,1,1,3,1,H
2001-05-08,2000,Liverpool,Chelsea,2-2,2,2,1,1,4,0,D
2001-05-13,2000,Leeds United,Bradford City,6-1,6,1,1,1,7,5,H
2001-05-13,2000,Southampton,Manchester United,2-1,2,1,1,1,3,1,H
2001-05-15,2000,Newcastle United,Arsenal,0-0,0,0,1,1,0,0,D
2001-05-19,2000,Charlton Athletic,Liverpool,0-4,0,4,1,1,4,-4,A
2001-05-19,2000,Coventry City,Bradford City,0-0,0,0,1,1,0,0,D
2001-05-19,2000,Derby County,Ipswich Town,1-1,1,1,1,1,2,0,D
2001-05-19,2000,Everton,Sunderland,2-2,2,2,1,1,4,0,D
2001-05-19,2000,Leeds United,Leicester City,3-1,3,1,1,1,4,2,H
2001-05-19,2000,Manchester City,Chelsea,1-2,1,2,1,1,3,-1,A
2001-05-19,2000,Middlesbrough,West Ham United,2-1,2,1,1,1,3,1,H
2001-05-19,2000,Newcastle United,Aston Villa,3-0,3,0,1,1,3,3,H
2001-05-19,2000,Southampton,Arsenal,3-2,3,2,1,1,5,1,H
2001-05-19,2000,Tottenham Hotspur,Manchester United,3-1,3,1,1,1,4,2,H
2001-08-18,2001,Charlton Athletic,Everton,1-2,1,2,1,1,3,-1,A
2001-08-18,2001,Derby County,Blackburn Rovers,2-1,2,1,1,1,3,1,H
2001-08-18,2001,Leeds United,Southampton,2-0,2,0,1,1,2,2,H
2001-08-18,2001,Leicester City,Bolton Wanderers,0-5,0,5,1,1,5,-5,A
2001-08-18,2001,Liverpool,West Ham United,2-1,2,1,1,1,3,1,H
2001-08-18,2001,Middlesbrough,Arsenal,0-4,0,4,1,1,4,-4,A
2001-08-18,2001,Sunderland,Ipswich Town,1-0,1,0,1,1,1,1,H
2001-08-18,2001,Tottenham Hotspur,Aston Villa,0-0,0,0,1,1,0,0,D
2001-08-19,2001,Chelsea,Newcastle United,1-1,1,1,1,1,2,0,D
2001-08-19,2001,Manchester United,Fulham,3-2,3,2,1,1,5,1,H
2001-08-20,2001,Everton,Tottenham Hotspur,1-1,1,1,1,1,2,0,D
2001-08-21,2001,Arsenal,Leeds United,1-2,1,2,1,1,3,-1,A
2001-08-21,2001,Bolton Wanderers,Middlesbrough,1-0,1,0,1,1,1,1,H
2001-08-21,2001,Ipswich Town,Derby County,3-1,3,1,1,1,4,2,H
2001-08-22,2001,Blackburn Rovers,Manchester United,2-2,2,2,1,1,4,0,D
2001-08-22,2001,Fulham,Sunderland,2-0,2,0,1,1,2,2,H
2001-08-25,2001,Arsenal,Leicester City,4-0,4,0,1,1,4,4,H
2001-08-25,2001,Blackburn Rovers,Tottenham Hotspur,2-1,2,1,1,1,3,1,H
2001-08-25,2001,Everton,Middlesbrough,2-0,2,0,1,1,2,2,H
2001-08-25,2001,Fulham,Derby County,0-0,0,0,1,1,0,0,D
2001-08-25,2001,Ipswich Town,Charlton Athletic,0-1,0,1,1,1,1,-1,A
2001-08-25,2001,Southampton,Chelsea,0-2,0,2,1,1,2,-2,A
2001-08-25,2001,West Ham United,Leeds United,0-0,0,0,1,1,0,0,D
2001-08-26,2001,Aston Villa,Manchester United,1-1,1,1,1,1,2,0,D
2001-08-26,2001,Newcastle United,Sunderland,1-1,1,1,1,1,2,0,D
2001-08-27,2001,Bolton Wanderers,Liverpool,2-1,2,1,1,1,3,1,H
2001-09-08,2001,Chelsea,Arsenal,1-1,1,1,1,1,2,0,D
2001-09-08,2001,Derby County,West Ham United,0-0,0,0,1,1,0,0,D
2001-09-08,2001,Leeds United,Bolton Wanderers,0-0,0,0,1,1,0,0,D
2001-09-08,2001,Leicester City,Ipswich Town,1-1,1,1,1,1,2,0,D
2001-09-08,2001,Liverpool,Aston Villa,1-3,1,3,1,1,4,-2,A
2001-09-08,2001,Manchester United,Everton,4-1,4,1,1,1,5,3,H
2001-09-08,2001,Middlesbrough,Newcastle United,1-4,1,4,1,1,5,-3,A
2001-09-08,2001,Sunderland,Blackburn Rovers,1-0,1,0,1,1,1,1,H
2001-09-09,2001,Charlton Athletic,Fulham,1-1,1,1,1,1,2,0,D
2001-09-09,2001,Tottenham Hotspur,Southampton,2-0,2,0,1,1,2,2,H
2001-09-15,2001,Bolton Wanderers,Southampton,0-1,0,1,1,1,1,-1,A
2001-09-15,2001,Derby County,Leicester City,2-3,2,3,1,1,5,-1,A
2001-09-15,2001,Everton,Liverpool,1-3,1,3,1,1,4,-2,A
2001-09-15,2001,Fulham,Arsenal,1-3,1,3,1,1,4,-2,A
2001-09-15,2001,Middlesbrough,West Ham United,2-0,2,0,1,1,2,2,H
2001-09-15,2001,Newcastle United,Manchester United,4-3,4,3,1,1,7,1,H
2001-09-16,2001,Aston Villa,Sunderland,0-0,0,0,1,1,0,0,D
2001-09-16,2001,Charlton Athletic,Leeds United,0-2,0,2,1,1,2,-2,A
2001-09-16,2001,Ipswich Town,Blackburn Rovers,1-1,1,1,1,1,2,0,D
2001-09-16,2001,Tottenham Hotspur,Chelsea,2-3,2,3,1,1,5,-1,A
2001-09-17,2001,Leicester City,Middlesbrough,1-2,1,2,1,1,3,-1,A
2001-09-19,2001,Blackburn Rovers,Bolton Wanderers,1-1,1,1,1,1,2,0,D
2001-09-19,2001,Sunderland,Tottenham Hotspur,1-2,1,2,1,1,3,-1,A
2001-09-22,2001,Arsenal,Bolton Wanderers,1-1,1,1,1,1,2,0,D
2001-09-22,2001,Blackburn Rovers,Everton,1-0,1,0,1,1,1,1,H
2001-09-22,2001,Leicester City,Fulham,0-0,0,0,1,1,0,0,D
2001-09-22,2001,Liverpool,Tottenham Hotspur,1-0,1,0,1,1,1,1,H
2001-09-22,2001,Manchester United,Ipswich Town,4-0,4,0,1,1,4,4,H
2001-09-22,2001,Sunderland,Charlton Athletic,2-2,2,2,1,1,4,0,D
2001-09-23,2001,Chelsea,Middlesbrough,2-2,2,2,1,1,4,0,D
2001-09-23,2001,Leeds United,Derby County,3-0,3,0,1,1,3,3,H
2001-09-23,2001,West Ham United,Newcastle United,3-0,3,0,1,1,3,3,H
2001-09-24,2001,Southampton,Aston Villa,1-3,1,3,1,1,4,-2,A
2001-09-26,2001,Newcastle United,Leicester City,1-0,1,0,1,1,1,1,H
2001-09-29,2001,Bolton Wanderers,Sunderland,0-2,0,2,1,1,2,-2,A
2001-09-29,2001,Charlton Athletic,Leicester City,2-0,2,0,1,1,2,2,H
2001-09-29,2001,Derby County,Arsenal,0-2,0,2,1,1,2,-2,A
2001-09-29,2001,Everton,West Ham United,5-0,5,0,1,1,5,5,H
2001-09-29,2001,Middlesbrough,Southampton,1-3,1,3,1,1,4,-2,A
2001-09-29,2001,Tottenham Hotspur,Manchester United,3-5,3,5,1,1,8,-2,A
2001-09-30,2001,Aston Villa,Blackburn Rovers,2-0,2,0,1,1,2,2,H
2001-09-30,2001,Fulham,Chelsea,1-1,1,1,1,1,2,0,D
2001-09-30,2001,Ipswich Town,Leeds United,1-2,1,2,1,1,3,-1,A
2001-09-30,2001,Newcastle United,Liverpool,0-2,0,2,1,1,2,-2,A
2001-10-13,2001,Bolton Wanderers,Newcastle United,0-4,0,4,1,1,4,-4,A
2001-10-13,2001,Charlton Athletic,Middlesbrough,0-0,0,0,1,1,0,0,D
2001-10-13,2001,Chelsea,Leicester City,2-0,2,0,1,1,2,2,H
2001-10-13,2001,Ipswich Town,Everton,0-0,0,0,1,1,0,0,D
2001-10-13,2001,Liverpool,Leeds United,1-1,1,1,1,1,2,0,D
2001-10-13,2001,Southampton,Arsenal,0-2,0,2,1,1,2,-2,A
2001-10-13,2001,Sunderland,Manchester United,1-3,1,3,1,1,4,-2,A
2001-10-14,2001,Aston Villa,Fulham,2-0,2,0,1,1,2,2,H
2001-10-14,2001,Blackburn Rovers,West Ham United,7-1,7,1,1,1,8,6,H
2001-10-15,2001,Tottenham Hotspur,Derby County,3-1,3,1,1,1,4,2,H
2001-10-20,2001,Arsenal,Blackburn Rovers,3-3,3,3,1,1,6,0,D
2001-10-20,2001,Derby County,Charlton Athletic,1-1,1,1,1,1,2,0,D
2001-10-20,2001,Everton,Aston Villa,3-2,3,2,1,1,5,1,H
2001-10-20,2001,Leicester City,Liverpool,1-4,1,4,1,1,5,-3,A
2001-10-20,2001,Manchester United,Bolton Wanderers,1-2,1,2,1,1,3,-1,A
2001-10-20,2001,West Ham United,Southampton,2-0,2,0,1,1,2,2,H
2001-10-21,2001,Fulham,Ipswich Town,1-1,1,1,1,1,2,0,D
2001-10-21,2001,Leeds United,Chelsea,0-0,0,0,1,1,0,0,D
2001-10-21,2001,Newcastle United,Tottenham Hotspur,0-2,0,2,1,1,2,-2,A
2001-10-22,2001,Middlesbrough,Sunderland,2-0,2,0,1,1,2,2,H
2001-10-24,2001,Aston Villa,Charlton Athletic,1-0,1,0,1,1,1,1,H
2001-10-24,2001,Southampton,Ipswich Town,3-3,3,3,1,1,6,0,D
2001-10-24,2001,West Ham United,Chelsea,2-1,2,1,1,1,3,1,H
2001-10-27,2001,Aston Villa,Bolton Wanderers,3-2,3,2,1,1,5,1,H
2001-10-27,2001,Charlton Athletic,Liverpool,0-2,0,2,1,1,2,-2,A
2001-10-27,2001,Everton,Newcastle United,1-3,1,3,1,1,4,-2,A
2001-10-27,2001,Fulham,Southampton,2-1,2,1,1,1,3,1,H
2001-10-27,2001,Manchester United,Leeds United,1-1,1,1,1,1,2,0,D
2001-10-27,2001,Sunderland,Arsenal,1-1,1,1,1,1,2,0,D
2001-10-27,2001,Tottenham Hotspur,Middlesbrough,2-1,2,1,1,1,3,1,H
2001-10-28,2001,Derby County,Chelsea,1-1,1,1,1,1,2,0,D
2001-10-28,2001,Ipswich Town,West Ham United,2-3,2,3,1,1,5,-1,A
2001-10-29,2001,Blackburn Rovers,Leicester City,0-0,0,0,1,1,0,0,D
2001-11-03,2001,Bolton Wanderers,Everton,2-2,2,2,1,1,4,0,D
2001-11-03,2001,Leicester City,Sunderland,1-0,1,0,1,1,1,1,H
2001-11-03,2001,Middlesbrough,Derby County,5-1,5,1,1,1,6,4,H
2001-11-03,2001,Newcastle United,Aston Villa,3-0,3,0,1,1,3,3,H
2001-11-03,2001,Southampton,Blackburn Rovers,1-2,1,2,1,1,3,-1,A
2001-11-03,2001,West Ham United,Fulham,0-2,0,2,1,1,2,-2,A
2001-11-04,2001,Arsenal,Charlton Athletic,2-4,2,4,1,1,6,-2,A
2001-11-04,2001,Chelsea,Ipswich Town,2-1,2,1,1,1,3,1,H
2001-11-04,2001,Leeds United,Tottenham Hotspur,2-1,2,1,1,1,3,1,H
2001-11-04,2001,Liverpool,Manchester United,3-1,3,1,1,1,4,2,H
2001-11-17,2001,Aston Villa,Middlesbrough,0-0,0,0,1,1,0,0,D
2001-11-17,2001,Blackburn Rovers,Liverpool,1-1,1,1,1,1,2,0,D
2001-11-17,2001,Derby County,Southampton,1-0,1,0,1,1,1,1,H
2001-11-17,2001,Fulham,Newcastle United,3-1,3,1,1,1,4,2,H
2001-11-17,2001,Manchester United,Leicester City,2-0,2,0,1,1,2,2,H
2001-11-17,2001,Tottenham Hotspur,Arsenal,1-1,1,1,1,1,2,0,D
2001-11-18,2001,Everton,Chelsea,0-0,0,0,1,1,0,0,D
2001-11-18,2001,Ipswich Town,Bolton Wanderers,1-2,1,2,1,1,3,-1,A
2001-11-18,2001,Sunderland,Leeds United,2-0,2,0,1,1,2,2,H
2001-11-19,2001,Charlton Athletic,West Ham United,4-4,4,4,1,1,8,0,D
2001-11-24,2001,Bolton Wanderers,Fulham,0-0,0,0,1,1,0,0,D
2001-11-24,2001,Chelsea,Blackburn Rovers,0-0,0,0,1,1,0,0,D
2001-11-24,2001,Leicester City,Everton,0-0,0,0,1,1,0,0,D
2001-11-24,2001,Newcastle United,Derby County,1-0,1,0,1,1,1,1,H
2001-11-24,2001,Southampton,Charlton Athletic,1-0,1,0,1,1,1,1,H
2001-11-24,2001,West Ham United,Tottenham Hotspur,0-1,0,1,1,1,1,-1,A
2001-11-25,2001,Arsenal,Manchester United,3-1,3,1,1,1,4,2,H
2001-11-25,2001,Leeds United,Aston Villa,1-1,1,1,1,1,2,0,D
2001-11-25,2001,Liverpool,Sunderland,1-0,1,0,1,1,1,1,H
2001-11-25,2001,Middlesbrough,Ipswich Town,0-0,0,0,1,1,0,0,D
2001-12-01,2001,Aston Villa,Leicester City,0-2,0,2,1,1,2,-2,A
2001-12-01,2001,Blackburn Rovers,Middlesbrough,0-1,0,1,1,1,1,-1,A
2001-12-01,2001,Charlton Athletic,Newcastle United,1-1,1,1,1,1,2,0,D
2001-12-01,2001,Derby County,Liverpool,0-1,0,1,1,1,1,-1,A
2001-12-01,2001,Ipswich Town,Arsenal,0-2,0,2,1,1,2,-2,A
2001-12-01,2001,Manchester United,Chelsea,0-3,0,3,1,1,3,-3,A
2001-12-01,2001,Sunderland,West Ham United,1-0,1,0,1,1,1,1,H
2001-12-02,2001,Everton,Southampton,2-0,2,0,1,1,2,2,H
2001-12-02,2001,Fulham,Leeds United,0-0,0,0,1,1,0,0,D
2001-12-03,2001,Tottenham Hotspur,Bolton Wanderers,3-2,3,2,1,1,5,1,H
2001-12-05,2001,Chelsea,Charlton Athletic,0-1,0,1,1,1,1,-1,A
2001-12-05,2001,West Ham United,Aston Villa,1-1,1,1,1,1,2,0,D
2001-12-08,2001,Charlton Athletic,Tottenham Hotspur,3-1,3,1,1,1,4,2,H
2001-12-08,2001,Derby County,Bolton Wanderers,1-0,1,0,1,1,1,1,H
2001-12-08,2001,Fulham,Everton,2-0,2,0,1,1,2,2,H
2001-12-08,2001,Leicester City,Southampton,0-4,0,4,1,1,4,-4,A
2001-12-08,2001,Liverpool,Middlesbrough,2-0,2,0,1,1,2,2,H
2001-12-08,2001,Manchester United,West Ham United,0-1,0,1,1,1,1,-1,A
2001-12-09,2001,Arsenal,Aston Villa,3-2,3,2,1,1,5,1,H
2001-12-09,2001,Blackburn Rovers,Leeds United,1-2,1,2,1,1,3,-1,A
2001-12-09,2001,Ipswich Town,Newcastle United,0-1,0,1,1,1,1,-1,A
2001-12-09,2001,Sunderland,Chelsea,0-0,0,0,1,1,0,0,D
2001-12-12,2001,Liverpool,Fulham,0-0,0,0,1,1,0,0,D
2001-12-12,2001,Manchester United,Derby County,5-0,5,0,1,1,5,5,H
2001-12-15,2001,Bolton Wanderers,Charlton Athletic,0-0,0,0,1,1,0,0,D
2001-12-15,2001,Everton,Derby County,1-0,1,0,1,1,1,1,H
2001-12-15,2001,Middlesbrough,Manchester United,0-1,0,1,1,1,1,-1,A
2001-12-15,2001,Newcastle United,Blackburn Rovers,2-1,2,1,1,1,3,1,H
2001-12-15,2001,Southampton,Sunderland,2-0,2,0,1,1,2,2,H
2001-12-15,2001,Tottenham Hotspur,Fulham,4-0,4,0,1,1,4,4,H
2001-12-15,2001,West Ham United,Arsenal,1-1,1,1,1,1,2,0,D
2001-12-16,2001,Chelsea,Liverpool,4-0,4,0,1,1,4,4,H
2001-12-16,2001,Leeds United,Leicester City,2-2,2,2,1,1,4,0,D
2001-12-17,2001,Aston Villa,Ipswich Town,2-1,2,1,1,1,3,1,H
2001-12-18,2001,Arsenal,Newcastle United,1-3,1,3,1,1,4,-2,A
2001-12-19,2001,Leeds United,Everton,3-2,3,2,1,1,5,1,H
2001-12-22,2001,Charlton Athletic,Blackburn Rovers,0-2,0,2,1,1,2,-2,A
2001-12-22,2001,Derby County,Aston Villa,3-1,3,1,1,1,4,2,H
2001-12-22,2001,Leeds United,Newcastle United,3-4,3,4,1,1,7,-1,A
2001-12-22,2001,Leicester City,West Ham United,1-1,1,1,1,1,2,0,D
2001-12-22,2001,Manchester United,Southampton,6-1,6,1,1,1,7,5,H
2001-12-22,2001,Sunderland,Everton,1-0,1,0,1,1,1,1,H
2001-12-22,2001,Tottenham Hotspur,Ipswich Town,1-2,1,2,1,1,3,-1,A
2001-12-23,2001,Chelsea,Bolton Wanderers,5-1,5,1,1,1,6,4,H
2001-12-23,2001,Liverpool,Arsenal,1-2,1,2,1,1,3,-1,A
2001-12-26,2001,Arsenal,Chelsea,2-1,2,1,1,1,3,1,H
2001-12-26,2001,Aston Villa,Liverpool,1-2,1,2,1,1,3,-1,A
2001-12-26,2001,Blackburn Rovers,Sunderland,0-3,0,3,1,1,3,-3,A
2001-12-26,2001,Bolton Wanderers,Leeds United,0-3,0,3,1,1,3,-3,A
2001-12-26,2001,Everton,Manchester United,0-2,0,2,1,1,2,-2,A
2001-12-26,2001,Fulham,Charlton Athletic,0-0,0,0,1,1,0,0,D
2001-12-26,2001,Ipswich Town,Leicester City,2-0,2,0,1,1,2,2,H
2001-12-26,2001,Newcastle United,Middlesbrough,3-0,3,0,1,1,3,3,H
2001-12-26,2001,Southampton,Tottenham Hotspur,1-0,1,0,1,1,1,1,H
2001-12-26,2001,West Ham United,Derby County,4-0,4,0,1,1,4,4,H
2001-12-29,2001,Arsenal,Middlesbrough,2-1,2,1,1,1,3,1,H
2001-12-29,2001,Aston Villa,Tottenham Hotspur,1-1,1,1,1,1,2,0,D
2001-12-29,2001,Blackburn Rovers,Derby County,0-1,0,1,1,1,1,-1,A
2001-12-29,2001,Bolton Wanderers,Leicester City,2-2,2,2,1,1,4,0,D
2001-12-29,2001,Everton,Charlton Athletic,0-3,0,3,1,1,3,-3,A
2001-12-29,2001,Ipswich Town,Sunderland,5-0,5,0,1,1,5,5,H
2001-12-29,2001,Newcastle United,Chelsea,1-2,1,2,1,1,3,-1,A
2001-12-29,2001,Southampton,Leeds United,0-1,0,1,1,1,1,-1,A
2001-12-29,2001,West Ham United,Liverpool,1-1,1,1,1,1,2,0,D
2001-12-30,2001,Fulham,Manchester United,2-3,2,3,1,1,5,-1,A
2002-01-01,2001,Charlton Athletic,Ipswich Town,3-2,3,2,1,1,5,1,H
2002-01-01,2001,Chelsea,Southampton,2-4,2,4,1,1,6,-2,A
2002-01-01,2001,Leeds United,West Ham United,3-0,3,0,1,1,3,3,H
2002-01-01,2001,Liverpool,Bolton Wanderers,1-1,1,1,1,1,2,0,D
2002-01-01,2001,Middlesbrough,Everton,1-0,1,0,1,1,1,1,H
2002-01-01,2001,Sunderland,Aston Villa,1-1,1,1,1,1,2,0,D
2002-01-01,2001,Tottenham Hotspur,Blackburn Rovers,1-0,1,0,1,1,1,1,H
2002-01-02,2001,Derby County,Fulham,0-1,0,1,1,1,1,-1,A
2002-01-02,2001,Manchester United,Newcastle United,3-1,3,1,1,1,4,2,H
2002-01-09,2001,Southampton,Liverpool,2-0,2,0,1,1,2,2,H
2002-01-12,2001,Aston Villa,Derby County,2-1,2,1,1,1,3,1,H
2002-01-12,2001,Blackburn Rovers,Charlton Athletic,4-1,4,1,1,1,5,3,H
2002-01-12,2001,Bolton Wanderers,Chelsea,2-2,2,2,1,1,4,0,D
2002-01-12,2001,Everton,Sunderland,1-0,1,0,1,1,1,1,H
2002-01-12,2001,Fulham,Middlesbrough,2-1,2,1,1,1,3,1,H
2002-01-12,2001,Ipswich Town,Tottenham Hotspur,2-1,2,1,1,1,3,1,H
2002-01-12,2001,Newcastle United,Leeds United,3-1,3,1,1,1,4,2,H
2002-01-12,2001,West Ham United,Leicester City,1-0,1,0,1,1,1,1,H
2002-01-13,2001,Arsenal,Liverpool,1-1,1,1,1,1,2,0,D
2002-01-13,2001,Southampton,Manchester United,1-3,1,3,1,1,4,-2,A
2002-01-19,2001,Derby County,Ipswich Town,1-3,1,3,1,1,4,-2,A
2002-01-19,2001,Leicester City,Newcastle United,0-0,0,0,1,1,0,0,D
2002-01-19,2001,Liverpool,Southampton,1-1,1,1,1,1,2,0,D
2002-01-19,2001,Manchester United,Blackburn Rovers,2-1,2,1,1,1,3,1,H
2002-01-19,2001,Middlesbrough,Bolton Wanderers,1-1,1,1,1,1,2,0,D
2002-01-19,2001,Sunderland,Fulham,1-1,1,1,1,1,2,0,D
2002-01-19,2001,Tottenham Hotspur,Everton,1-1,1,1,1,1,2,0,D
2002-01-20,2001,Chelsea,West Ham United,5-1,5,1,1,1,6,4,H
2002-01-20,2001,Leeds United,Arsenal,1-1,1,1,1,1,2,0,D
2002-01-21,2001,Charlton Athletic,Aston Villa,1-2,1,2,1,1,3,-1,A
2002-01-22,2001,Manchester United,Liverpool,0-1,0,1,1,1,1,-1,A
2002-01-23,2001,Leicester City,Arsenal,1-3,1,3,1,1,4,-2,A
2002-01-29,2001,Bolton Wanderers,Manchester United,0-4,0,4,1,1,4,-4,A
2002-01-29,2001,Charlton Athletic,Derby County,1-0,1,0,1,1,1,1,H
2002-01-29,2001,Sunderland,Middlesbrough,0-1,0,1,1,1,1,-1,A
2002-01-30,2001,Aston Villa,Everton,0-0,0,0,1,1,0,0,D
2002-01-30,2001,Blackburn Rovers,Arsenal,2-3,2,3,1,1,5,-1,A
2002-01-30,2001,Chelsea,Leeds United,2-0,2,0,1,1,2,2,H
2002-01-30,2001,Ipswich Town,Fulham,1-0,1,0,1,1,1,1,H
2002-01-30,2001,Liverpool,Leicester City,1-0,1,0,1,1,1,1,H
2002-01-30,2001,Southampton,West Ham United,2-0,2,0,1,1,2,2,H
2002-01-30,2001,Tottenham Hotspur,Newcastle United,1-3,1,3,1,1,4,-2,A
2002-02-02,2001,Arsenal,Southampton,1-1,1,1,1,1,2,0,D
2002-02-02,2001,Derby County,Tottenham Hotspur,1-0,1,0,1,1,1,1,H
2002-02-02,2001,Everton,Ipswich Town,1-2,1,2,1,1,3,-1,A
2002-02-02,2001,Fulham,Aston Villa,0-0,0,0,1,1,0,0,D
2002-02-02,2001,Leicester City,Chelsea,2-3,2,3,1,1,5,-1,A
2002-02-02,2001,Manchester United,Sunderland,4-1,4,1,1,1,5,3,H
2002-02-02,2001,Newcastle United,Bolton Wanderers,3-2,3,2,1,1,5,1,H
2002-02-02,2001,West Ham United,Blackburn Rovers,2-0,2,0,1,1,2,2,H
2002-02-03,2001,Leeds United,Liverpool,0-4,0,4,1,1,4,-4,A
2002-02-03,2001,Middlesbrough,Charlton Athletic,0-0,0,0,1,1,0,0,D
2002-02-09,2001,Aston Villa,Chelsea,1-1,1,1,1,1,2,0,D
2002-02-09,2001,Bolton Wanderers,West Ham United,1-0,1,0,1,1,1,1,H
2002-02-09,2001,Derby County,Sunderland,0-1,0,1,1,1,1,-1,A
2002-02-09,2001,Fulham,Blackburn Rovers,2-0,2,0,1,1,2,2,H
2002-02-09,2001,Ipswich Town,Liverpool,0-6,0,6,1,1,6,-6,A
2002-02-09,2001,Middlesbrough,Leeds United,2-2,2,2,1,1,4,0,D
2002-02-09,2001,Newcastle United,Southampton,3-1,3,1,1,1,4,2,H
2002-02-09,2001,Tottenham Hotspur,Leicester City,2-1,2,1,1,1,3,1,H
2002-02-10,2001,Charlton Athletic,Manchester United,0-2,0,2,1,1,2,-2,A
2002-02-10,2001,Everton,Arsenal,0-1,0,1,1,1,1,-1,A
2002-02-19,2001,Middlesbrough,Fulham,2-1,2,1,1,1,3,1,H
2002-02-23,2001,Arsenal,Fulham,4-1,4,1,1,1,5,3,H
2002-02-23,2001,Leicester City,Derby County,0-3,0,3,1,1,3,-3,A
2002-02-23,2001,Liverpool,Everton,1-1,1,1,1,1,2,0,D
2002-02-23,2001,Manchester United,Aston Villa,1-0,1,0,1,1,1,1,H
2002-02-23,2001,Southampton,Bolton Wanderers,0-0,0,0,1,1,0,0,D
2002-02-23,2001,West Ham United,Middlesbrough,1-0,1,0,1,1,1,1,H
2002-02-24,2001,Leeds United,Charlton Athletic,0-0,0,0,1,1,0,0,D
2002-02-24,2001,Sunderland,Newcastle United,0-1,0,1,1,1,1,-1,A
2002-03-02,2001,Aston Villa,West Ham United,2-1,2,1,1,1,3,1,H
2002-03-02,2001,Bolton Wanderers,Blackburn Rovers,1-1,1,1,1,1,2,0,D
2002-03-02,2001,Charlton Athletic,Chelsea,2-1,2,1,1,1,3,1,H
2002-03-02,2001,Fulham,Liverpool,0-2,0,2,1,1,2,-2,A
2002-03-02,2001,Ipswich Town,Southampton,1-3,1,3,1,1,4,-2,A
2002-03-02,2001,Middlesbrough,Leicester City,1-0,1,0,1,1,1,1,H
2002-03-02,2001,Newcastle United,Arsenal,0-2,0,2,1,1,2,-2,A
2002-03-02,2001,Tottenham Hotspur,Sunderland,2-1,2,1,1,1,3,1,H
2002-03-03,2001,Derby County,Manchester United,2-2,2,2,1,1,4,0,D
2002-03-03,2001,Everton,Leeds United,0-0,0,0,1,1,0,0,D
2002-03-05,2001,Arsenal,Derby County,1-0,1,0,1,1,1,1,H
2002-03-05,2001,Blackburn Rovers,Aston Villa,3-0,3,0,1,1,3,3,H
2002-03-05,2001,Sunderland,Bolton Wanderers,1-0,1,0,1,1,1,1,H
2002-03-06,2001,Chelsea,Fulham,3-2,3,2,1,1,5,1,H
2002-03-06,2001,Leeds United,Ipswich Town,2-0,2,0,1,1,2,2,H
2002-03-06,2001,Liverpool,Newcastle United,3-0,3,0,1,1,3,3,H
2002-03-06,2001,Manchester United,Tottenham Hotspur,4-0,4,0,1,1,4,4,H
2002-03-06,2001,Southampton,Middlesbrough,1-1,1,1,1,1,2,0,D
2002-03-06,2001,West Ham United,Everton,1-0,1,0,1,1,1,1,H
2002-03-09,2001,Leicester City,Charlton Athletic,1-1,1,1,1,1,2,0,D
2002-03-13,2001,Blackburn Rovers,Ipswich Town,2-1,2,1,1,1,3,1,H
2002-03-13,2001,Chelsea,Tottenham Hotspur,4-0,4,0,1,1,4,4,H
2002-03-16,2001,Bolton Wanderers,Derby County,1-3,1,3,1,1,4,-2,A
2002-03-16,2001,Chelsea,Sunderland,4-0,4,0,1,1,4,4,H
2002-03-16,2001,Everton,Fulham,2-1,2,1,1,1,3,1,H
2002-03-16,2001,Middlesbrough,Liverpool,1-2,1,2,1,1,3,-1,A
2002-03-16,2001,Newcastle United,Ipswich Town,2-2,2,2,1,1,4,0,D
2002-03-16,2001,Southampton,Leicester City,2-2,2,2,1,1,4,0,D
2002-03-16,2001,West Ham United,Manchester United,3-5,3,5,1,1,8,-2,A
2002-03-17,2001,Aston Villa,Arsenal,1-2,1,2,1,1,3,-1,A
2002-03-17,2001,Leeds United,Blackburn Rovers,3-1,3,1,1,1,4,2,H
2002-03-18,2001,Tottenham Hotspur,Charlton Athletic,0-1,0,1,1,1,1,-1,A
2002-03-23,2001,Charlton Athletic,Bolton Wanderers,1-2,1,2,1,1,3,-1,A
2002-03-23,2001,Derby County,Everton,3-4,3,4,1,1,7,-1,A
2002-03-23,2001,Ipswich Town,Aston Villa,0-0,0,0,1,1,0,0,D
2002-03-23,2001,Leicester City,Leeds United,0-2,0,2,1,1,2,-2,A
2002-03-23,2001,Manchester United,Middlesbrough,0-1,0,1,1,1,1,-1,A
2002-03-23,2001,Sunderland,Southampton,1-1,1,1,1,1,2,0,D
2002-03-24,2001,Fulham,Tottenham Hotspur,0-2,0,2,1,1,2,-2,A
2002-03-24,2001,Liverpool,Chelsea,1-0,1,0,1,1,1,1,H
2002-03-29,2001,Newcastle United,Everton,6-2,6,2,1,1,8,4,H
2002-03-30,2001,Arsenal,Sunderland,3-0,3,0,1,1,3,3,H
2002-03-30,2001,Bolton Wanderers,Aston Villa,3-2,3,2,1,1,5,1,H
2002-03-30,2001,Chelsea,Derby County,2-1,2,1,1,1,3,1,H
2002-03-30,2001,Leeds United,Manchester United,3-4,3,4,1,1,7,-1,A
2002-03-30,2001,Leicester City,Blackburn Rovers,2-1,2,1,1,1,3,1,H
2002-03-30,2001,Liverpool,Charlton Athletic,2-0,2,0,1,1,2,2,H
2002-03-30,2001,Middlesbrough,Tottenham Hotspur,1-1,1,1,1,1,2,0,D
2002-03-30,2001,Southampton,Fulham,1-1,1,1,1,1,2,0,D
2002-03-30,2001,West Ham United,Ipswich Town,3-1,3,1,1,1,4,2,H
2002-04-01,2001,Blackburn Rovers,Southampton,2-0,2,0,1,1,2,2,H
2002-04-01,2001,Charlton Athletic,Arsenal,0-3,0,3,1,1,3,-3,A
2002-04-01,2001,Derby County,Middlesbrough,0-1,0,1,1,1,1,-1,A
2002-04-01,2001,Everton,Bolton Wanderers,3-1,3,1,1,1,4,2,H
2002-04-01,2001,Fulham,West Ham United,0-1,0,1,1,1,1,-1,A
2002-04-01,2001,Ipswich Town,Chelsea,0-0,0,0,1,1,0,0,D
2002-04-01,2001,Sunderland,Leicester City,2-1,2,1,1,1,3,1,H
2002-04-01,2001,Tottenham Hotspur,Leeds United,2-1,2,1,1,1,3,1,H
2002-04-02,2001,Aston Villa,Newcastle United,1-1,1,1,1,1,2,0,D
2002-04-06,2001,Arsenal,Tottenham Hotspur,2-1,2,1,1,1,3,1,H
2002-04-06,2001,Bolton Wanderers,Ipswich Town,4-1,4,1,1,1,5,3,H
2002-04-06,2001,Chelsea,Everton,3-0,3,0,1,1,3,3,H
2002-04-06,2001,Leicester City,Manchester United,0-1,0,1,1,1,1,-1,A
2002-04-06,2001,Middlesbrough,Aston Villa,2-1,2,1,1,1,3,1,H
2002-04-06,2001,Southampton,Derby County,2-0,2,0,1,1,2,2,H
2002-04-06,2001,West Ham United,Charlton Athletic,2-0,2,0,1,1,2,2,H
2002-04-07,2001,Leeds United,Sunderland,2-0,2,0,1,1,2,2,H
2002-04-08,2001,Newcastle United,Fulham,1-1,1,1,1,1,2,0,D
2002-04-10,2001,Blackburn Rovers,Chelsea,0-0,0,0,1,1,0,0,D
2002-04-13,2001,Aston Villa,Leeds United,0-1,0,1,1,1,1,-1,A
2002-04-13,2001,Charlton Athletic,Southampton,1-1,1,1,1,1,2,0,D
2002-04-13,2001,Derby County,Newcastle United,2-3,2,3,1,1,5,-1,A
2002-04-13,2001,Everton,Leicester City,2-2,2,2,1,1,4,0,D
2002-04-13,2001,Sunderland,Liverpool,0-1,0,1,1,1,1,-1,A
2002-04-13,2001,Tottenham Hotspur,West Ham United,1-1,1,1,1,1,2,0,D
2002-04-20,2001,Bolton Wanderers,Tottenham Hotspur,1-1,1,1,1,1,2,0,D
2002-04-20,2001,Chelsea,Manchester United,0-3,0,3,1,1,3,-3,A
2002-04-20,2001,Leeds United,Fulham,0-1,0,1,1,1,1,-1,A
2002-04-20,2001,Leicester City,Aston Villa,2-2,2,2,1,1,4,0,D
2002-04-20,2001,Liverpool,Derby County,2-0,2,0,1,1,2,2,H
2002-04-20,2001,Middlesbrough,Blackburn Rovers,1-3,1,3,1,1,4,-2,A
2002-04-20,2001,Newcastle United,Charlton Athletic,3-0,3,0,1,1,3,3,H
2002-04-20,2001,Southampton,Everton,0-1,0,1,1,1,1,-1,A
2002-04-20,2001,West Ham United,Sunderland,3-0,3,0,1,1,3,3,H
2002-04-21,2001,Arsenal,Ipswich Town,2-0,2,0,1,1,2,2,H
2002-04-23,2001,Blackburn Rovers,Newcastle United,2-2,2,2,1,1,4,0,D
2002-04-23,2001,Fulham,Bolton Wanderers,3-0,3,0,1,1,3,3,H
2002-04-24,2001,Arsenal,West Ham United,2-0,2,0,1,1,2,2,H
2002-04-24,2001,Ipswich Town,Middlesbrough,1-0,1,0,1,1,1,1,H
2002-04-27,2001,Aston Villa,Southampton,2-1,2,1,1,1,3,1,H
2002-04-27,2001,Charlton Athletic,Sunderland,2-2,2,2,1,1,4,0,D
2002-04-27,2001,Derby County,Leeds United,0-1,0,1,1,1,1,-1,A
2002-04-27,2001,Fulham,Leicester City,0-0,0,0,1,1,0,0,D
2002-04-27,2001,Ipswich Town,Manchester United,0-1,0,1,1,1,1,-1,A
2002-04-27,2001,Middlesbrough,Chelsea,0-2,0,2,1,1,2,-2,A
2002-04-27,2001,Newcastle United,West Ham United,3-1,3,1,1,1,4,2,H
2002-04-27,2001,Tottenham Hotspur,Liverpool,1-0,1,0,1,1,1,1,H
2002-04-28,2001,Everton,Blackburn Rovers,1-2,1,2,1,1,3,-1,A
2002-04-29,2001,Bolton Wanderers,Arsenal,0-2,0,2,1,1,2,-2,A
2002-05-08,2001,Liverpool,Blackburn Rovers,4-3,4,3,1,1,7,1,H
2002-05-08,2001,Manchester United,Arsenal,0-1,0,1,1,1,1,-1,A
2002-05-11,2001,Arsenal,Everton,4-3,4,3,1,1,7,1,H
2002-05-11,2001,Blackburn Rovers,Fulham,3-0,3,0,1,1,3,3,H
2002-05-11,2001,Chelsea,Aston Villa,1-3,1,3,1,1,4,-2,A
2002-05-11,2001,Leeds United,Middlesbrough,1-0,1,0,1,1,1,1,H
2002-05-11,2001,Leicester City,Tottenham Hotspur,2-1,2,1,1,1,3,1,H
2002-05-11,2001,Liverpool,Ipswich Town,5-0,5,0,1,1,5,5,H
2002-05-11,2001,Manchester United,Charlton Athletic,0-0,0,0,1,1,0,0,D
2002-05-11,2001,Southampton,Newcastle United,3-1,3,1,1,1,4,2,H
2002-05-11,2001,Sunderland,Derby County,1-1,1,1,1,1,2,0,D
2002-05-11,2001,West Ham United,Bolton Wanderers,2-1,2,1,1,1,3,1,H
2002-08-17,2002,Blackburn Rovers,Sunderland,0-0,0,0,1,1,0,0,D
2002-08-17,2002,Charlton Athletic,Chelsea,2-3,2,3,1,1,5,-1,A
2002-08-17,2002,Everton,Tottenham Hotspur,2-2,2,2,1,1,4,0,D
2002-08-17,2002,Fulham,Bolton Wanderers,4-1,4,1,1,1,5,3,H
2002-08-17,2002,Leeds United,Manchester City,3-0,3,0,1,1,3,3,H
2002-08-17,2002,Manchester United,West Bromwich Albion,1-0,1,0,1,1,1,1,H
2002-08-17,2002,Southampton,Middlesbrough,0-0,0,0,1,1,0,0,D
2002-08-18,2002,Arsenal,Birmingham City,2-0,2,0,1,1,2,2,H
2002-08-18,2002,Aston Villa,Liverpool,0-1,0,1,1,1,1,-1,A
2002-08-19,2002,Newcastle United,West Ham United,4-0,4,0,1,1,4,4,H
2002-08-23,2002,Chelsea,Manchester United,2-2,2,2,1,1,4,0,D
2002-08-24,2002,Birmingham City,Blackburn Rovers,0-1,0,1,1,1,1,-1,A
2002-08-24,2002,Bolton Wanderers,Charlton Athletic,1-2,1,2,1,1,3,-1,A
2002-08-24,2002,Liverpool,Southampton,3-0,3,0,1,1,3,3,H
2002-08-24,2002,Manchester City,Newcastle United,1-0,1,0,1,1,1,1,H
2002-08-24,2002,Middlesbrough,Fulham,2-2,2,2,1,1,4,0,D
2002-08-24,2002,Sunderland,Everton,0-1,0,1,1,1,1,-1,A
2002-08-24,2002,Tottenham Hotspur,Aston Villa,1-0,1,0,1,1,1,1,H
2002-08-24,2002,West Bromwich Albion,Leeds United,1-3,1,3,1,1,4,-2,A
2002-08-24,2002,West Ham United,Arsenal,2-2,2,2,1,1,4,0,D
2002-08-27,2002,Arsenal,West Bromwich Albion,5-2,5,2,1,1,7,3,H
2002-08-27,2002,Charlton Athletic,Tottenham Hotspur,0-1,0,1,1,1,1,-1,A
2002-08-28,2002,Aston Villa,Manchester City,1-0,1,0,1,1,1,1,H
2002-08-28,2002,Blackburn Rovers,Liverpool,2-2,2,2,1,1,4,0,D
2002-08-28,2002,Everton,Birmingham City,1-1,1,1,1,1,2,0,D
2002-08-28,2002,Leeds United,Sunderland,0-1,0,1,1,1,1,-1,A
2002-08-28,2002,Southampton,Chelsea,1-1,1,1,1,1,2,0,D
2002-08-31,2002,Birmingham City,Leeds United,2-1,2,1,1,1,3,1,H
2002-08-31,2002,Manchester City,Everton,3-1,3,1,1,1,4,2,H
2002-08-31,2002,Middlesbrough,Blackburn Rovers,1-0,1,0,1,1,1,1,H
2002-08-31,2002,Sunderland,Manchester United,1-1,1,1,1,1,2,0,D
2002-08-31,2002,Tottenham Hotspur,Southampton,2-1,2,1,1,1,3,1,H
2002-08-31,2002,West Bromwich Albion,Fulham,1-0,1,0,1,1,1,1,H
2002-08-31,2002,West Ham United,Charlton Athletic,0-2,0,2,1,1,2,-2,A
2002-09-01,2002,Bolton Wanderers,Aston Villa,1-0,1,0,1,1,1,1,H
2002-09-01,2002,Chelsea,Arsenal,1-1,1,1,1,1,2,0,D
2002-09-02,2002,Liverpool,Newcastle United,2-2,2,2,1,1,4,0,D
2002-09-03,2002,Manchester United,Middlesbrough,1-0,1,0,1,1,1,1,H
2002-09-10,2002,Arsenal,Manchester City,2-1,2,1,1,1,3,1,H
2002-09-10,2002,Middlesbrough,Sunderland,3-0,3,0,1,1,3,3,H
2002-09-11,2002,Aston Villa,Charlton Athletic,2-0,2,0,1,1,2,2,H
2002-09-11,2002,Blackburn Rovers,Chelsea,2-3,2,3,1,1,5,-1,A
2002-09-11,2002,Fulham,Tottenham Hotspur,3-2,3,2,1,1,5,1,H
2002-09-11,2002,Liverpool,Birmingham City,2-2,2,2,1,1,4,0,D
2002-09-11,2002,Manchester United,Bolton Wanderers,0-1,0,1,1,1,1,-1,A
2002-09-11,2002,Newcastle United,Leeds United,0-2,0,2,1,1,2,-2,A
2002-09-11,2002,Southampton,Everton,1-0,1,0,1,1,1,1,H
2002-09-11,2002,West Ham United,West Bromwich Albion,0-1,0,1,1,1,1,-1,A
2002-09-14,2002,Bolton Wanderers,Liverpool,2-3,2,3,1,1,5,-1,A
2002-09-14,2002,Charlton Athletic,Arsenal,0-3,0,3,1,1,3,-3,A
2002-09-14,2002,Chelsea,Newcastle United,3-0,3,0,1,1,3,3,H
2002-09-14,2002,Everton,Middlesbrough,2-1,2,1,1,1,3,1,H
2002-09-14,2002,Leeds United,Manchester United,1-0,1,0,1,1,1,1,H
2002-09-14,2002,Sunderland,Fulham,0-3,0,3,1,1,3,-3,A
2002-09-14,2002,West Bromwich Albion,Southampton,1-0,1,0,1,1,1,1,H
2002-09-15,2002,Manchester City,Blackburn Rovers,2-2,2,2,1,1,4,0,D
2002-09-15,2002,Tottenham Hotspur,West Ham United,3-2,3,2,1,1,5,1,H
2002-09-16,2002,Birmingham City,Aston Villa,3-0,3,0,1,1,3,3,H
2002-09-21,2002,Arsenal,Bolton Wanderers,2-1,2,1,1,1,3,1,H
2002-09-21,2002,Liverpool,West Bromwich Albion,2-0,2,0,1,1,2,2,H
2002-09-21,2002,Manchester United,Tottenham Hotspur,1-0,1,0,1,1,1,1,H
2002-09-21,2002,Middlesbrough,Birmingham City,1-0,1,0,1,1,1,1,H
2002-09-21,2002,Newcastle United,Sunderland,2-0,2,0,1,1,2,2,H
2002-09-21,2002,Southampton,Charlton Athletic,0-0,0,0,1,1,0,0,D
2002-09-21,2002,West Ham United,Manchester City,0-0,0,0,1,1,0,0,D
2002-09-22,2002,Aston Villa,Everton,3-2,3,2,1,1,5,1,H
2002-09-22,2002,Blackburn Rovers,Leeds United,1-0,1,0,1,1,1,1,H
2002-09-23,2002,Fulham,Chelsea,0-0,0,0,1,1,0,0,D
2002-09-28,2002,Birmingham City,Newcastle United,0-2,0,2,1,1,2,-2,A
2002-09-28,2002,Bolton Wanderers,Southampton,1-1,1,1,1,1,2,0,D
2002-09-28,2002,Charlton Athletic,Manchester United,1-3,1,3,1,1,4,-2,A
2002-09-28,2002,Chelsea,West Ham United,2-3,2,3,1,1,5,-1,A
2002-09-28,2002,Everton,Fulham,2-0,2,0,1,1,2,2,H
2002-09-28,2002,Leeds United,Arsenal,1-4,1,4,1,1,5,-3,A
2002-09-28,2002,Manchester City,Liverpool,0-3,0,3,1,1,3,-3,A
2002-09-28,2002,Sunderland,Aston Villa,1-0,1,0,1,1,1,1,H
2002-09-28,2002,Tottenham Hotspur,Middlesbrough,0-3,0,3,1,1,3,-3,A
2002-09-30,2002,West Bromwich Albion,Blackburn Rovers,0-2,0,2,1,1,2,-2,A
2002-10-05,2002,Middlesbrough,Bolton Wanderers,2-0,2,0,1,1,2,2,H
2002-10-05,2002,Newcastle United,West Bromwich Albion,2-1,2,1,1,1,3,1,H
2002-10-05,2002,Southampton,Manchester City,2-0,2,0,1,1,2,2,H
2002-10-05,2002,West Ham United,Birmingham City,1-2,1,2,1,1,3,-1,A
2002-10-06,2002,Arsenal,Sunderland,3-1,3,1,1,1,4,2,H
2002-10-06,2002,Aston Villa,Leeds United,0-0,0,0,1,1,0,0,D
2002-10-06,2002,Blackburn Rovers,Tottenham Hotspur,1-2,1,2,1,1,3,-1,A
2002-10-06,2002,Fulham,Charlton Athletic,1-0,1,0,1,1,1,1,H
2002-10-06,2002,Liverpool,Chelsea,1-0,1,0,1,1,1,1,H
2002-10-07,2002,Manchester United,Everton,3-0,3,0,1,1,3,3,H
2002-10-19,2002,Blackburn Rovers,Newcastle United,5-2,5,2,1,1,7,3,H
2002-10-19,2002,Everton,Arsenal,2-1,2,1,1,1,3,1,H
2002-10-19,2002,Fulham,Manchester United,1-1,1,1,1,1,2,0,D
2002-10-19,2002,Leeds United,Liverpool,0-1,0,1,1,1,1,-1,A
2002-10-19,2002,Manchester City,Chelsea,0-3,0,3,1,1,3,-3,A
2002-10-19,2002,Sunderland,West Ham United,0-1,0,1,1,1,1,-1,A
2002-10-19,2002,West Bromwich Albion,Birmingham City,1-1,1,1,1,1,2,0,D
2002-10-20,2002,Charlton Athletic,Middlesbrough,1-0,1,0,1,1,1,1,H
2002-10-20,2002,Tottenham Hotspur,Bolton Wanderers,3-1,3,1,1,1,4,2,H
2002-10-21,2002,Aston Villa,Southampton,0-1,0,1,1,1,1,-1,A
2002-10-23,2002,Fulham,West Ham United,0-1,0,1,1,1,1,-1,A
2002-10-26,2002,Arsenal,Blackburn Rovers,1-2,1,2,1,1,3,-1,A
2002-10-26,2002,Birmingham City,Manchester City,0-2,0,2,1,1,2,-2,A
2002-10-26,2002,Chelsea,West Bromwich Albion,2-0,2,0,1,1,2,2,H
2002-10-26,2002,Liverpool,Tottenham Hotspur,2-1,2,1,1,1,3,1,H
2002-10-26,2002,Manchester United,Aston Villa,1-1,1,1,1,1,2,0,D
2002-10-26,2002,Middlesbrough,Leeds United,2-2,2,2,1,1,4,0,D
2002-10-26,2002,Newcastle United,Charlton Athletic,2-1,2,1,1,1,3,1,H
2002-10-27,2002,Southampton,Fulham,4-2,4,2,1,1,6,2,H
2002-10-27,2002,West Ham United,Everton,0-1,0,1,1,1,1,-1,A
2002-10-28,2002,Bolton Wanderers,Sunderland,1-1,1,1,1,1,2,0,D
2002-11-02,2002,Birmingham City,Bolton Wanderers,3-1,3,1,1,1,4,2,H
2002-11-02,2002,Liverpool,West Ham United,2-0,2,0,1,1,2,2,H
2002-11-02,2002,Manchester United,Southampton,2-1,2,1,1,1,3,1,H
2002-11-02,2002,West Bromwich Albion,Manchester City,1-2,1,2,1,1,3,-1,A
2002-11-03,2002,Blackburn Rovers,Aston Villa,0-0,0,0,1,1,0,0,D
2002-11-03,2002,Charlton Athletic,Sunderland,1-1,1,1,1,1,2,0,D
2002-11-03,2002,Fulham,Arsenal,0-1,0,1,1,1,1,-1,A
2002-11-03,2002,Leeds United,Everton,0-1,0,1,1,1,1,-1,A
2002-11-03,2002,Tottenham Hotspur,Chelsea,0-0,0,0,1,1,0,0,D
2002-11-04,2002,Newcastle United,Middlesbrough,2-0,2,0,1,1,2,2,H
2002-11-09,2002,Arsenal,Newcastle United,1-0,1,0,1,1,1,1,H
2002-11-09,2002,Aston Villa,Fulham,3-1,3,1,1,1,4,2,H
2002-11-09,2002,Bolton Wanderers,West Bromwich Albion,1-1,1,1,1,1,2,0,D
2002-11-09,2002,Chelsea,Birmingham City,3-0,3,0,1,1,3,3,H
2002-11-09,2002,Everton,Charlton Athletic,1-0,1,0,1,1,1,1,H
2002-11-09,2002,Manchester City,Manchester United,3-1,3,1,1,1,4,2,H
2002-11-09,2002,Middlesbrough,Liverpool,1-0,1,0,1,1,1,1,H
2002-11-09,2002,Southampton,Blackburn Rovers,1-1,1,1,1,1,2,0,D
2002-11-10,2002,Sunderland,Tottenham Hotspur,2-0,2,0,1,1,2,2,H
2002-11-10,2002,West Ham United,Leeds United,3-4,3,4,1,1,7,-1,A
2002-11-16,2002,Arsenal,Tottenham Hotspur,3-0,3,0,1,1,3,3,H
2002-11-16,2002,Chelsea,Middlesbrough,1-0,1,0,1,1,1,1,H
2002-11-16,2002,Manchester City,Charlton Athletic,0-1,0,1,1,1,1,-1,A
2002-11-16,2002,Newcastle United,Southampton,2-1,2,1,1,1,3,1,H
2002-11-16,2002,West Bromwich Albion,Aston Villa,0-0,0,0,1,1,0,0,D
2002-11-17,2002,Birmingham City,Fulham,0-0,0,0,1,1,0,0,D
2002-11-17,2002,Blackburn Rovers,Everton,0-1,0,1,1,1,1,-1,A
2002-11-17,2002,Leeds United,Bolton Wanderers,2-4,2,4,1,1,6,-2,A
2002-11-17,2002,Liverpool,Sunderland,0-0,0,0,1,1,0,0,D
2002-11-17,2002,West Ham United,Manchester United,1-1,1,1,1,1,2,0,D
2002-11-23,2002,Aston Villa,West Ham United,4-1,4,1,1,1,5,3,H
2002-11-23,2002,Bolton Wanderers,Chelsea,1-1,1,1,1,1,2,0,D
2002-11-23,2002,Everton,West Bromwich Albion,1-0,1,0,1,1,1,1,H
2002-11-23,2002,Fulham,Liverpool,3-2,3,2,1,1,5,1,H
2002-11-23,2002,Manchester United,Newcastle United,5-3,5,3,1,1,8,2,H
2002-11-23,2002,Middlesbrough,Manchester City,3-1,3,1,1,1,4,2,H
2002-11-23,2002,Southampton,Arsenal,3-2,3,2,1,1,5,1,H
2002-11-23,2002,Sunderland,Birmingham City,0-1,0,1,1,1,1,-1,A
2002-11-24,2002,Charlton Athletic,Blackburn Rovers,3-1,3,1,1,1,4,2,H
2002-11-24,2002,Tottenham Hotspur,Leeds United,2-0,2,0,1,1,2,2,H
2002-11-30,2002,Arsenal,Aston Villa,3-1,3,1,1,1,4,2,H
2002-11-30,2002,Birmingham City,Tottenham Hotspur,1-1,1,1,1,1,2,0,D
2002-11-30,2002,Blackburn Rovers,Fulham,2-1,2,1,1,1,3,1,H
2002-11-30,2002,Chelsea,Sunderland,3-0,3,0,1,1,3,3,H
2002-11-30,2002,Manchester City,Bolton Wanderers,2-0,2,0,1,1,2,2,H
2002-11-30,2002,West Bromwich Albion,Middlesbrough,1-0,1,0,1,1,1,1,H
2002-12-01,2002,Leeds United,Charlton Athletic,1-2,1,2,1,1,3,-1,A
2002-12-01,2002,Liverpool,Manchester United,1-2,1,2,1,1,3,-1,A
2002-12-01,2002,Newcastle United,Everton,2-1,2,1,1,1,3,1,H
2002-12-02,2002,West Ham United,Southampton,0-1,0,1,1,1,1,-1,A
2002-12-07,2002,Aston Villa,Newcastle United,0-1,0,1,1,1,1,-1,A
2002-12-07,2002,Bolton Wanderers,Blackburn Rovers,1-1,1,1,1,1,2,0,D
2002-12-07,2002,Charlton Athletic,Liverpool,2-0,2,0,1,1,2,2,H
2002-12-07,2002,Everton,Chelsea,1-3,1,3,1,1,4,-2,A
2002-12-07,2002,Fulham,Leeds United,1-0,1,0,1,1,1,1,H
2002-12-07,2002,Manchester United,Arsenal,2-0,2,0,1,1,2,2,H
2002-12-07,2002,Middlesbrough,West Ham United,2-2,2,2,1,1,4,0,D
2002-12-07,2002,Southampton,Birmingham City,2-0,2,0,1,1,2,2,H
2002-12-08,2002,Tottenham Hotspur,West Bromwich Albion,3-1,3,1,1,1,4,2,H
2002-12-09,2002,Sunderland,Manchester City,0-3,0,3,1,1,3,-3,A
2002-12-14,2002,Aston Villa,West Bromwich Albion,2-1,2,1,1,1,3,1,H
2002-12-14,2002,Charlton Athletic,Manchester City,2-2,2,2,1,1,4,0,D
2002-12-14,2002,Everton,Blackburn Rovers,2-1,2,1,1,1,3,1,H
2002-12-14,2002,Manchester United,West Ham United,3-0,3,0,1,1,3,3,H
2002-12-14,2002,Middlesbrough,Chelsea,1-1,1,1,1,1,2,0,D
2002-12-14,2002,Southampton,Newcastle United,1-1,1,1,1,1,2,0,D
2002-12-15,2002,Fulham,Birmingham City,0-1,0,1,1,1,1,-1,A
2002-12-15,2002,Sunderland,Liverpool,2-1,2,1,1,1,3,1,H
2002-12-15,2002,Tottenham Hotspur,Arsenal,1-1,1,1,1,1,2,0,D
2002-12-16,2002,Bolton Wanderers,Leeds United,0-3,0,3,1,1,3,-3,A
2002-12-21,2002,Arsenal,Middlesbrough,2-0,2,0,1,1,2,2,H
2002-12-21,2002,Birmingham City,Charlton Athletic,1-1,1,1,1,1,2,0,D
2002-12-21,2002,Chelsea,Aston Villa,2-0,2,0,1,1,2,2,H
2002-12-21,2002,Leeds United,Southampton,1-1,1,1,1,1,2,0,D
2002-12-21,2002,Newcastle United,Fulham,2-0,2,0,1,1,2,2,H
2002-12-21,2002,West Bromwich Albion,Sunderland,2-2,2,2,1,1,4,0,D
2002-12-21,2002,West Ham United,Bolton Wanderers,1-1,1,1,1,1,2,0,D
2002-12-22,2002,Blackburn Rovers,Manchester United,1-0,1,0,1,1,1,1,H
2002-12-22,2002,Liverpool,Everton,0-0,0,0,1,1,0,0,D
2002-12-23,2002,Manchester City,Tottenham Hotspur,2-3,2,3,1,1,5,-1,A
2002-12-26,2002,Birmingham City,Everton,1-1,1,1,1,1,2,0,D
2002-12-26,2002,Bolton Wanderers,Newcastle United,4-3,4,3,1,1,7,1,H
2002-12-26,2002,Chelsea,Southampton,0-0,0,0,1,1,0,0,D
2002-12-26,2002,Liverpool,Blackburn Rovers,1-1,1,1,1,1,2,0,D
2002-12-26,2002,Manchester City,Aston Villa,3-1,3,1,1,1,4,2,H
2002-12-26,2002,Middlesbrough,Manchester United,3-1,3,1,1,1,4,2,H
2002-12-26,2002,Sunderland,Leeds United,1-2,1,2,1,1,3,-1,A
2002-12-26,2002,Tottenham Hotspur,Charlton Athletic,2-2,2,2,1,1,4,0,D
2002-12-26,2002,West Bromwich Albion,Arsenal,1-2,1,2,1,1,3,-1,A
2002-12-26,2002,West Ham United,Fulham,1-1,1,1,1,1,2,0,D
2002-12-28,2002,Aston Villa,Middlesbrough,1-0,1,0,1,1,1,1,H
2002-12-28,2002,Blackburn Rovers,West Ham United,2-2,2,2,1,1,4,0,D
2002-12-28,2002,Charlton Athletic,West Bromwich Albion,1-0,1,0,1,1,1,1,H
2002-12-28,2002,Everton,Bolton Wanderers,0-0,0,0,1,1,0,0,D
2002-12-28,2002,Fulham,Manchester City,0-1,0,1,1,1,1,-1,A
2002-12-28,2002,Leeds United,Chelsea,2-0,2,0,1,1,2,2,H
2002-12-28,2002,Manchester United,Birmingham City,2-0,2,0,1,1,2,2,H
2002-12-28,2002,Southampton,Sunderland,2-1,2,1,1,1,3,1,H
2002-12-29,2002,Arsenal,Liverpool,1-1,1,1,1,1,2,0,D
2002-12-29,2002,Newcastle United,Tottenham Hotspur,2-1,2,1,1,1,3,1,H
2003-01-01,2002,Arsenal,Chelsea,3-2,3,2,1,1,5,1,H
2003-01-01,2002,Aston Villa,Bolton Wanderers,2-0,2,0,1,1,2,2,H
2003-01-01,2002,Blackburn Rovers,Middlesbrough,1-0,1,0,1,1,1,1,H
2003-01-01,2002,Everton,Manchester City,2-2,2,2,1,1,4,0,D
2003-01-01,2002,Leeds United,Birmingham City,2-0,2,0,1,1,2,2,H
2003-01-01,2002,Manchester United,Sunderland,2-1,2,1,1,1,3,1,H
2003-01-01,2002,Newcastle United,Liverpool,1-0,1,0,1,1,1,1,H
2003-01-01,2002,Southampton,Tottenham Hotspur,1-0,1,0,1,1,1,1,H
2003-01-11,2002,Bolton Wanderers,Fulham,0-0,0,0,1,1,0,0,D
2003-01-11,2002,Chelsea,Charlton Athletic,4-1,4,1,1,1,5,3,H
2003-01-11,2002,Liverpool,Aston Villa,1-1,1,1,1,1,2,0,D
2003-01-11,2002,Manchester City,Leeds United,2-1,2,1,1,1,3,1,H
2003-01-11,2002,Middlesbrough,Southampton,2-2,2,2,1,1,4,0,D
2003-01-11,2002,Sunderland,Blackburn Rovers,0-0,0,0,1,1,0,0,D
2003-01-11,2002,West Bromwich Albion,Manchester United,1-3,1,3,1,1,4,-2,A
2003-01-11,2002,West Ham United,Newcastle United,2-2,2,2,1,1,4,0,D
2003-01-12,2002,Birmingham City,Arsenal,0-4,0,4,1,1,4,-4,A
2003-01-12,2002,Tottenham Hotspur,Everton,4-3,4,3,1,1,7,1,H
2003-01-18,2002,Aston Villa,Tottenham Hotspur,0-1,0,1,1,1,1,-1,A
2003-01-18,2002,Blackburn Rovers,Birmingham City,1-1,1,1,1,1,2,0,D
2003-01-18,2002,Charlton Athletic,Bolton Wanderers,1-1,1,1,1,1,2,0,D
2003-01-18,2002,Everton,Sunderland,2-1,2,1,1,1,3,1,H
2003-01-18,2002,Leeds United,West Bromwich Albion,0-0,0,0,1,1,0,0,D
2003-01-18,2002,Manchester United,Chelsea,2-1,2,1,1,1,3,1,H
2003-01-18,2002,Newcastle United,Manchester City,2-0,2,0,1,1,2,2,H
2003-01-18,2002,Southampton,Liverpool,0-1,0,1,1,1,1,-1,A
2003-01-19,2002,Arsenal,West Ham United,3-1,3,1,1,1,4,2,H
2003-01-19,2002,Fulham,Middlesbrough,1-0,1,0,1,1,1,1,H
2003-01-22,2002,Charlton Athletic,West Ham United,4-2,4,2,1,1,6,2,H
2003-01-22,2002,Newcastle United,Bolton Wanderers,1-0,1,0,1,1,1,1,H
2003-01-28,2002,Bolton Wanderers,Everton,1-2,1,2,1,1,3,-1,A
2003-01-28,2002,Chelsea,Leeds United,3-2,3,2,1,1,5,1,H
2003-01-28,2002,Middlesbrough,Aston Villa,2-5,2,5,1,1,7,-3,A
2003-01-28,2002,Sunderland,Southampton,0-1,0,1,1,1,1,-1,A
2003-01-29,2002,Liverpool,Arsenal,2-2,2,2,1,1,4,0,D
2003-01-29,2002,Manchester City,Fulham,4-1,4,1,1,1,5,3,H
2003-01-29,2002,Tottenham Hotspur,Newcastle United,0-1,0,1,1,1,1,-1,A
2003-01-29,2002,West Bromwich Albion,Charlton Athletic,0-1,0,1,1,1,1,-1,A
2003-01-29,2002,West Ham United,Blackburn Rovers,2-1,2,1,1,1,3,1,H
2003-02-01,2002,Arsenal,Fulham,2-1,2,1,1,1,3,1,H
2003-02-01,2002,Bolton Wanderers,Birmingham City,4-2,4,2,1,1,6,2,H
2003-02-01,2002,Chelsea,Tottenham Hotspur,1-1,1,1,1,1,2,0,D
2003-02-01,2002,Everton,Leeds United,2-0,2,0,1,1,2,2,H
2003-02-01,2002,Manchester City,West Bromwich Albion,1-2,1,2,1,1,3,-1,A
2003-02-01,2002,Southampton,Manchester United,0-2,0,2,1,1,2,-2,A
2003-02-01,2002,Sunderland,Charlton Athletic,1-3,1,3,1,1,4,-2,A
2003-02-02,2002,Aston Villa,Blackburn Rovers,3-0,3,0,1,1,3,3,H
2003-02-02,2002,West Ham United,Liverpool,0-3,0,3,1,1,3,-3,A
2003-02-04,2002,Birmingham City,Manchester United,0-1,0,1,1,1,1,-1,A
2003-02-08,2002,Birmingham City,Chelsea,1-3,1,3,1,1,4,-2,A
2003-02-08,2002,Blackburn Rovers,Southampton,1-0,1,0,1,1,1,1,H
2003-02-08,2002,Charlton Athletic,Everton,2-1,2,1,1,1,3,1,H
2003-02-08,2002,Fulham,Aston Villa,2-1,2,1,1,1,3,1,H
2003-02-08,2002,Leeds United,West Ham United,1-0,1,0,1,1,1,1,H
2003-02-08,2002,Liverpool,Middlesbrough,1-1,1,1,1,1,2,0,D
2003-02-08,2002,Tottenham Hotspur,Sunderland,4-1,4,1,1,1,5,3,H
2003-02-08,2002,West Bromwich Albion,Bolton Wanderers,1-1,1,1,1,1,2,0,D
2003-02-09,2002,Manchester United,Manchester City,1-1,1,1,1,1,2,0,D
2003-02-09,2002,Newcastle United,Arsenal,1-1,1,1,1,1,2,0,D
2003-02-19,2002,Fulham,West Bromwich Albion,3-0,3,0,1,1,3,3,H
2003-02-22,2002,Bolton Wanderers,Manchester United,1-1,1,1,1,1,2,0,D
2003-02-22,2002,Charlton Athletic,Aston Villa,3-0,3,0,1,1,3,3,H
2003-02-22,2002,Chelsea,Blackburn Rovers,1-2,1,2,1,1,3,-1,A
2003-02-22,2002,Everton,Southampton,2-1,2,1,1,1,3,1,H
2003-02-22,2002,Leeds United,Newcastle United,0-3,0,3,1,1,3,-3,A
2003-02-22,2002,Manchester City,Arsenal,1-5,1,5,1,1,6,-4,A
2003-02-22,2002,Sunderland,Middlesbrough,1-3,1,3,1,1,4,-2,A
2003-02-23,2002,Birmingham City,Liverpool,2-1,2,1,1,1,3,1,H
2003-02-23,2002,West Bromwich Albion,West Ham United,1-2,1,2,1,1,3,-1,A
2003-02-24,2002,Tottenham Hotspur,Fulham,1-1,1,1,1,1,2,0,D
2003-03-01,2002,Blackburn Rovers,Manchester City,1-0,1,0,1,1,1,1,H
2003-03-01,2002,Fulham,Sunderland,1-0,1,0,1,1,1,1,H
2003-03-01,2002,Middlesbrough,Everton,1-1,1,1,1,1,2,0,D
2003-03-01,2002,Newcastle United,Chelsea,2-1,2,1,1,1,3,1,H
2003-03-01,2002,Southampton,West Bromwich Albion,1-0,1,0,1,1,1,1,H
2003-03-01,2002,West Ham United,Tottenham Hotspur,2-0,2,0,1,1,2,2,H
2003-03-02,2002,Arsenal,Charlton Athletic,2-0,2,0,1,1,2,2,H
2003-03-03,2002,Aston Villa,Birmingham City,0-2,0,2,1,1,2,-2,A
2003-03-05,2002,Manchester United,Leeds United,2-1,2,1,1,1,3,1,H
2003-03-05,2002,Middlesbrough,Newcastle United,1-0,1,0,1,1,1,1,H
2003-03-08,2002,Liverpool,Bolton Wanderers,2-0,2,0,1,1,2,2,H
2003-03-15,2002,Aston Villa,Manchester United,0-1,0,1,1,1,1,-1,A
2003-03-15,2002,Blackburn Rovers,Arsenal,2-0,2,0,1,1,2,2,H
2003-03-15,2002,Charlton Athletic,Newcastle United,0-2,0,2,1,1,2,-2,A
2003-03-15,2002,Everton,West Ham United,0-0,0,0,1,1,0,0,D
2003-03-15,2002,Fulham,Southampton,2-2,2,2,1,1,4,0,D
2003-03-15,2002,Leeds United,Middlesbrough,2-3,2,3,1,1,5,-1,A
2003-03-15,2002,Sunderland,Bolton Wanderers,0-2,0,2,1,1,2,-2,A
2003-03-16,2002,Manchester City,Birmingham City,1-0,1,0,1,1,1,1,H
2003-03-16,2002,Tottenham Hotspur,Liverpool,2-3,2,3,1,1,5,-1,A
2003-03-16,2002,West Bromwich Albion,Chelsea,0-2,0,2,1,1,2,-2,A
2003-03-22,2002,Birmingham City,West Bromwich Albion,1-0,1,0,1,1,1,1,H
2003-03-22,2002,Chelsea,Manchester City,5-0,5,0,1,1,5,5,H
2003-03-22,2002,Manchester United,Fulham,3-0,3,0,1,1,3,3,H
2003-03-22,2002,Middlesbrough,Charlton Athletic,1-1,1,1,1,1,2,0,D
2003-03-22,2002,Newcastle United,Blackburn Rovers,5-1,5,1,1,1,6,4,H
2003-03-22,2002,Southampton,Aston Villa,2-2,2,2,1,1,4,0,D
2003-03-22,2002,West Ham United,Sunderland,2-0,2,0,1,1,2,2,H
2003-03-23,2002,Arsenal,Everton,2-1,2,1,1,1,3,1,H
2003-03-23,2002,Liverpool,Leeds United,3-1,3,1,1,1,4,2,H
2003-03-24,2002,Bolton Wanderers,Tottenham Hotspur,1-0,1,0,1,1,1,1,H
2003-04-05,2002,Aston Villa,Arsenal,1-1,1,1,1,1,2,0,D
2003-04-05,2002,Bolton Wanderers,Manchester City,2-0,2,0,1,1,2,2,H
2003-04-05,2002,Charlton Athletic,Leeds United,1-6,1,6,1,1,7,-5,A
2003-04-05,2002,Manchester United,Liverpool,4-0,4,0,1,1,4,4,H
2003-04-05,2002,Middlesbrough,West Bromwich Albion,3-0,3,0,1,1,3,3,H
2003-04-05,2002,Southampton,West Ham United,1-1,1,1,1,1,2,0,D
2003-04-05,2002,Sunderland,Chelsea,1-2,1,2,1,1,3,-1,A
2003-04-05,2002,Tottenham Hotspur,Birmingham City,2-1,2,1,1,1,3,1,H
2003-04-06,2002,Everton,Newcastle United,2-1,2,1,1,1,3,1,H
2003-04-07,2002,Fulham,Blackburn Rovers,0-4,0,4,1,1,4,-4,A
2003-04-12,2002,Birmingham City,Sunderland,2-0,2,0,1,1,2,2,H
2003-04-12,2002,Blackburn Rovers,Charlton Athletic,1-0,1,0,1,1,1,1,H
2003-04-12,2002,Chelsea,Bolton Wanderers,1-0,1,0,1,1,1,1,H
2003-04-12,2002,Leeds United,Tottenham Hotspur,2-2,2,2,1,1,4,0,D
2003-04-12,2002,Liverpool,Fulham,2-0,2,0,1,1,2,2,H
2003-04-12,2002,Manchester City,Middlesbrough,0-0,0,0,1,1,0,0,D
2003-04-12,2002,Newcastle United,Manchester United,2-6,2,6,1,1,8,-4,A
2003-04-12,2002,West Bromwich Albion,Everton,1-2,1,2,1,1,3,-1,A
2003-04-12,2002,West Ham United,Aston Villa,2-2,2,2,1,1,4,0,D
2003-04-16,2002,Arsenal,Manchester United,2-2,2,2,1,1,4,0,D
2003-04-18,2002,Tottenham Hotspur,Manchester City,0-2,0,2,1,1,2,-2,A
2003-04-19,2002,Aston Villa,Chelsea,2-1,2,1,1,1,3,1,H
2003-04-19,2002,Bolton Wanderers,West Ham United,1-0,1,0,1,1,1,1,H
2003-04-19,2002,Charlton Athletic,Birmingham City,0-2,0,2,1,1,2,-2,A
2003-04-19,2002,Everton,Liverpool,1-2,1,2,1,1,3,-1,A
2003-04-19,2002,Fulham,Newcastle United,2-1,2,1,1,1,3,1,H
2003-04-19,2002,Manchester United,Blackburn Rovers,3-1,3,1,1,1,4,2,H
2003-04-19,2002,Middlesbrough,Arsenal,0-2,0,2,1,1,2,-2,A
2003-04-19,2002,Southampton,Leeds United,3-2,3,2,1,1,5,1,H
2003-04-19,2002,Sunderland,West Bromwich Albion,1-2,1,2,1,1,3,-1,A
2003-04-21,2002,Birmingham City,Southampton,3-2,3,2,1,1,5,1,H
2003-04-21,2002,Blackburn Rovers,Bolton Wanderers,0-0,0,0,1,1,0,0,D
2003-04-21,2002,Chelsea,Everton,4-1,4,1,1,1,5,3,H
2003-04-21,2002,Liverpool,Charlton Athletic,2-1,2,1,1,1,3,1,H
2003-04-21,2002,Manchester City,Sunderland,3-0,3,0,1,1,3,3,H
2003-04-21,2002,Newcastle United,Aston Villa,1-1,1,1,1,1,2,0,D
2003-04-21,2002,West Bromwich Albion,Tottenham Hotspur,2-3,2,3,1,1,5,-1,A
2003-04-21,2002,West Ham United,Middlesbrough,1-0,1,0,1,1,1,1,H
2003-04-22,2002,Leeds United,Fulham,2-0,2,0,1,1,2,2,H
2003-04-26,2002,Birmingham City,Middlesbrough,3-0,3,0,1,1,3,3,H
2003-04-26,2002,Bolton Wanderers,Arsenal,2-2,2,2,1,1,4,0,D
2003-04-26,2002,Charlton Athletic,Southampton,2-1,2,1,1,1,3,1,H
2003-04-26,2002,Chelsea,Fulham,1-1,1,1,1,1,2,0,D
2003-04-26,2002,Everton,Aston Villa,2-1,2,1,1,1,3,1,H
2003-04-26,2002,Leeds United,Blackburn Rovers,2-3,2,3,1,1,5,-1,A
2003-04-26,2002,Sunderland,Newcastle United,0-1,0,1,1,1,1,-1,A
2003-04-26,2002,West Bromwich Albion,Liverpool,0-6,0,6,1,1,6,-6,A
2003-04-27,2002,Manchester City,West Ham United,0-1,0,1,1,1,1,-1,A
2003-04-27,2002,Tottenham Hotspur,Manchester United,0-2,0,2,1,1,2,-2,A
2003-05-03,2002,Aston Villa,Sunderland,1-0,1,0,1,1,1,1,H
2003-05-03,2002,Blackburn Rovers,West Bromwich Albion,1-1,1,1,1,1,2,0,D
2003-05-03,2002,Fulham,Everton,2-0,2,0,1,1,2,2,H
2003-05-03,2002,Liverpool,Manchester City,1-2,1,2,1,1,3,-1,A
2003-05-03,2002,Manchester United,Charlton Athletic,4-1,4,1,1,1,5,3,H
2003-05-03,2002,Middlesbrough,Tottenham Hotspur,5-1,5,1,1,1,6,4,H
2003-05-03,2002,Newcastle United,Birmingham City,1-0,1,0,1,1,1,1,H
2003-05-03,2002,Southampton,Bolton Wanderers,0-0,0,0,1,1,0,0,D
2003-05-03,2002,West Ham United,Chelsea,1-0,1,0,1,1,1,1,H
2003-05-04,2002,Arsenal,Leeds United,2-3,2,3,1,1,5,-1,A
2003-05-07,2002,Arsenal,Southampton,6-1,6,1,1,1,7,5,H
2003-05-11,2002,Birmingham City,West Ham United,2-2,2,2,1,1,4,0,D
2003-05-11,2002,Bolton Wanderers,Middlesbrough,2-1,2,1,1,1,3,1,H
2003-05-11,2002,Charlton Athletic,Fulham,0-1,0,1,1,1,1,-1,A
2003-05-11,2002,Chelsea,Liverpool,2-1,2,1,1,1,3,1,H
2003-05-11,2002,Everton,Manchester United,1-2,1,2,1,1,3,-1,A
2003-05-11,2002,Leeds United,Aston Villa,3-1,3,1,1,1,4,2,H
2003-05-11,2002,Manchester City,Southampton,0-1,0,1,1,1,1,-1,A
2003-05-11,2002,Sunderland,Arsenal,0-4,0,4,1,1,4,-4,A
2003-05-11,2002,Tottenham Hotspur,Blackburn Rovers,0-4,0,4,1,1,4,-4,A
2003-05-11,2002,West Bromwich Albion,Newcastle United,2-2,2,2,1,1,4,0,D
2003-08-16,2003,Arsenal,Everton,2-1,2,1,1,1,3,1,H
2003-08-16,2003,Birmingham City,Tottenham Hotspur,1-0,1,0,1,1,1,1,H
2003-08-16,2003,Blackburn Rovers,Wolverhampton Wanderers,5-1,5,1,1,1,6,4,H
2003-08-16,2003,Fulham,Middlesbrough,3-2,3,2,1,1,5,1,H
2003-08-16,2003,Leicester City,Southampton,2-2,2,2,1,1,4,0,D
2003-08-16,2003,Manchester United,Bolton Wanderers,4-0,4,0,1,1,4,4,H
2003-08-16,2003,Portsmouth,Aston Villa,2-1,2,1,1,1,3,1,H
2003-08-17,2003,Charlton Athletic,Manchester City,0-3,0,3,1,1,3,-3,A
2003-08-17,2003,Leeds United,Newcastle United,2-2,2,2,1,1,4,0,D
2003-08-17,2003,Liverpool,Chelsea,1-2,1,2,1,1,3,-1,A
2003-08-23,2003,Bolton Wanderers,Blackburn Rovers,2-2,2,2,1,1,4,0,D
2003-08-23,2003,Chelsea,Leicester City,2-1,2,1,1,1,3,1,H
2003-08-23,2003,Everton,Fulham,3-1,3,1,1,1,4,2,H
2003-08-23,2003,Manchester City,Portsmouth,1-1,1,1,1,1,2,0,D
2003-08-23,2003,Newcastle United,Manchester United,1-2,1,2,1,1,3,-1,A
2003-08-23,2003,Southampton,Birmingham City,0-0,0,0,1,1,0,0,D
2003-08-23,2003,Tottenham Hotspur,Leeds United,2-1,2,1,1,1,3,1,H
2003-08-23,2003,Wolverhampton Wanderers,Charlton Athletic,0-4,0,4,1,1,4,-4,A
2003-08-24,2003,Aston Villa,Liverpool,0-0,0,0,1,1,0,0,D
2003-08-24,2003,Middlesbrough,Arsenal,0-4,0,4,1,1,4,-4,A
2003-08-25,2003,Blackburn Rovers,Manchester City,2-3,2,3,1,1,5,-1,A
2003-08-26,2003,Charlton Athletic,Everton,2-2,2,2,1,1,4,0,D
2003-08-26,2003,Leeds United,Southampton,0-0,0,0,1,1,0,0,D
2003-08-26,2003,Leicester City,Middlesbrough,0-0,0,0,1,1,0,0,D
2003-08-26,2003,Portsmouth,Bolton Wanderers,4-0,4,0,1,1,4,4,H
2003-08-27,2003,Arsenal,Aston Villa,2-0,2,0,1,1,2,2,H
2003-08-27,2003,Liverpool,Tottenham Hotspur,0-0,0,0,1,1,0,0,D
2003-08-27,2003,Manchester United,Wolverhampton Wanderers,1-0,1,0,1,1,1,1,H
2003-08-30,2003,Aston Villa,Leicester City,3-1,3,1,1,1,4,2,H
2003-08-30,2003,Bolton Wanderers,Charlton Athletic,0-0,0,0,1,1,0,0,D
2003-08-30,2003,Chelsea,Blackburn Rovers,2-2,2,2,1,1,4,0,D
2003-08-30,2003,Everton,Liverpool,0-3,0,3,1,1,3,-3,A
2003-08-30,2003,Middlesbrough,Leeds United,2-3,2,3,1,1,5,-1,A
2003-08-30,2003,Newcastle United,Birmingham City,0-1,0,1,1,1,1,-1,A
2003-08-30,2003,Tottenham Hotspur,Fulham,0-3,0,3,1,1,3,-3,A
2003-08-30,2003,Wolverhampton Wanderers,Portsmouth,0-0,0,0,1,1,0,0,D
2003-08-31,2003,Manchester City,Arsenal,1-2,1,2,1,1,3,-1,A
2003-08-31,2003,Southampton,Manchester United,1-0,1,0,1,1,1,1,H
2003-09-13,2003,Arsenal,Portsmouth,1-1,1,1,1,1,2,0,D
2003-09-13,2003,Blackburn Rovers,Liverpool,1-3,1,3,1,1,4,-2,A
2003-09-13,2003,Bolton Wanderers,Middlesbrough,2-0,2,0,1,1,2,2,H
2003-09-13,2003,Charlton Athletic,Manchester United,0-2,0,2,1,1,2,-2,A
2003-09-13,2003,Chelsea,Tottenham Hotspur,4-2,4,2,1,1,6,2,H
2003-09-13,2003,Everton,Newcastle United,2-2,2,2,1,1,4,0,D
2003-09-13,2003,Southampton,Wolverhampton Wanderers,2-0,2,0,1,1,2,2,H
2003-09-14,2003,Birmingham City,Fulham,2-2,2,2,1,1,4,0,D
2003-09-14,2003,Manchester City,Aston Villa,4-1,4,1,1,1,5,3,H
2003-09-15,2003,Leicester City,Leeds United,4-0,4,0,1,1,4,4,H
2003-09-20,2003,Aston Villa,Charlton Athletic,2-1,2,1,1,1,3,1,H
2003-09-20,2003,Fulham,Manchester City,2-2,2,2,1,1,4,0,D
2003-09-20,2003,Leeds United,Birmingham City,0-2,0,2,1,1,2,-2,A
2003-09-20,2003,Liverpool,Leicester City,2-1,2,1,1,1,3,1,H
2003-09-20,2003,Newcastle United,Bolton Wanderers,0-0,0,0,1,1,0,0,D
2003-09-20,2003,Portsmouth,Blackburn Rovers,1-2,1,2,1,1,3,-1,A
2003-09-20,2003,Tottenham Hotspur,Southampton,1-3,1,3,1,1,4,-2,A
2003-09-20,2003,Wolverhampton Wanderers,Chelsea,0-5,0,5,1,1,5,-5,A
2003-09-21,2003,Manchester United,Arsenal,0-0,0,0,1,1,0,0,D
2003-09-21,2003,Middlesbrough,Everton,1-0,1,0,1,1,1,1,H
2003-09-26,2003,Arsenal,Newcastle United,3-2,3,2,1,1,5,1,H
2003-09-27,2003,Birmingham City,Portsmouth,2-0,2,0,1,1,2,2,H
2003-09-27,2003,Bolton Wanderers,Wolverhampton Wanderers,1-1,1,1,1,1,2,0,D
2003-09-27,2003,Chelsea,Aston Villa,1-0,1,0,1,1,1,1,H
2003-09-27,2003,Leicester City,Manchester United,1-4,1,4,1,1,5,-3,A
2003-09-27,2003,Southampton,Middlesbrough,0-1,0,1,1,1,1,-1,A
2003-09-28,2003,Blackburn Rovers,Fulham,0-2,0,2,1,1,2,-2,A
2003-09-28,2003,Charlton Athletic,Liverpool,3-2,3,2,1,1,5,1,H
2003-09-28,2003,Everton,Leeds United,4-0,4,0,1,1,4,4,H
2003-09-28,2003,Manchester City,Tottenham Hotspur,0-0,0,0,1,1,0,0,D
2003-10-04,2003,Fulham,Leicester City,2-0,2,0,1,1,2,2,H
2003-10-04,2003,Leeds United,Blackburn Rovers,2-1,2,1,1,1,3,1,H
2003-10-04,2003,Liverpool,Arsenal,1-2,1,2,1,1,3,-1,A
2003-10-04,2003,Manchester United,Birmingham City,3-0,3,0,1,1,3,3,H
2003-10-04,2003,Newcastle United,Southampton,1-0,1,0,1,1,1,1,H
2003-10-04,2003,Portsmouth,Charlton Athletic,1-2,1,2,1,1,3,-1,A
2003-10-04,2003,Tottenham Hotspur,Everton,3-0,3,0,1,1,3,3,H
2003-10-04,2003,Wolverhampton Wanderers,Manchester City,1-0,1,0,1,1,1,1,H
2003-10-05,2003,Aston Villa,Bolton Wanderers,1-1,1,1,1,1,2,0,D
2003-10-05,2003,Middlesbrough,Chelsea,1-2,1,2,1,1,3,-1,A
2003-10-14,2003,Birmingham City,Chelsea,0-0,0,0,1,1,0,0,D
2003-10-18,2003,Arsenal,Chelsea,2-1,2,1,1,1,3,1,H
2003-10-18,2003,Fulham,Wolverhampton Wanderers,0-0,0,0,1,1,0,0,D
2003-10-18,2003,Leeds United,Manchester United,0-1,0,1,1,1,1,-1,A
2003-10-18,2003,Manchester City,Bolton Wanderers,6-2,6,2,1,1,8,4,H
2003-10-18,2003,Middlesbrough,Newcastle United,0-1,0,1,1,1,1,-1,A
2003-10-18,2003,Portsmouth,Liverpool,1-0,1,0,1,1,1,1,H
2003-10-19,2003,Birmingham City,Aston Villa,0-0,0,0,1,1,0,0,D
2003-10-19,2003,Everton,Southampton,0-0,0,0,1,1,0,0,D
2003-10-19,2003,Leicester City,Tottenham Hotspur,1-2,1,2,1,1,3,-1,A
2003-10-20,2003,Blackburn Rovers,Charlton Athletic,0-1,0,1,1,1,1,-1,A
2003-10-21,2003,Fulham,Newcastle United,2-3,2,3,1,1,5,-1,A
2003-10-25,2003,Aston Villa,Everton,0-0,0,0,1,1,0,0,D
2003-10-25,2003,Bolton Wanderers,Birmingham City,0-1,0,1,1,1,1,-1,A
2003-10-25,2003,Chelsea,Manchester City,1-0,1,0,1,1,1,1,H
2003-10-25,2003,Liverpool,Leeds United,3-1,3,1,1,1,4,2,H
2003-10-25,2003,Manchester United,Fulham,1-3,1,3,1,1,4,-2,A
2003-10-25,2003,Newcastle United,Portsmouth,3-0,3,0,1,1,3,3,H
2003-10-25,2003,Southampton,Blackburn Rovers,2-0,2,0,1,1,2,2,H
2003-10-25,2003,Wolverhampton Wanderers,Leicester City,4-3,4,3,1,1,7,1,H
2003-10-26,2003,Charlton Athletic,Arsenal,1-1,1,1,1,1,2,0,D
2003-10-26,2003,Tottenham Hotspur,Middlesbrough,0-0,0,0,1,1,0,0,D
2003-11-01,2003,Everton,Chelsea,0-1,0,1,1,1,1,-1,A
2003-11-01,2003,Leeds United,Arsenal,1-4,1,4,1,1,5,-3,A
2003-11-01,2003,Manchester United,Portsmouth,3-0,3,0,1,1,3,3,H
2003-11-01,2003,Middlesbrough,Wolverhampton Wanderers,2-0,2,0,1,1,2,2,H
2003-11-01,2003,Newcastle United,Aston Villa,1-1,1,1,1,1,2,0,D
2003-11-01,2003,Southampton,Manchester City,0-2,0,2,1,1,2,-2,A
2003-11-01,2003,Tottenham Hotspur,Bolton Wanderers,0-1,0,1,1,1,1,-1,A
2003-11-02,2003,Fulham,Liverpool,1-2,1,2,1,1,3,-1,A
2003-11-02,2003,Leicester City,Blackburn Rovers,2-0,2,0,1,1,2,2,H
2003-11-03,2003,Birmingham City,Charlton Athletic,1-2,1,2,1,1,3,-1,A
2003-11-08,2003,Arsenal,Tottenham Hotspur,2-1,2,1,1,1,3,1,H
2003-11-08,2003,Aston Villa,Middlesbrough,0-2,0,2,1,1,2,-2,A
2003-11-08,2003,Bolton Wanderers,Southampton,0-0,0,0,1,1,0,0,D
2003-11-08,2003,Charlton Athletic,Fulham,3-1,3,1,1,1,4,2,H
2003-11-08,2003,Portsmouth,Leeds United,6-1,6,1,1,1,7,5,H
2003-11-08,2003,Wolverhampton Wanderers,Birmingham City,1-1,1,1,1,1,2,0,D
2003-11-09,2003,Chelsea,Newcastle United,5-0,5,0,1,1,5,5,H
2003-11-09,2003,Liverpool,Manchester United,1-2,1,2,1,1,3,-1,A
2003-11-09,2003,Manchester City,Leicester City,0-3,0,3,1,1,3,-3,A
2003-11-10,2003,Blackburn Rovers,Everton,2-1,2,1,1,1,3,1,H
2003-11-22,2003,Birmingham City,Arsenal,0-3,0,3,1,1,3,-3,A
2003-11-22,2003,Everton,Wolverhampton Wanderers,2-0,2,0,1,1,2,2,H
2003-11-22,2003,Leeds United,Bolton Wanderers,0-2,0,2,1,1,2,-2,A
2003-11-22,2003,Leicester City,Charlton Athletic,1-1,1,1,1,1,2,0,D
2003-11-22,2003,Manchester United,Blackburn Rovers,2-1,2,1,1,1,3,1,H
2003-11-22,2003,Middlesbrough,Liverpool,0-0,0,0,1,1,0,0,D
2003-11-22,2003,Newcastle United,Manchester City,3-0,3,0,1,1,3,3,H
2003-11-22,2003,Southampton,Chelsea,0-1,0,1,1,1,1,-1,A
2003-11-23,2003,Tottenham Hotspur,Aston Villa,2-1,2,1,1,1,3,1,H
2003-11-24,2003,Fulham,Portsmouth,2-0,2,0,1,1,2,2,H
2003-11-29,2003,Aston Villa,Southampton,1-0,1,0,1,1,1,1,H
2003-11-29,2003,Blackburn Rovers,Tottenham Hotspur,1-0,1,0,1,1,1,1,H
2003-11-29,2003,Bolton Wanderers,Everton,2-0,2,0,1,1,2,2,H
2003-11-29,2003,Charlton Athletic,Leeds United,0-1,0,1,1,1,1,-1,A
2003-11-29,2003,Portsmouth,Leicester City,0-2,0,2,1,1,2,-2,A
2003-11-29,2003,Wolverhampton Wanderers,Newcastle United,1-1,1,1,1,1,2,0,D
2003-11-30,2003,Arsenal,Fulham,0-0,0,0,1,1,0,0,D
2003-11-30,2003,Chelsea,Manchester United,1-0,1,0,1,1,1,1,H
2003-11-30,2003,Liverpool,Birmingham City,3-1,3,1,1,1,4,2,H
2003-11-30,2003,Manchester City,Middlesbrough,0-1,0,1,1,1,1,-1,A
2003-12-06,2003,Birmingham City,Blackburn Rovers,0-4,0,4,1,1,4,-4,A
2003-12-06,2003,Fulham,Bolton Wanderers,2-1,2,1,1,1,3,1,H
2003-12-06,2003,Leeds United,Chelsea,1-1,1,1,1,1,2,0,D
2003-12-06,2003,Leicester City,Arsenal,1-1,1,1,1,1,2,0,D
2003-12-06,2003,Manchester United,Aston Villa,4-0,4,0,1,1,4,4,H
2003-12-06,2003,Middlesbrough,Portsmouth,0-0,0,0,1,1,0,0,D
2003-12-06,2003,Newcastle United,Liverpool,1-1,1,1,1,1,2,0,D
2003-12-06,2003,Tottenham Hotspur,Wolverhampton Wanderers,5-2,5,2,1,1,7,3,H
2003-12-07,2003,Everton,Manchester City,0-0,0,0,1,1,0,0,D
2003-12-07,2003,Southampton,Charlton Athletic,3-2,3,2,1,1,5,1,H
2003-12-13,2003,Chelsea,Bolton Wanderers,1-2,1,2,1,1,3,-1,A
2003-12-13,2003,Leicester City,Birmingham City,0-2,0,2,1,1,2,-2,A
2003-12-13,2003,Liverpool,Southampton,1-2,1,2,1,1,3,-1,A
2003-12-13,2003,Manchester United,Manchester City,3-1,3,1,1,1,4,2,H
2003-12-13,2003,Middlesbrough,Charlton Athletic,0-0,0,0,1,1,0,0,D
2003-12-13,2003,Newcastle United,Tottenham Hotspur,4-0,4,0,1,1,4,4,H
2003-12-13,2003,Portsmouth,Everton,1-2,1,2,1,1,3,-1,A
2003-12-14,2003,Arsenal,Blackburn Rovers,1-0,1,0,1,1,1,1,H
2003-12-14,2003,Aston Villa,Wolverhampton Wanderers,3-2,3,2,1,1,5,1,H
2003-12-14,2003,Leeds United,Fulham,3-2,3,2,1,1,5,1,H
2003-12-20,2003,Blackburn Rovers,Aston Villa,0-2,0,2,1,1,2,-2,A
2003-12-20,2003,Bolton Wanderers,Arsenal,1-1,1,1,1,1,2,0,D
2003-12-20,2003,Charlton Athletic,Newcastle United,0-0,0,0,1,1,0,0,D
2003-12-20,2003,Everton,Leicester City,3-2,3,2,1,1,5,1,H
2003-12-20,2003,Fulham,Chelsea,0-1,0,1,1,1,1,-1,A
2003-12-21,2003,Southampton,Portsmouth,3-0,3,0,1,1,3,3,H
2003-12-21,2003,Tottenham Hotspur,Manchester United,1-2,1,2,1,1,3,-1,A
2003-12-22,2003,Manchester City,Leeds United,1-1,1,1,1,1,2,0,D
2003-12-26,2003,Arsenal,Wolverhampton Wanderers,3-0,3,0,1,1,3,3,H
2003-12-26,2003,Birmingham City,Manchester City,2-1,2,1,1,1,3,1,H
2003-12-26,2003,Blackburn Rovers,Middlesbrough,2-2,2,2,1,1,4,0,D
2003-12-26,2003,Charlton Athletic,Chelsea,4-2,4,2,1,1,6,2,H
2003-12-26,2003,Fulham,Southampton,2-0,2,0,1,1,2,2,H
2003-12-26,2003,Leeds United,Aston Villa,0-0,0,0,1,1,0,0,D
2003-12-26,2003,Leicester City,Newcastle United,1-1,1,1,1,1,2,0,D
2003-12-26,2003,Liverpool,Bolton Wanderers,3-1,3,1,1,1,4,2,H
2003-12-26,2003,Manchester United,Everton,3-2,3,2,1,1,5,1,H
2003-12-26,2003,Portsmouth,Tottenham Hotspur,2-0,2,0,1,1,2,2,H
2003-12-28,2003,Aston Villa,Fulham,3-0,3,0,1,1,3,3,H
2003-12-28,2003,Bolton Wanderers,Leicester City,2-2,2,2,1,1,4,0,D
2003-12-28,2003,Chelsea,Portsmouth,3-0,3,0,1,1,3,3,H
2003-12-28,2003,Everton,Birmingham City,1-0,1,0,1,1,1,1,H
2003-12-28,2003,Manchester City,Liverpool,2-2,2,2,1,1,4,0,D
2003-12-28,2003,Middlesbrough,Manchester United,0-1,0,1,1,1,1,-1,A
2003-12-28,2003,Newcastle United,Blackburn Rovers,0-1,0,1,1,1,1,-1,A
2003-12-28,2003,Tottenham Hotspur,Charlton Athletic,0-1,0,1,1,1,1,-1,A
2003-12-28,2003,Wolverhampton Wanderers,Leeds United,3-1,3,1,1,1,4,2,H
2003-12-29,2003,Southampton,Arsenal,0-1,0,1,1,1,1,-1,A
2004-01-06,2003,Aston Villa,Portsmouth,2-1,2,1,1,1,3,1,H
2004-01-07,2003,Bolton Wanderers,Manchester United,1-2,1,2,1,1,3,-1,A
2004-01-07,2003,Chelsea,Liverpool,0-1,0,1,1,1,1,-1,A
2004-01-07,2003,Everton,Arsenal,1-1,1,1,1,1,2,0,D
2004-01-07,2003,Manchester City,Charlton Athletic,1-1,1,1,1,1,2,0,D
2004-01-07,2003,Middlesbrough,Fulham,2-1,2,1,1,1,3,1,H
2004-01-07,2003,Newcastle United,Leeds United,1-0,1,0,1,1,1,1,H
2004-01-07,2003,Southampton,Leicester City,0-0,0,0,1,1,0,0,D
2004-01-07,2003,Tottenham Hotspur,Birmingham City,4-1,4,1,1,1,5,3,H
2004-01-07,2003,Wolverhampton Wanderers,Blackburn Rovers,2-2,2,2,1,1,4,0,D
2004-01-10,2003,Arsenal,Middlesbrough,4-1,4,1,1,1,5,3,H
2004-01-10,2003,Birmingham City,Southampton,2-1,2,1,1,1,3,1,H
2004-01-10,2003,Blackburn Rovers,Bolton Wanderers,3-4,3,4,1,1,7,-1,A
2004-01-10,2003,Charlton Athletic,Wolverhampton Wanderers,2-0,2,0,1,1,2,2,H
2004-01-10,2003,Fulham,Everton,2-1,2,1,1,1,3,1,H
2004-01-10,2003,Leeds United,Tottenham Hotspur,0-1,0,1,1,1,1,-1,A
2004-01-10,2003,Liverpool,Aston Villa,1-0,1,0,1,1,1,1,H
2004-01-10,2003,Portsmouth,Manchester City,4-2,4,2,1,1,6,2,H
2004-01-11,2003,Leicester City,Chelsea,0-4,0,4,1,1,4,-4,A
2004-01-11,2003,Manchester United,Newcastle United,0-0,0,0,1,1,0,0,D
2004-01-17,2003,Bolton Wanderers,Portsmouth,1-0,1,0,1,1,1,1,H
2004-01-17,2003,Everton,Charlton Athletic,0-1,0,1,1,1,1,-1,A
2004-01-17,2003,Manchester City,Blackburn Rovers,1-1,1,1,1,1,2,0,D
2004-01-17,2003,Middlesbrough,Leicester City,3-3,3,3,1,1,6,0,D
2004-01-17,2003,Southampton,Leeds United,2-1,2,1,1,1,3,1,H
2004-01-17,2003,Tottenham Hotspur,Liverpool,2-1,2,1,1,1,3,1,H
2004-01-17,2003,Wolverhampton Wanderers,Manchester United,1-0,1,0,1,1,1,1,H
2004-01-18,2003,Aston Villa,Arsenal,0-2,0,2,1,1,2,-2,A
2004-01-18,2003,Chelsea,Birmingham City,0-0,0,0,1,1,0,0,D
2004-01-19,2003,Newcastle United,Fulham,3-1,3,1,1,1,4,2,H
2004-01-21,2003,Wolverhampton Wanderers,Liverpool,1-1,1,1,1,1,2,0,D
2004-01-31,2003,Birmingham City,Newcastle United,1-1,1,1,1,1,2,0,D
2004-01-31,2003,Charlton Athletic,Bolton Wanderers,1-2,1,2,1,1,3,-1,A
2004-01-31,2003,Fulham,Tottenham Hotspur,2-1,2,1,1,1,3,1,H
2004-01-31,2003,Leeds United,Middlesbrough,0-3,0,3,1,1,3,-3,A
2004-01-31,2003,Leicester City,Aston Villa,0-5,0,5,1,1,5,-5,A
2004-01-31,2003,Liverpool,Everton,0-0,0,0,1,1,0,0,D
2004-01-31,2003,Manchester United,Southampton,3-2,3,2,1,1,5,1,H
2004-01-31,2003,Portsmouth,Wolverhampton Wanderers,0-0,0,0,1,1,0,0,D
2004-02-01,2003,Arsenal,Manchester City,2-1,2,1,1,1,3,1,H
2004-02-01,2003,Blackburn Rovers,Chelsea,2-3,2,3,1,1,5,-1,A
2004-02-07,2003,Aston Villa,Leeds United,2-0,2,0,1,1,2,2,H
2004-02-07,2003,Bolton Wanderers,Liverpool,2-2,2,2,1,1,4,0,D
2004-02-07,2003,Everton,Manchester United,3-4,3,4,1,1,7,-1,A
2004-02-07,2003,Middlesbrough,Blackburn Rovers,0-1,0,1,1,1,1,-1,A
2004-02-07,2003,Newcastle United,Leicester City,3-1,3,1,1,1,4,2,H
2004-02-07,2003,Southampton,Fulham,0-0,0,0,1,1,0,0,D
2004-02-07,2003,Tottenham Hotspur,Portsmouth,4-3,4,3,1,1,7,1,H
2004-02-07,2003,Wolverhampton Wanderers,Arsenal,1-3,1,3,1,1,4,-2,A
2004-02-08,2003,Chelsea,Charlton Athletic,1-0,1,0,1,1,1,1,H
2004-02-08,2003,Manchester City,Birmingham City,0-0,0,0,1,1,0,0,D
2004-02-10,2003,Arsenal,Southampton,2-0,2,0,1,1,2,2,H
2004-02-10,2003,Leeds United,Wolverhampton Wanderers,4-1,4,1,1,1,5,3,H
2004-02-10,2003,Leicester City,Bolton Wanderers,1-1,1,1,1,1,2,0,D
2004-02-11,2003,Birmingham City,Everton,3-0,3,0,1,1,3,3,H
2004-02-11,2003,Blackburn Rovers,Newcastle United,1-1,1,1,1,1,2,0,D
2004-02-11,2003,Charlton Athletic,Tottenham Hotspur,2-4,2,4,1,1,6,-2,A
2004-02-11,2003,Fulham,Aston Villa,1-2,1,2,1,1,3,-1,A
2004-02-11,2003,Liverpool,Manchester City,2-1,2,1,1,1,3,1,H
2004-02-11,2003,Manchester United,Middlesbrough,2-3,2,3,1,1,5,-1,A
2004-02-11,2003,Portsmouth,Chelsea,0-2,0,2,1,1,2,-2,A
2004-02-21,2003,Bolton Wanderers,Manchester City,1-3,1,3,1,1,4,-2,A
2004-02-21,2003,Charlton Athletic,Blackburn Rovers,3-2,3,2,1,1,5,1,H
2004-02-21,2003,Chelsea,Arsenal,1-2,1,2,1,1,3,-1,A
2004-02-21,2003,Manchester United,Leeds United,1-1,1,1,1,1,2,0,D
2004-02-21,2003,Newcastle United,Middlesbrough,2-1,2,1,1,1,3,1,H
2004-02-21,2003,Southampton,Everton,3-3,3,3,1,1,6,0,D
2004-02-21,2003,Wolverhampton Wanderers,Fulham,2-1,2,1,1,1,3,1,H
2004-02-22,2003,Aston Villa,Birmingham City,2-2,2,2,1,1,4,0,D
2004-02-22,2003,Tottenham Hotspur,Leicester City,4-4,4,4,1,1,8,0,D
2004-02-28,2003,Arsenal,Charlton Athletic,2-1,2,1,1,1,3,1,H
2004-02-28,2003,Blackburn Rovers,Southampton,1-1,1,1,1,1,2,0,D
2004-02-28,2003,Everton,Aston Villa,2-0,2,0,1,1,2,2,H
2004-02-28,2003,Fulham,Manchester United,1-1,1,1,1,1,2,0,D
2004-02-28,2003,Leicester City,Wolverhampton Wanderers,0-0,0,0,1,1,0,0,D
2004-02-28,2003,Manchester City,Chelsea,0-1,0,1,1,1,1,-1,A
2004-02-29,2003,Leeds United,Liverpool,2-2,2,2,1,1,4,0,D
2004-02-29,2003,Portsmouth,Newcastle United,1-1,1,1,1,1,2,0,D
2004-03-03,2003,Birmingham City,Middlesbrough,3-1,3,1,1,1,4,2,H
2004-03-06,2003,Birmingham City,Bolton Wanderers,2-0,2,0,1,1,2,2,H
2004-03-09,2003,Middlesbrough,Tottenham Hotspur,1-0,1,0,1,1,1,1,H
2004-03-13,2003,Birmingham City,Leicester City,0-1,0,1,1,1,1,-1,A
2004-03-13,2003,Blackburn Rovers,Arsenal,0-2,0,2,1,1,2,-2,A
2004-03-13,2003,Bolton Wanderers,Chelsea,0-2,0,2,1,1,2,-2,A
2004-03-13,2003,Charlton Athletic,Middlesbrough,1-0,1,0,1,1,1,1,H
2004-03-13,2003,Everton,Portsmouth,1-0,1,0,1,1,1,1,H
2004-03-13,2003,Fulham,Leeds United,2-0,2,0,1,1,2,2,H
2004-03-14,2003,Manchester City,Manchester United,4-1,4,1,1,1,5,3,H
2004-03-14,2003,Southampton,Liverpool,2-0,2,0,1,1,2,2,H
2004-03-14,2003,Tottenham Hotspur,Newcastle United,1-0,1,0,1,1,1,1,H
2004-03-14,2003,Wolverhampton Wanderers,Aston Villa,0-4,0,4,1,1,4,-4,A
2004-03-17,2003,Liverpool,Portsmouth,3-0,3,0,1,1,3,3,H
2004-03-20,2003,Arsenal,Bolton Wanderers,2-1,2,1,1,1,3,1,H
2004-03-20,2003,Aston Villa,Blackburn Rovers,0-2,0,2,1,1,2,-2,A
2004-03-20,2003,Chelsea,Fulham,2-1,2,1,1,1,3,1,H
2004-03-20,2003,Leicester City,Everton,1-1,1,1,1,1,2,0,D
2004-03-20,2003,Liverpool,Wolverhampton Wanderers,1-0,1,0,1,1,1,1,H
2004-03-20,2003,Manchester United,Tottenham Hotspur,3-0,3,0,1,1,3,3,H
2004-03-20,2003,Middlesbrough,Birmingham City,5-3,5,3,1,1,8,2,H
2004-03-20,2003,Newcastle United,Charlton Athletic,3-1,3,1,1,1,4,2,H
2004-03-21,2003,Portsmouth,Southampton,1-0,1,0,1,1,1,1,H
2004-03-22,2003,Leeds United,Manchester City,2-1,2,1,1,1,3,1,H
2004-03-27,2003,Birmingham City,Leeds United,4-1,4,1,1,1,5,3,H
2004-03-27,2003,Blackburn Rovers,Portsmouth,1-2,1,2,1,1,3,-1,A
2004-03-27,2003,Charlton Athletic,Aston Villa,1-2,1,2,1,1,3,-1,A
2004-03-27,2003,Chelsea,Wolverhampton Wanderers,5-2,5,2,1,1,7,3,H
2004-03-27,2003,Everton,Middlesbrough,1-1,1,1,1,1,2,0,D
2004-03-27,2003,Manchester City,Fulham,0-0,0,0,1,1,0,0,D
2004-03-27,2003,Southampton,Tottenham Hotspur,1-0,1,0,1,1,1,1,H
2004-03-28,2003,Arsenal,Manchester United,1-1,1,1,1,1,2,0,D
2004-03-28,2003,Bolton Wanderers,Newcastle United,1-0,1,0,1,1,1,1,H
2004-03-28,2003,Leicester City,Liverpool,0-0,0,0,1,1,0,0,D
2004-04-03,2003,Fulham,Birmingham City,0-0,0,0,1,1,0,0,D
2004-04-03,2003,Middlesbrough,Bolton Wanderers,2-0,2,0,1,1,2,2,H
2004-04-03,2003,Newcastle United,Everton,4-2,4,2,1,1,6,2,H
2004-04-03,2003,Tottenham Hotspur,Chelsea,0-1,0,1,1,1,1,-1,A
2004-04-03,2003,Wolverhampton Wanderers,Southampton,1-4,1,4,1,1,5,-3,A
2004-04-04,2003,Aston Villa,Manchester City,1-1,1,1,1,1,2,0,D
2004-04-04,2003,Liverpool,Blackburn Rovers,4-0,4,0,1,1,4,4,H
2004-04-05,2003,Leeds United,Leicester City,3-2,3,2,1,1,5,1,H
2004-04-09,2003,Arsenal,Liverpool,4-2,4,2,1,1,6,2,H
2004-04-09,2003,Everton,Tottenham Hotspur,3-1,3,1,1,1,4,2,H
2004-04-10,2003,Birmingham City,Manchester United,1-2,1,2,1,1,3,-1,A
2004-04-10,2003,Blackburn Rovers,Leeds United,1-2,1,2,1,1,3,-1,A
2004-04-10,2003,Bolton Wanderers,Aston Villa,2-2,2,2,1,1,4,0,D
2004-04-10,2003,Charlton Athletic,Portsmouth,1-1,1,1,1,1,2,0,D
2004-04-10,2003,Chelsea,Middlesbrough,0-0,0,0,1,1,0,0,D
2004-04-10,2003,Leicester City,Fulham,0-2,0,2,1,1,2,-2,A
2004-04-10,2003,Manchester City,Wolverhampton Wanderers,3-3,3,3,1,1,6,0,D
2004-04-11,2003,Newcastle United,Arsenal,0-0,0,0,1,1,0,0,D
2004-04-12,2003,Aston Villa,Chelsea,3-2,3,2,1,1,5,1,H
2004-04-12,2003,Fulham,Blackburn Rovers,3-4,3,4,1,1,7,-1,A
2004-04-12,2003,Liverpool,Charlton Athletic,0-1,0,1,1,1,1,-1,A
2004-04-12,2003,Middlesbrough,Southampton,3-1,3,1,1,1,4,2,H
2004-04-12,2003,Portsmouth,Birmingham City,3-1,3,1,1,1,4,2,H
2004-04-12,2003,Tottenham Hotspur,Manchester City,1-1,1,1,1,1,2,0,D
2004-04-12,2003,Wolverhampton Wanderers,Bolton Wanderers,1-2,1,2,1,1,3,-1,A
2004-04-13,2003,Leeds United,Everton,1-1,1,1,1,1,2,0,D
2004-04-13,2003,Manchester United,Leicester City,1-0,1,0,1,1,1,1,H
2004-04-16,2003,Arsenal,Leeds United,5-0,5,0,1,1,5,5,H
2004-04-17,2003,Blackburn Rovers,Leicester City,1-0,1,0,1,1,1,1,H
2004-04-17,2003,Bolton Wanderers,Tottenham Hotspur,2-0,2,0,1,1,2,2,H
2004-04-17,2003,Charlton Athletic,Birmingham City,1-1,1,1,1,1,2,0,D
2004-04-17,2003,Chelsea,Everton,0-0,0,0,1,1,0,0,D
2004-04-17,2003,Liverpool,Fulham,0-0,0,0,1,1,0,0,D
2004-04-17,2003,Manchester City,Southampton,1-3,1,3,1,1,4,-2,A
2004-04-17,2003,Portsmouth,Manchester United,1-0,1,0,1,1,1,1,H
2004-04-17,2003,Wolverhampton Wanderers,Middlesbrough,2-0,2,0,1,1,2,2,H
2004-04-18,2003,Aston Villa,Newcastle United,0-0,0,0,1,1,0,0,D
2004-04-20,2003,Manchester United,Charlton Athletic,2-0,2,0,1,1,2,2,H
2004-04-24,2003,Everton,Blackburn Rovers,0-1,0,1,1,1,1,-1,A
2004-04-24,2003,Fulham,Charlton Athletic,2-0,2,0,1,1,2,2,H
2004-04-24,2003,Leicester City,Manchester City,1-1,1,1,1,1,2,0,D
2004-04-24,2003,Manchester United,Liverpool,0-1,0,1,1,1,1,-1,A
2004-04-24,2003,Middlesbrough,Aston Villa,1-2,1,2,1,1,3,-1,A
2004-04-24,2003,Southampton,Bolton Wanderers,1-2,1,2,1,1,3,-1,A
2004-04-25,2003,Birmingham City,Wolverhampton Wanderers,2-2,2,2,1,1,4,0,D
2004-04-25,2003,Leeds United,Portsmouth,1-2,1,2,1,1,3,-1,A
2004-04-25,2003,Newcastle United,Chelsea,2-1,2,1,1,1,3,1,H
2004-04-25,2003,Tottenham Hotspur,Arsenal,2-2,2,2,1,1,4,0,D
2004-05-01,2003,Arsenal,Birmingham City,0-0,0,0,1,1,0,0,D
2004-05-01,2003,Blackburn Rovers,Manchester United,1-0,1,0,1,1,1,1,H
2004-05-01,2003,Charlton Athletic,Leicester City,2-2,2,2,1,1,4,0,D
2004-05-01,2003,Chelsea,Southampton,4-0,4,0,1,1,4,4,H
2004-05-01,2003,Manchester City,Newcastle United,1-0,1,0,1,1,1,1,H
2004-05-01,2003,Portsmouth,Fulham,1-1,1,1,1,1,2,0,D
2004-05-01,2003,Wolverhampton Wanderers,Everton,2-1,2,1,1,1,3,1,H
2004-05-02,2003,Aston Villa,Tottenham Hotspur,1-0,1,0,1,1,1,1,H
2004-05-02,2003,Bolton Wanderers,Leeds United,4-1,4,1,1,1,5,3,H
2004-05-02,2003,Liverpool,Middlesbrough,2-0,2,0,1,1,2,2,H
2004-05-04,2003,Portsmouth,Arsenal,1-1,1,1,1,1,2,0,D
2004-05-08,2003,Birmingham City,Liverpool,0-3,0,3,1,1,3,-3,A
2004-05-08,2003,Everton,Bolton Wanderers,1-2,1,2,1,1,3,-1,A
2004-05-08,2003,Leeds United,Charlton Athletic,3-3,3,3,1,1,6,0,D
2004-05-08,2003,Leicester City,Portsmouth,3-1,3,1,1,1,4,2,H
2004-05-08,2003,Manchester United,Chelsea,1-1,1,1,1,1,2,0,D
2004-05-08,2003,Middlesbrough,Manchester City,2-1,2,1,1,1,3,1,H
2004-05-08,2003,Southampton,Aston Villa,1-1,1,1,1,1,2,0,D
2004-05-08,2003,Tottenham Hotspur,Blackburn Rovers,1-0,1,0,1,1,1,1,H
2004-05-09,2003,Fulham,Arsenal,0-1,0,1,1,1,1,-1,A
2004-05-09,2003,Newcastle United,Wolverhampton Wanderers,1-1,1,1,1,1,2,0,D
2004-05-12,2003,Southampton,Newcastle United,3-3,3,3,1,1,6,0,D
2004-05-15,2003,Arsenal,Leicester City,2-1,2,1,1,1,3,1,H
2004-05-15,2003,Aston Villa,Manchester United,0-2,0,2,1,1,2,-2,A
2004-05-15,2003,Blackburn Rovers,Birmingham City,1-1,1,1,1,1,2,0,D
2004-05-15,2003,Bolton Wanderers,Fulham,0-2,0,2,1,1,2,-2,A
2004-05-15,2003,Charlton Athletic,Southampton,2-1,2,1,1,1,3,1,H
2004-05-15,2003,Chelsea,Leeds United,1-0,1,0,1,1,1,1,H
2004-05-15,2003,Liverpool,Newcastle United,1-1,1,1,1,1,2,0,D
2004-05-15,2003,Manchester City,Everton,5-1,5,1,1,1,6,4,H
2004-05-15,2003,Portsmouth,Middlesbrough,5-1,5,1,1,1,6,4,H
2004-05-15,2003,Wolverhampton Wanderers,Tottenham Hotspur,0-2,0,2,1,1,2,-2,A
2004-08-14,2004,Aston Villa,Southampton,2-0,2,0,1,1,2,2,H
2004-08-14,2004,Blackburn Rovers,West Bromwich Albion,1-1,1,1,1,1,2,0,D
2004-08-14,2004,Bolton Wanderers,Charlton Athletic,4-1,4,1,1,1,5,3,H
2004-08-14,2004,Manchester City,Fulham,1-1,1,1,1,1,2,0,D
2004-08-14,2004,Middlesbrough,Newcastle United,2-2,2,2,1,1,4,0,D
2004-08-14,2004,Norwich City,Crystal Palace,1-1,1,1,1,1,2,0,D
2004-08-14,2004,Portsmouth,Birmingham City,1-1,1,1,1,1,2,0,D
2004-08-14,2004,Tottenham Hotspur,Liverpool,1-1,1,1,1,1,2,0,D
2004-08-15,2004,Chelsea,Manchester United,1-0,1,0,1,1,1,1,H
2004-08-15,2004,Everton,Arsenal,1-4,1,4,1,1,5,-3,A
2004-08-21,2004,Birmingham City,Chelsea,0-1,0,1,1,1,1,-1,A
2004-08-21,2004,Charlton Athletic,Portsmouth,2-1,2,1,1,1,3,1,H
2004-08-21,2004,Crystal Palace,Everton,1-3,1,3,1,1,4,-2,A
2004-08-21,2004,Fulham,Bolton Wanderers,2-0,2,0,1,1,2,2,H
2004-08-21,2004,Liverpool,Manchester City,2-1,2,1,1,1,3,1,H
2004-08-21,2004,Manchester United,Norwich City,2-1,2,1,1,1,3,1,H
2004-08-21,2004,Newcastle United,Tottenham Hotspur,0-1,0,1,1,1,1,-1,A
2004-08-21,2004,Southampton,Blackburn Rovers,3-2,3,2,1,1,5,1,H
2004-08-22,2004,Arsenal,Middlesbrough,5-3,5,3,1,1,8,2,H
2004-08-22,2004,West Bromwich Albion,Aston Villa,1-1,1,1,1,1,2,0,D
2004-08-24,2004,Birmingham City,Manchester City,1-0,1,0,1,1,1,1,H
2004-08-24,2004,Crystal Palace,Chelsea,0-2,0,2,1,1,2,-2,A
2004-08-25,2004,Arsenal,Blackburn Rovers,3-0,3,0,1,1,3,3,H
2004-08-25,2004,Charlton Athletic,Aston Villa,3-0,3,0,1,1,3,3,H
2004-08-25,2004,Fulham,Middlesbrough,0-2,0,2,1,1,2,-2,A
2004-08-25,2004,Newcastle United,Norwich City,2-2,2,2,1,1,4,0,D
2004-08-25,2004,Southampton,Bolton Wanderers,1-2,1,2,1,1,3,-1,A
2004-08-25,2004,West Bromwich Albion,Tottenham Hotspur,1-1,1,1,1,1,2,0,D
2004-08-28,2004,Aston Villa,Newcastle United,4-2,4,2,1,1,6,2,H
2004-08-28,2004,Blackburn Rovers,Manchester United,1-1,1,1,1,1,2,0,D
2004-08-28,2004,Chelsea,Southampton,2-1,2,1,1,1,3,1,H
2004-08-28,2004,Everton,West Bromwich Albion,2-1,2,1,1,1,3,1,H
2004-08-28,2004,Manchester City,Charlton Athletic,4-0,4,0,1,1,4,4,H
2004-08-28,2004,Middlesbrough,Crystal Palace,2-1,2,1,1,1,3,1,H
2004-08-28,2004,Norwich City,Arsenal,1-4,1,4,1,1,5,-3,A
2004-08-28,2004,Tottenham Hotspur,Birmingham City,1-0,1,0,1,1,1,1,H
2004-08-29,2004,Bolton Wanderers,Liverpool,1-0,1,0,1,1,1,1,H
2004-08-30,2004,Manchester United,Everton,0-0,0,0,1,1,0,0,D
2004-08-30,2004,Portsmouth,Fulham,4-3,4,3,1,1,7,1,H
2004-09-11,2004,Aston Villa,Chelsea,0-0,0,0,1,1,0,0,D
2004-09-11,2004,Bolton Wanderers,Manchester United,2-2,2,2,1,1,4,0,D
2004-09-11,2004,Fulham,Arsenal,0-3,0,3,1,1,3,-3,A
2004-09-11,2004,Liverpool,West Bromwich Albion,3-0,3,0,1,1,3,3,H
2004-09-11,2004,Manchester City,Everton,0-1,0,1,1,1,1,-1,A
2004-09-11,2004,Middlesbrough,Birmingham City,2-1,2,1,1,1,3,1,H
2004-09-11,2004,Newcastle United,Blackburn Rovers,3-0,3,0,1,1,3,3,H
2004-09-11,2004,Portsmouth,Crystal Palace,3-1,3,1,1,1,4,2,H
2004-09-12,2004,Tottenham Hotspur,Norwich City,0-0,0,0,1,1,0,0,D
2004-09-13,2004,Charlton Athletic,Southampton,0-0,0,0,1,1,0,0,D
2004-09-18,2004,Arsenal,Bolton Wanderers,2-2,2,2,1,1,4,0,D
2004-09-18,2004,Birmingham City,Charlton Athletic,1-1,1,1,1,1,2,0,D
2004-09-18,2004,Blackburn Rovers,Portsmouth,1-0,1,0,1,1,1,1,H
2004-09-18,2004,Crystal Palace,Manchester City,1-2,1,2,1,1,3,-1,A
2004-09-18,2004,Norwich City,Aston Villa,0-0,0,0,1,1,0,0,D
2004-09-18,2004,West Bromwich Albion,Fulham,1-1,1,1,1,1,2,0,D
2004-09-19,2004,Chelsea,Tottenham Hotspur,0-0,0,0,1,1,0,0,D
2004-09-19,2004,Everton,Middlesbrough,1-0,1,0,1,1,1,1,H
2004-09-19,2004,Southampton,Newcastle United,1-2,1,2,1,1,3,-1,A
2004-09-20,2004,Manchester United,Liverpool,2-1,2,1,1,1,3,1,H
2004-09-25,2004,Aston Villa,Crystal Palace,1-1,1,1,1,1,2,0,D
2004-09-25,2004,Bolton Wanderers,Birmingham City,1-1,1,1,1,1,2,0,D
2004-09-25,2004,Fulham,Southampton,1-0,1,0,1,1,1,1,H
2004-09-25,2004,Liverpool,Norwich City,3-0,3,0,1,1,3,3,H
2004-09-25,2004,Manchester City,Arsenal,0-1,0,1,1,1,1,-1,A
2004-09-25,2004,Middlesbrough,Chelsea,0-1,0,1,1,1,1,-1,A
2004-09-25,2004,Newcastle United,West Bromwich Albion,3-1,3,1,1,1,4,2,H
2004-09-25,2004,Tottenham Hotspur,Manchester United,0-1,0,1,1,1,1,-1,A
2004-09-26,2004,Portsmouth,Everton,0-1,0,1,1,1,1,-1,A
2004-09-27,2004,Charlton Athletic,Blackburn Rovers,1-0,1,0,1,1,1,1,H
2004-10-02,2004,Arsenal,Charlton Athletic,4-0,4,0,1,1,4,4,H
2004-10-02,2004,Blackburn Rovers,Aston Villa,2-2,2,2,1,1,4,0,D
2004-10-02,2004,Everton,Tottenham Hotspur,0-1,0,1,1,1,1,-1,A
2004-10-02,2004,Norwich City,Portsmouth,2-2,2,2,1,1,4,0,D
2004-10-02,2004,Southampton,Manchester City,0-0,0,0,1,1,0,0,D
2004-10-02,2004,West Bromwich Albion,Bolton Wanderers,2-1,2,1,1,1,3,1,H
2004-10-03,2004,Birmingham City,Newcastle United,2-2,2,2,1,1,4,0,D
2004-10-03,2004,Chelsea,Liverpool,1-0,1,0,1,1,1,1,H
2004-10-03,2004,Manchester United,Middlesbrough,1-1,1,1,1,1,2,0,D
2004-10-04,2004,Crystal Palace,Fulham,2-0,2,0,1,1,2,2,H
2004-10-16,2004,Arsenal,Aston Villa,3-1,3,1,1,1,4,2,H
2004-10-16,2004,Birmingham City,Manchester United,0-0,0,0,1,1,0,0,D
2004-10-16,2004,Blackburn Rovers,Middlesbrough,0-4,0,4,1,1,4,-4,A
2004-10-16,2004,Bolton Wanderers,Crystal Palace,1-0,1,0,1,1,1,1,H
2004-10-16,2004,Everton,Southampton,1-0,1,0,1,1,1,1,H
2004-10-16,2004,Fulham,Liverpool,2-4,2,4,1,1,6,-2,A
2004-10-16,2004,Manchester City,Chelsea,1-0,1,0,1,1,1,1,H
2004-10-16,2004,West Bromwich Albion,Norwich City,0-0,0,0,1,1,0,0,D
2004-10-17,2004,Charlton Athletic,Newcastle United,1-1,1,1,1,1,2,0,D
2004-10-18,2004,Portsmouth,Tottenham Hotspur,1-0,1,0,1,1,1,1,H
2004-10-23,2004,Aston Villa,Fulham,2-0,2,0,1,1,2,2,H
2004-10-23,2004,Chelsea,Blackburn Rovers,4-0,4,0,1,1,4,4,H
2004-10-23,2004,Crystal Palace,West Bromwich Albion,3-0,3,0,1,1,3,3,H
2004-10-23,2004,Liverpool,Charlton Athletic,2-0,2,0,1,1,2,2,H
2004-10-23,2004,Norwich City,Everton,2-3,2,3,1,1,5,-1,A
2004-10-23,2004,Tottenham Hotspur,Bolton Wanderers,1-2,1,2,1,1,3,-1,A
2004-10-24,2004,Manchester United,Arsenal,2-0,2,0,1,1,2,2,H
2004-10-24,2004,Middlesbrough,Portsmouth,1-1,1,1,1,1,2,0,D
2004-10-24,2004,Newcastle United,Manchester City,4-3,4,3,1,1,7,1,H
2004-10-24,2004,Southampton,Birmingham City,0-0,0,0,1,1,0,0,D
2004-10-30,2004,Arsenal,Southampton,2-2,2,2,1,1,4,0,D
2004-10-30,2004,Birmingham City,Crystal Palace,0-1,0,1,1,1,1,-1,A
2004-10-30,2004,Blackburn Rovers,Liverpool,2-2,2,2,1,1,4,0,D
2004-10-30,2004,Charlton Athletic,Middlesbrough,1-2,1,2,1,1,3,-1,A
2004-10-30,2004,Everton,Aston Villa,1-1,1,1,1,1,2,0,D
2004-10-30,2004,Fulham,Tottenham Hotspur,2-0,2,0,1,1,2,2,H
2004-10-30,2004,Portsmouth,Manchester United,2-0,2,0,1,1,2,2,H
2004-10-30,2004,West Bromwich Albion,Chelsea,1-4,1,4,1,1,5,-3,A
2004-10-31,2004,Bolton Wanderers,Newcastle United,2-1,2,1,1,1,3,1,H
2004-11-01,2004,Manchester City,Norwich City,1-1,1,1,1,1,2,0,D
2004-11-06,2004,Aston Villa,Portsmouth,3-0,3,0,1,1,3,3,H
2004-11-06,2004,Chelsea,Everton,1-0,1,0,1,1,1,1,H
2004-11-06,2004,Crystal Palace,Arsenal,1-1,1,1,1,1,2,0,D
2004-11-06,2004,Liverpool,Birmingham City,0-1,0,1,1,1,1,-1,A
2004-11-06,2004,Norwich City,Blackburn Rovers,1-1,1,1,1,1,2,0,D
2004-11-06,2004,Southampton,West Bromwich Albion,2-2,2,2,1,1,4,0,D
2004-11-06,2004,Tottenham Hotspur,Charlton Athletic,2-3,2,3,1,1,5,-1,A
2004-11-07,2004,Manchester United,Manchester City,0-0,0,0,1,1,0,0,D
2004-11-07,2004,Middlesbrough,Bolton Wanderers,1-1,1,1,1,1,2,0,D
2004-11-07,2004,Newcastle United,Fulham,1-4,1,4,1,1,5,-3,A
2004-11-13,2004,Birmingham City,Everton,0-1,0,1,1,1,1,-1,A
2004-11-13,2004,Bolton Wanderers,Aston Villa,1-2,1,2,1,1,3,-1,A
2004-11-13,2004,Charlton Athletic,Norwich City,4-0,4,0,1,1,4,4,H
2004-11-13,2004,Fulham,Chelsea,1-4,1,4,1,1,5,-3,A
2004-11-13,2004,Liverpool,Crystal Palace,3-2,3,2,1,1,5,1,H
2004-11-13,2004,Manchester City,Blackburn Rovers,1-1,1,1,1,1,2,0,D
2004-11-13,2004,Southampton,Portsmouth,2-1,2,1,1,1,3,1,H
2004-11-13,2004,Tottenham Hotspur,Arsenal,4-5,4,5,1,1,9,-1,A
2004-11-14,2004,Newcastle United,Manchester United,1-3,1,3,1,1,4,-2,A
2004-11-14,2004,West Bromwich Albion,Middlesbrough,1-2,1,2,1,1,3,-1,A
2004-11-20,2004,Arsenal,West Bromwich Albion,1-1,1,1,1,1,2,0,D
2004-11-20,2004,Chelsea,Bolton Wanderers,2-2,2,2,1,1,4,0,D
2004-11-20,2004,Crystal Palace,Newcastle United,0-2,0,2,1,1,2,-2,A
2004-11-20,2004,Everton,Fulham,1-0,1,0,1,1,1,1,H
2004-11-20,2004,Manchester United,Charlton Athletic,2-0,2,0,1,1,2,2,H
2004-11-20,2004,Middlesbrough,Liverpool,2-0,2,0,1,1,2,2,H
2004-11-20,2004,Norwich City,Southampton,2-1,2,1,1,1,3,1,H
2004-11-20,2004,Portsmouth,Manchester City,1-3,1,3,1,1,4,-2,A
2004-11-21,2004,Blackburn Rovers,Birmingham City,3-3,3,3,1,1,6,0,D
2004-11-22,2004,Aston Villa,Tottenham Hotspur,1-0,1,0,1,1,1,1,H
2004-11-27,2004,Birmingham City,Norwich City,1-1,1,1,1,1,2,0,D
2004-11-27,2004,Bolton Wanderers,Portsmouth,0-1,0,1,1,1,1,-1,A
2004-11-27,2004,Charlton Athletic,Chelsea,0-4,0,4,1,1,4,-4,A
2004-11-27,2004,Fulham,Blackburn Rovers,0-2,0,2,1,1,2,-2,A
2004-11-27,2004,Manchester City,Aston Villa,2-0,2,0,1,1,2,2,H
2004-11-27,2004,Southampton,Crystal Palace,2-2,2,2,1,1,4,0,D
2004-11-27,2004,West Bromwich Albion,Manchester United,0-3,0,3,1,1,3,-3,A
2004-11-28,2004,Liverpool,Arsenal,2-1,2,1,1,1,3,1,H
2004-11-28,2004,Newcastle United,Everton,1-1,1,1,1,1,2,0,D
2004-11-28,2004,Tottenham Hotspur,Middlesbrough,2-0,2,0,1,1,2,2,H
2004-12-04,2004,Arsenal,Birmingham City,3-0,3,0,1,1,3,3,H
2004-12-04,2004,Aston Villa,Liverpool,1-1,1,1,1,1,2,0,D
2004-12-04,2004,Blackburn Rovers,Tottenham Hotspur,0-1,0,1,1,1,1,-1,A
2004-12-04,2004,Chelsea,Newcastle United,4-0,4,0,1,1,4,4,H
2004-12-04,2004,Everton,Bolton Wanderers,3-2,3,2,1,1,5,1,H
2004-12-04,2004,Manchester United,Southampton,3-0,3,0,1,1,3,3,H
2004-12-04,2004,Norwich City,Fulham,0-1,0,1,1,1,1,-1,A
2004-12-04,2004,Portsmouth,West Bromwich Albion,3-2,3,2,1,1,5,1,H
2004-12-05,2004,Crystal Palace,Charlton Athletic,0-1,0,1,1,1,1,-1,A
2004-12-06,2004,Middlesbrough,Manchester City,3-2,3,2,1,1,5,1,H
2004-12-11,2004,Crystal Palace,Blackburn Rovers,0-0,0,0,1,1,0,0,D
2004-12-11,2004,Everton,Liverpool,1-0,1,0,1,1,1,1,H
2004-12-11,2004,Manchester City,Tottenham Hotspur,0-1,0,1,1,1,1,-1,A
2004-12-11,2004,Newcastle United,Portsmouth,1-1,1,1,1,1,2,0,D
2004-12-11,2004,Norwich City,Bolton Wanderers,3-2,3,2,1,1,5,1,H
2004-12-11,2004,Southampton,Middlesbrough,2-2,2,2,1,1,4,0,D
2004-12-11,2004,West Bromwich Albion,Charlton Athletic,0-1,0,1,1,1,1,-1,A
2004-12-12,2004,Arsenal,Chelsea,2-2,2,2,1,1,4,0,D
2004-12-12,2004,Aston Villa,Birmingham City,1-2,1,2,1,1,3,-1,A
2004-12-13,2004,Fulham,Manchester United,1-1,1,1,1,1,2,0,D
2004-12-14,2004,Liverpool,Portsmouth,1-1,1,1,1,1,2,0,D
2004-12-18,2004,Birmingham City,West Bromwich Albion,4-0,4,0,1,1,4,4,H
2004-12-18,2004,Blackburn Rovers,Everton,0-0,0,0,1,1,0,0,D
2004-12-18,2004,Bolton Wanderers,Manchester City,0-1,0,1,1,1,1,-1,A
2004-12-18,2004,Chelsea,Norwich City,4-0,4,0,1,1,4,4,H
2004-12-18,2004,Manchester United,Crystal Palace,5-2,5,2,1,1,7,3,H
2004-12-18,2004,Middlesbrough,Aston Villa,3-0,3,0,1,1,3,3,H
2004-12-18,2004,Tottenham Hotspur,Southampton,5-1,5,1,1,1,6,4,H
2004-12-19,2004,Liverpool,Newcastle United,3-1,3,1,1,1,4,2,H
2004-12-19,2004,Portsmouth,Arsenal,0-1,0,1,1,1,1,-1,A
2004-12-20,2004,Charlton Athletic,Fulham,2-1,2,1,1,1,3,1,H
2004-12-26,2004,Arsenal,Fulham,2-0,2,0,1,1,2,2,H
2004-12-26,2004,Birmingham City,Middlesbrough,2-0,2,0,1,1,2,2,H
2004-12-26,2004,Blackburn Rovers,Newcastle United,2-2,2,2,1,1,4,0,D
2004-12-26,2004,Chelsea,Aston Villa,1-0,1,0,1,1,1,1,H
2004-12-26,2004,Crystal Palace,Portsmouth,0-1,0,1,1,1,1,-1,A
2004-12-26,2004,Everton,Manchester City,2-1,2,1,1,1,3,1,H
2004-12-26,2004,Manchester United,Bolton Wanderers,2-0,2,0,1,1,2,2,H
2004-12-26,2004,Norwich City,Tottenham Hotspur,0-2,0,2,1,1,2,-2,A
2004-12-26,2004,Southampton,Charlton Athletic,0-0,0,0,1,1,0,0,D
2004-12-26,2004,West Bromwich Albion,Liverpool,0-5,0,5,1,1,5,-5,A
2004-12-28,2004,Aston Villa,Manchester United,0-1,0,1,1,1,1,-1,A
2004-12-28,2004,Bolton Wanderers,Blackburn Rovers,0-1,0,1,1,1,1,-1,A
2004-12-28,2004,Charlton Athletic,Everton,2-0,2,0,1,1,2,2,H
2004-12-28,2004,Fulham,Birmingham City,2-3,2,3,1,1,5,-1,A
2004-12-28,2004,Liverpool,Southampton,1-0,1,0,1,1,1,1,H
2004-12-28,2004,Manchester City,West Bromwich Albion,1-1,1,1,1,1,2,0,D
2004-12-28,2004,Middlesbrough,Norwich City,2-0,2,0,1,1,2,2,H
2004-12-28,2004,Portsmouth,Chelsea,0-2,0,2,1,1,2,-2,A
2004-12-28,2004,Tottenham Hotspur,Crystal Palace,1-1,1,1,1,1,2,0,D
2004-12-29,2004,Newcastle United,Arsenal,0-1,0,1,1,1,1,-1,A
2005-01-01,2004,Aston Villa,Blackburn Rovers,1-0,1,0,1,1,1,1,H
2005-01-01,2004,Bolton Wanderers,West Bromwich Albion,1-1,1,1,1,1,2,0,D
2005-01-01,2004,Charlton Athletic,Arsenal,1-3,1,3,1,1,4,-2,A
2005-01-01,2004,Fulham,Crystal Palace,3-1,3,1,1,1,4,2,H
2005-01-01,2004,Liverpool,Chelsea,0-1,0,1,1,1,1,-1,A
2005-01-01,2004,Manchester City,Southampton,2-1,2,1,1,1,3,1,H
2005-01-01,2004,Middlesbrough,Manchester United,0-2,0,2,1,1,2,-2,A
2005-01-01,2004,Newcastle United,Birmingham City,2-1,2,1,1,1,3,1,H
2005-01-01,2004,Portsmouth,Norwich City,1-1,1,1,1,1,2,0,D
2005-01-01,2004,Tottenham Hotspur,Everton,5-2,5,2,1,1,7,3,H
2005-01-03,2004,Blackburn Rovers,Charlton Athletic,1-0,1,0,1,1,1,1,H
2005-01-03,2004,Crystal Palace,Aston Villa,2-0,2,0,1,1,2,2,H
2005-01-03,2004,Norwich City,Liverpool,1-2,1,2,1,1,3,-1,A
2005-01-03,2004,West Bromwich Albion,Newcastle United,0-0,0,0,1,1,0,0,D
2005-01-04,2004,Arsenal,Manchester City,1-1,1,1,1,1,2,0,D
2005-01-04,2004,Birmingham City,Bolton Wanderers,1-2,1,2,1,1,3,-1,A
2005-01-04,2004,Chelsea,Middlesbrough,2-0,2,0,1,1,2,2,H
2005-01-04,2004,Everton,Portsmouth,2-1,2,1,1,1,3,1,H
2005-01-04,2004,Manchester United,Tottenham Hotspur,0-0,0,0,1,1,0,0,D
2005-01-05,2004,Southampton,Fulham,3-3,3,3,1,1,6,0,D
2005-01-15,2004,Aston Villa,Norwich City,3-0,3,0,1,1,3,3,H
2005-01-15,2004,Bolton Wanderers,Arsenal,1-0,1,0,1,1,1,1,H
2005-01-15,2004,Charlton Athletic,Birmingham City,3-1,3,1,1,1,4,2,H
2005-01-15,2004,Liverpool,Manchester United,0-1,0,1,1,1,1,-1,A
2005-01-15,2004,Manchester City,Crystal Palace,3-1,3,1,1,1,4,2,H
2005-01-15,2004,Newcastle United,Southampton,2-1,2,1,1,1,3,1,H
2005-01-15,2004,Portsmouth,Blackburn Rovers,0-1,0,1,1,1,1,-1,A
2005-01-15,2004,Tottenham Hotspur,Chelsea,0-2,0,2,1,1,2,-2,A
2005-01-16,2004,Fulham,West Bromwich Albion,1-0,1,0,1,1,1,1,H
2005-01-16,2004,Middlesbrough,Everton,1-1,1,1,1,1,2,0,D
2005-01-22,2004,Birmingham City,Fulham,1-2,1,2,1,1,3,-1,A
2005-01-22,2004,Chelsea,Portsmouth,3-0,3,0,1,1,3,3,H
2005-01-22,2004,Crystal Palace,Tottenham Hotspur,3-0,3,0,1,1,3,3,H
2005-01-22,2004,Everton,Charlton Athletic,0-1,0,1,1,1,1,-1,A
2005-01-22,2004,Manchester United,Aston Villa,3-1,3,1,1,1,4,2,H
2005-01-22,2004,Norwich City,Middlesbrough,4-4,4,4,1,1,8,0,D
2005-01-22,2004,Southampton,Liverpool,2-0,2,0,1,1,2,2,H
2005-01-22,2004,West Bromwich Albion,Manchester City,2-0,2,0,1,1,2,2,H
2005-01-23,2004,Arsenal,Newcastle United,1-0,1,0,1,1,1,1,H
2005-01-24,2004,Blackburn Rovers,Bolton Wanderers,0-1,0,1,1,1,1,-1,A
2005-02-01,2004,Arsenal,Manchester United,2-4,2,4,1,1,6,-2,A
2005-02-01,2004,Bolton Wanderers,Tottenham Hotspur,3-1,3,1,1,1,4,2,H
2005-02-01,2004,Charlton Athletic,Liverpool,1-2,1,2,1,1,3,-1,A
2005-02-01,2004,Portsmouth,Middlesbrough,2-1,2,1,1,1,3,1,H
2005-02-01,2004,West Bromwich Albion,Crystal Palace,2-2,2,2,1,1,4,0,D
2005-02-02,2004,Birmingham City,Southampton,2-1,2,1,1,1,3,1,H
2005-02-02,2004,Blackburn Rovers,Chelsea,0-1,0,1,1,1,1,-1,A
2005-02-02,2004,Everton,Norwich City,1-0,1,0,1,1,1,1,H
2005-02-02,2004,Fulham,Aston Villa,1-1,1,1,1,1,2,0,D
2005-02-02,2004,Manchester City,Newcastle United,1-1,1,1,1,1,2,0,D
2005-02-05,2004,Aston Villa,Arsenal,1-3,1,3,1,1,4,-2,A
2005-02-05,2004,Crystal Palace,Bolton Wanderers,0-1,0,1,1,1,1,-1,A
2005-02-05,2004,Liverpool,Fulham,3-1,3,1,1,1,4,2,H
2005-02-05,2004,Manchester United,Birmingham City,2-0,2,0,1,1,2,2,H
2005-02-05,2004,Middlesbrough,Blackburn Rovers,1-0,1,0,1,1,1,1,H
2005-02-05,2004,Newcastle United,Charlton Athletic,1-1,1,1,1,1,2,0,D
2005-02-05,2004,Norwich City,West Bromwich Albion,3-2,3,2,1,1,5,1,H
2005-02-05,2004,Tottenham Hotspur,Portsmouth,3-1,3,1,1,1,4,2,H
2005-02-06,2004,Chelsea,Manchester City,0-0,0,0,1,1,0,0,D
2005-02-06,2004,Southampton,Everton,2-2,2,2,1,1,4,0,D
2005-02-12,2004,Birmingham City,Liverpool,2-0,2,0,1,1,2,2,H
2005-02-12,2004,Blackburn Rovers,Norwich City,3-0,3,0,1,1,3,3,H
2005-02-12,2004,Bolton Wanderers,Middlesbrough,0-0,0,0,1,1,0,0,D
2005-02-12,2004,Everton,Chelsea,0-1,0,1,1,1,1,-1,A
2005-02-12,2004,Portsmouth,Aston Villa,1-2,1,2,1,1,3,-1,A
2005-02-13,2004,Manchester City,Manchester United,0-2,0,2,1,1,2,-2,A
2005-02-14,2004,Arsenal,Crystal Palace,5-1,5,1,1,1,6,4,H
2005-02-22,2004,West Bromwich Albion,Southampton,0-0,0,0,1,1,0,0,D
2005-02-26,2004,Aston Villa,Everton,1-3,1,3,1,1,4,-2,A
2005-02-26,2004,Crystal Palace,Birmingham City,2-0,2,0,1,1,2,2,H
2005-02-26,2004,Manchester United,Portsmouth,2-1,2,1,1,1,3,1,H
2005-02-26,2004,Southampton,Arsenal,1-1,1,1,1,1,2,0,D
2005-02-26,2004,Tottenham Hotspur,Fulham,2-0,2,0,1,1,2,2,H
2005-02-27,2004,Middlesbrough,Charlton Athletic,2-2,2,2,1,1,4,0,D
2005-02-27,2004,Newcastle United,Bolton Wanderers,2-1,2,1,1,1,3,1,H
2005-02-28,2004,Norwich City,Manchester City,2-3,2,3,1,1,5,-1,A
2005-03-05,2004,Arsenal,Portsmouth,3-0,3,0,1,1,3,3,H
2005-03-05,2004,Aston Villa,Middlesbrough,2-0,2,0,1,1,2,2,H
2005-03-05,2004,Crystal Palace,Manchester United,0-0,0,0,1,1,0,0,D
2005-03-05,2004,Fulham,Charlton Athletic,0-0,0,0,1,1,0,0,D
2005-03-05,2004,Newcastle United,Liverpool,1-0,1,0,1,1,1,1,H
2005-03-05,2004,Norwich City,Chelsea,1-3,1,3,1,1,4,-2,A
2005-03-05,2004,Southampton,Tottenham Hotspur,1-0,1,0,1,1,1,1,H
2005-03-06,2004,Everton,Blackburn Rovers,0-1,0,1,1,1,1,-1,A
2005-03-06,2004,West Bromwich Albion,Birmingham City,2-0,2,0,1,1,2,2,H
2005-03-07,2004,Manchester City,Bolton Wanderers,0-1,0,1,1,1,1,-1,A
2005-03-15,2004,Chelsea,West Bromwich Albion,1-0,1,0,1,1,1,1,H
2005-03-16,2004,Charlton Athletic,Tottenham Hotspur,2-0,2,0,1,1,2,2,H
2005-03-16,2004,Liverpool,Blackburn Rovers,0-0,0,0,1,1,0,0,D
2005-03-19,2004,Blackburn Rovers,Arsenal,0-1,0,1,1,1,1,-1,A
2005-03-19,2004,Bolton Wanderers,Norwich City,1-0,1,0,1,1,1,1,H
2005-03-19,2004,Charlton Athletic,West Bromwich Albion,1-4,1,4,1,1,5,-3,A
2005-03-19,2004,Chelsea,Crystal Palace,4-1,4,1,1,1,5,3,H
2005-03-19,2004,Manchester United,Fulham,1-0,1,0,1,1,1,1,H
2005-03-19,2004,Portsmouth,Newcastle United,1-1,1,1,1,1,2,0,D
2005-03-19,2004,Tottenham Hotspur,Manchester City,2-1,2,1,1,1,3,1,H
2005-03-20,2004,Birmingham City,Aston Villa,2-0,2,0,1,1,2,2,H
2005-03-20,2004,Liverpool,Everton,2-1,2,1,1,1,3,1,H
2005-03-20,2004,Middlesbrough,Southampton,1-3,1,3,1,1,4,-2,A
2005-04-02,2004,Arsenal,Norwich City,4-1,4,1,1,1,5,3,H
2005-04-02,2004,Birmingham City,Tottenham Hotspur,1-1,1,1,1,1,2,0,D
2005-04-02,2004,Charlton Athletic,Manchester City,2-2,2,2,1,1,4,0,D
2005-04-02,2004,Crystal Palace,Middlesbrough,0-1,0,1,1,1,1,-1,A
2005-04-02,2004,Liverpool,Bolton Wanderers,1-0,1,0,1,1,1,1,H
2005-04-02,2004,Manchester United,Blackburn Rovers,0-0,0,0,1,1,0,0,D
2005-04-02,2004,Newcastle United,Aston Villa,0-3,0,3,1,1,3,-3,A
2005-04-02,2004,Southampton,Chelsea,1-3,1,3,1,1,4,-2,A
2005-04-03,2004,Fulham,Portsmouth,3-1,3,1,1,1,4,2,H
2005-04-03,2004,West Bromwich Albion,Everton,1-0,1,0,1,1,1,1,H
2005-04-09,2004,Blackburn Rovers,Southampton,3-0,3,0,1,1,3,3,H
2005-04-09,2004,Bolton Wanderers,Fulham,3-1,3,1,1,1,4,2,H
2005-04-09,2004,Chelsea,Birmingham City,1-1,1,1,1,1,2,0,D
2005-04-09,2004,Manchester City,Liverpool,1-0,1,0,1,1,1,1,H
2005-04-09,2004,Middlesbrough,Arsenal,0-1,0,1,1,1,1,-1,A
2005-04-09,2004,Norwich City,Manchester United,2-0,2,0,1,1,2,2,H
2005-04-09,2004,Portsmouth,Charlton Athletic,4-2,4,2,1,1,6,2,H
2005-04-10,2004,Aston Villa,West Bromwich Albion,1-1,1,1,1,1,2,0,D
2005-04-10,2004,Everton,Crystal Palace,4-0,4,0,1,1,4,4,H
2005-04-10,2004,Tottenham Hotspur,Newcastle United,1-0,1,0,1,1,1,1,H
2005-04-16,2004,Birmingham City,Portsmouth,0-0,0,0,1,1,0,0,D
2005-04-16,2004,Charlton Athletic,Bolton Wanderers,1-2,1,2,1,1,3,-1,A
2005-04-16,2004,Crystal Palace,Norwich City,3-3,3,3,1,1,6,0,D
2005-04-16,2004,Fulham,Manchester City,1-1,1,1,1,1,2,0,D
2005-04-16,2004,Liverpool,Tottenham Hotspur,2-2,2,2,1,1,4,0,D
2005-04-16,2004,Southampton,Aston Villa,2-3,2,3,1,1,5,-1,A
2005-04-19,2004,Bolton Wanderers,Southampton,1-1,1,1,1,1,2,0,D
2005-04-19,2004,Middlesbrough,Fulham,1-1,1,1,1,1,2,0,D
2005-04-20,2004,Aston Villa,Charlton Athletic,0-0,0,0,1,1,0,0,D
2005-04-20,2004,Blackburn Rovers,Crystal Palace,1-0,1,0,1,1,1,1,H
2005-04-20,2004,Chelsea,Arsenal,0-0,0,0,1,1,0,0,D
2005-04-20,2004,Everton,Manchester United,1-0,1,0,1,1,1,1,H
2005-04-20,2004,Manchester City,Birmingham City,3-0,3,0,1,1,3,3,H
2005-04-20,2004,Norwich City,Newcastle United,2-1,2,1,1,1,3,1,H
2005-04-20,2004,Portsmouth,Liverpool,1-2,1,2,1,1,3,-1,A
2005-04-20,2004,Tottenham Hotspur,West Bromwich Albion,1-1,1,1,1,1,2,0,D
2005-04-23,2004,Aston Villa,Bolton Wanderers,1-1,1,1,1,1,2,0,D
2005-04-23,2004,Blackburn Rovers,Manchester City,0-0,0,0,1,1,0,0,D
2005-04-23,2004,Chelsea,Fulham,3-1,3,1,1,1,4,2,H
2005-04-23,2004,Crystal Palace,Liverpool,1-0,1,0,1,1,1,1,H
2005-04-23,2004,Everton,Birmingham City,1-1,1,1,1,1,2,0,D
2005-04-23,2004,Middlesbrough,West Bromwich Albion,4-0,4,0,1,1,4,4,H
2005-04-23,2004,Norwich City,Charlton Athletic,1-0,1,0,1,1,1,1,H
2005-04-24,2004,Manchester United,Newcastle United,2-1,2,1,1,1,3,1,H
2005-04-24,2004,Portsmouth,Southampton,4-1,4,1,1,1,5,3,H
2005-04-25,2004,Arsenal,Tottenham Hotspur,1-0,1,0,1,1,1,1,H
2005-04-26,2004,West Bromwich Albion,Blackburn Rovers,1-1,1,1,1,1,2,0,D
2005-04-27,2004,Newcastle United,Middlesbrough,0-0,0,0,1,1,0,0,D
2005-04-30,2004,Birmingham City,Blackburn Rovers,2-1,2,1,1,1,3,1,H
2005-04-30,2004,Bolton Wanderers,Chelsea,0-2,0,2,1,1,2,-2,A
2005-04-30,2004,Fulham,Everton,2-0,2,0,1,1,2,2,H
2005-04-30,2004,Liverpool,Middlesbrough,1-1,1,1,1,1,2,0,D
2005-04-30,2004,Manchester City,Portsmouth,2-0,2,0,1,1,2,2,H
2005-04-30,2004,Newcastle United,Crystal Palace,0-0,0,0,1,1,0,0,D
2005-04-30,2004,Southampton,Norwich City,4-3,4,3,1,1,7,1,H
2005-05-01,2004,Charlton Athletic,Manchester United,0-4,0,4,1,1,4,-4,A
2005-05-01,2004,Tottenham Hotspur,Aston Villa,5-1,5,1,1,1,6,4,H
2005-05-02,2004,West Bromwich Albion,Arsenal,0-2,0,2,1,1,2,-2,A
2005-05-04,2004,Fulham,Newcastle United,1-3,1,3,1,1,4,-2,A
2005-05-07,2004,Aston Villa,Manchester City,1-2,1,2,1,1,3,-1,A
2005-05-07,2004,Blackburn Rovers,Fulham,1-3,1,3,1,1,4,-2,A
2005-05-07,2004,Chelsea,Charlton Athletic,1-0,1,0,1,1,1,1,H
2005-05-07,2004,Crystal Palace,Southampton,2-2,2,2,1,1,4,0,D
2005-05-07,2004,Everton,Newcastle United,2-0,2,0,1,1,2,2,H
2005-05-07,2004,Manchester United,West Bromwich Albion,1-1,1,1,1,1,2,0,D
2005-05-07,2004,Middlesbrough,Tottenham Hotspur,1-0,1,0,1,1,1,1,H
2005-05-07,2004,Norwich City,Birmingham City,1-0,1,0,1,1,1,1,H
2005-05-07,2004,Portsmouth,Bolton Wanderers,1-1,1,1,1,1,2,0,D
2005-05-08,2004,Arsenal,Liverpool,3-1,3,1,1,1,4,2,H
2005-05-10,2004,Manchester United,Chelsea,1-3,1,3,1,1,4,-2,A
2005-05-11,2004,Arsenal,Everton,7-0,7,0,1,1,7,7,H
2005-05-15,2004,Birmingham City,Arsenal,2-1,2,1,1,1,3,1,H
2005-05-15,2004,Bolton Wanderers,Everton,3-2,3,2,1,1,5,1,H
2005-05-15,2004,Charlton Athletic,Crystal Palace,2-2,2,2,1,1,4,0,D
2005-05-15,2004,Fulham,Norwich City,6-0,6,0,1,1,6,6,H
2005-05-15,2004,Liverpool,Aston Villa,2-1,2,1,1,1,3,1,H
2005-05-15,2004,Manchester City,Middlesbrough,1-1,1,1,1,1,2,0,D
2005-05-15,2004,Newcastle United,Chelsea,1-1,1,1,1,1,2,0,D
2005-05-15,2004,Southampton,Manchester United,1-2,1,2,1,1,3,-1,A
2005-05-15,2004,Tottenham Hotspur,Blackburn Rovers,0-0,0,0,1,1,0,0,D
2005-05-15,2004,West Bromwich Albion,Portsmouth,2-0,2,0,1,1,2,2,H
2005-08-13,2005,Aston Villa,Bolton Wanderers,2-2,2,2,1,1,4,0,D
2005-08-13,2005,Everton,Manchester United,0-2,0,2,1,1,2,-2,A
2005-08-13,2005,Fulham,Birmingham City,0-0,0,0,1,1,0,0,D
2005-08-13,2005,Manchester City,West Bromwich Albion,0-0,0,0,1,1,0,0,D
2005-08-13,2005,Middlesbrough,Liverpool,0-0,0,0,1,1,0,0,D
2005-08-13,2005,Portsmouth,Tottenham Hotspur,0-2,0,2,1,1,2,-2,A
2005-08-13,2005,Sunderland,Charlton Athletic,1-3,1,3,1,1,4,-2,A
2005-08-13,2005,West Ham United,Blackburn Rovers,3-1,3,1,1,1,4,2,H
2005-08-14,2005,Arsenal,Newcastle United,2-0,2,0,1,1,2,2,H
2005-08-14,2005,Wigan Athletic,Chelsea,0-1,0,1,1,1,1,-1,A
2005-08-20,2005,Birmingham City,Manchester City,1-2,1,2,1,1,3,-1,A
2005-08-20,2005,Blackburn Rovers,Fulham,2-1,2,1,1,1,3,1,H
2005-08-20,2005,Charlton Athletic,Wigan Athletic,1-0,1,0,1,1,1,1,H
2005-08-20,2005,Liverpool,Sunderland,1-0,1,0,1,1,1,1,H
2005-08-20,2005,Manchester United,Aston Villa,1-0,1,0,1,1,1,1,H
2005-08-20,2005,Newcastle United,West Ham United,0-0,0,0,1,1,0,0,D
2005-08-20,2005,Tottenham Hotspur,Middlesbrough,2-0,2,0,1,1,2,2,H
2005-08-20,2005,West Bromwich Albion,Portsmouth,2-1,2,1,1,1,3,1,H
2005-08-21,2005,Bolton Wanderers,Everton,0-1,0,1,1,1,1,-1,A
2005-08-21,2005,Chelsea,Arsenal,1-0,1,0,1,1,1,1,H
2005-08-23,2005,Birmingham City,Middlesbrough,0-3,0,3,1,1,3,-3,A
2005-08-23,2005,Portsmouth,Aston Villa,1-1,1,1,1,1,2,0,D
2005-08-23,2005,Sunderland,Manchester City,1-2,1,2,1,1,3,-1,A
2005-08-24,2005,Arsenal,Fulham,4-1,4,1,1,1,5,3,H
2005-08-24,2005,Blackburn Rovers,Tottenham Hotspur,0-0,0,0,1,1,0,0,D
2005-08-24,2005,Bolton Wanderers,Newcastle United,2-0,2,0,1,1,2,2,H
2005-08-24,2005,Chelsea,West Bromwich Albion,4-0,4,0,1,1,4,4,H
2005-08-27,2005,Aston Villa,Blackburn Rovers,1-0,1,0,1,1,1,1,H
2005-08-27,2005,Fulham,Everton,1-0,1,0,1,1,1,1,H
2005-08-27,2005,Manchester City,Portsmouth,2-1,2,1,1,1,3,1,H
2005-08-27,2005,Tottenham Hotspur,Chelsea,0-2,0,2,1,1,2,-2,A
2005-08-27,2005,West Bromwich Albion,Birmingham City,2-3,2,3,1,1,5,-1,A
2005-08-27,2005,West Ham United,Bolton Wanderers,1-2,1,2,1,1,3,-1,A
2005-08-27,2005,Wigan Athletic,Sunderland,1-0,1,0,1,1,1,1,H
2005-08-28,2005,Middlesbrough,Charlton Athletic,0-3,0,3,1,1,3,-3,A
2005-08-28,2005,Newcastle United,Manchester United,0-2,0,2,1,1,2,-2,A
2005-09-10,2005,Birmingham City,Charlton Athletic,0-1,0,1,1,1,1,-1,A
2005-09-10,2005,Chelsea,Sunderland,2-0,2,0,1,1,2,2,H
2005-09-10,2005,Everton,Portsmouth,0-1,0,1,1,1,1,-1,A
2005-09-10,2005,Manchester United,Manchester City,1-1,1,1,1,1,2,0,D
2005-09-10,2005,Middlesbrough,Arsenal,2-1,2,1,1,1,3,1,H
2005-09-10,2005,Newcastle United,Fulham,1-1,1,1,1,1,2,0,D
2005-09-10,2005,Tottenham Hotspur,Liverpool,0-0,0,0,1,1,0,0,D
2005-09-10,2005,West Bromwich Albion,Wigan Athletic,1-2,1,2,1,1,3,-1,A
2005-09-11,2005,Bolton Wanderers,Blackburn Rovers,0-0,0,0,1,1,0,0,D
2005-09-12,2005,West Ham United,Aston Villa,4-0,4,0,1,1,4,4,H
2005-09-17,2005,Aston Villa,Tottenham Hotspur,1-1,1,1,1,1,2,0,D
2005-09-17,2005,Charlton Athletic,Chelsea,0-2,0,2,1,1,2,-2,A
2005-09-17,2005,Fulham,West Ham United,1-2,1,2,1,1,3,-1,A
2005-09-17,2005,Portsmouth,Birmingham City,1-1,1,1,1,1,2,0,D
2005-09-17,2005,Sunderland,West Bromwich Albion,1-1,1,1,1,1,2,0,D
2005-09-18,2005,Blackburn Rovers,Newcastle United,0-3,0,3,1,1,3,-3,A
2005-09-18,2005,Liverpool,Manchester United,0-0,0,0,1,1,0,0,D
2005-09-18,2005,Manchester City,Bolton Wanderers,0-1,0,1,1,1,1,-1,A
2005-09-18,2005,Wigan Athletic,Middlesbrough,1-1,1,1,1,1,2,0,D
2005-09-19,2005,Arsenal,Everton,2-0,2,0,1,1,2,2,H
2005-09-24,2005,Birmingham City,Liverpool,2-2,2,2,1,1,4,0,D
2005-09-24,2005,Bolton Wanderers,Portsmouth,1-0,1,0,1,1,1,1,H
2005-09-24,2005,Chelsea,Aston Villa,2-1,2,1,1,1,3,1,H
2005-09-24,2005,Everton,Wigan Athletic,0-1,0,1,1,1,1,-1,A
2005-09-24,2005,Manchester United,Blackburn Rovers,1-2,1,2,1,1,3,-1,A
2005-09-24,2005,Newcastle United,Manchester City,1-0,1,0,1,1,1,1,H
2005-09-24,2005,West Bromwich Albion,Charlton Athletic,1-2,1,2,1,1,3,-1,A
2005-09-24,2005,West Ham United,Arsenal,0-0,0,0,1,1,0,0,D
2005-09-25,2005,Middlesbrough,Sunderland,0-2,0,2,1,1,2,-2,A
2005-09-26,2005,Tottenham Hotspur,Fulham,1-0,1,0,1,1,1,1,H
2005-10-01,2005,Blackburn Rovers,West Bromwich Albion,2-0,2,0,1,1,2,2,H
2005-10-01,2005,Charlton Athletic,Tottenham Hotspur,2-3,2,3,1,1,5,-1,A
2005-10-01,2005,Fulham,Manchester United,2-3,2,3,1,1,5,-1,A
2005-10-01,2005,Portsmouth,Newcastle United,0-0,0,0,1,1,0,0,D
2005-10-01,2005,Sunderland,West Ham United,1-1,1,1,1,1,2,0,D
2005-10-02,2005,Arsenal,Birmingham City,1-0,1,0,1,1,1,1,H
2005-10-02,2005,Aston Villa,Middlesbrough,2-3,2,3,1,1,5,-1,A
2005-10-02,2005,Liverpool,Chelsea,1-4,1,4,1,1,5,-3,A
2005-10-02,2005,Manchester City,Everton,2-0,2,0,1,1,2,2,H
2005-10-02,2005,Wigan Athletic,Bolton Wanderers,2-1,2,1,1,1,3,1,H
2005-10-15,2005,Chelsea,Bolton Wanderers,5-1,5,1,1,1,6,4,H
2005-10-15,2005,Liverpool,Blackburn Rovers,1-0,1,0,1,1,1,1,H
2005-10-15,2005,Middlesbrough,Portsmouth,1-1,1,1,1,1,2,0,D
2005-10-15,2005,Sunderland,Manchester United,1-3,1,3,1,1,4,-2,A
2005-10-15,2005,Tottenham Hotspur,Everton,2-0,2,0,1,1,2,2,H
2005-10-15,2005,West Bromwich Albion,Arsenal,2-1,2,1,1,1,3,1,H
2005-10-15,2005,Wigan Athletic,Newcastle United,1-0,1,0,1,1,1,1,H
2005-10-16,2005,Birmingham City,Aston Villa,0-1,0,1,1,1,1,-1,A
2005-10-16,2005,Manchester City,West Ham United,2-1,2,1,1,1,3,1,H
2005-10-17,2005,Charlton Athletic,Fulham,1-1,1,1,1,1,2,0,D
2005-10-22,2005,Arsenal,Manchester City,1-0,1,0,1,1,1,1,H
2005-10-22,2005,Aston Villa,Wigan Athletic,0-2,0,2,1,1,2,-2,A
2005-10-22,2005,Blackburn Rovers,Birmingham City,2-0,2,0,1,1,2,2,H
2005-10-22,2005,Fulham,Liverpool,2-0,2,0,1,1,2,2,H
2005-10-22,2005,Manchester United,Tottenham Hotspur,1-1,1,1,1,1,2,0,D
2005-10-22,2005,Portsmouth,Charlton Athletic,1-2,1,2,1,1,3,-1,A
2005-10-23,2005,Bolton Wanderers,West Bromwich Albion,2-0,2,0,1,1,2,2,H
2005-10-23,2005,Everton,Chelsea,1-1,1,1,1,1,2,0,D
2005-10-23,2005,Newcastle United,Sunderland,3-2,3,2,1,1,5,1,H
2005-10-23,2005,West Ham United,Middlesbrough,2-1,2,1,1,1,3,1,H
2005-10-29,2005,Birmingham City,Everton,0-1,0,1,1,1,1,-1,A
2005-10-29,2005,Charlton Athletic,Bolton Wanderers,0-1,0,1,1,1,1,-1,A
2005-10-29,2005,Chelsea,Blackburn Rovers,4-2,4,2,1,1,6,2,H
2005-10-29,2005,Liverpool,West Ham United,2-0,2,0,1,1,2,2,H
2005-10-29,2005,Middlesbrough,Manchester United,4-1,4,1,1,1,5,3,H
2005-10-29,2005,Sunderland,Portsmouth,1-4,1,4,1,1,5,-3,A
2005-10-29,2005,Tottenham Hotspur,Arsenal,1-1,1,1,1,1,2,0,D
2005-10-29,2005,Wigan Athletic,Fulham,1-0,1,0,1,1,1,1,H
2005-10-30,2005,West Bromwich Albion,Newcastle United,0-3,0,3,1,1,3,-3,A
2005-10-31,2005,Manchester City,Aston Villa,3-1,3,1,1,1,4,2,H
2005-11-05,2005,Arsenal,Sunderland,3-1,3,1,1,1,4,2,H
2005-11-05,2005,Aston Villa,Liverpool,0-2,0,2,1,1,2,-2,A
2005-11-05,2005,Blackburn Rovers,Charlton Athletic,4-1,4,1,1,1,5,3,H
2005-11-05,2005,Fulham,Manchester City,2-1,2,1,1,1,3,1,H
2005-11-05,2005,Newcastle United,Birmingham City,1-0,1,0,1,1,1,1,H
2005-11-05,2005,Portsmouth,Wigan Athletic,0-2,0,2,1,1,2,-2,A
2005-11-05,2005,West Ham United,West Bromwich Albion,1-0,1,0,1,1,1,1,H
2005-11-06,2005,Everton,Middlesbrough,1-0,1,0,1,1,1,1,H
2005-11-06,2005,Manchester United,Chelsea,1-0,1,0,1,1,1,1,H
2005-11-07,2005,Bolton Wanderers,Tottenham Hotspur,1-0,1,0,1,1,1,1,H
2005-11-19,2005,Charlton Athletic,Manchester United,1-3,1,3,1,1,4,-2,A
2005-11-19,2005,Chelsea,Newcastle United,3-0,3,0,1,1,3,3,H
2005-11-19,2005,Liverpool,Portsmouth,3-0,3,0,1,1,3,3,H
2005-11-19,2005,Manchester City,Blackburn Rovers,0-0,0,0,1,1,0,0,D
2005-11-19,2005,Sunderland,Aston Villa,1-3,1,3,1,1,4,-2,A
2005-11-19,2005,West Bromwich Albion,Everton,4-0,4,0,1,1,4,4,H
2005-11-19,2005,Wigan Athletic,Arsenal,2-3,2,3,1,1,5,-1,A
2005-11-20,2005,Middlesbrough,Fulham,3-2,3,2,1,1,5,1,H
2005-11-20,2005,Tottenham Hotspur,West Ham United,1-1,1,1,1,1,2,0,D
2005-11-26,2005,Arsenal,Blackburn Rovers,3-0,3,0,1,1,3,3,H
2005-11-26,2005,Aston Villa,Charlton Athletic,1-0,1,0,1,1,1,1,H
2005-11-26,2005,Manchester City,Liverpool,0-1,0,1,1,1,1,-1,A
2005-11-26,2005,Portsmouth,Chelsea,0-2,0,2,1,1,2,-2,A
2005-11-26,2005,Sunderland,Birmingham City,0-1,0,1,1,1,1,-1,A
2005-11-26,2005,Wigan Athletic,Tottenham Hotspur,1-2,1,2,1,1,3,-1,A
2005-11-27,2005,Everton,Newcastle United,1-0,1,0,1,1,1,1,H
2005-11-27,2005,Fulham,Bolton Wanderers,2-1,2,1,1,1,3,1,H
2005-11-27,2005,Middlesbrough,West Bromwich Albion,2-2,2,2,1,1,4,0,D
2005-11-27,2005,West Ham United,Manchester United,1-2,1,2,1,1,3,-1,A
2005-11-30,2005,Sunderland,Liverpool,0-2,0,2,1,1,2,-2,A
2005-12-03,2005,Blackburn Rovers,Everton,0-2,0,2,1,1,2,-2,A
2005-12-03,2005,Bolton Wanderers,Arsenal,2-0,2,0,1,1,2,2,H
2005-12-03,2005,Chelsea,Middlesbrough,1-0,1,0,1,1,1,1,H
2005-12-03,2005,Liverpool,Wigan Athletic,3-0,3,0,1,1,3,3,H
2005-12-03,2005,Manchester United,Portsmouth,3-0,3,0,1,1,3,3,H
2005-12-03,2005,Newcastle United,Aston Villa,1-1,1,1,1,1,2,0,D
2005-12-03,2005,Tottenham Hotspur,Sunderland,3-2,3,2,1,1,5,1,H
2005-12-03,2005,West Bromwich Albion,Fulham,0-0,0,0,1,1,0,0,D
2005-12-04,2005,Charlton Athletic,Manchester City,2-5,2,5,1,1,7,-3,A
2005-12-05,2005,Birmingham City,West Ham United,1-2,1,2,1,1,3,-1,A
2005-12-10,2005,Birmingham City,Fulham,1-0,1,0,1,1,1,1,H
2005-12-10,2005,Blackburn Rovers,West Ham United,3-2,3,2,1,1,5,1,H
2005-12-10,2005,Bolton Wanderers,Aston Villa,1-1,1,1,1,1,2,0,D
2005-12-10,2005,Charlton Athletic,Sunderland,2-0,2,0,1,1,2,2,H
2005-12-10,2005,Chelsea,Wigan Athletic,1-0,1,0,1,1,1,1,H
2005-12-10,2005,Liverpool,Middlesbrough,2-0,2,0,1,1,2,2,H
2005-12-10,2005,Newcastle United,Arsenal,1-0,1,0,1,1,1,1,H
2005-12-10,2005,West Bromwich Albion,Manchester City,2-0,2,0,1,1,2,2,H
2005-12-11,2005,Manchester United,Everton,1-1,1,1,1,1,2,0,D
2005-12-12,2005,Tottenham Hotspur,Portsmouth,3-1,3,1,1,1,4,2,H
2005-12-14,2005,Everton,West Ham United,1-2,1,2,1,1,3,-1,A
2005-12-14,2005,Manchester United,Wigan Athletic,4-0,4,0,1,1,4,4,H
2005-12-17,2005,Aston Villa,Manchester United,0-2,0,2,1,1,2,-2,A
2005-12-17,2005,Everton,Bolton Wanderers,0-4,0,4,1,1,4,-4,A
2005-12-17,2005,Fulham,Blackburn Rovers,2-1,2,1,1,1,3,1,H
2005-12-17,2005,Manchester City,Birmingham City,4-1,4,1,1,1,5,3,H
2005-12-17,2005,Portsmouth,West Bromwich Albion,1-0,1,0,1,1,1,1,H
2005-12-17,2005,West Ham United,Newcastle United,2-4,2,4,1,1,6,-2,A
2005-12-17,2005,Wigan Athletic,Charlton Athletic,3-0,3,0,1,1,3,3,H
2005-12-18,2005,Arsenal,Chelsea,0-2,0,2,1,1,2,-2,A
2005-12-18,2005,Middlesbrough,Tottenham Hotspur,3-3,3,3,1,1,6,0,D
2005-12-26,2005,Aston Villa,Everton,4-0,4,0,1,1,4,4,H
2005-12-26,2005,Charlton Athletic,Arsenal,0-1,0,1,1,1,1,-1,A
2005-12-26,2005,Chelsea,Fulham,3-2,3,2,1,1,5,1,H
2005-12-26,2005,Liverpool,Newcastle United,2-0,2,0,1,1,2,2,H
2005-12-26,2005,Manchester United,West Bromwich Albion,3-0,3,0,1,1,3,3,H
2005-12-26,2005,Middlesbrough,Blackburn Rovers,0-2,0,2,1,1,2,-2,A
2005-12-26,2005,Portsmouth,West Ham United,1-1,1,1,1,1,2,0,D
2005-12-26,2005,Sunderland,Bolton Wanderers,0-0,0,0,1,1,0,0,D
2005-12-26,2005,Tottenham Hotspur,Birmingham City,2-0,2,0,1,1,2,2,H
2005-12-26,2005,Wigan Athletic,Manchester City,4-3,4,3,1,1,7,1,H
2005-12-28,2005,Arsenal,Portsmouth,4-0,4,0,1,1,4,4,H
2005-12-28,2005,Birmingham City,Manchester United,2-2,2,2,1,1,4,0,D
2005-12-28,2005,Everton,Liverpool,1-3,1,3,1,1,4,-2,A
2005-12-28,2005,Fulham,Aston Villa,3-3,3,3,1,1,6,0,D
2005-12-28,2005,Manchester City,Chelsea,0-1,0,1,1,1,1,-1,A
2005-12-28,2005,West Bromwich Albion,Tottenham Hotspur,2-0,2,0,1,1,2,2,H
2005-12-28,2005,West Ham United,Wigan Athletic,0-2,0,2,1,1,2,-2,A
2005-12-31,2005,Aston Villa,Arsenal,0-0,0,0,1,1,0,0,D
2005-12-31,2005,Charlton Athletic,West Ham United,2-0,2,0,1,1,2,2,H
2005-12-31,2005,Chelsea,Birmingham City,2-0,2,0,1,1,2,2,H
2005-12-31,2005,Liverpool,West Bromwich Albion,1-0,1,0,1,1,1,1,H
2005-12-31,2005,Manchester United,Bolton Wanderers,4-1,4,1,1,1,5,3,H
2005-12-31,2005,Middlesbrough,Manchester City,0-0,0,0,1,1,0,0,D
2005-12-31,2005,Portsmouth,Fulham,1-0,1,0,1,1,1,1,H
2005-12-31,2005,Sunderland,Everton,0-1,0,1,1,1,1,-1,A
2005-12-31,2005,Tottenham Hotspur,Newcastle United,2-0,2,0,1,1,2,2,H
2005-12-31,2005,Wigan Athletic,Blackburn Rovers,0-3,0,3,1,1,3,-3,A
2006-01-02,2005,Birmingham City,Wigan Athletic,2-0,2,0,1,1,2,2,H
2006-01-02,2005,Blackburn Rovers,Portsmouth,2-1,2,1,1,1,3,1,H
2006-01-02,2005,Bolton Wanderers,Liverpool,2-2,2,2,1,1,4,0,D
2006-01-02,2005,Everton,Charlton Athletic,3-1,3,1,1,1,4,2,H
2006-01-02,2005,Fulham,Sunderland,2-1,2,1,1,1,3,1,H
2006-01-02,2005,Newcastle United,Middlesbrough,2-2,2,2,1,1,4,0,D
2006-01-02,2005,West Bromwich Albion,Aston Villa,1-2,1,2,1,1,3,-1,A
2006-01-02,2005,West Ham United,Chelsea,1-3,1,3,1,1,4,-2,A
2006-01-03,2005,Arsenal,Manchester United,0-0,0,0,1,1,0,0,D
2006-01-04,2005,Manchester City,Tottenham Hotspur,0-2,0,2,1,1,2,-2,A
2006-01-14,2005,Arsenal,Middlesbrough,7-0,7,0,1,1,7,7,H
2006-01-14,2005,Aston Villa,West Ham United,1-2,1,2,1,1,3,-1,A
2006-01-14,2005,Blackburn Rovers,Bolton Wanderers,0-0,0,0,1,1,0,0,D
2006-01-14,2005,Charlton Athletic,Birmingham City,2-0,2,0,1,1,2,2,H
2006-01-14,2005,Fulham,Newcastle United,1-0,1,0,1,1,1,1,H
2006-01-14,2005,Liverpool,Tottenham Hotspur,1-0,1,0,1,1,1,1,H
2006-01-14,2005,Manchester City,Manchester United,3-1,3,1,1,1,4,2,H
2006-01-14,2005,Portsmouth,Everton,0-1,0,1,1,1,1,-1,A
2006-01-15,2005,Sunderland,Chelsea,1-2,1,2,1,1,3,-1,A
2006-01-15,2005,Wigan Athletic,West Bromwich Albion,0-1,0,1,1,1,1,-1,A
2006-01-21,2005,Birmingham City,Portsmouth,5-0,5,0,1,1,5,5,H
2006-01-21,2005,Bolton Wanderers,Manchester City,2-0,2,0,1,1,2,2,H
2006-01-21,2005,Everton,Arsenal,1-0,1,0,1,1,1,1,H
2006-01-21,2005,Middlesbrough,Wigan Athletic,2-3,2,3,1,1,5,-1,A
2006-01-21,2005,Newcastle United,Blackburn Rovers,0-1,0,1,1,1,1,-1,A
2006-01-21,2005,Tottenham Hotspur,Aston Villa,0-0,0,0,1,1,0,0,D
2006-01-21,2005,West Bromwich Albion,Sunderland,0-1,0,1,1,1,1,-1,A
2006-01-22,2005,Chelsea,Charlton Athletic,1-1,1,1,1,1,2,0,D
2006-01-22,2005,Manchester United,Liverpool,1-0,1,0,1,1,1,1,H
2006-01-23,2005,West Ham United,Fulham,2-1,2,1,1,1,3,1,H
2006-01-31,2005,Charlton Athletic,West Bromwich Albion,0-0,0,0,1,1,0,0,D
2006-01-31,2005,Fulham,Tottenham Hotspur,1-0,1,0,1,1,1,1,H
2006-01-31,2005,Sunderland,Middlesbrough,0-3,0,3,1,1,3,-3,A
2006-01-31,2005,Wigan Athletic,Everton,1-1,1,1,1,1,2,0,D
2006-02-01,2005,Arsenal,West Ham United,2-3,2,3,1,1,5,-1,A
2006-02-01,2005,Aston Villa,Chelsea,1-1,1,1,1,1,2,0,D
2006-02-01,2005,Blackburn Rovers,Manchester United,4-3,4,3,1,1,7,1,H
2006-02-01,2005,Liverpool,Birmingham City,1-1,1,1,1,1,2,0,D
2006-02-01,2005,Manchester City,Newcastle United,3-0,3,0,1,1,3,3,H
2006-02-01,2005,Portsmouth,Bolton Wanderers,1-1,1,1,1,1,2,0,D
2006-02-04,2005,Birmingham City,Arsenal,0-2,0,2,1,1,2,-2,A
2006-02-04,2005,Bolton Wanderers,Wigan Athletic,1-1,1,1,1,1,2,0,D
2006-02-04,2005,Everton,Manchester City,1-0,1,0,1,1,1,1,H
2006-02-04,2005,Manchester United,Fulham,4-2,4,2,1,1,6,2,H
2006-02-04,2005,Middlesbrough,Aston Villa,0-4,0,4,1,1,4,-4,A
2006-02-04,2005,Newcastle United,Portsmouth,2-0,2,0,1,1,2,2,H
2006-02-04,2005,West Bromwich Albion,Blackburn Rovers,2-0,2,0,1,1,2,2,H
2006-02-04,2005,West Ham United,Sunderland,2-0,2,0,1,1,2,2,H
2006-02-05,2005,Chelsea,Liverpool,2-0,2,0,1,1,2,2,H
2006-02-05,2005,Tottenham Hotspur,Charlton Athletic,3-1,3,1,1,1,4,2,H
2006-02-08,2005,Charlton Athletic,Liverpool,2-0,2,0,1,1,2,2,H
2006-02-11,2005,Arsenal,Bolton Wanderers,1-1,1,1,1,1,2,0,D
2006-02-11,2005,Aston Villa,Newcastle United,1-2,1,2,1,1,3,-1,A
2006-02-11,2005,Everton,Blackburn Rovers,1-0,1,0,1,1,1,1,H
2006-02-11,2005,Fulham,West Bromwich Albion,6-1,6,1,1,1,7,5,H
2006-02-11,2005,Middlesbrough,Chelsea,3-0,3,0,1,1,3,3,H
2006-02-11,2005,Portsmouth,Manchester United,1-3,1,3,1,1,4,-2,A
2006-02-11,2005,Wigan Athletic,Liverpool,0-1,0,1,1,1,1,-1,A
2006-02-12,2005,Manchester City,Charlton Athletic,3-2,3,2,1,1,5,1,H
2006-02-12,2005,Sunderland,Tottenham Hotspur,1-1,1,1,1,1,2,0,D
2006-02-13,2005,West Ham United,Birmingham City,3-0,3,0,1,1,3,3,H
2006-02-14,2005,Liverpool,Arsenal,1-0,1,0,1,1,1,1,H
2006-02-15,2005,Blackburn Rovers,Sunderland,2-0,2,0,1,1,2,2,H
2006-02-19,2005,Tottenham Hotspur,Wigan Athletic,2-2,2,2,1,1,4,0,D
2006-02-22,2005,Newcastle United,Charlton Athletic,0-0,0,0,1,1,0,0,D
2006-02-25,2005,Birmingham City,Sunderland,1-0,1,0,1,1,1,1,H
2006-02-25,2005,Blackburn Rovers,Arsenal,1-0,1,0,1,1,1,1,H
2006-02-25,2005,Charlton Athletic,Aston Villa,0-0,0,0,1,1,0,0,D
2006-02-25,2005,Chelsea,Portsmouth,2-0,2,0,1,1,2,2,H
2006-02-25,2005,Newcastle United,Everton,2-0,2,0,1,1,2,2,H
2006-02-26,2005,Bolton Wanderers,Fulham,2-1,2,1,1,1,3,1,H
2006-02-26,2005,Liverpool,Manchester City,1-0,1,0,1,1,1,1,H
2006-02-26,2005,West Bromwich Albion,Middlesbrough,0-2,0,2,1,1,2,-2,A
2006-03-04,2005,Aston Villa,Portsmouth,1-0,1,0,1,1,1,1,H
2006-03-04,2005,Fulham,Arsenal,0-4,0,4,1,1,4,-4,A
2006-03-04,2005,Liverpool,Charlton Athletic,0-0,0,0,1,1,0,0,D
2006-03-04,2005,Middlesbrough,Birmingham City,1-0,1,0,1,1,1,1,H
2006-03-04,2005,Newcastle United,Bolton Wanderers,3-1,3,1,1,1,4,2,H
2006-03-04,2005,West Bromwich Albion,Chelsea,1-2,1,2,1,1,3,-1,A
2006-03-04,2005,West Ham United,Everton,2-2,2,2,1,1,4,0,D
2006-03-05,2005,Manchester City,Sunderland,2-1,2,1,1,1,3,1,H
2006-03-05,2005,Tottenham Hotspur,Blackburn Rovers,3-2,3,2,1,1,5,1,H
2006-03-06,2005,Wigan Athletic,Manchester United,1-2,1,2,1,1,3,-1,A
2006-03-11,2005,Birmingham City,West Bromwich Albion,1-1,1,1,1,1,2,0,D
2006-03-11,2005,Blackburn Rovers,Aston Villa,2-0,2,0,1,1,2,2,H
2006-03-11,2005,Bolton Wanderers,West Ham United,4-1,4,1,1,1,5,3,H
2006-03-11,2005,Chelsea,Tottenham Hotspur,2-1,2,1,1,1,3,1,H
2006-03-11,2005,Everton,Fulham,3-1,3,1,1,1,4,2,H
2006-03-11,2005,Portsmouth,Manchester City,2-1,2,1,1,1,3,1,H
2006-03-11,2005,Sunderland,Wigan Athletic,0-1,0,1,1,1,1,-1,A
2006-03-12,2005,Arsenal,Liverpool,2-1,2,1,1,1,3,1,H
2006-03-12,2005,Charlton Athletic,Middlesbrough,2-1,2,1,1,1,3,1,H
2006-03-12,2005,Manchester United,Newcastle United,2-0,2,0,1,1,2,2,H
2006-03-15,2005,Liverpool,Fulham,5-1,5,1,1,1,6,4,H
2006-03-18,2005,Arsenal,Charlton Athletic,3-0,3,0,1,1,3,3,H
2006-03-18,2005,Birmingham City,Tottenham Hotspur,0-2,0,2,1,1,2,-2,A
2006-03-18,2005,Blackburn Rovers,Middlesbrough,3-2,3,2,1,1,5,1,H
2006-03-18,2005,Bolton Wanderers,Sunderland,2-0,2,0,1,1,2,2,H
2006-03-18,2005,Everton,Aston Villa,4-1,4,1,1,1,5,3,H
2006-03-18,2005,Manchester City,Wigan Athletic,0-1,0,1,1,1,1,-1,A
2006-03-18,2005,West Bromwich Albion,Manchester United,1-2,1,2,1,1,3,-1,A
2006-03-18,2005,West Ham United,Portsmouth,2-4,2,4,1,1,6,-2,A
2006-03-19,2005,Fulham,Chelsea,1-0,1,0,1,1,1,1,H
2006-03-19,2005,Newcastle United,Liverpool,1-3,1,3,1,1,4,-2,A
2006-03-25,2005,Aston Villa,Fulham,0-0,0,0,1,1,0,0,D
2006-03-25,2005,Chelsea,Manchester City,2-0,2,0,1,1,2,2,H
2006-03-25,2005,Liverpool,Everton,3-1,3,1,1,1,4,2,H
2006-03-25,2005,Sunderland,Blackburn Rovers,0-1,0,1,1,1,1,-1,A
2006-03-25,2005,Wigan Athletic,West Ham United,1-2,1,2,1,1,3,-1,A
2006-03-26,2005,Charlton Athletic,Newcastle United,3-1,3,1,1,1,4,2,H
2006-03-26,2005,Manchester United,Birmingham City,3-0,3,0,1,1,3,3,H
2006-03-26,2005,Middlesbrough,Bolton Wanderers,4-3,4,3,1,1,7,1,H
2006-03-27,2005,Tottenham Hotspur,West Bromwich Albion,2-1,2,1,1,1,3,1,H
2006-03-29,2005,Manchester United,West Ham United,1-0,1,0,1,1,1,1,H
2006-04-01,2005,Arsenal,Aston Villa,5-0,5,0,1,1,5,5,H
2006-04-01,2005,Birmingham City,Chelsea,0-0,0,0,1,1,0,0,D
2006-04-01,2005,Bolton Wanderers,Manchester United,1-2,1,2,1,1,3,-1,A
2006-04-01,2005,Everton,Sunderland,2-2,2,2,1,1,4,0,D
2006-04-01,2005,Fulham,Portsmouth,1-3,1,3,1,1,4,-2,A
2006-04-01,2005,Newcastle United,Tottenham Hotspur,3-1,3,1,1,1,4,2,H
2006-04-01,2005,West Bromwich Albion,Liverpool,0-2,0,2,1,1,2,-2,A
2006-04-02,2005,Manchester City,Middlesbrough,0-1,0,1,1,1,1,-1,A
2006-04-02,2005,West Ham United,Charlton Athletic,0-0,0,0,1,1,0,0,D
2006-04-03,2005,Blackburn Rovers,Wigan Athletic,1-1,1,1,1,1,2,0,D
2006-04-04,2005,Birmingham City,Bolton Wanderers,1-0,1,0,1,1,1,1,H
2006-04-08,2005,Charlton Athletic,Everton,0-0,0,0,1,1,0,0,D
2006-04-08,2005,Portsmouth,Blackburn Rovers,2-2,2,2,1,1,4,0,D
2006-04-08,2005,Tottenham Hotspur,Manchester City,2-1,2,1,1,1,3,1,H
2006-04-08,2005,Wigan Athletic,Birmingham City,1-1,1,1,1,1,2,0,D
2006-04-09,2005,Aston Villa,West Bromwich Albion,0-0,0,0,1,1,0,0,D
2006-04-09,2005,Chelsea,West Ham United,4-1,4,1,1,1,5,3,H
2006-04-09,2005,Liverpool,Bolton Wanderers,1-0,1,0,1,1,1,1,H
2006-04-09,2005,Manchester United,Arsenal,2-0,2,0,1,1,2,2,H
2006-04-09,2005,Middlesbrough,Newcastle United,1-2,1,2,1,1,3,-1,A
2006-04-12,2005,Portsmouth,Arsenal,1-1,1,1,1,1,2,0,D
2006-04-14,2005,Manchester United,Sunderland,0-0,0,0,1,1,0,0,D
2006-04-15,2005,Arsenal,West Bromwich Albion,3-1,3,1,1,1,4,2,H
2006-04-15,2005,Bolton Wanderers,Chelsea,0-2,0,2,1,1,2,-2,A
2006-04-15,2005,Everton,Tottenham Hotspur,0-1,0,1,1,1,1,-1,A
2006-04-15,2005,Fulham,Charlton Athletic,2-1,2,1,1,1,3,1,H
2006-04-15,2005,Newcastle United,Wigan Athletic,3-1,3,1,1,1,4,2,H
2006-04-15,2005,Portsmouth,Middlesbrough,1-0,1,0,1,1,1,1,H
2006-04-15,2005,West Ham United,Manchester City,1-0,1,0,1,1,1,1,H
2006-04-16,2005,Aston Villa,Birmingham City,3-1,3,1,1,1,4,2,H
2006-04-16,2005,Blackburn Rovers,Liverpool,0-1,0,1,1,1,1,-1,A
2006-04-17,2005,Charlton Athletic,Portsmouth,2-1,2,1,1,1,3,1,H
2006-04-17,2005,Chelsea,Everton,3-0,3,0,1,1,3,3,H
2006-04-17,2005,Middlesbrough,West Ham United,2-0,2,0,1,1,2,2,H
2006-04-17,2005,Sunderland,Newcastle United,1-4,1,4,1,1,5,-3,A
2006-04-17,2005,Tottenham Hotspur,Manchester United,1-2,1,2,1,1,3,-1,A
2006-04-17,2005,West Bromwich Albion,Bolton Wanderers,0-0,0,0,1,1,0,0,D
2006-04-18,2005,Wigan Athletic,Aston Villa,3-2,3,2,1,1,5,1,H
2006-04-19,2005,Birmingham City,Blackburn Rovers,2-1,2,1,1,1,3,1,H
2006-04-22,2005,Arsenal,Tottenham Hotspur,1-1,1,1,1,1,2,0,D
2006-04-22,2005,Bolton Wanderers,Charlton Athletic,4-1,4,1,1,1,5,3,H
2006-04-22,2005,Everton,Birmingham City,0-0,0,0,1,1,0,0,D
2006-04-22,2005,Newcastle United,West Bromwich Albion,3-0,3,0,1,1,3,3,H
2006-04-22,2005,Portsmouth,Sunderland,2-1,2,1,1,1,3,1,H
2006-04-24,2005,Fulham,Wigan Athletic,1-0,1,0,1,1,1,1,H
2006-04-25,2005,Aston Villa,Manchester City,0-1,0,1,1,1,1,-1,A
2006-04-26,2005,West Ham United,Liverpool,1-2,1,2,1,1,3,-1,A
2006-04-29,2005,Birmingham City,Newcastle United,0-0,0,0,1,1,0,0,D
2006-04-29,2005,Charlton Athletic,Blackburn Rovers,0-2,0,2,1,1,2,-2,A
2006-04-29,2005,Chelsea,Manchester United,3-0,3,0,1,1,3,3,H
2006-04-29,2005,Liverpool,Aston Villa,3-1,3,1,1,1,4,2,H
2006-04-29,2005,Manchester City,Fulham,1-2,1,2,1,1,3,-1,A
2006-04-29,2005,Middlesbrough,Everton,0-1,0,1,1,1,1,-1,A
2006-04-29,2005,Wigan Athletic,Portsmouth,1-2,1,2,1,1,3,-1,A
2006-04-30,2005,Tottenham Hotspur,Bolton Wanderers,1-0,1,0,1,1,1,1,H
2006-05-01,2005,Manchester United,Middlesbrough,0-0,0,0,1,1,0,0,D
2006-05-01,2005,Sunderland,Arsenal,0-3,0,3,1,1,3,-3,A
2006-05-01,2005,West Bromwich Albion,West Ham United,0-1,0,1,1,1,1,-1,A
2006-05-02,2005,Blackburn Rovers,Chelsea,1-0,1,0,1,1,1,1,H
2006-05-03,2005,Bolton Wanderers,Middlesbrough,1-1,1,1,1,1,2,0,D
2006-05-04,2005,Manchester City,Arsenal,1-3,1,3,1,1,4,-2,A
2006-05-04,2005,Sunderland,Fulham,2-1,2,1,1,1,3,1,H
2006-05-07,2005,Arsenal,Wigan Athletic,4-2,4,2,1,1,6,2,H
2006-05-07,2005,Aston Villa,Sunderland,2-1,2,1,1,1,3,1,H
2006-05-07,2005,Blackburn Rovers,Manchester City,2-0,2,0,1,1,2,2,H
2006-05-07,2005,Bolton Wanderers,Birmingham City,1-0,1,0,1,1,1,1,H
2006-05-07,2005,Everton,West Bromwich Albion,2-2,2,2,1,1,4,0,D
2006-05-07,2005,Fulham,Middlesbrough,1-0,1,0,1,1,1,1,H
2006-05-07,2005,Manchester United,Charlton Athletic,4-0,4,0,1,1,4,4,H
2006-05-07,2005,Newcastle United,Chelsea,1-0,1,0,1,1,1,1,H
2006-05-07,2005,Portsmouth,Liverpool,1-3,1,3,1,1,4,-2,A
2006-05-07,2005,West Ham United,Tottenham Hotspur,2-1,2,1,1,1,3,1,H
2006-08-19,2006,Arsenal,Aston Villa,1-1,1,1,1,1,2,0,D
2006-08-19,2006,Bolton Wanderers,Tottenham Hotspur,2-0,2,0,1,1,2,2,H
2006-08-19,2006,Everton,Watford,2-1,2,1,1,1,3,1,H
2006-08-19,2006,Newcastle United,Wigan Athletic,2-1,2,1,1,1,3,1,H
2006-08-19,2006,Portsmouth,Blackburn Rovers,3-0,3,0,1,1,3,3,H
2006-08-19,2006,Reading,Middlesbrough,3-2,3,2,1,1,5,1,H
2006-08-19,2006,Sheffield United,Liverpool,1-1,1,1,1,1,2,0,D
2006-08-19,2006,West Ham United,Charlton Athletic,3-1,3,1,1,1,4,2,H
2006-08-20,2006,Chelsea,Manchester City,3-0,3,0,1,1,3,3,H
2006-08-20,2006,Manchester United,Fulham,5-1,5,1,1,1,6,4,H
2006-08-22,2006,Tottenham Hotspur,Sheffield United,2-0,2,0,1,1,2,2,H
2006-08-22,2006,Watford,West Ham United,1-1,1,1,1,1,2,0,D
2006-08-23,2006,Aston Villa,Reading,2-1,2,1,1,1,3,1,H
2006-08-23,2006,Blackburn Rovers,Everton,1-1,1,1,1,1,2,0,D
2006-08-23,2006,Charlton Athletic,Manchester United,0-3,0,3,1,1,3,-3,A
2006-08-23,2006,Fulham,Bolton Wanderers,1-1,1,1,1,1,2,0,D
2006-08-23,2006,Manchester City,Portsmouth,0-0,0,0,1,1,0,0,D
2006-08-23,2006,Middlesbrough,Chelsea,2-1,2,1,1,1,3,1,H
2006-08-26,2006,Charlton Athletic,Bolton Wanderers,2-0,2,0,1,1,2,2,H
2006-08-26,2006,Fulham,Sheffield United,1-0,1,0,1,1,1,1,H
2006-08-26,2006,Liverpool,West Ham United,2-1,2,1,1,1,3,1,H
2006-08-26,2006,Manchester City,Arsenal,1-0,1,0,1,1,1,1,H
2006-08-26,2006,Tottenham Hotspur,Everton,0-2,0,2,1,1,2,-2,A
2006-08-26,2006,Watford,Manchester United,1-2,1,2,1,1,3,-1,A
2006-08-26,2006,Wigan Athletic,Reading,1-0,1,0,1,1,1,1,H
2006-08-27,2006,Aston Villa,Newcastle United,2-0,2,0,1,1,2,2,H
2006-08-27,2006,Blackburn Rovers,Chelsea,0-2,0,2,1,1,2,-2,A
2006-08-28,2006,Middlesbrough,Portsmouth,0-4,0,4,1,1,4,-4,A
2006-09-09,2006,Arsenal,Middlesbrough,1-1,1,1,1,1,2,0,D
2006-09-09,2006,Bolton Wanderers,Watford,1-0,1,0,1,1,1,1,H
2006-09-09,2006,Chelsea,Charlton Athletic,2-1,2,1,1,1,3,1,H
2006-09-09,2006,Everton,Liverpool,3-0,3,0,1,1,3,3,H
2006-09-09,2006,Manchester United,Tottenham Hotspur,1-0,1,0,1,1,1,1,H
2006-09-09,2006,Newcastle United,Fulham,1-2,1,2,1,1,3,-1,A
2006-09-09,2006,Portsmouth,Wigan Athletic,1-0,1,0,1,1,1,1,H
2006-09-09,2006,Sheffield United,Blackburn Rovers,0-0,0,0,1,1,0,0,D
2006-09-10,2006,West Ham United,Aston Villa,1-1,1,1,1,1,2,0,D
2006-09-11,2006,Reading,Manchester City,1-0,1,0,1,1,1,1,H
2006-09-16,2006,Bolton Wanderers,Middlesbrough,0-0,0,0,1,1,0,0,D
2006-09-16,2006,Charlton Athletic,Portsmouth,0-1,0,1,1,1,1,-1,A
2006-09-16,2006,Everton,Wigan Athletic,2-2,2,2,1,1,4,0,D
2006-09-16,2006,Sheffield United,Reading,1-2,1,2,1,1,3,-1,A
2006-09-16,2006,Watford,Aston Villa,0-0,0,0,1,1,0,0,D
2006-09-17,2006,Blackburn Rovers,Manchester City,4-2,4,2,1,1,6,2,H
2006-09-17,2006,Chelsea,Liverpool,1-0,1,0,1,1,1,1,H
2006-09-17,2006,Manchester United,Arsenal,0-1,0,1,1,1,1,-1,A
2006-09-17,2006,Tottenham Hotspur,Fulham,0-0,0,0,1,1,0,0,D
2006-09-17,2006,West Ham United,Newcastle United,0-2,0,2,1,1,2,-2,A
2006-09-20,2006,Liverpool,Newcastle United,2-0,2,0,1,1,2,2,H
2006-09-23,2006,Arsenal,Sheffield United,3-0,3,0,1,1,3,3,H
2006-09-23,2006,Aston Villa,Charlton Athletic,2-0,2,0,1,1,2,2,H
2006-09-23,2006,Fulham,Chelsea,0-2,0,2,1,1,2,-2,A
2006-09-23,2006,Liverpool,Tottenham Hotspur,3-0,3,0,1,1,3,3,H
2006-09-23,2006,Manchester City,West Ham United,2-0,2,0,1,1,2,2,H
2006-09-23,2006,Middlesbrough,Blackburn Rovers,0-1,0,1,1,1,1,-1,A
2006-09-23,2006,Reading,Manchester United,1-1,1,1,1,1,2,0,D
2006-09-23,2006,Wigan Athletic,Watford,1-1,1,1,1,1,2,0,D
2006-09-24,2006,Newcastle United,Everton,1-1,1,1,1,1,2,0,D
2006-09-25,2006,Portsmouth,Bolton Wanderers,0-1,0,1,1,1,1,-1,A
2006-09-30,2006,Bolton Wanderers,Liverpool,2-0,2,0,1,1,2,2,H
2006-09-30,2006,Charlton Athletic,Arsenal,1-2,1,2,1,1,3,-1,A
2006-09-30,2006,Chelsea,Aston Villa,1-1,1,1,1,1,2,0,D
2006-09-30,2006,Everton,Manchester City,1-1,1,1,1,1,2,0,D
2006-09-30,2006,Sheffield United,Middlesbrough,2-1,2,1,1,1,3,1,H
2006-10-01,2006,Blackburn Rovers,Wigan Athletic,2-1,2,1,1,1,3,1,H
2006-10-01,2006,Manchester United,Newcastle United,2-0,2,0,1,1,2,2,H
2006-10-01,2006,Tottenham Hotspur,Portsmouth,2-1,2,1,1,1,3,1,H
2006-10-01,2006,West Ham United,Reading,0-1,0,1,1,1,1,-1,A
2006-10-02,2006,Watford,Fulham,3-3,3,3,1,1,6,0,D
2006-10-14,2006,Arsenal,Watford,3-0,3,0,1,1,3,3,H
2006-10-14,2006,Aston Villa,Tottenham Hotspur,1-1,1,1,1,1,2,0,D
2006-10-14,2006,Liverpool,Blackburn Rovers,1-1,1,1,1,1,2,0,D
2006-10-14,2006,Manchester City,Sheffield United,0-0,0,0,1,1,0,0,D
2006-10-14,2006,Middlesbrough,Everton,2-1,2,1,1,1,3,1,H
2006-10-14,2006,Portsmouth,West Ham United,2-0,2,0,1,1,2,2,H
2006-10-14,2006,Reading,Chelsea,0-1,0,1,1,1,1,-1,A
2006-10-14,2006,Wigan Athletic,Manchester United,1-3,1,3,1,1,4,-2,A
2006-10-15,2006,Newcastle United,Bolton Wanderers,1-2,1,2,1,1,3,-1,A
2006-10-16,2006,Fulham,Charlton Athletic,2-1,2,1,1,1,3,1,H
2006-10-21,2006,Aston Villa,Fulham,1-1,1,1,1,1,2,0,D
2006-10-21,2006,Charlton Athletic,Watford,0-0,0,0,1,1,0,0,D
2006-10-21,2006,Chelsea,Portsmouth,2-1,2,1,1,1,3,1,H
2006-10-21,2006,Everton,Sheffield United,2-0,2,0,1,1,2,2,H
2006-10-21,2006,Wigan Athletic,Manchester City,4-0,4,0,1,1,4,4,H
2006-10-22,2006,Blackburn Rovers,Bolton Wanderers,0-1,0,1,1,1,1,-1,A
2006-10-22,2006,Manchester United,Liverpool,2-0,2,0,1,1,2,2,H
2006-10-22,2006,Middlesbrough,Newcastle United,1-0,1,0,1,1,1,1,H
2006-10-22,2006,Reading,Arsenal,0-4,0,4,1,1,4,-4,A
2006-10-22,2006,Tottenham Hotspur,West Ham United,1-0,1,0,1,1,1,1,H
2006-10-28,2006,Arsenal,Everton,1-1,1,1,1,1,2,0,D
2006-10-28,2006,Bolton Wanderers,Manchester United,0-4,0,4,1,1,4,-4,A
2006-10-28,2006,Fulham,Wigan Athletic,0-1,0,1,1,1,1,-1,A
2006-10-28,2006,Liverpool,Aston Villa,3-1,3,1,1,1,4,2,H
2006-10-28,2006,Newcastle United,Charlton Athletic,0-0,0,0,1,1,0,0,D
2006-10-28,2006,Portsmouth,Reading,3-1,3,1,1,1,4,2,H
2006-10-28,2006,Sheffield United,Chelsea,0-2,0,2,1,1,2,-2,A
2006-10-28,2006,Watford,Tottenham Hotspur,0-0,0,0,1,1,0,0,D
2006-10-29,2006,West Ham United,Blackburn Rovers,2-1,2,1,1,1,3,1,H
2006-10-30,2006,Manchester City,Middlesbrough,1-0,1,0,1,1,1,1,H
2006-11-04,2006,Bolton Wanderers,Wigan Athletic,0-1,0,1,1,1,1,-1,A
2006-11-04,2006,Charlton Athletic,Manchester City,1-0,1,0,1,1,1,1,H
2006-11-04,2006,Fulham,Everton,1-0,1,0,1,1,1,1,H
2006-11-04,2006,Liverpool,Reading,2-0,2,0,1,1,2,2,H
2006-11-04,2006,Manchester United,Portsmouth,3-0,3,0,1,1,3,3,H
2006-11-04,2006,Newcastle United,Sheffield United,0-1,0,1,1,1,1,-1,A
2006-11-04,2006,Watford,Middlesbrough,2-0,2,0,1,1,2,2,H
2006-11-05,2006,Aston Villa,Blackburn Rovers,2-0,2,0,1,1,2,2,H
2006-11-05,2006,Tottenham Hotspur,Chelsea,2-1,2,1,1,1,3,1,H
2006-11-05,2006,West Ham United,Arsenal,1-0,1,0,1,1,1,1,H
2006-11-11,2006,Blackburn Rovers,Manchester United,0-1,0,1,1,1,1,-1,A
2006-11-11,2006,Chelsea,Watford,4-0,4,0,1,1,4,4,H
2006-11-11,2006,Everton,Aston Villa,0-1,0,1,1,1,1,-1,A
2006-11-11,2006,Manchester City,Newcastle United,0-0,0,0,1,1,0,0,D
2006-11-11,2006,Middlesbrough,West Ham United,1-0,1,0,1,1,1,1,H
2006-11-11,2006,Portsmouth,Fulham,1-1,1,1,1,1,2,0,D
2006-11-11,2006,Sheffield United,Bolton Wanderers,2-2,2,2,1,1,4,0,D
2006-11-11,2006,Wigan Athletic,Charlton Athletic,3-2,3,2,1,1,5,1,H
2006-11-12,2006,Arsenal,Liverpool,3-0,3,0,1,1,3,3,H
2006-11-12,2006,Reading,Tottenham Hotspur,3-1,3,1,1,1,4,2,H
2006-11-18,2006,Arsenal,Newcastle United,1-1,1,1,1,1,2,0,D
2006-11-18,2006,Chelsea,West Ham United,1-0,1,0,1,1,1,1,H
2006-11-18,2006,Everton,Bolton Wanderers,1-0,1,0,1,1,1,1,H
2006-11-18,2006,Manchester City,Fulham,3-1,3,1,1,1,4,2,H
2006-11-18,2006,Middlesbrough,Liverpool,0-0,0,0,1,1,0,0,D
2006-11-18,2006,Portsmouth,Watford,2-1,2,1,1,1,3,1,H
2006-11-18,2006,Reading,Charlton Athletic,2-0,2,0,1,1,2,2,H
2006-11-18,2006,Sheffield United,Manchester United,1-2,1,2,1,1,3,-1,A
2006-11-19,2006,Blackburn Rovers,Tottenham Hotspur,1-1,1,1,1,1,2,0,D
2006-11-19,2006,Wigan Athletic,Aston Villa,0-0,0,0,1,1,0,0,D
2006-11-25,2006,Aston Villa,Middlesbrough,1-1,1,1,1,1,2,0,D
2006-11-25,2006,Bolton Wanderers,Arsenal,3-1,3,1,1,1,4,2,H
2006-11-25,2006,Charlton Athletic,Everton,1-1,1,1,1,1,2,0,D
2006-11-25,2006,Fulham,Reading,0-1,0,1,1,1,1,-1,A
2006-11-25,2006,Liverpool,Manchester City,1-0,1,0,1,1,1,1,H
2006-11-25,2006,West Ham United,Sheffield United,1-0,1,0,1,1,1,1,H
2006-11-26,2006,Manchester United,Chelsea,1-1,1,1,1,1,2,0,D
2006-11-26,2006,Newcastle United,Portsmouth,1-0,1,0,1,1,1,1,H
2006-11-26,2006,Tottenham Hotspur,Wigan Athletic,3-1,3,1,1,1,4,2,H
2006-11-28,2006,Watford,Sheffield United,0-1,0,1,1,1,1,-1,A
2006-11-29,2006,Aston Villa,Manchester City,1-3,1,3,1,1,4,-2,A
2006-11-29,2006,Bolton Wanderers,Chelsea,0-1,0,1,1,1,1,-1,A
2006-11-29,2006,Fulham,Arsenal,2-1,2,1,1,1,3,1,H
2006-11-29,2006,Liverpool,Portsmouth,0-0,0,0,1,1,0,0,D
2006-11-29,2006,Manchester United,Everton,3-0,3,0,1,1,3,3,H
2006-12-02,2006,Arsenal,Tottenham Hotspur,3-0,3,0,1,1,3,3,H
2006-12-02,2006,Blackburn Rovers,Fulham,2-0,2,0,1,1,2,2,H
2006-12-02,2006,Middlesbrough,Manchester United,1-2,1,2,1,1,3,-1,A
2006-12-02,2006,Portsmouth,Aston Villa,2-2,2,2,1,1,4,0,D
2006-12-02,2006,Reading,Bolton Wanderers,1-0,1,0,1,1,1,1,H
2006-12-02,2006,Sheffield United,Charlton Athletic,2-1,2,1,1,1,3,1,H
2006-12-02,2006,Wigan Athletic,Liverpool,0-4,0,4,1,1,4,-4,A
2006-12-03,2006,Everton,West Ham United,2-0,2,0,1,1,2,2,H
2006-12-04,2006,Manchester City,Watford,0-0,0,0,1,1,0,0,D
2006-12-05,2006,Charlton Athletic,Blackburn Rovers,1-0,1,0,1,1,1,1,H
2006-12-05,2006,Tottenham Hotspur,Middlesbrough,2-1,2,1,1,1,3,1,H
2006-12-06,2006,Newcastle United,Reading,3-2,3,2,1,1,5,1,H
2006-12-06,2006,West Ham United,Wigan Athletic,0-2,0,2,1,1,2,-2,A
2006-12-09,2006,Blackburn Rovers,Newcastle United,1-3,1,3,1,1,4,-2,A
2006-12-09,2006,Bolton Wanderers,West Ham United,4-0,4,0,1,1,4,4,H
2006-12-09,2006,Liverpool,Fulham,4-0,4,0,1,1,4,4,H
2006-12-09,2006,Manchester United,Manchester City,3-1,3,1,1,1,4,2,H
2006-12-09,2006,Middlesbrough,Wigan Athletic,1-1,1,1,1,1,2,0,D
2006-12-09,2006,Portsmouth,Everton,2-0,2,0,1,1,2,2,H
2006-12-09,2006,Tottenham Hotspur,Charlton Athletic,5-1,5,1,1,1,6,4,H
2006-12-09,2006,Watford,Reading,0-0,0,0,1,1,0,0,D
2006-12-10,2006,Chelsea,Arsenal,1-1,1,1,1,1,2,0,D
2006-12-11,2006,Sheffield United,Aston Villa,2-2,2,2,1,1,4,0,D
2006-12-13,2006,Chelsea,Newcastle United,1-0,1,0,1,1,1,1,H
2006-12-13,2006,Wigan Athletic,Arsenal,0-1,0,1,1,1,1,-1,A
2006-12-16,2006,Arsenal,Portsmouth,2-2,2,2,1,1,4,0,D
2006-12-16,2006,Aston Villa,Bolton Wanderers,0-1,0,1,1,1,1,-1,A
2006-12-16,2006,Charlton Athletic,Liverpool,0-3,0,3,1,1,3,-3,A
2006-12-16,2006,Newcastle United,Watford,2-1,2,1,1,1,3,1,H
2006-12-16,2006,Reading,Blackburn Rovers,1-2,1,2,1,1,3,-1,A
2006-12-16,2006,Wigan Athletic,Sheffield United,0-1,0,1,1,1,1,-1,A
2006-12-17,2006,Everton,Chelsea,2-3,2,3,1,1,5,-1,A
2006-12-17,2006,Manchester City,Tottenham Hotspur,1-2,1,2,1,1,3,-1,A
2006-12-17,2006,West Ham United,Manchester United,1-0,1,0,1,1,1,1,H
2006-12-18,2006,Fulham,Middlesbrough,2-1,2,1,1,1,3,1,H
2006-12-23,2006,Arsenal,Blackburn Rovers,6-2,6,2,1,1,8,4,H
2006-12-23,2006,Aston Villa,Manchester United,0-3,0,3,1,1,3,-3,A
2006-12-23,2006,Fulham,West Ham United,0-0,0,0,1,1,0,0,D
2006-12-23,2006,Liverpool,Watford,2-0,2,0,1,1,2,2,H
2006-12-23,2006,Manchester City,Bolton Wanderers,0-2,0,2,1,1,2,-2,A
2006-12-23,2006,Middlesbrough,Charlton Athletic,2-0,2,0,1,1,2,2,H
2006-12-23,2006,Newcastle United,Tottenham Hotspur,3-1,3,1,1,1,4,2,H
2006-12-23,2006,Portsmouth,Sheffield United,3-1,3,1,1,1,4,2,H
2006-12-23,2006,Reading,Everton,0-2,0,2,1,1,2,-2,A
2006-12-23,2006,Wigan Athletic,Chelsea,2-3,2,3,1,1,5,-1,A
2006-12-26,2006,Blackburn Rovers,Liverpool,1-0,1,0,1,1,1,1,H
2006-12-26,2006,Bolton Wanderers,Newcastle United,2-1,2,1,1,1,3,1,H
2006-12-26,2006,Chelsea,Reading,2-2,2,2,1,1,4,0,D
2006-12-26,2006,Everton,Middlesbrough,0-0,0,0,1,1,0,0,D
2006-12-26,2006,Manchester United,Wigan Athletic,3-1,3,1,1,1,4,2,H
2006-12-26,2006,Sheffield United,Manchester City,0-1,0,1,1,1,1,-1,A
2006-12-26,2006,Tottenham Hotspur,Aston Villa,2-1,2,1,1,1,3,1,H
2006-12-26,2006,Watford,Arsenal,1-2,1,2,1,1,3,-1,A
2006-12-26,2006,West Ham United,Portsmouth,1-2,1,2,1,1,3,-1,A
2006-12-27,2006,Charlton Athletic,Fulham,2-2,2,2,1,1,4,0,D
2006-12-30,2006,Blackburn Rovers,Middlesbrough,2-1,2,1,1,1,3,1,H
2006-12-30,2006,Bolton Wanderers,Portsmouth,3-2,3,2,1,1,5,1,H
2006-12-30,2006,Charlton Athletic,Aston Villa,2-1,2,1,1,1,3,1,H
2006-12-30,2006,Chelsea,Fulham,2-2,2,2,1,1,4,0,D
2006-12-30,2006,Everton,Newcastle United,3-0,3,0,1,1,3,3,H
2006-12-30,2006,Manchester United,Reading,3-2,3,2,1,1,5,1,H
2006-12-30,2006,Sheffield United,Arsenal,1-0,1,0,1,1,1,1,H
2006-12-30,2006,Tottenham Hotspur,Liverpool,0-1,0,1,1,1,1,-1,A
2006-12-30,2006,West Ham United,Manchester City,0-1,0,1,1,1,1,-1,A
2007-01-01,2006,Fulham,Watford,0-0,0,0,1,1,0,0,D
2007-01-01,2006,Liverpool,Bolton Wanderers,3-0,3,0,1,1,3,3,H
2007-01-01,2006,Manchester City,Everton,2-1,2,1,1,1,3,1,H
2007-01-01,2006,Middlesbrough,Sheffield United,3-1,3,1,1,1,4,2,H
2007-01-01,2006,Newcastle United,Manchester United,2-2,2,2,1,1,4,0,D
2007-01-01,2006,Portsmouth,Tottenham Hotspur,1-1,1,1,1,1,2,0,D
2007-01-01,2006,Reading,West Ham United,6-0,6,0,1,1,6,6,H
2007-01-01,2006,Wigan Athletic,Blackburn Rovers,0-3,0,3,1,1,3,-3,A
2007-01-02,2006,Arsenal,Charlton Athletic,4-0,4,0,1,1,4,4,H
2007-01-02,2006,Aston Villa,Chelsea,0-0,0,0,1,1,0,0,D
2007-01-13,2006,Blackburn Rovers,Arsenal,0-2,0,2,1,1,2,-2,A
2007-01-13,2006,Bolton Wanderers,Manchester City,0-0,0,0,1,1,0,0,D
2007-01-13,2006,Charlton Athletic,Middlesbrough,1-3,1,3,1,1,4,-2,A
2007-01-13,2006,Chelsea,Wigan Athletic,4-0,4,0,1,1,4,4,H
2007-01-13,2006,Manchester United,Aston Villa,3-1,3,1,1,1,4,2,H
2007-01-13,2006,Sheffield United,Portsmouth,1-1,1,1,1,1,2,0,D
2007-01-13,2006,Watford,Liverpool,0-3,0,3,1,1,3,-3,A
2007-01-13,2006,West Ham United,Fulham,3-3,3,3,1,1,6,0,D
2007-01-14,2006,Everton,Reading,1-1,1,1,1,1,2,0,D
2007-01-14,2006,Tottenham Hotspur,Newcastle United,2-3,2,3,1,1,5,-1,A
2007-01-20,2006,Aston Villa,Watford,2-0,2,0,1,1,2,2,H
2007-01-20,2006,Fulham,Tottenham Hotspur,1-1,1,1,1,1,2,0,D
2007-01-20,2006,Liverpool,Chelsea,2-0,2,0,1,1,2,2,H
2007-01-20,2006,Manchester City,Blackburn Rovers,0-3,0,3,1,1,3,-3,A
2007-01-20,2006,Middlesbrough,Bolton Wanderers,5-1,5,1,1,1,6,4,H
2007-01-20,2006,Newcastle United,West Ham United,2-2,2,2,1,1,4,0,D
2007-01-20,2006,Portsmouth,Charlton Athletic,0-1,0,1,1,1,1,-1,A
2007-01-20,2006,Reading,Sheffield United,3-1,3,1,1,1,4,2,H
2007-01-21,2006,Arsenal,Manchester United,2-1,2,1,1,1,3,1,H
2007-01-21,2006,Wigan Athletic,Everton,0-2,0,2,1,1,2,-2,A
2007-01-23,2006,Watford,Blackburn Rovers,2-1,2,1,1,1,3,1,H
2007-01-30,2006,Portsmouth,Middlesbrough,0-0,0,0,1,1,0,0,D
2007-01-30,2006,Reading,Wigan Athletic,3-2,3,2,1,1,5,1,H
2007-01-30,2006,Sheffield United,Fulham,2-0,2,0,1,1,2,2,H
2007-01-30,2006,West Ham United,Liverpool,1-2,1,2,1,1,3,-1,A
2007-01-31,2006,Bolton Wanderers,Charlton Athletic,1-1,1,1,1,1,2,0,D
2007-01-31,2006,Chelsea,Blackburn Rovers,3-0,3,0,1,1,3,3,H
2007-01-31,2006,Manchester United,Watford,4-0,4,0,1,1,4,4,H
2007-01-31,2006,Newcastle United,Aston Villa,3-1,3,1,1,1,4,2,H
2007-02-03,2006,Aston Villa,West Ham United,1-0,1,0,1,1,1,1,H
2007-02-03,2006,Blackburn Rovers,Sheffield United,2-1,2,1,1,1,3,1,H
2007-02-03,2006,Charlton Athletic,Chelsea,0-1,0,1,1,1,1,-1,A
2007-02-03,2006,Fulham,Newcastle United,2-1,2,1,1,1,3,1,H
2007-02-03,2006,Liverpool,Everton,0-0,0,0,1,1,0,0,D
2007-02-03,2006,Manchester City,Reading,0-2,0,2,1,1,2,-2,A
2007-02-03,2006,Middlesbrough,Arsenal,1-1,1,1,1,1,2,0,D
2007-02-03,2006,Watford,Bolton Wanderers,0-1,0,1,1,1,1,-1,A
2007-02-03,2006,Wigan Athletic,Portsmouth,1-0,1,0,1,1,1,1,H
2007-02-04,2006,Tottenham Hotspur,Manchester United,0-4,0,4,1,1,4,-4,A
2007-02-10,2006,Chelsea,Middlesbrough,3-0,3,0,1,1,3,3,H
2007-02-10,2006,Everton,Blackburn Rovers,1-0,1,0,1,1,1,1,H
2007-02-10,2006,Manchester United,Charlton Athletic,2-0,2,0,1,1,2,2,H
2007-02-10,2006,Newcastle United,Liverpool,2-1,2,1,1,1,3,1,H
2007-02-10,2006,Portsmouth,Manchester City,2-1,2,1,1,1,3,1,H
2007-02-10,2006,Reading,Aston Villa,2-0,2,0,1,1,2,2,H
2007-02-10,2006,Sheffield United,Tottenham Hotspur,2-1,2,1,1,1,3,1,H
2007-02-10,2006,West Ham United,Watford,0-1,0,1,1,1,1,-1,A
2007-02-11,2006,Arsenal,Wigan Athletic,2-1,2,1,1,1,3,1,H
2007-02-11,2006,Bolton Wanderers,Fulham,2-1,2,1,1,1,3,1,H
2007-02-21,2006,Everton,Tottenham Hotspur,1-2,1,2,1,1,3,-1,A
2007-02-21,2006,Watford,Wigan Athletic,1-1,1,1,1,1,2,0,D
2007-02-24,2006,Charlton Athletic,West Ham United,4-0,4,0,1,1,4,4,H
2007-02-24,2006,Fulham,Manchester United,1-2,1,2,1,1,3,-1,A
2007-02-24,2006,Liverpool,Sheffield United,4-0,4,0,1,1,4,4,H
2007-02-24,2006,Middlesbrough,Reading,2-1,2,1,1,1,3,1,H
2007-02-24,2006,Watford,Everton,0-3,0,3,1,1,3,-3,A
2007-02-25,2006,Blackburn Rovers,Portsmouth,3-0,3,0,1,1,3,3,H
2007-02-25,2006,Tottenham Hotspur,Bolton Wanderers,4-1,4,1,1,1,5,3,H
2007-02-25,2006,Wigan Athletic,Newcastle United,1-0,1,0,1,1,1,1,H
2007-03-03,2006,Arsenal,Reading,2-1,2,1,1,1,3,1,H
2007-03-03,2006,Fulham,Aston Villa,1-1,1,1,1,1,2,0,D
2007-03-03,2006,Liverpool,Manchester United,0-1,0,1,1,1,1,-1,A
2007-03-03,2006,Manchester City,Wigan Athletic,0-1,0,1,1,1,1,-1,A
2007-03-03,2006,Newcastle United,Middlesbrough,0-0,0,0,1,1,0,0,D
2007-03-03,2006,Portsmouth,Chelsea,0-2,0,2,1,1,2,-2,A
2007-03-03,2006,Sheffield United,Everton,1-1,1,1,1,1,2,0,D
2007-03-03,2006,Watford,Charlton Athletic,2-2,2,2,1,1,4,0,D
2007-03-04,2006,Bolton Wanderers,Blackburn Rovers,1-2,1,2,1,1,3,-1,A
2007-03-04,2006,West Ham United,Tottenham Hotspur,3-4,3,4,1,1,7,-1,A
2007-03-14,2006,Aston Villa,Arsenal,0-1,0,1,1,1,1,-1,A
2007-03-14,2006,Manchester City,Chelsea,0-1,0,1,1,1,1,-1,A
2007-03-17,2006,Blackburn Rovers,West Ham United,1-2,1,2,1,1,3,-1,A
2007-03-17,2006,Chelsea,Sheffield United,3-0,3,0,1,1,3,3,H
2007-03-17,2006,Manchester United,Bolton Wanderers,4-1,4,1,1,1,5,3,H
2007-03-17,2006,Middlesbrough,Manchester City,0-2,0,2,1,1,2,-2,A
2007-03-17,2006,Reading,Portsmouth,0-0,0,0,1,1,0,0,D
2007-03-17,2006,Tottenham Hotspur,Watford,3-1,3,1,1,1,4,2,H
2007-03-17,2006,Wigan Athletic,Fulham,0-0,0,0,1,1,0,0,D
2007-03-18,2006,Aston Villa,Liverpool,0-0,0,0,1,1,0,0,D
2007-03-18,2006,Charlton Athletic,Newcastle United,2-0,2,0,1,1,2,2,H
2007-03-18,2006,Everton,Arsenal,1-0,1,0,1,1,1,1,H
2007-03-31,2006,Bolton Wanderers,Sheffield United,1-0,1,0,1,1,1,1,H
2007-03-31,2006,Charlton Athletic,Wigan Athletic,1-0,1,0,1,1,1,1,H
2007-03-31,2006,Fulham,Portsmouth,1-1,1,1,1,1,2,0,D
2007-03-31,2006,Liverpool,Arsenal,4-1,4,1,1,1,5,3,H
2007-03-31,2006,Manchester United,Blackburn Rovers,4-1,4,1,1,1,5,3,H
2007-03-31,2006,Newcastle United,Manchester City,0-1,0,1,1,1,1,-1,A
2007-03-31,2006,Watford,Chelsea,0-1,0,1,1,1,1,-1,A
2007-03-31,2006,West Ham United,Middlesbrough,2-0,2,0,1,1,2,2,H
2007-04-01,2006,Tottenham Hotspur,Reading,1-0,1,0,1,1,1,1,H
2007-04-02,2006,Aston Villa,Everton,1-1,1,1,1,1,2,0,D
2007-04-06,2006,Everton,Fulham,4-1,4,1,1,1,5,3,H
2007-04-06,2006,Manchester City,Charlton Athletic,0-0,0,0,1,1,0,0,D
2007-04-07,2006,Arsenal,West Ham United,0-1,0,1,1,1,1,-1,A
2007-04-07,2006,Blackburn Rovers,Aston Villa,1-2,1,2,1,1,3,-1,A
2007-04-07,2006,Chelsea,Tottenham Hotspur,1-0,1,0,1,1,1,1,H
2007-04-07,2006,Middlesbrough,Watford,4-1,4,1,1,1,5,3,H
2007-04-07,2006,Portsmouth,Manchester United,2-1,2,1,1,1,3,1,H
2007-04-07,2006,Reading,Liverpool,1-2,1,2,1,1,3,-1,A
2007-04-07,2006,Sheffield United,Newcastle United,1-2,1,2,1,1,3,-1,A
2007-04-07,2006,Wigan Athletic,Bolton Wanderers,1-3,1,3,1,1,4,-2,A
2007-04-09,2006,Aston Villa,Wigan Athletic,1-1,1,1,1,1,2,0,D
2007-04-09,2006,Bolton Wanderers,Everton,1-1,1,1,1,1,2,0,D
2007-04-09,2006,Charlton Athletic,Reading,0-0,0,0,1,1,0,0,D
2007-04-09,2006,Fulham,Manchester City,1-3,1,3,1,1,4,-2,A
2007-04-09,2006,Newcastle United,Arsenal,0-0,0,0,1,1,0,0,D
2007-04-09,2006,Watford,Portsmouth,4-2,4,2,1,1,6,2,H
2007-04-14,2006,Arsenal,Bolton Wanderers,2-1,2,1,1,1,3,1,H
2007-04-14,2006,Manchester City,Liverpool,0-0,0,0,1,1,0,0,D
2007-04-14,2006,Middlesbrough,Aston Villa,1-3,1,3,1,1,4,-2,A
2007-04-14,2006,Portsmouth,Newcastle United,2-1,2,1,1,1,3,1,H
2007-04-14,2006,Reading,Fulham,1-0,1,0,1,1,1,1,H
2007-04-14,2006,Sheffield United,West Ham United,3-0,3,0,1,1,3,3,H
2007-04-15,2006,Everton,Charlton Athletic,2-1,2,1,1,1,3,1,H
2007-04-15,2006,Wigan Athletic,Tottenham Hotspur,3-3,3,3,1,1,6,0,D
2007-04-17,2006,Arsenal,Manchester City,3-1,3,1,1,1,4,2,H
2007-04-17,2006,Manchester United,Sheffield United,2-0,2,0,1,1,2,2,H
2007-04-18,2006,Blackburn Rovers,Watford,3-1,3,1,1,1,4,2,H
2007-04-18,2006,Liverpool,Middlesbrough,2-0,2,0,1,1,2,2,H
2007-04-18,2006,West Ham United,Chelsea,1-4,1,4,1,1,5,-3,A
2007-04-21,2006,Bolton Wanderers,Reading,1-3,1,3,1,1,4,-2,A
2007-04-21,2006,Charlton Athletic,Sheffield United,1-1,1,1,1,1,2,0,D
2007-04-21,2006,Fulham,Blackburn Rovers,1-1,1,1,1,1,2,0,D
2007-04-21,2006,Liverpool,Wigan Athletic,2-0,2,0,1,1,2,2,H
2007-04-21,2006,Manchester United,Middlesbrough,1-1,1,1,1,1,2,0,D
2007-04-21,2006,Tottenham Hotspur,Arsenal,2-2,2,2,1,1,4,0,D
2007-04-21,2006,Watford,Manchester City,1-1,1,1,1,1,2,0,D
2007-04-21,2006,West Ham United,Everton,1-0,1,0,1,1,1,1,H
2007-04-22,2006,Aston Villa,Portsmouth,0-0,0,0,1,1,0,0,D
2007-04-22,2006,Newcastle United,Chelsea,0-0,0,0,1,1,0,0,D
2007-04-28,2006,Blackburn Rovers,Charlton Athletic,4-1,4,1,1,1,5,3,H
2007-04-28,2006,Chelsea,Bolton Wanderers,2-2,2,2,1,1,4,0,D
2007-04-28,2006,Everton,Manchester United,2-4,2,4,1,1,6,-2,A
2007-04-28,2006,Manchester City,Aston Villa,0-2,0,2,1,1,2,-2,A
2007-04-28,2006,Middlesbrough,Tottenham Hotspur,2-3,2,3,1,1,5,-1,A
2007-04-28,2006,Portsmouth,Liverpool,2-1,2,1,1,1,3,1,H
2007-04-28,2006,Sheffield United,Watford,1-0,1,0,1,1,1,1,H
2007-04-28,2006,Wigan Athletic,West Ham United,0-3,0,3,1,1,3,-3,A
2007-04-29,2006,Arsenal,Fulham,3-1,3,1,1,1,4,2,H
2007-04-30,2006,Reading,Newcastle United,1-0,1,0,1,1,1,1,H
2007-05-05,2006,Aston Villa,Sheffield United,3-0,3,0,1,1,3,3,H
2007-05-05,2006,Everton,Portsmouth,3-0,3,0,1,1,3,3,H
2007-05-05,2006,Fulham,Liverpool,1-0,1,0,1,1,1,1,H
2007-05-05,2006,Manchester City,Manchester United,0-1,0,1,1,1,1,-1,A
2007-05-05,2006,Newcastle United,Blackburn Rovers,0-2,0,2,1,1,2,-2,A
2007-05-05,2006,Reading,Watford,0-2,0,2,1,1,2,-2,A
2007-05-05,2006,West Ham United,Bolton Wanderers,3-1,3,1,1,1,4,2,H
2007-05-05,2006,Wigan Athletic,Middlesbrough,0-1,0,1,1,1,1,-1,A
2007-05-06,2006,Arsenal,Chelsea,1-1,1,1,1,1,2,0,D
2007-05-07,2006,Charlton Athletic,Tottenham Hotspur,0-2,0,2,1,1,2,-2,A
2007-05-09,2006,Chelsea,Manchester United,0-0,0,0,1,1,0,0,D
2007-05-10,2006,Tottenham Hotspur,Blackburn Rovers,1-1,1,1,1,1,2,0,D
2007-05-13,2006,Blackburn Rovers,Reading,3-3,3,3,1,1,6,0,D
2007-05-13,2006,Bolton Wanderers,Aston Villa,2-2,2,2,1,1,4,0,D
2007-05-13,2006,Chelsea,Everton,1-1,1,1,1,1,2,0,D
2007-05-13,2006,Liverpool,Charlton Athletic,2-2,2,2,1,1,4,0,D
2007-05-13,2006,Manchester United,West Ham United,0-1,0,1,1,1,1,-1,A
2007-05-13,2006,Middlesbrough,Fulham,3-1,3,1,1,1,4,2,H
2007-05-13,2006,Portsmouth,Arsenal,0-0,0,0,1,1,0,0,D
2007-05-13,2006,Sheffield United,Wigan Athletic,1-2,1,2,1,1,3,-1,A
2007-05-13,2006,Tottenham Hotspur,Manchester City,2-1,2,1,1,1,3,1,H
2007-05-13,2006,Watford,Newcastle United,1-1,1,1,1,1,2,0,D
2007-08-11,2007,Aston Villa,Liverpool,1-2,1,2,1,1,3,-1,A
2007-08-11,2007,Bolton Wanderers,Newcastle United,1-3,1,3,1,1,4,-2,A
2007-08-11,2007,Derby County,Portsmouth,2-2,2,2,1,1,4,0,D
2007-08-11,2007,Everton,Wigan Athletic,2-1,2,1,1,1,3,1,H
2007-08-11,2007,Middlesbrough,Blackburn Rovers,1-2,1,2,1,1,3,-1,A
2007-08-11,2007,Sunderland,Tottenham Hotspur,1-0,1,0,1,1,1,1,H
2007-08-11,2007,West Ham United,Manchester City,0-2,0,2,1,1,2,-2,A
2007-08-12,2007,Arsenal,Fulham,2-1,2,1,1,1,3,1,H
2007-08-12,2007,Chelsea,Birmingham City,3-2,3,2,1,1,5,1,H
2007-08-12,2007,Manchester United,Reading,0-0,0,0,1,1,0,0,D
2007-08-14,2007,Tottenham Hotspur,Everton,1-3,1,3,1,1,4,-2,A
2007-08-15,2007,Birmingham City,Sunderland,2-2,2,2,1,1,4,0,D
2007-08-15,2007,Fulham,Bolton Wanderers,2-1,2,1,1,1,3,1,H
2007-08-15,2007,Manchester City,Derby County,1-0,1,0,1,1,1,1,H
2007-08-15,2007,Portsmouth,Manchester United,1-1,1,1,1,1,2,0,D
2007-08-15,2007,Reading,Chelsea,1-2,1,2,1,1,3,-1,A
2007-08-15,2007,Wigan Athletic,Middlesbrough,1-0,1,0,1,1,1,1,H
2007-08-18,2007,Birmingham City,West Ham United,0-1,0,1,1,1,1,-1,A
2007-08-18,2007,Fulham,Middlesbrough,1-2,1,2,1,1,3,-1,A
2007-08-18,2007,Newcastle United,Aston Villa,0-0,0,0,1,1,0,0,D
2007-08-18,2007,Portsmouth,Bolton Wanderers,3-1,3,1,1,1,4,2,H
2007-08-18,2007,Reading,Everton,1-0,1,0,1,1,1,1,H
2007-08-18,2007,Tottenham Hotspur,Derby County,4-0,4,0,1,1,4,4,H
2007-08-18,2007,Wigan Athletic,Sunderland,3-0,3,0,1,1,3,3,H
2007-08-19,2007,Blackburn Rovers,Arsenal,1-1,1,1,1,1,2,0,D
2007-08-19,2007,Liverpool,Chelsea,1-1,1,1,1,1,2,0,D
2007-08-19,2007,Manchester City,Manchester United,1-0,1,0,1,1,1,1,H
2007-08-25,2007,Arsenal,Manchester City,1-0,1,0,1,1,1,1,H
2007-08-25,2007,Aston Villa,Fulham,2-1,2,1,1,1,3,1,H
2007-08-25,2007,Bolton Wanderers,Reading,3-0,3,0,1,1,3,3,H
2007-08-25,2007,Chelsea,Portsmouth,1-0,1,0,1,1,1,1,H
2007-08-25,2007,Derby County,Birmingham City,1-2,1,2,1,1,3,-1,A
2007-08-25,2007,Everton,Blackburn Rovers,1-1,1,1,1,1,2,0,D
2007-08-25,2007,Sunderland,Liverpool,0-2,0,2,1,1,2,-2,A
2007-08-25,2007,West Ham United,Wigan Athletic,1-1,1,1,1,1,2,0,D
2007-08-26,2007,Manchester United,Tottenham Hotspur,1-0,1,0,1,1,1,1,H
2007-08-26,2007,Middlesbrough,Newcastle United,2-2,2,2,1,1,4,0,D
2007-09-01,2007,Bolton Wanderers,Everton,1-2,1,2,1,1,3,-1,A
2007-09-01,2007,Fulham,Tottenham Hotspur,3-3,3,3,1,1,6,0,D
2007-09-01,2007,Liverpool,Derby County,6-0,6,0,1,1,6,6,H
2007-09-01,2007,Manchester United,Sunderland,1-0,1,0,1,1,1,1,H
2007-09-01,2007,Middlesbrough,Birmingham City,2-0,2,0,1,1,2,2,H
2007-09-01,2007,Newcastle United,Wigan Athletic,1-0,1,0,1,1,1,1,H
2007-09-01,2007,Reading,West Ham United,0-3,0,3,1,1,3,-3,A
2007-09-02,2007,Arsenal,Portsmouth,3-1,3,1,1,1,4,2,H
2007-09-02,2007,Aston Villa,Chelsea,2-0,2,0,1,1,2,2,H
2007-09-02,2007,Blackburn Rovers,Manchester City,1-0,1,0,1,1,1,1,H
2007-09-15,2007,Birmingham City,Bolton Wanderers,1-0,1,0,1,1,1,1,H
2007-09-15,2007,Chelsea,Blackburn Rovers,0-0,0,0,1,1,0,0,D
2007-09-15,2007,Everton,Manchester United,0-1,0,1,1,1,1,-1,A
2007-09-15,2007,Portsmouth,Liverpool,0-0,0,0,1,1,0,0,D
2007-09-15,2007,Sunderland,Reading,2-1,2,1,1,1,3,1,H
2007-09-15,2007,Tottenham Hotspur,Arsenal,1-3,1,3,1,1,4,-2,A
2007-09-15,2007,West Ham United,Middlesbrough,3-0,3,0,1,1,3,3,H
2007-09-15,2007,Wigan Athletic,Fulham,1-1,1,1,1,1,2,0,D
2007-09-16,2007,Manchester City,Aston Villa,1-0,1,0,1,1,1,1,H
2007-09-17,2007,Derby County,Newcastle United,1-0,1,0,1,1,1,1,H
2007-09-22,2007,Arsenal,Derby County,5-0,5,0,1,1,5,5,H
2007-09-22,2007,Fulham,Manchester City,3-3,3,3,1,1,6,0,D
2007-09-22,2007,Liverpool,Birmingham City,0-0,0,0,1,1,0,0,D
2007-09-22,2007,Middlesbrough,Sunderland,2-2,2,2,1,1,4,0,D
2007-09-22,2007,Reading,Wigan Athletic,2-1,2,1,1,1,3,1,H
2007-09-23,2007,Aston Villa,Everton,2-0,2,0,1,1,2,2,H
2007-09-23,2007,Blackburn Rovers,Portsmouth,0-1,0,1,1,1,1,-1,A
2007-09-23,2007,Bolton Wanderers,Tottenham Hotspur,1-1,1,1,1,1,2,0,D
2007-09-23,2007,Manchester United,Chelsea,2-0,2,0,1,1,2,2,H
2007-09-23,2007,Newcastle United,West Ham United,3-1,3,1,1,1,4,2,H
2007-09-29,2007,Birmingham City,Manchester United,0-1,0,1,1,1,1,-1,A
2007-09-29,2007,Chelsea,Fulham,0-0,0,0,1,1,0,0,D
2007-09-29,2007,Derby County,Bolton Wanderers,1-1,1,1,1,1,2,0,D
2007-09-29,2007,Manchester City,Newcastle United,3-1,3,1,1,1,4,2,H
2007-09-29,2007,Portsmouth,Reading,7-4,7,4,1,1,11,3,H
2007-09-29,2007,Sunderland,Blackburn Rovers,1-2,1,2,1,1,3,-1,A
2007-09-29,2007,West Ham United,Arsenal,0-1,0,1,1,1,1,-1,A
2007-09-29,2007,Wigan Athletic,Liverpool,0-1,0,1,1,1,1,-1,A
2007-09-30,2007,Everton,Middlesbrough,2-0,2,0,1,1,2,2,H
2007-10-01,2007,Tottenham Hotspur,Aston Villa,4-4,4,4,1,1,8,0,D
2007-10-06,2007,Aston Villa,West Ham United,1-0,1,0,1,1,1,1,H
2007-10-06,2007,Manchester United,Wigan Athletic,4-0,4,0,1,1,4,4,H
2007-10-07,2007,Arsenal,Sunderland,3-2,3,2,1,1,5,1,H
2007-10-07,2007,Blackburn Rovers,Birmingham City,2-1,2,1,1,1,3,1,H
2007-10-07,2007,Bolton Wanderers,Chelsea,0-1,0,1,1,1,1,-1,A
2007-10-07,2007,Fulham,Portsmouth,0-2,0,2,1,1,2,-2,A
2007-10-07,2007,Liverpool,Tottenham Hotspur,2-2,2,2,1,1,4,0,D
2007-10-07,2007,Manchester City,Middlesbrough,3-1,3,1,1,1,4,2,H
2007-10-07,2007,Newcastle United,Everton,3-2,3,2,1,1,5,1,H
2007-10-07,2007,Reading,Derby County,1-0,1,0,1,1,1,1,H
2007-10-20,2007,Arsenal,Bolton Wanderers,2-0,2,0,1,1,2,2,H
2007-10-20,2007,Aston Villa,Manchester United,1-4,1,4,1,1,5,-3,A
2007-10-20,2007,Blackburn Rovers,Reading,4-2,4,2,1,1,6,2,H
2007-10-20,2007,Everton,Liverpool,1-2,1,2,1,1,3,-1,A
2007-10-20,2007,Fulham,Derby County,0-0,0,0,1,1,0,0,D
2007-10-20,2007,Manchester City,Birmingham City,1-0,1,0,1,1,1,1,H
2007-10-20,2007,Middlesbrough,Chelsea,0-2,0,2,1,1,2,-2,A
2007-10-20,2007,Wigan Athletic,Portsmouth,0-2,0,2,1,1,2,-2,A
2007-10-21,2007,West Ham United,Sunderland,3-1,3,1,1,1,4,2,H
2007-10-22,2007,Newcastle United,Tottenham Hotspur,3-1,3,1,1,1,4,2,H
2007-10-27,2007,Birmingham City,Wigan Athletic,3-2,3,2,1,1,5,1,H
2007-10-27,2007,Chelsea,Manchester City,6-0,6,0,1,1,6,6,H
2007-10-27,2007,Manchester United,Middlesbrough,4-1,4,1,1,1,5,3,H
2007-10-27,2007,Portsmouth,West Ham United,0-0,0,0,1,1,0,0,D
2007-10-27,2007,Reading,Newcastle United,2-1,2,1,1,1,3,1,H
2007-10-27,2007,Sunderland,Fulham,1-1,1,1,1,1,2,0,D
2007-10-28,2007,Bolton Wanderers,Aston Villa,1-1,1,1,1,1,2,0,D
2007-10-28,2007,Derby County,Everton,0-2,0,2,1,1,2,-2,A
2007-10-28,2007,Liverpool,Arsenal,1-1,1,1,1,1,2,0,D
2007-10-28,2007,Tottenham Hotspur,Blackburn Rovers,1-2,1,2,1,1,3,-1,A
2007-11-03,2007,Arsenal,Manchester United,2-2,2,2,1,1,4,0,D
2007-11-03,2007,Aston Villa,Derby County,2-0,2,0,1,1,2,2,H
2007-11-03,2007,Blackburn Rovers,Liverpool,0-0,0,0,1,1,0,0,D
2007-11-03,2007,Everton,Birmingham City,3-1,3,1,1,1,4,2,H
2007-11-03,2007,Fulham,Reading,3-1,3,1,1,1,4,2,H
2007-11-03,2007,Middlesbrough,Tottenham Hotspur,1-1,1,1,1,1,2,0,D
2007-11-03,2007,Newcastle United,Portsmouth,1-4,1,4,1,1,5,-3,A
2007-11-03,2007,Wigan Athletic,Chelsea,0-2,0,2,1,1,2,-2,A
2007-11-04,2007,West Ham United,Bolton Wanderers,1-1,1,1,1,1,2,0,D
2007-11-05,2007,Manchester City,Sunderland,1-0,1,0,1,1,1,1,H
2007-11-10,2007,Derby County,West Ham United,0-5,0,5,1,1,5,-5,A
2007-11-10,2007,Liverpool,Fulham,2-0,2,0,1,1,2,2,H
2007-11-10,2007,Sunderland,Newcastle United,1-1,1,1,1,1,2,0,D
2007-11-11,2007,Birmingham City,Aston Villa,1-2,1,2,1,1,3,-1,A
2007-11-11,2007,Bolton Wanderers,Middlesbrough,0-0,0,0,1,1,0,0,D
2007-11-11,2007,Chelsea,Everton,1-1,1,1,1,1,2,0,D
2007-11-11,2007,Manchester United,Blackburn Rovers,2-0,2,0,1,1,2,2,H
2007-11-11,2007,Portsmouth,Manchester City,0-0,0,0,1,1,0,0,D
2007-11-11,2007,Tottenham Hotspur,Wigan Athletic,4-0,4,0,1,1,4,4,H
2007-11-12,2007,Reading,Arsenal,1-3,1,3,1,1,4,-2,A
2007-11-24,2007,Arsenal,Wigan Athletic,2-0,2,0,1,1,2,2,H
2007-11-24,2007,Birmingham City,Portsmouth,0-2,0,2,1,1,2,-2,A
2007-11-24,2007,Bolton Wanderers,Manchester United,1-0,1,0,1,1,1,1,H
2007-11-24,2007,Derby County,Chelsea,0-2,0,2,1,1,2,-2,A
2007-11-24,2007,Everton,Sunderland,7-1,7,1,1,1,8,6,H
2007-11-24,2007,Manchester City,Reading,2-1,2,1,1,1,3,1,H
2007-11-24,2007,Middlesbrough,Aston Villa,0-3,0,3,1,1,3,-3,A
2007-11-24,2007,Newcastle United,Liverpool,0-3,0,3,1,1,3,-3,A
2007-11-25,2007,Fulham,Blackburn Rovers,2-2,2,2,1,1,4,0,D
2007-11-25,2007,West Ham United,Tottenham Hotspur,1-1,1,1,1,1,2,0,D
2007-11-28,2007,Blackburn Rovers,Aston Villa,0-4,0,4,1,1,4,-4,A
2007-12-01,2007,Aston Villa,Arsenal,1-2,1,2,1,1,3,-1,A
2007-12-01,2007,Blackburn Rovers,Newcastle United,3-1,3,1,1,1,4,2,H
2007-12-01,2007,Chelsea,West Ham United,1-0,1,0,1,1,1,1,H
2007-12-01,2007,Portsmouth,Everton,0-0,0,0,1,1,0,0,D
2007-12-01,2007,Reading,Middlesbrough,1-1,1,1,1,1,2,0,D
2007-12-01,2007,Sunderland,Derby County,1-0,1,0,1,1,1,1,H
2007-12-01,2007,Wigan Athletic,Manchester City,1-1,1,1,1,1,2,0,D
2007-12-02,2007,Liverpool,Bolton Wanderers,4-0,4,0,1,1,4,4,H
2007-12-02,2007,Tottenham Hotspur,Birmingham City,2-3,2,3,1,1,5,-1,A
2007-12-03,2007,Manchester United,Fulham,2-0,2,0,1,1,2,2,H
2007-12-05,2007,Newcastle United,Arsenal,1-1,1,1,1,1,2,0,D
2007-12-08,2007,Aston Villa,Portsmouth,1-3,1,3,1,1,4,-2,A
2007-12-08,2007,Chelsea,Sunderland,2-0,2,0,1,1,2,2,H
2007-12-08,2007,Everton,Fulham,3-0,3,0,1,1,3,3,H
2007-12-08,2007,Manchester United,Derby County,4-1,4,1,1,1,5,3,H
2007-12-08,2007,Newcastle United,Birmingham City,2-1,2,1,1,1,3,1,H
2007-12-08,2007,Reading,Liverpool,3-1,3,1,1,1,4,2,H
2007-12-09,2007,Blackburn Rovers,West Ham United,0-1,0,1,1,1,1,-1,A
2007-12-09,2007,Bolton Wanderers,Wigan Athletic,4-1,4,1,1,1,5,3,H
2007-12-09,2007,Middlesbrough,Arsenal,2-1,2,1,1,1,3,1,H
2007-12-09,2007,Tottenham Hotspur,Manchester City,2-1,2,1,1,1,3,1,H
2007-12-15,2007,Birmingham City,Reading,1-1,1,1,1,1,2,0,D
2007-12-15,2007,Derby County,Middlesbrough,0-1,0,1,1,1,1,-1,A
2007-12-15,2007,Fulham,Newcastle United,0-1,0,1,1,1,1,-1,A
2007-12-15,2007,Manchester City,Bolton Wanderers,4-2,4,2,1,1,6,2,H
2007-12-15,2007,Portsmouth,Tottenham Hotspur,0-1,0,1,1,1,1,-1,A
2007-12-15,2007,Sunderland,Aston Villa,1-1,1,1,1,1,2,0,D
2007-12-15,2007,West Ham United,Everton,0-2,0,2,1,1,2,-2,A
2007-12-15,2007,Wigan Athletic,Blackburn Rovers,5-3,5,3,1,1,8,2,H
2007-12-16,2007,Arsenal,Chelsea,1-0,1,0,1,1,1,1,H
2007-12-16,2007,Liverpool,Manchester United,0-1,0,1,1,1,1,-1,A
2007-12-22,2007,Arsenal,Tottenham Hotspur,2-1,2,1,1,1,3,1,H
2007-12-22,2007,Aston Villa,Manchester City,1-1,1,1,1,1,2,0,D
2007-12-22,2007,Bolton Wanderers,Birmingham City,3-0,3,0,1,1,3,3,H
2007-12-22,2007,Fulham,Wigan Athletic,1-1,1,1,1,1,2,0,D
2007-12-22,2007,Liverpool,Portsmouth,4-1,4,1,1,1,5,3,H
2007-12-22,2007,Middlesbrough,West Ham United,1-2,1,2,1,1,3,-1,A
2007-12-22,2007,Reading,Sunderland,2-1,2,1,1,1,3,1,H
2007-12-23,2007,Blackburn Rovers,Chelsea,0-1,0,1,1,1,1,-1,A
2007-12-23,2007,Manchester United,Everton,2-1,2,1,1,1,3,1,H
2007-12-23,2007,Newcastle United,Derby County,2-2,2,2,1,1,4,0,D
2007-12-26,2007,Birmingham City,Middlesbrough,3-0,3,0,1,1,3,3,H
2007-12-26,2007,Chelsea,Aston Villa,4-4,4,4,1,1,8,0,D
2007-12-26,2007,Derby County,Liverpool,1-2,1,2,1,1,3,-1,A
2007-12-26,2007,Everton,Bolton Wanderers,2-0,2,0,1,1,2,2,H
2007-12-26,2007,Portsmouth,Arsenal,0-0,0,0,1,1,0,0,D
2007-12-26,2007,Sunderland,Manchester United,0-4,0,4,1,1,4,-4,A
2007-12-26,2007,Tottenham Hotspur,Fulham,5-1,5,1,1,1,6,4,H
2007-12-26,2007,West Ham United,Reading,1-1,1,1,1,1,2,0,D
2007-12-26,2007,Wigan Athletic,Newcastle United,1-0,1,0,1,1,1,1,H
2007-12-27,2007,Manchester City,Blackburn Rovers,2-2,2,2,1,1,4,0,D
2007-12-29,2007,Birmingham City,Fulham,1-1,1,1,1,1,2,0,D
2007-12-29,2007,Chelsea,Newcastle United,2-1,2,1,1,1,3,1,H
2007-12-29,2007,Everton,Arsenal,1-4,1,4,1,1,5,-3,A
2007-12-29,2007,Portsmouth,Middlesbrough,0-1,0,1,1,1,1,-1,A
2007-12-29,2007,Sunderland,Bolton Wanderers,3-1,3,1,1,1,4,2,H
2007-12-29,2007,Tottenham Hotspur,Reading,6-4,6,4,1,1,10,2,H
2007-12-29,2007,West Ham United,Manchester United,2-1,2,1,1,1,3,1,H
2007-12-29,2007,Wigan Athletic,Aston Villa,1-2,1,2,1,1,3,-1,A
2007-12-30,2007,Derby County,Blackburn Rovers,1-2,1,2,1,1,3,-1,A
2007-12-30,2007,Manchester City,Liverpool,0-0,0,0,1,1,0,0,D
2008-01-01,2007,Arsenal,West Ham United,2-0,2,0,1,1,2,2,H
2008-01-01,2007,Aston Villa,Tottenham Hotspur,2-1,2,1,1,1,3,1,H
2008-01-01,2007,Fulham,Chelsea,1-2,1,2,1,1,3,-1,A
2008-01-01,2007,Manchester United,Birmingham City,1-0,1,0,1,1,1,1,H
2008-01-01,2007,Middlesbrough,Everton,0-2,0,2,1,1,2,-2,A
2008-01-01,2007,Reading,Portsmouth,0-2,0,2,1,1,2,-2,A
2008-01-02,2007,Blackburn Rovers,Sunderland,1-0,1,0,1,1,1,1,H
2008-01-02,2007,Bolton Wanderers,Derby County,1-0,1,0,1,1,1,1,H
2008-01-02,2007,Liverpool,Wigan Athletic,1-1,1,1,1,1,2,0,D
2008-01-02,2007,Newcastle United,Manchester City,0-2,0,2,1,1,2,-2,A
2008-01-12,2007,Arsenal,Birmingham City,1-1,1,1,1,1,2,0,D
2008-01-12,2007,Aston Villa,Reading,3-1,3,1,1,1,4,2,H
2008-01-12,2007,Chelsea,Tottenham Hotspur,2-0,2,0,1,1,2,2,H
2008-01-12,2007,Derby County,Wigan Athletic,0-1,0,1,1,1,1,-1,A
2008-01-12,2007,Everton,Manchester City,1-0,1,0,1,1,1,1,H
2008-01-12,2007,Manchester United,Newcastle United,6-0,6,0,1,1,6,6,H
2008-01-12,2007,Middlesbrough,Liverpool,1-1,1,1,1,1,2,0,D
2008-01-12,2007,West Ham United,Fulham,2-1,2,1,1,1,3,1,H
2008-01-13,2007,Bolton Wanderers,Blackburn Rovers,1-2,1,2,1,1,3,-1,A
2008-01-13,2007,Sunderland,Portsmouth,2-0,2,0,1,1,2,2,H
2008-01-19,2007,Birmingham City,Chelsea,0-1,0,1,1,1,1,-1,A
2008-01-19,2007,Blackburn Rovers,Middlesbrough,1-1,1,1,1,1,2,0,D
2008-01-19,2007,Fulham,Arsenal,0-3,0,3,1,1,3,-3,A
2008-01-19,2007,Newcastle United,Bolton Wanderers,0-0,0,0,1,1,0,0,D
2008-01-19,2007,Portsmouth,Derby County,3-1,3,1,1,1,4,2,H
2008-01-19,2007,Reading,Manchester United,0-2,0,2,1,1,2,-2,A
2008-01-19,2007,Tottenham Hotspur,Sunderland,2-0,2,0,1,1,2,2,H
2008-01-20,2007,Manchester City,West Ham United,1-1,1,1,1,1,2,0,D
2008-01-20,2007,Wigan Athletic,Everton,1-2,1,2,1,1,3,-1,A
2008-01-21,2007,Liverpool,Aston Villa,2-2,2,2,1,1,4,0,D
2008-01-26,2007,Aston Villa,Blackburn Rovers,1-1,1,1,1,1,2,0,D
2008-01-29,2007,Arsenal,Newcastle United,3-0,3,0,1,1,3,3,H
2008-01-29,2007,Bolton Wanderers,Fulham,0-0,0,0,1,1,0,0,D
2008-01-29,2007,Middlesbrough,Wigan Athletic,1-0,1,0,1,1,1,1,H
2008-01-29,2007,Sunderland,Birmingham City,2-0,2,0,1,1,2,2,H
2008-01-30,2007,Chelsea,Reading,1-0,1,0,1,1,1,1,H
2008-01-30,2007,Derby County,Manchester City,1-1,1,1,1,1,2,0,D
2008-01-30,2007,Everton,Tottenham Hotspur,0-0,0,0,1,1,0,0,D
2008-01-30,2007,Manchester United,Portsmouth,2-0,2,0,1,1,2,2,H
2008-01-30,2007,West Ham United,Liverpool,1-0,1,0,1,1,1,1,H
2008-02-02,2007,Birmingham City,Derby County,1-1,1,1,1,1,2,0,D
2008-02-02,2007,Blackburn Rovers,Everton,0-0,0,0,1,1,0,0,D
2008-02-02,2007,Liverpool,Sunderland,3-0,3,0,1,1,3,3,H
2008-02-02,2007,Manchester City,Arsenal,1-3,1,3,1,1,4,-2,A
2008-02-02,2007,Portsmouth,Chelsea,1-1,1,1,1,1,2,0,D
2008-02-02,2007,Reading,Bolton Wanderers,0-2,0,2,1,1,2,-2,A
2008-02-02,2007,Tottenham Hotspur,Manchester United,1-1,1,1,1,1,2,0,D
2008-02-02,2007,Wigan Athletic,West Ham United,1-0,1,0,1,1,1,1,H
2008-02-03,2007,Fulham,Aston Villa,2-1,2,1,1,1,3,1,H
2008-02-03,2007,Newcastle United,Middlesbrough,1-1,1,1,1,1,2,0,D
2008-02-09,2007,Aston Villa,Newcastle United,4-1,4,1,1,1,5,3,H
2008-02-09,2007,Bolton Wanderers,Portsmouth,0-1,0,1,1,1,1,-1,A
2008-02-09,2007,Derby County,Tottenham Hotspur,0-3,0,3,1,1,3,-3,A
2008-02-09,2007,Everton,Reading,1-0,1,0,1,1,1,1,H
2008-02-09,2007,Middlesbrough,Fulham,1-0,1,0,1,1,1,1,H
2008-02-09,2007,Sunderland,Wigan Athletic,2-0,2,0,1,1,2,2,H
2008-02-09,2007,West Ham United,Birmingham City,1-1,1,1,1,1,2,0,D
2008-02-10,2007,Chelsea,Liverpool,0-0,0,0,1,1,0,0,D
2008-02-10,2007,Manchester United,Manchester City,1-2,1,2,1,1,3,-1,A
2008-02-11,2007,Arsenal,Blackburn Rovers,2-0,2,0,1,1,2,2,H
2008-02-23,2007,Birmingham City,Arsenal,2-2,2,2,1,1,4,0,D
2008-02-23,2007,Fulham,West Ham United,0-1,0,1,1,1,1,-1,A
2008-02-23,2007,Liverpool,Middlesbrough,3-2,3,2,1,1,5,1,H
2008-02-23,2007,Newcastle United,Manchester United,1-5,1,5,1,1,6,-4,A
2008-02-23,2007,Portsmouth,Sunderland,1-0,1,0,1,1,1,1,H
2008-02-23,2007,Wigan Athletic,Derby County,2-0,2,0,1,1,2,2,H
2008-02-24,2007,Blackburn Rovers,Bolton Wanderers,4-1,4,1,1,1,5,3,H
2008-02-24,2007,Reading,Aston Villa,1-2,1,2,1,1,3,-1,A
2008-02-25,2007,Manchester City,Everton,0-2,0,2,1,1,2,-2,A
2008-03-01,2007,Arsenal,Aston Villa,1-1,1,1,1,1,2,0,D
2008-03-01,2007,Birmingham City,Tottenham Hotspur,4-1,4,1,1,1,5,3,H
2008-03-01,2007,Derby County,Sunderland,0-0,0,0,1,1,0,0,D
2008-03-01,2007,Fulham,Manchester United,0-3,0,3,1,1,3,-3,A
2008-03-01,2007,Manchester City,Wigan Athletic,0-0,0,0,1,1,0,0,D
2008-03-01,2007,Middlesbrough,Reading,0-1,0,1,1,1,1,-1,A
2008-03-01,2007,Newcastle United,Blackburn Rovers,0-1,0,1,1,1,1,-1,A
2008-03-01,2007,West Ham United,Chelsea,0-4,0,4,1,1,4,-4,A
2008-03-02,2007,Bolton Wanderers,Liverpool,1-3,1,3,1,1,4,-2,A
2008-03-02,2007,Everton,Portsmouth,3-1,3,1,1,1,4,2,H
2008-03-05,2007,Liverpool,West Ham United,4-0,4,0,1,1,4,4,H
2008-03-08,2007,Blackburn Rovers,Fulham,1-1,1,1,1,1,2,0,D
2008-03-08,2007,Liverpool,Newcastle United,3-0,3,0,1,1,3,3,H
2008-03-08,2007,Reading,Manchester City,2-0,2,0,1,1,2,2,H
2008-03-09,2007,Sunderland,Everton,0-1,0,1,1,1,1,-1,A
2008-03-09,2007,Tottenham Hotspur,West Ham United,4-0,4,0,1,1,4,4,H
2008-03-09,2007,Wigan Athletic,Arsenal,0-0,0,0,1,1,0,0,D
2008-03-12,2007,Aston Villa,Middlesbrough,1-1,1,1,1,1,2,0,D
2008-03-12,2007,Chelsea,Derby County,6-1,6,1,1,1,7,5,H
2008-03-12,2007,Portsmouth,Birmingham City,4-2,4,2,1,1,6,2,H
2008-03-15,2007,Arsenal,Middlesbrough,1-1,1,1,1,1,2,0,D
2008-03-15,2007,Derby County,Manchester United,0-1,0,1,1,1,1,-1,A
2008-03-15,2007,Liverpool,Reading,2-1,2,1,1,1,3,1,H
2008-03-15,2007,Portsmouth,Aston Villa,2-0,2,0,1,1,2,2,H
2008-03-15,2007,Sunderland,Chelsea,0-1,0,1,1,1,1,-1,A
2008-03-15,2007,West Ham United,Blackburn Rovers,2-1,2,1,1,1,3,1,H
2008-03-16,2007,Fulham,Everton,1-0,1,0,1,1,1,1,H
2008-03-16,2007,Manchester City,Tottenham Hotspur,2-1,2,1,1,1,3,1,H
2008-03-16,2007,Wigan Athletic,Bolton Wanderers,1-0,1,0,1,1,1,1,H
2008-03-17,2007,Birmingham City,Newcastle United,1-1,1,1,1,1,2,0,D
2008-03-19,2007,Manchester United,Bolton Wanderers,2-0,2,0,1,1,2,2,H
2008-03-19,2007,Tottenham Hotspur,Chelsea,4-4,4,4,1,1,8,0,D
2008-03-22,2007,Aston Villa,Sunderland,0-1,0,1,1,1,1,-1,A
2008-03-22,2007,Blackburn Rovers,Wigan Athletic,3-1,3,1,1,1,4,2,H
2008-03-22,2007,Bolton Wanderers,Manchester City,0-0,0,0,1,1,0,0,D
2008-03-22,2007,Everton,West Ham United,1-1,1,1,1,1,2,0,D
2008-03-22,2007,Middlesbrough,Derby County,1-0,1,0,1,1,1,1,H
2008-03-22,2007,Newcastle United,Fulham,2-0,2,0,1,1,2,2,H
2008-03-22,2007,Reading,Birmingham City,2-1,2,1,1,1,3,1,H
2008-03-22,2007,Tottenham Hotspur,Portsmouth,2-0,2,0,1,1,2,2,H
2008-03-23,2007,Chelsea,Arsenal,2-1,2,1,1,1,3,1,H
2008-03-23,2007,Manchester United,Liverpool,3-0,3,0,1,1,3,3,H
2008-03-29,2007,Birmingham City,Manchester City,3-1,3,1,1,1,4,2,H
2008-03-29,2007,Bolton Wanderers,Arsenal,2-3,2,3,1,1,5,-1,A
2008-03-29,2007,Derby County,Fulham,2-2,2,2,1,1,4,0,D
2008-03-29,2007,Manchester United,Aston Villa,4-0,4,0,1,1,4,4,H
2008-03-29,2007,Portsmouth,Wigan Athletic,2-0,2,0,1,1,2,2,H
2008-03-29,2007,Reading,Blackburn Rovers,0-0,0,0,1,1,0,0,D
2008-03-29,2007,Sunderland,West Ham United,2-1,2,1,1,1,3,1,H
2008-03-30,2007,Chelsea,Middlesbrough,1-0,1,0,1,1,1,1,H
2008-03-30,2007,Liverpool,Everton,1-0,1,0,1,1,1,1,H
2008-03-30,2007,Tottenham Hotspur,Newcastle United,1-4,1,4,1,1,5,-3,A
2008-04-05,2007,Arsenal,Liverpool,1-1,1,1,1,1,2,0,D
2008-04-05,2007,Aston Villa,Bolton Wanderers,4-0,4,0,1,1,4,4,H
2008-04-05,2007,Blackburn Rovers,Tottenham Hotspur,1-1,1,1,1,1,2,0,D
2008-04-05,2007,Fulham,Sunderland,1-3,1,3,1,1,4,-2,A
2008-04-05,2007,Manchester City,Chelsea,0-2,0,2,1,1,2,-2,A
2008-04-05,2007,Newcastle United,Reading,3-0,3,0,1,1,3,3,H
2008-04-05,2007,Wigan Athletic,Birmingham City,2-0,2,0,1,1,2,2,H
2008-04-06,2007,Everton,Derby County,1-0,1,0,1,1,1,1,H
2008-04-06,2007,Middlesbrough,Manchester United,2-2,2,2,1,1,4,0,D
2008-04-08,2007,West Ham United,Portsmouth,0-1,0,1,1,1,1,-1,A
2008-04-12,2007,Birmingham City,Everton,1-1,1,1,1,1,2,0,D
2008-04-12,2007,Bolton Wanderers,West Ham United,1-0,1,0,1,1,1,1,H
2008-04-12,2007,Derby County,Aston Villa,0-6,0,6,1,1,6,-6,A
2008-04-12,2007,Portsmouth,Newcastle United,0-0,0,0,1,1,0,0,D
2008-04-12,2007,Reading,Fulham,0-2,0,2,1,1,2,-2,A
2008-04-12,2007,Sunderland,Manchester City,1-2,1,2,1,1,3,-1,A
2008-04-12,2007,Tottenham Hotspur,Middlesbrough,1-1,1,1,1,1,2,0,D
2008-04-13,2007,Liverpool,Blackburn Rovers,3-1,3,1,1,1,4,2,H
2008-04-13,2007,Manchester United,Arsenal,2-1,2,1,1,1,3,1,H
2008-04-14,2007,Chelsea,Wigan Athletic,1-1,1,1,1,1,2,0,D
2008-04-17,2007,Everton,Chelsea,0-1,0,1,1,1,1,-1,A
2008-04-19,2007,Arsenal,Reading,2-0,2,0,1,1,2,2,H
2008-04-19,2007,Blackburn Rovers,Manchester United,1-1,1,1,1,1,2,0,D
2008-04-19,2007,Fulham,Liverpool,0-2,0,2,1,1,2,-2,A
2008-04-19,2007,Middlesbrough,Bolton Wanderers,0-1,0,1,1,1,1,-1,A
2008-04-19,2007,West Ham United,Derby County,2-1,2,1,1,1,3,1,H
2008-04-19,2007,Wigan Athletic,Tottenham Hotspur,1-1,1,1,1,1,2,0,D
2008-04-20,2007,Aston Villa,Birmingham City,5-1,5,1,1,1,6,4,H
2008-04-20,2007,Manchester City,Portsmouth,3-1,3,1,1,1,4,2,H
2008-04-20,2007,Newcastle United,Sunderland,2-0,2,0,1,1,2,2,H
2008-04-26,2007,Birmingham City,Liverpool,2-2,2,2,1,1,4,0,D
2008-04-26,2007,Chelsea,Manchester United,2-1,2,1,1,1,3,1,H
2008-04-26,2007,Manchester City,Fulham,2-3,2,3,1,1,5,-1,A
2008-04-26,2007,Sunderland,Middlesbrough,3-2,3,2,1,1,5,1,H
2008-04-26,2007,Tottenham Hotspur,Bolton Wanderers,1-1,1,1,1,1,2,0,D
2008-04-26,2007,West Ham United,Newcastle United,2-2,2,2,1,1,4,0,D
2008-04-26,2007,Wigan Athletic,Reading,0-0,0,0,1,1,0,0,D
2008-04-27,2007,Everton,Aston Villa,2-2,2,2,1,1,4,0,D
2008-04-27,2007,Portsmouth,Blackburn Rovers,0-1,0,1,1,1,1,-1,A
2008-04-28,2007,Derby County,Arsenal,2-6,2,6,1,1,8,-4,A
2008-05-03,2007,Aston Villa,Wigan Athletic,0-2,0,2,1,1,2,-2,A
2008-05-03,2007,Blackburn Rovers,Derby County,3-1,3,1,1,1,4,2,H
2008-05-03,2007,Bolton Wanderers,Sunderland,2-0,2,0,1,1,2,2,H
2008-05-03,2007,Fulham,Birmingham City,2-0,2,0,1,1,2,2,H
2008-05-03,2007,Manchester United,West Ham United,4-1,4,1,1,1,5,3,H
2008-05-03,2007,Middlesbrough,Portsmouth,2-0,2,0,1,1,2,2,H
2008-05-03,2007,Reading,Tottenham Hotspur,0-1,0,1,1,1,1,-1,A
2008-05-04,2007,Arsenal,Everton,1-0,1,0,1,1,1,1,H
2008-05-04,2007,Liverpool,Manchester City,1-0,1,0,1,1,1,1,H
2008-05-05,2007,Newcastle United,Chelsea,0-2,0,2,1,1,2,-2,A
2008-05-11,2007,Birmingham City,Blackburn Rovers,4-1,4,1,1,1,5,3,H
2008-05-11,2007,Chelsea,Bolton Wanderers,1-1,1,1,1,1,2,0,D
2008-05-11,2007,Derby County,Reading,0-4,0,4,1,1,4,-4,A
2008-05-11,2007,Everton,Newcastle United,3-1,3,1,1,1,4,2,H
2008-05-11,2007,Middlesbrough,Manchester City,8-1,8,1,1,1,9,7,H
2008-05-11,2007,Portsmouth,Fulham,0-1,0,1,1,1,1,-1,A
2008-05-11,2007,Sunderland,Arsenal,0-1,0,1,1,1,1,-1,A
2008-05-11,2007,Tottenham Hotspur,Liverpool,0-2,0,2,1,1,2,-2,A
2008-05-11,2007,West Ham United,Aston Villa,2-2,2,2,1,1,4,0,D
2008-05-11,2007,Wigan Athletic,Manchester United,0-2,0,2,1,1,2,-2,A
2008-08-16,2008,Arsenal,West Bromwich Albion,1-0,1,0,1,1,1,1,H
2008-08-16,2008,Bolton Wanderers,Stoke City,3-1,3,1,1,1,4,2,H
2008-08-16,2008,Everton,Blackburn Rovers,2-3,2,3,1,1,5,-1,A
2008-08-16,2008,Hull City,Fulham,2-1,2,1,1,1,3,1,H
2008-08-16,2008,Middlesbrough,Tottenham Hotspur,2-1,2,1,1,1,3,1,H
2008-08-16,2008,Sunderland,Liverpool,0-1,0,1,1,1,1,-1,A
2008-08-16,2008,West Ham United,Wigan Athletic,2-1,2,1,1,1,3,1,H
2008-08-17,2008,Aston Villa,Manchester City,4-2,4,2,1,1,6,2,H
2008-08-17,2008,Chelsea,Portsmouth,4-0,4,0,1,1,4,4,H
2008-08-17,2008,Manchester United,Newcastle United,1-1,1,1,1,1,2,0,D
2008-08-23,2008,Blackburn Rovers,Hull City,1-1,1,1,1,1,2,0,D
2008-08-23,2008,Fulham,Arsenal,1-0,1,0,1,1,1,1,H
2008-08-23,2008,Liverpool,Middlesbrough,2-1,2,1,1,1,3,1,H
2008-08-23,2008,Newcastle United,Bolton Wanderers,1-0,1,0,1,1,1,1,H
2008-08-23,2008,Stoke City,Aston Villa,3-2,3,2,1,1,5,1,H
2008-08-23,2008,Tottenham Hotspur,Sunderland,1-2,1,2,1,1,3,-1,A
2008-08-23,2008,West Bromwich Albion,Everton,1-2,1,2,1,1,3,-1,A
2008-08-24,2008,Manchester City,West Ham United,3-0,3,0,1,1,3,3,H
2008-08-24,2008,Wigan Athletic,Chelsea,0-1,0,1,1,1,1,-1,A
2008-08-25,2008,Portsmouth,Manchester United,0-1,0,1,1,1,1,-1,A
2008-08-30,2008,Arsenal,Newcastle United,3-0,3,0,1,1,3,3,H
2008-08-30,2008,Bolton Wanderers,West Bromwich Albion,0-0,0,0,1,1,0,0,D
2008-08-30,2008,Everton,Portsmouth,0-3,0,3,1,1,3,-3,A
2008-08-30,2008,Hull City,Wigan Athletic,0-5,0,5,1,1,5,-5,A
2008-08-30,2008,Middlesbrough,Stoke City,2-1,2,1,1,1,3,1,H
2008-08-30,2008,West Ham United,Blackburn Rovers,4-1,4,1,1,1,5,3,H
2008-08-31,2008,Aston Villa,Liverpool,0-0,0,0,1,1,0,0,D
2008-08-31,2008,Chelsea,Tottenham Hotspur,1-1,1,1,1,1,2,0,D
2008-08-31,2008,Sunderland,Manchester City,0-3,0,3,1,1,3,-3,A
2008-09-13,2008,Blackburn Rovers,Arsenal,0-4,0,4,1,1,4,-4,A
2008-09-13,2008,Fulham,Bolton Wanderers,2-1,2,1,1,1,3,1,H
2008-09-13,2008,Liverpool,Manchester United,2-1,2,1,1,1,3,1,H
2008-09-13,2008,Manchester City,Chelsea,1-3,1,3,1,1,4,-2,A
2008-09-13,2008,Newcastle United,Hull City,1-2,1,2,1,1,3,-1,A
2008-09-13,2008,Portsmouth,Middlesbrough,2-1,2,1,1,1,3,1,H
2008-09-13,2008,West Bromwich Albion,West Ham United,3-2,3,2,1,1,5,1,H
2008-09-13,2008,Wigan Athletic,Sunderland,1-1,1,1,1,1,2,0,D
2008-09-14,2008,Stoke City,Everton,2-3,2,3,1,1,5,-1,A
2008-09-15,2008,Tottenham Hotspur,Aston Villa,1-2,1,2,1,1,3,-1,A
2008-09-20,2008,Blackburn Rovers,Fulham,1-0,1,0,1,1,1,1,H
2008-09-20,2008,Bolton Wanderers,Arsenal,1-3,1,3,1,1,4,-2,A
2008-09-20,2008,Liverpool,Stoke City,0-0,0,0,1,1,0,0,D
2008-09-20,2008,Sunderland,Middlesbrough,2-0,2,0,1,1,2,2,H
2008-09-20,2008,West Ham United,Newcastle United,3-1,3,1,1,1,4,2,H
2008-09-21,2008,Chelsea,Manchester United,1-1,1,1,1,1,2,0,D
2008-09-21,2008,Hull City,Everton,2-2,2,2,1,1,4,0,D
2008-09-21,2008,Manchester City,Portsmouth,6-0,6,0,1,1,6,6,H
2008-09-21,2008,Tottenham Hotspur,Wigan Athletic,0-0,0,0,1,1,0,0,D
2008-09-21,2008,West Bromwich Albion,Aston Villa,1-2,1,2,1,1,3,-1,A
2008-09-27,2008,Arsenal,Hull City,1-2,1,2,1,1,3,-1,A
2008-09-27,2008,Aston Villa,Sunderland,2-1,2,1,1,1,3,1,H
2008-09-27,2008,Everton,Liverpool,0-2,0,2,1,1,2,-2,A
2008-09-27,2008,Fulham,West Ham United,1-2,1,2,1,1,3,-1,A
2008-09-27,2008,Manchester United,Bolton Wanderers,2-0,2,0,1,1,2,2,H
2008-09-27,2008,Middlesbrough,West Bromwich Albion,0-1,0,1,1,1,1,-1,A
2008-09-27,2008,Newcastle United,Blackburn Rovers,1-2,1,2,1,1,3,-1,A
2008-09-27,2008,Stoke City,Chelsea,0-2,0,2,1,1,2,-2,A
2008-09-28,2008,Portsmouth,Tottenham Hotspur,2-0,2,0,1,1,2,2,H
2008-09-28,2008,Wigan Athletic,Manchester City,2-1,2,1,1,1,3,1,H
2008-10-04,2008,Blackburn Rovers,Manchester United,0-2,0,2,1,1,2,-2,A
2008-10-04,2008,Sunderland,Arsenal,1-1,1,1,1,1,2,0,D
2008-10-04,2008,West Bromwich Albion,Fulham,1-0,1,0,1,1,1,1,H
2008-10-04,2008,Wigan Athletic,Middlesbrough,0-1,0,1,1,1,1,-1,A
2008-10-05,2008,Chelsea,Aston Villa,2-0,2,0,1,1,2,2,H
2008-10-05,2008,Everton,Newcastle United,2-2,2,2,1,1,4,0,D
2008-10-05,2008,Manchester City,Liverpool,2-3,2,3,1,1,5,-1,A
2008-10-05,2008,Portsmouth,Stoke City,2-1,2,1,1,1,3,1,H
2008-10-05,2008,Tottenham Hotspur,Hull City,0-1,0,1,1,1,1,-1,A
2008-10-05,2008,West Ham United,Bolton Wanderers,1-3,1,3,1,1,4,-2,A
2008-10-18,2008,Arsenal,Everton,3-1,3,1,1,1,4,2,H
2008-10-18,2008,Aston Villa,Portsmouth,0-0,0,0,1,1,0,0,D
2008-10-18,2008,Bolton Wanderers,Blackburn Rovers,0-0,0,0,1,1,0,0,D
2008-10-18,2008,Fulham,Sunderland,0-0,0,0,1,1,0,0,D
2008-10-18,2008,Liverpool,Wigan Athletic,3-2,3,2,1,1,5,1,H
2008-10-18,2008,Manchester United,West Bromwich Albion,4-0,4,0,1,1,4,4,H
2008-10-18,2008,Middlesbrough,Chelsea,0-5,0,5,1,1,5,-5,A
2008-10-19,2008,Hull City,West Ham United,1-0,1,0,1,1,1,1,H
2008-10-19,2008,Stoke City,Tottenham Hotspur,2-1,2,1,1,1,3,1,H
2008-10-20,2008,Newcastle United,Manchester City,2-2,2,2,1,1,4,0,D
2008-10-25,2008,Blackburn Rovers,Middlesbrough,1-1,1,1,1,1,2,0,D
2008-10-25,2008,Everton,Manchester United,1-1,1,1,1,1,2,0,D
2008-10-25,2008,Sunderland,Newcastle United,2-1,2,1,1,1,3,1,H
2008-10-25,2008,West Bromwich Albion,Hull City,0-3,0,3,1,1,3,-3,A
2008-10-26,2008,Chelsea,Liverpool,0-1,0,1,1,1,1,-1,A
2008-10-26,2008,Manchester City,Stoke City,3-0,3,0,1,1,3,3,H
2008-10-26,2008,Portsmouth,Fulham,1-1,1,1,1,1,2,0,D
2008-10-26,2008,Tottenham Hotspur,Bolton Wanderers,2-0,2,0,1,1,2,2,H
2008-10-26,2008,West Ham United,Arsenal,0-2,0,2,1,1,2,-2,A
2008-10-26,2008,Wigan Athletic,Aston Villa,0-4,0,4,1,1,4,-4,A
2008-10-28,2008,Newcastle United,West Bromwich Albion,2-1,2,1,1,1,3,1,H
2008-10-29,2008,Arsenal,Tottenham Hotspur,4-4,4,4,1,1,8,0,D
2008-10-29,2008,Aston Villa,Blackburn Rovers,3-2,3,2,1,1,5,1,H
2008-10-29,2008,Bolton Wanderers,Everton,0-1,0,1,1,1,1,-1,A
2008-10-29,2008,Fulham,Wigan Athletic,2-0,2,0,1,1,2,2,H
2008-10-29,2008,Hull City,Chelsea,0-3,0,3,1,1,3,-3,A
2008-10-29,2008,Liverpool,Portsmouth,1-0,1,0,1,1,1,1,H
2008-10-29,2008,Manchester United,West Ham United,2-0,2,0,1,1,2,2,H
2008-10-29,2008,Middlesbrough,Manchester City,2-0,2,0,1,1,2,2,H
2008-10-29,2008,Stoke City,Sunderland,1-0,1,0,1,1,1,1,H
2008-11-01,2008,Chelsea,Sunderland,5-0,5,0,1,1,5,5,H
2008-11-01,2008,Everton,Fulham,1-0,1,0,1,1,1,1,H
2008-11-01,2008,Manchester United,Hull City,4-3,4,3,1,1,7,1,H
2008-11-01,2008,Middlesbrough,West Ham United,1-1,1,1,1,1,2,0,D
2008-11-01,2008,Portsmouth,Wigan Athletic,1-2,1,2,1,1,3,-1,A
2008-11-01,2008,Stoke City,Arsenal,2-1,2,1,1,1,3,1,H
2008-11-01,2008,Tottenham Hotspur,Liverpool,2-1,2,1,1,1,3,1,H
2008-11-01,2008,West Bromwich Albion,Blackburn Rovers,2-2,2,2,1,1,4,0,D
2008-11-02,2008,Bolton Wanderers,Manchester City,2-0,2,0,1,1,2,2,H
2008-11-03,2008,Newcastle United,Aston Villa,2-0,2,0,1,1,2,2,H
2008-11-08,2008,Arsenal,Manchester United,2-1,2,1,1,1,3,1,H
2008-11-08,2008,Hull City,Bolton Wanderers,0-1,0,1,1,1,1,-1,A
2008-11-08,2008,Liverpool,West Bromwich Albion,3-0,3,0,1,1,3,3,H
2008-11-08,2008,Sunderland,Portsmouth,1-2,1,2,1,1,3,-1,A
2008-11-08,2008,West Ham United,Everton,1-3,1,3,1,1,4,-2,A
2008-11-08,2008,Wigan Athletic,Stoke City,0-0,0,0,1,1,0,0,D
2008-11-09,2008,Aston Villa,Middlesbrough,1-2,1,2,1,1,3,-1,A
2008-11-09,2008,Blackburn Rovers,Chelsea,0-2,0,2,1,1,2,-2,A
2008-11-09,2008,Fulham,Newcastle United,2-1,2,1,1,1,3,1,H
2008-11-09,2008,Manchester City,Tottenham Hotspur,1-2,1,2,1,1,3,-1,A
2008-11-15,2008,Arsenal,Aston Villa,0-2,0,2,1,1,2,-2,A
2008-11-15,2008,Blackburn Rovers,Sunderland,1-2,1,2,1,1,3,-1,A
2008-11-15,2008,Bolton Wanderers,Liverpool,0-2,0,2,1,1,2,-2,A
2008-11-15,2008,Fulham,Tottenham Hotspur,2-1,2,1,1,1,3,1,H
2008-11-15,2008,Manchester United,Stoke City,5-0,5,0,1,1,5,5,H
2008-11-15,2008,Newcastle United,Wigan Athletic,2-2,2,2,1,1,4,0,D
2008-11-15,2008,West Bromwich Albion,Chelsea,0-3,0,3,1,1,3,-3,A
2008-11-15,2008,West Ham United,Portsmouth,0-0,0,0,1,1,0,0,D
2008-11-16,2008,Everton,Middlesbrough,1-1,1,1,1,1,2,0,D
2008-11-16,2008,Hull City,Manchester City,2-2,2,2,1,1,4,0,D
2008-11-22,2008,Aston Villa,Manchester United,0-0,0,0,1,1,0,0,D
2008-11-22,2008,Chelsea,Newcastle United,0-0,0,0,1,1,0,0,D
2008-11-22,2008,Liverpool,Fulham,0-0,0,0,1,1,0,0,D
2008-11-22,2008,Manchester City,Arsenal,3-0,3,0,1,1,3,3,H
2008-11-22,2008,Middlesbrough,Bolton Wanderers,1-3,1,3,1,1,4,-2,A
2008-11-22,2008,Portsmouth,Hull City,2-2,2,2,1,1,4,0,D
2008-11-22,2008,Stoke City,West Bromwich Albion,1-0,1,0,1,1,1,1,H
2008-11-23,2008,Sunderland,West Ham United,0-1,0,1,1,1,1,-1,A
2008-11-23,2008,Tottenham Hotspur,Blackburn Rovers,1-0,1,0,1,1,1,1,H
2008-11-24,2008,Wigan Athletic,Everton,1-0,1,0,1,1,1,1,H
2008-11-29,2008,Aston Villa,Fulham,0-0,0,0,1,1,0,0,D
2008-11-29,2008,Middlesbrough,Newcastle United,0-0,0,0,1,1,0,0,D
2008-11-29,2008,Stoke City,Hull City,1-1,1,1,1,1,2,0,D
2008-11-29,2008,Sunderland,Bolton Wanderers,1-4,1,4,1,1,5,-3,A
2008-11-29,2008,Wigan Athletic,West Bromwich Albion,2-1,2,1,1,1,3,1,H
2008-11-30,2008,Chelsea,Arsenal,1-2,1,2,1,1,3,-1,A
2008-11-30,2008,Manchester City,Manchester United,0-1,0,1,1,1,1,-1,A
2008-11-30,2008,Portsmouth,Blackburn Rovers,3-2,3,2,1,1,5,1,H
2008-11-30,2008,Tottenham Hotspur,Everton,0-1,0,1,1,1,1,-1,A
2008-12-01,2008,Liverpool,West Ham United,0-0,0,0,1,1,0,0,D
2008-12-06,2008,Arsenal,Wigan Athletic,1-0,1,0,1,1,1,1,H
2008-12-06,2008,Blackburn Rovers,Liverpool,1-3,1,3,1,1,4,-2,A
2008-12-06,2008,Bolton Wanderers,Chelsea,0-2,0,2,1,1,2,-2,A
2008-12-06,2008,Fulham,Manchester City,1-1,1,1,1,1,2,0,D
2008-12-06,2008,Hull City,Middlesbrough,2-1,2,1,1,1,3,1,H
2008-12-06,2008,Manchester United,Sunderland,1-0,1,0,1,1,1,1,H
2008-12-06,2008,Newcastle United,Stoke City,2-2,2,2,1,1,4,0,D
2008-12-07,2008,Everton,Aston Villa,2-3,2,3,1,1,5,-1,A
2008-12-07,2008,West Bromwich Albion,Portsmouth,1-1,1,1,1,1,2,0,D
2008-12-08,2008,West Ham United,Tottenham Hotspur,0-2,0,2,1,1,2,-2,A
2008-12-13,2008,Aston Villa,Bolton Wanderers,4-2,4,2,1,1,6,2,H
2008-12-13,2008,Liverpool,Hull City,2-2,2,2,1,1,4,0,D
2008-12-13,2008,Manchester City,Everton,0-1,0,1,1,1,1,-1,A
2008-12-13,2008,Middlesbrough,Arsenal,1-1,1,1,1,1,2,0,D
2008-12-13,2008,Stoke City,Fulham,0-0,0,0,1,1,0,0,D
2008-12-13,2008,Sunderland,West Bromwich Albion,4-0,4,0,1,1,4,4,H
2008-12-13,2008,Tottenham Hotspur,Manchester United,0-0,0,0,1,1,0,0,D
2008-12-13,2008,Wigan Athletic,Blackburn Rovers,3-0,3,0,1,1,3,3,H
2008-12-14,2008,Chelsea,West Ham United,1-1,1,1,1,1,2,0,D
2008-12-14,2008,Portsmouth,Newcastle United,0-3,0,3,1,1,3,-3,A
2008-12-20,2008,Blackburn Rovers,Stoke City,3-0,3,0,1,1,3,3,H
2008-12-20,2008,Bolton Wanderers,Portsmouth,2-1,2,1,1,1,3,1,H
2008-12-20,2008,Fulham,Middlesbrough,3-0,3,0,1,1,3,3,H
2008-12-20,2008,Hull City,Sunderland,1-4,1,4,1,1,5,-3,A
2008-12-20,2008,West Ham United,Aston Villa,0-1,0,1,1,1,1,-1,A
2008-12-21,2008,Arsenal,Liverpool,1-1,1,1,1,1,2,0,D
2008-12-21,2008,Newcastle United,Tottenham Hotspur,2-1,2,1,1,1,3,1,H
2008-12-21,2008,West Bromwich Albion,Manchester City,2-1,2,1,1,1,3,1,H
2008-12-22,2008,Everton,Chelsea,0-0,0,0,1,1,0,0,D
2008-12-26,2008,Aston Villa,Arsenal,2-2,2,2,1,1,4,0,D
2008-12-26,2008,Chelsea,West Bromwich Albion,2-0,2,0,1,1,2,2,H
2008-12-26,2008,Liverpool,Bolton Wanderers,3-0,3,0,1,1,3,3,H
2008-12-26,2008,Manchester City,Hull City,5-1,5,1,1,1,6,4,H
2008-12-26,2008,Middlesbrough,Everton,0-1,0,1,1,1,1,-1,A
2008-12-26,2008,Portsmouth,West Ham United,1-4,1,4,1,1,5,-3,A
2008-12-26,2008,Stoke City,Manchester United,0-1,0,1,1,1,1,-1,A
2008-12-26,2008,Sunderland,Blackburn Rovers,0-0,0,0,1,1,0,0,D
2008-12-26,2008,Tottenham Hotspur,Fulham,0-0,0,0,1,1,0,0,D
2008-12-26,2008,Wigan Athletic,Newcastle United,2-1,2,1,1,1,3,1,H
2008-12-28,2008,Arsenal,Portsmouth,1-0,1,0,1,1,1,1,H
2008-12-28,2008,Blackburn Rovers,Manchester City,2-2,2,2,1,1,4,0,D
2008-12-28,2008,Bolton Wanderers,Wigan Athletic,0-1,0,1,1,1,1,-1,A
2008-12-28,2008,Everton,Sunderland,3-0,3,0,1,1,3,3,H
2008-12-28,2008,Fulham,Chelsea,2-2,2,2,1,1,4,0,D
2008-12-28,2008,Newcastle United,Liverpool,1-5,1,5,1,1,6,-4,A
2008-12-28,2008,West Bromwich Albion,Tottenham Hotspur,2-0,2,0,1,1,2,2,H
2008-12-28,2008,West Ham United,Stoke City,2-1,2,1,1,1,3,1,H
2008-12-29,2008,Manchester United,Middlesbrough,1-0,1,0,1,1,1,1,H
2008-12-30,2008,Hull City,Aston Villa,0-1,0,1,1,1,1,-1,A
2009-01-10,2008,Arsenal,Bolton Wanderers,1-0,1,0,1,1,1,1,H
2009-01-10,2008,Aston Villa,West Bromwich Albion,2-1,2,1,1,1,3,1,H
2009-01-10,2008,Everton,Hull City,2-0,2,0,1,1,2,2,H
2009-01-10,2008,Middlesbrough,Sunderland,1-1,1,1,1,1,2,0,D
2009-01-10,2008,Newcastle United,West Ham United,2-2,2,2,1,1,4,0,D
2009-01-10,2008,Stoke City,Liverpool,0-0,0,0,1,1,0,0,D
2009-01-11,2008,Manchester United,Chelsea,3-0,3,0,1,1,3,3,H
2009-01-11,2008,Wigan Athletic,Tottenham Hotspur,1-0,1,0,1,1,1,1,H
2009-01-14,2008,Manchester United,Wigan Athletic,1-0,1,0,1,1,1,1,H
2009-01-17,2008,Blackburn Rovers,Newcastle United,3-0,3,0,1,1,3,3,H
2009-01-17,2008,Bolton Wanderers,Manchester United,0-1,0,1,1,1,1,-1,A
2009-01-17,2008,Chelsea,Stoke City,2-1,2,1,1,1,3,1,H
2009-01-17,2008,Hull City,Arsenal,1-3,1,3,1,1,4,-2,A
2009-01-17,2008,Manchester City,Wigan Athletic,1-0,1,0,1,1,1,1,H
2009-01-17,2008,Sunderland,Aston Villa,1-2,1,2,1,1,3,-1,A
2009-01-17,2008,West Bromwich Albion,Middlesbrough,3-0,3,0,1,1,3,3,H
2009-01-18,2008,Tottenham Hotspur,Portsmouth,1-1,1,1,1,1,2,0,D
2009-01-18,2008,West Ham United,Fulham,3-1,3,1,1,1,4,2,H
2009-01-19,2008,Liverpool,Everton,1-1,1,1,1,1,2,0,D
2009-01-27,2008,Portsmouth,Aston Villa,0-1,0,1,1,1,1,-1,A
2009-01-27,2008,Sunderland,Fulham,1-0,1,0,1,1,1,1,H
2009-01-27,2008,Tottenham Hotspur,Stoke City,3-1,3,1,1,1,4,2,H
2009-01-27,2008,West Bromwich Albion,Manchester United,0-5,0,5,1,1,5,-5,A
2009-01-28,2008,Blackburn Rovers,Bolton Wanderers,2-2,2,2,1,1,4,0,D
2009-01-28,2008,Chelsea,Middlesbrough,2-0,2,0,1,1,2,2,H
2009-01-28,2008,Everton,Arsenal,1-1,1,1,1,1,2,0,D
2009-01-28,2008,Manchester City,Newcastle United,2-1,2,1,1,1,3,1,H
2009-01-28,2008,West Ham United,Hull City,2-0,2,0,1,1,2,2,H
2009-01-28,2008,Wigan Athletic,Liverpool,1-1,1,1,1,1,2,0,D
2009-01-31,2008,Arsenal,West Ham United,0-0,0,0,1,1,0,0,D
2009-01-31,2008,Aston Villa,Wigan Athletic,0-0,0,0,1,1,0,0,D
2009-01-31,2008,Bolton Wanderers,Tottenham Hotspur,3-2,3,2,1,1,5,1,H
2009-01-31,2008,Fulham,Portsmouth,3-1,3,1,1,1,4,2,H
2009-01-31,2008,Hull City,West Bromwich Albion,2-2,2,2,1,1,4,0,D
2009-01-31,2008,Manchester United,Everton,1-0,1,0,1,1,1,1,H
2009-01-31,2008,Middlesbrough,Blackburn Rovers,0-0,0,0,1,1,0,0,D
2009-01-31,2008,Stoke City,Manchester City,1-0,1,0,1,1,1,1,H
2009-02-01,2008,Liverpool,Chelsea,2-0,2,0,1,1,2,2,H
2009-02-01,2008,Newcastle United,Sunderland,1-1,1,1,1,1,2,0,D
2009-02-07,2008,Blackburn Rovers,Aston Villa,0-2,0,2,1,1,2,-2,A
2009-02-07,2008,Chelsea,Hull City,0-0,0,0,1,1,0,0,D
2009-02-07,2008,Everton,Bolton Wanderers,3-0,3,0,1,1,3,3,H
2009-02-07,2008,Manchester City,Middlesbrough,1-0,1,0,1,1,1,1,H
2009-02-07,2008,Portsmouth,Liverpool,2-3,2,3,1,1,5,-1,A
2009-02-07,2008,Sunderland,Stoke City,2-0,2,0,1,1,2,2,H
2009-02-07,2008,West Bromwich Albion,Newcastle United,2-3,2,3,1,1,5,-1,A
2009-02-07,2008,Wigan Athletic,Fulham,0-0,0,0,1,1,0,0,D
2009-02-08,2008,Tottenham Hotspur,Arsenal,0-0,0,0,1,1,0,0,D
2009-02-08,2008,West Ham United,Manchester United,0-1,0,1,1,1,1,-1,A
2009-02-14,2008,Portsmouth,Manchester City,2-0,2,0,1,1,2,2,H
2009-02-18,2008,Manchester United,Fulham,3-0,3,0,1,1,3,3,H
2009-02-21,2008,Arsenal,Sunderland,0-0,0,0,1,1,0,0,D
2009-02-21,2008,Aston Villa,Chelsea,0-1,0,1,1,1,1,-1,A
2009-02-21,2008,Bolton Wanderers,West Ham United,2-1,2,1,1,1,3,1,H
2009-02-21,2008,Manchester United,Blackburn Rovers,2-1,2,1,1,1,3,1,H
2009-02-21,2008,Middlesbrough,Wigan Athletic,0-0,0,0,1,1,0,0,D
2009-02-21,2008,Stoke City,Portsmouth,2-2,2,2,1,1,4,0,D
2009-02-22,2008,Fulham,West Bromwich Albion,2-0,2,0,1,1,2,2,H
2009-02-22,2008,Liverpool,Manchester City,1-1,1,1,1,1,2,0,D
2009-02-22,2008,Newcastle United,Everton,0-0,0,0,1,1,0,0,D
2009-02-23,2008,Hull City,Tottenham Hotspur,1-2,1,2,1,1,3,-1,A
2009-02-28,2008,Arsenal,Fulham,0-0,0,0,1,1,0,0,D
2009-02-28,2008,Chelsea,Wigan Athletic,2-1,2,1,1,1,3,1,H
2009-02-28,2008,Everton,West Bromwich Albion,2-0,2,0,1,1,2,2,H
2009-02-28,2008,Middlesbrough,Liverpool,2-0,2,0,1,1,2,2,H
2009-03-01,2008,Aston Villa,Stoke City,2-2,2,2,1,1,4,0,D
2009-03-01,2008,Bolton Wanderers,Newcastle United,1-0,1,0,1,1,1,1,H
2009-03-01,2008,Hull City,Blackburn Rovers,1-2,1,2,1,1,3,-1,A
2009-03-01,2008,West Ham United,Manchester City,1-0,1,0,1,1,1,1,H
2009-03-03,2008,Liverpool,Sunderland,2-0,2,0,1,1,2,2,H
2009-03-03,2008,Portsmouth,Chelsea,0-1,0,1,1,1,1,-1,A
2009-03-03,2008,West Bromwich Albion,Arsenal,1-3,1,3,1,1,4,-2,A
2009-03-04,2008,Blackburn Rovers,Everton,0-0,0,0,1,1,0,0,D
2009-03-04,2008,Fulham,Hull City,0-1,0,1,1,1,1,-1,A
2009-03-04,2008,Manchester City,Aston Villa,2-0,2,0,1,1,2,2,H
2009-03-04,2008,Newcastle United,Manchester United,1-2,1,2,1,1,3,-1,A
2009-03-04,2008,Stoke City,Bolton Wanderers,2-0,2,0,1,1,2,2,H
2009-03-04,2008,Tottenham Hotspur,Middlesbrough,4-0,4,0,1,1,4,4,H
2009-03-04,2008,Wigan Athletic,West Ham United,0-1,0,1,1,1,1,-1,A
2009-03-07,2008,Sunderland,Tottenham Hotspur,1-1,1,1,1,1,2,0,D
2009-03-11,2008,Fulham,Blackburn Rovers,1-2,1,2,1,1,3,-1,A
2009-03-14,2008,Arsenal,Blackburn Rovers,4-0,4,0,1,1,4,4,H
2009-03-14,2008,Bolton Wanderers,Fulham,1-3,1,3,1,1,4,-2,A
2009-03-14,2008,Everton,Stoke City,3-1,3,1,1,1,4,2,H
2009-03-14,2008,Hull City,Newcastle United,1-1,1,1,1,1,2,0,D
2009-03-14,2008,Manchester United,Liverpool,1-4,1,4,1,1,5,-3,A
2009-03-14,2008,Middlesbrough,Portsmouth,1-1,1,1,1,1,2,0,D
2009-03-14,2008,Sunderland,Wigan Athletic,1-2,1,2,1,1,3,-1,A
2009-03-15,2008,Aston Villa,Tottenham Hotspur,1-2,1,2,1,1,3,-1,A
2009-03-15,2008,Chelsea,Manchester City,1-0,1,0,1,1,1,1,H
2009-03-16,2008,West Ham United,West Bromwich Albion,0-0,0,0,1,1,0,0,D
2009-03-21,2008,Blackburn Rovers,West Ham United,1-1,1,1,1,1,2,0,D
2009-03-21,2008,Fulham,Manchester United,2-0,2,0,1,1,2,2,H
2009-03-21,2008,Newcastle United,Arsenal,1-3,1,3,1,1,4,-2,A
2009-03-21,2008,Portsmouth,Everton,2-1,2,1,1,1,3,1,H
2009-03-21,2008,Stoke City,Middlesbrough,1-0,1,0,1,1,1,1,H
2009-03-21,2008,Tottenham Hotspur,Chelsea,1-0,1,0,1,1,1,1,H
2009-03-21,2008,West Bromwich Albion,Bolton Wanderers,1-1,1,1,1,1,2,0,D
2009-03-22,2008,Liverpool,Aston Villa,5-0,5,0,1,1,5,5,H
2009-03-22,2008,Manchester City,Sunderland,1-0,1,0,1,1,1,1,H
2009-03-22,2008,Wigan Athletic,Hull City,1-0,1,0,1,1,1,1,H
2009-04-04,2008,Arsenal,Manchester City,2-0,2,0,1,1,2,2,H
2009-04-04,2008,Blackburn Rovers,Tottenham Hotspur,2-1,2,1,1,1,3,1,H
2009-04-04,2008,Bolton Wanderers,Middlesbrough,4-1,4,1,1,1,5,3,H
2009-04-04,2008,Fulham,Liverpool,0-1,0,1,1,1,1,-1,A
2009-04-04,2008,Hull City,Portsmouth,0-0,0,0,1,1,0,0,D
2009-04-04,2008,Newcastle United,Chelsea,0-2,0,2,1,1,2,-2,A
2009-04-04,2008,West Bromwich Albion,Stoke City,0-2,0,2,1,1,2,-2,A
2009-04-04,2008,West Ham United,Sunderland,2-0,2,0,1,1,2,2,H
2009-04-05,2008,Everton,Wigan Athletic,4-0,4,0,1,1,4,4,H
2009-04-05,2008,Manchester United,Aston Villa,3-2,3,2,1,1,5,1,H
2009-04-11,2008,Chelsea,Bolton Wanderers,4-3,4,3,1,1,7,1,H
2009-04-11,2008,Liverpool,Blackburn Rovers,4-0,4,0,1,1,4,4,H
2009-04-11,2008,Middlesbrough,Hull City,3-1,3,1,1,1,4,2,H
2009-04-11,2008,Portsmouth,West Bromwich Albion,2-2,2,2,1,1,4,0,D
2009-04-11,2008,Stoke City,Newcastle United,1-1,1,1,1,1,2,0,D
2009-04-11,2008,Sunderland,Manchester United,1-2,1,2,1,1,3,-1,A
2009-04-11,2008,Tottenham Hotspur,West Ham United,1-0,1,0,1,1,1,1,H
2009-04-11,2008,Wigan Athletic,Arsenal,1-4,1,4,1,1,5,-3,A
2009-04-12,2008,Aston Villa,Everton,3-3,3,3,1,1,6,0,D
2009-04-12,2008,Manchester City,Fulham,1-3,1,3,1,1,4,-2,A
2009-04-18,2008,Aston Villa,West Ham United,1-1,1,1,1,1,2,0,D
2009-04-18,2008,Middlesbrough,Fulham,0-0,0,0,1,1,0,0,D
2009-04-18,2008,Portsmouth,Bolton Wanderers,1-0,1,0,1,1,1,1,H
2009-04-18,2008,Stoke City,Blackburn Rovers,1-0,1,0,1,1,1,1,H
2009-04-18,2008,Sunderland,Hull City,1-0,1,0,1,1,1,1,H
2009-04-19,2008,Manchester City,West Bromwich Albion,4-2,4,2,1,1,6,2,H
2009-04-19,2008,Tottenham Hotspur,Newcastle United,1-0,1,0,1,1,1,1,H
2009-04-21,2008,Liverpool,Arsenal,4-4,4,4,1,1,8,0,D
2009-04-22,2008,Chelsea,Everton,0-0,0,0,1,1,0,0,D
2009-04-22,2008,Manchester United,Portsmouth,2-0,2,0,1,1,2,2,H
2009-04-25,2008,Bolton Wanderers,Aston Villa,1-1,1,1,1,1,2,0,D
2009-04-25,2008,Everton,Manchester City,1-2,1,2,1,1,3,-1,A
2009-04-25,2008,Fulham,Stoke City,1-0,1,0,1,1,1,1,H
2009-04-25,2008,Hull City,Liverpool,1-3,1,3,1,1,4,-2,A
2009-04-25,2008,Manchester United,Tottenham Hotspur,5-2,5,2,1,1,7,3,H
2009-04-25,2008,West Bromwich Albion,Sunderland,3-0,3,0,1,1,3,3,H
2009-04-25,2008,West Ham United,Chelsea,0-1,0,1,1,1,1,-1,A
2009-04-26,2008,Arsenal,Middlesbrough,2-0,2,0,1,1,2,2,H
2009-04-26,2008,Blackburn Rovers,Wigan Athletic,2-0,2,0,1,1,2,2,H
2009-04-27,2008,Newcastle United,Portsmouth,0-0,0,0,1,1,0,0,D
2009-05-02,2008,Chelsea,Fulham,3-1,3,1,1,1,4,2,H
2009-05-02,2008,Manchester City,Blackburn Rovers,3-1,3,1,1,1,4,2,H
2009-05-02,2008,Middlesbrough,Manchester United,0-2,0,2,1,1,2,-2,A
2009-05-02,2008,Portsmouth,Arsenal,0-3,0,3,1,1,3,-3,A
2009-05-02,2008,Stoke City,West Ham United,0-1,0,1,1,1,1,-1,A
2009-05-02,2008,Tottenham Hotspur,West Bromwich Albion,1-0,1,0,1,1,1,1,H
2009-05-02,2008,Wigan Athletic,Bolton Wanderers,0-0,0,0,1,1,0,0,D
2009-05-03,2008,Liverpool,Newcastle United,3-0,3,0,1,1,3,3,H
2009-05-03,2008,Sunderland,Everton,0-2,0,2,1,1,2,-2,A
2009-05-04,2008,Aston Villa,Hull City,1-0,1,0,1,1,1,1,H
2009-05-09,2008,Blackburn Rovers,Portsmouth,2-0,2,0,1,1,2,2,H
2009-05-09,2008,Bolton Wanderers,Sunderland,0-0,0,0,1,1,0,0,D
2009-05-09,2008,Everton,Tottenham Hotspur,0-0,0,0,1,1,0,0,D
2009-05-09,2008,Fulham,Aston Villa,3-1,3,1,1,1,4,2,H
2009-05-09,2008,Hull City,Stoke City,1-2,1,2,1,1,3,-1,A
2009-05-09,2008,West Bromwich Albion,Wigan Athletic,3-1,3,1,1,1,4,2,H
2009-05-09,2008,West Ham United,Liverpool,0-3,0,3,1,1,3,-3,A
2009-05-10,2008,Arsenal,Chelsea,1-4,1,4,1,1,5,-3,A
2009-05-10,2008,Manchester United,Manchester City,2-0,2,0,1,1,2,2,H
2009-05-11,2008,Newcastle United,Middlesbrough,3-1,3,1,1,1,4,2,H
2009-05-13,2008,Wigan Athletic,Manchester United,1-2,1,2,1,1,3,-1,A
2009-05-16,2008,Bolton Wanderers,Hull City,1-1,1,1,1,1,2,0,D
2009-05-16,2008,Everton,West Ham United,3-1,3,1,1,1,4,2,H
2009-05-16,2008,Manchester United,Arsenal,0-0,0,0,1,1,0,0,D
2009-05-16,2008,Middlesbrough,Aston Villa,1-1,1,1,1,1,2,0,D
2009-05-16,2008,Newcastle United,Fulham,0-1,0,1,1,1,1,-1,A
2009-05-16,2008,Stoke City,Wigan Athletic,2-0,2,0,1,1,2,2,H
2009-05-16,2008,Tottenham Hotspur,Manchester City,2-1,2,1,1,1,3,1,H
2009-05-17,2008,Chelsea,Blackburn Rovers,2-0,2,0,1,1,2,2,H
2009-05-17,2008,West Bromwich Albion,Liverpool,0-2,0,2,1,1,2,-2,A
2009-05-18,2008,Portsmouth,Sunderland,3-1,3,1,1,1,4,2,H
2009-05-24,2008,Arsenal,Stoke City,4-1,4,1,1,1,5,3,H
2009-05-24,2008,Aston Villa,Newcastle United,1-0,1,0,1,1,1,1,H
2009-05-24,2008,Blackburn Rovers,West Bromwich Albion,0-0,0,0,1,1,0,0,D
2009-05-24,2008,Fulham,Everton,0-2,0,2,1,1,2,-2,A
2009-05-24,2008,Hull City,Manchester United,0-1,0,1,1,1,1,-1,A
2009-05-24,2008,Liverpool,Tottenham Hotspur,3-1,3,1,1,1,4,2,H
2009-05-24,2008,Manchester City,Bolton Wanderers,1-0,1,0,1,1,1,1,H
2009-05-24,2008,Sunderland,Chelsea,2-3,2,3,1,1,5,-1,A
2009-05-24,2008,West Ham United,Middlesbrough,2-1,2,1,1,1,3,1,H
2009-05-24,2008,Wigan Athletic,Portsmouth,1-0,1,0,1,1,1,1,H
2009-08-15,2009,Aston Villa,Wigan Athletic,0-2,0,2,1,1,2,-2,A
2009-08-15,2009,Blackburn Rovers,Manchester City,0-2,0,2,1,1,2,-2,A
2009-08-15,2009,Bolton Wanderers,Sunderland,0-1,0,1,1,1,1,-1,A
2009-08-15,2009,Chelsea,Hull City,2-1,2,1,1,1,3,1,H
2009-08-15,2009,Everton,Arsenal,1-6,1,6,1,1,7,-5,A
2009-08-15,2009,Portsmouth,Fulham,0-1,0,1,1,1,1,-1,A
2009-08-15,2009,Stoke City,Burnley,2-0,2,0,1,1,2,2,H
2009-08-15,2009,Wolverhampton Wanderers,West Ham United,0-2,0,2,1,1,2,-2,A
2009-08-16,2009,Manchester United,Birmingham City,1-0,1,0,1,1,1,1,H
2009-08-16,2009,Tottenham Hotspur,Liverpool,2-1,2,1,1,1,3,1,H
2009-08-18,2009,Sunderland,Chelsea,1-3,1,3,1,1,4,-2,A
2009-08-18,2009,Wigan Athletic,Wolverhampton Wanderers,0-1,0,1,1,1,1,-1,A
2009-08-19,2009,Birmingham City,Portsmouth,1-0,1,0,1,1,1,1,H
2009-08-19,2009,Burnley,Manchester United,1-0,1,0,1,1,1,1,H
2009-08-19,2009,Hull City,Tottenham Hotspur,1-5,1,5,1,1,6,-4,A
2009-08-19,2009,Liverpool,Stoke City,4-0,4,0,1,1,4,4,H
2009-08-22,2009,Arsenal,Portsmouth,4-1,4,1,1,1,5,3,H
2009-08-22,2009,Birmingham City,Stoke City,0-0,0,0,1,1,0,0,D
2009-08-22,2009,Hull City,Bolton Wanderers,1-0,1,0,1,1,1,1,H
2009-08-22,2009,Manchester City,Wolverhampton Wanderers,1-0,1,0,1,1,1,1,H
2009-08-22,2009,Sunderland,Blackburn Rovers,2-1,2,1,1,1,3,1,H
2009-08-22,2009,Wigan Athletic,Manchester United,0-5,0,5,1,1,5,-5,A
2009-08-23,2009,Burnley,Everton,1-0,1,0,1,1,1,1,H
2009-08-23,2009,Fulham,Chelsea,0-2,0,2,1,1,2,-2,A
2009-08-23,2009,West Ham United,Tottenham Hotspur,1-2,1,2,1,1,3,-1,A
2009-08-24,2009,Liverpool,Aston Villa,1-3,1,3,1,1,4,-2,A
2009-08-29,2009,Blackburn Rovers,West Ham United,0-0,0,0,1,1,0,0,D
2009-08-29,2009,Bolton Wanderers,Liverpool,2-3,2,3,1,1,5,-1,A
2009-08-29,2009,Chelsea,Burnley,3-0,3,0,1,1,3,3,H
2009-08-29,2009,Manchester United,Arsenal,2-1,2,1,1,1,3,1,H
2009-08-29,2009,Stoke City,Sunderland,1-0,1,0,1,1,1,1,H
2009-08-29,2009,Tottenham Hotspur,Birmingham City,2-1,2,1,1,1,3,1,H
2009-08-29,2009,Wolverhampton Wanderers,Hull City,1-1,1,1,1,1,2,0,D
2009-08-30,2009,Aston Villa,Fulham,2-0,2,0,1,1,2,2,H
2009-08-30,2009,Everton,Wigan Athletic,2-1,2,1,1,1,3,1,H
2009-08-30,2009,Portsmouth,Manchester City,0-1,0,1,1,1,1,-1,A
2009-09-12,2009,Blackburn Rovers,Wolverhampton Wanderers,3-1,3,1,1,1,4,2,H
2009-09-12,2009,Liverpool,Burnley,4-0,4,0,1,1,4,4,H
2009-09-12,2009,Manchester City,Arsenal,4-2,4,2,1,1,6,2,H
2009-09-12,2009,Portsmouth,Bolton Wanderers,2-3,2,3,1,1,5,-1,A
2009-09-12,2009,Stoke City,Chelsea,1-2,1,2,1,1,3,-1,A
2009-09-12,2009,Sunderland,Hull City,4-1,4,1,1,1,5,3,H
2009-09-12,2009,Tottenham Hotspur,Manchester United,1-3,1,3,1,1,4,-2,A
2009-09-12,2009,Wigan Athletic,West Ham United,1-0,1,0,1,1,1,1,H
2009-09-13,2009,Birmingham City,Aston Villa,0-1,0,1,1,1,1,-1,A
2009-09-13,2009,Fulham,Everton,2-1,2,1,1,1,3,1,H
2009-09-19,2009,Arsenal,Wigan Athletic,4-0,4,0,1,1,4,4,H
2009-09-19,2009,Aston Villa,Portsmouth,2-0,2,0,1,1,2,2,H
2009-09-19,2009,Bolton Wanderers,Stoke City,1-1,1,1,1,1,2,0,D
2009-09-19,2009,Burnley,Sunderland,3-1,3,1,1,1,4,2,H
2009-09-19,2009,Hull City,Birmingham City,0-1,0,1,1,1,1,-1,A
2009-09-19,2009,West Ham United,Liverpool,2-3,2,3,1,1,5,-1,A
2009-09-20,2009,Chelsea,Tottenham Hotspur,3-0,3,0,1,1,3,3,H
2009-09-20,2009,Everton,Blackburn Rovers,3-0,3,0,1,1,3,3,H
2009-09-20,2009,Manchester United,Manchester City,4-3,4,3,1,1,7,1,H
2009-09-20,2009,Wolverhampton Wanderers,Fulham,2-1,2,1,1,1,3,1,H
2009-09-26,2009,Birmingham City,Bolton Wanderers,1-2,1,2,1,1,3,-1,A
2009-09-26,2009,Blackburn Rovers,Aston Villa,2-1,2,1,1,1,3,1,H
2009-09-26,2009,Fulham,Arsenal,0-1,0,1,1,1,1,-1,A
2009-09-26,2009,Liverpool,Hull City,6-1,6,1,1,1,7,5,H
2009-09-26,2009,Portsmouth,Everton,0-1,0,1,1,1,1,-1,A
2009-09-26,2009,Stoke City,Manchester United,0-2,0,2,1,1,2,-2,A
2009-09-26,2009,Tottenham Hotspur,Burnley,5-0,5,0,1,1,5,5,H
2009-09-26,2009,Wigan Athletic,Chelsea,3-1,3,1,1,1,4,2,H
2009-09-27,2009,Sunderland,Wolverhampton Wanderers,5-2,5,2,1,1,7,3,H
2009-09-28,2009,Manchester City,West Ham United,3-1,3,1,1,1,4,2,H
2009-10-03,2009,Bolton Wanderers,Tottenham Hotspur,2-2,2,2,1,1,4,0,D
2009-10-03,2009,Burnley,Birmingham City,2-1,2,1,1,1,3,1,H
2009-10-03,2009,Hull City,Wigan Athletic,2-1,2,1,1,1,3,1,H
2009-10-03,2009,Manchester United,Sunderland,2-2,2,2,1,1,4,0,D
2009-10-03,2009,Wolverhampton Wanderers,Portsmouth,0-1,0,1,1,1,1,-1,A
2009-10-04,2009,Arsenal,Blackburn Rovers,6-2,6,2,1,1,8,4,H
2009-10-04,2009,Chelsea,Liverpool,2-0,2,0,1,1,2,2,H
2009-10-04,2009,Everton,Stoke City,1-1,1,1,1,1,2,0,D
2009-10-04,2009,West Ham United,Fulham,2-2,2,2,1,1,4,0,D
2009-10-05,2009,Aston Villa,Manchester City,1-1,1,1,1,1,2,0,D
2009-10-17,2009,Arsenal,Birmingham City,3-1,3,1,1,1,4,2,H
2009-10-17,2009,Aston Villa,Chelsea,2-1,2,1,1,1,3,1,H
2009-10-17,2009,Everton,Wolverhampton Wanderers,1-1,1,1,1,1,2,0,D
2009-10-17,2009,Manchester United,Bolton Wanderers,2-1,2,1,1,1,3,1,H
2009-10-17,2009,Portsmouth,Tottenham Hotspur,1-2,1,2,1,1,3,-1,A
2009-10-17,2009,Stoke City,West Ham United,2-1,2,1,1,1,3,1,H
2009-10-17,2009,Sunderland,Liverpool,1-0,1,0,1,1,1,1,H
2009-10-18,2009,Blackburn Rovers,Burnley,3-2,3,2,1,1,5,1,H
2009-10-18,2009,Wigan Athletic,Manchester City,1-1,1,1,1,1,2,0,D
2009-10-19,2009,Fulham,Hull City,2-0,2,0,1,1,2,2,H
2009-10-24,2009,Birmingham City,Sunderland,2-1,2,1,1,1,3,1,H
2009-10-24,2009,Burnley,Wigan Athletic,1-3,1,3,1,1,4,-2,A
2009-10-24,2009,Chelsea,Blackburn Rovers,5-0,5,0,1,1,5,5,H
2009-10-24,2009,Hull City,Portsmouth,0-0,0,0,1,1,0,0,D
2009-10-24,2009,Tottenham Hotspur,Stoke City,0-1,0,1,1,1,1,-1,A
2009-10-24,2009,Wolverhampton Wanderers,Aston Villa,1-1,1,1,1,1,2,0,D
2009-10-25,2009,Bolton Wanderers,Everton,3-2,3,2,1,1,5,1,H
2009-10-25,2009,Liverpool,Manchester United,2-0,2,0,1,1,2,2,H
2009-10-25,2009,Manchester City,Fulham,2-2,2,2,1,1,4,0,D
2009-10-25,2009,West Ham United,Arsenal,2-2,2,2,1,1,4,0,D
2009-10-31,2009,Arsenal,Tottenham Hotspur,3-0,3,0,1,1,3,3,H
2009-10-31,2009,Bolton Wanderers,Chelsea,0-4,0,4,1,1,4,-4,A
2009-10-31,2009,Burnley,Hull City,2-0,2,0,1,1,2,2,H
2009-10-31,2009,Everton,Aston Villa,1-1,1,1,1,1,2,0,D
2009-10-31,2009,Fulham,Liverpool,3-1,3,1,1,1,4,2,H
2009-10-31,2009,Manchester United,Blackburn Rovers,2-0,2,0,1,1,2,2,H
2009-10-31,2009,Portsmouth,Wigan Athletic,4-0,4,0,1,1,4,4,H
2009-10-31,2009,Stoke City,Wolverhampton Wanderers,2-2,2,2,1,1,4,0,D
2009-10-31,2009,Sunderland,West Ham United,2-2,2,2,1,1,4,0,D
2009-11-01,2009,Birmingham City,Manchester City,0-0,0,0,1,1,0,0,D
2009-11-04,2009,West Ham United,Aston Villa,2-1,2,1,1,1,3,1,H
2009-11-07,2009,Aston Villa,Bolton Wanderers,5-1,5,1,1,1,6,4,H
2009-11-07,2009,Blackburn Rovers,Portsmouth,3-1,3,1,1,1,4,2,H
2009-11-07,2009,Manchester City,Burnley,3-3,3,3,1,1,6,0,D
2009-11-07,2009,Tottenham Hotspur,Sunderland,2-0,2,0,1,1,2,2,H
2009-11-07,2009,Wolverhampton Wanderers,Arsenal,1-4,1,4,1,1,5,-3,A
2009-11-08,2009,Chelsea,Manchester United,1-0,1,0,1,1,1,1,H
2009-11-08,2009,Hull City,Stoke City,2-1,2,1,1,1,3,1,H
2009-11-08,2009,West Ham United,Everton,1-2,1,2,1,1,3,-1,A
2009-11-08,2009,Wigan Athletic,Fulham,1-1,1,1,1,1,2,0,D
2009-11-09,2009,Liverpool,Birmingham City,2-2,2,2,1,1,4,0,D
2009-11-21,2009,Birmingham City,Fulham,1-0,1,0,1,1,1,1,H
2009-11-21,2009,Burnley,Aston Villa,1-1,1,1,1,1,2,0,D
2009-11-21,2009,Chelsea,Wolverhampton Wanderers,4-0,4,0,1,1,4,4,H
2009-11-21,2009,Hull City,West Ham United,3-3,3,3,1,1,6,0,D
2009-11-21,2009,Liverpool,Manchester City,2-2,2,2,1,1,4,0,D
2009-11-21,2009,Manchester United,Everton,3-0,3,0,1,1,3,3,H
2009-11-21,2009,Sunderland,Arsenal,1-0,1,0,1,1,1,1,H
2009-11-22,2009,Bolton Wanderers,Blackburn Rovers,0-2,0,2,1,1,2,-2,A
2009-11-22,2009,Stoke City,Portsmouth,1-0,1,0,1,1,1,1,H
2009-11-22,2009,Tottenham Hotspur,Wigan Athletic,9-1,9,1,1,1,10,8,H
2009-11-25,2009,Fulham,Blackburn Rovers,3-0,3,0,1,1,3,3,H
2009-11-25,2009,Hull City,Everton,3-2,3,2,1,1,5,1,H
2009-11-28,2009,Aston Villa,Tottenham Hotspur,1-1,1,1,1,1,2,0,D
2009-11-28,2009,Blackburn Rovers,Stoke City,0-0,0,0,1,1,0,0,D
2009-11-28,2009,Fulham,Bolton Wanderers,1-1,1,1,1,1,2,0,D
2009-11-28,2009,Manchester City,Hull City,1-1,1,1,1,1,2,0,D
2009-11-28,2009,Portsmouth,Manchester United,1-4,1,4,1,1,5,-3,A
2009-11-28,2009,West Ham United,Burnley,5-3,5,3,1,1,8,2,H
2009-11-28,2009,Wigan Athletic,Sunderland,1-0,1,0,1,1,1,1,H
2009-11-29,2009,Arsenal,Chelsea,0-3,0,3,1,1,3,-3,A
2009-11-29,2009,Everton,Liverpool,0-2,0,2,1,1,2,-2,A
2009-11-29,2009,Wolverhampton Wanderers,Birmingham City,0-1,0,1,1,1,1,-1,A
2009-12-05,2009,Arsenal,Stoke City,2-0,2,0,1,1,2,2,H
2009-12-05,2009,Aston Villa,Hull City,3-0,3,0,1,1,3,3,H
2009-12-05,2009,Blackburn Rovers,Liverpool,0-0,0,0,1,1,0,0,D
2009-12-05,2009,Manchester City,Chelsea,2-1,2,1,1,1,3,1,H
2009-12-05,2009,Portsmouth,Burnley,2-0,2,0,1,1,2,2,H
2009-12-05,2009,West Ham United,Manchester United,0-4,0,4,1,1,4,-4,A
2009-12-05,2009,Wigan Athletic,Birmingham City,2-3,2,3,1,1,5,-1,A
2009-12-05,2009,Wolverhampton Wanderers,Bolton Wanderers,2-1,2,1,1,1,3,1,H
2009-12-06,2009,Everton,Tottenham Hotspur,2-2,2,2,1,1,4,0,D
2009-12-06,2009,Fulham,Sunderland,1-0,1,0,1,1,1,1,H
2009-12-12,2009,Birmingham City,West Ham United,1-0,1,0,1,1,1,1,H
2009-12-12,2009,Bolton Wanderers,Manchester City,3-3,3,3,1,1,6,0,D
2009-12-12,2009,Burnley,Fulham,1-1,1,1,1,1,2,0,D
2009-12-12,2009,Chelsea,Everton,3-3,3,3,1,1,6,0,D
2009-12-12,2009,Hull City,Blackburn Rovers,0-0,0,0,1,1,0,0,D
2009-12-12,2009,Manchester United,Aston Villa,0-1,0,1,1,1,1,-1,A
2009-12-12,2009,Stoke City,Wigan Athletic,2-2,2,2,1,1,4,0,D
2009-12-12,2009,Sunderland,Portsmouth,1-1,1,1,1,1,2,0,D
2009-12-12,2009,Tottenham Hotspur,Wolverhampton Wanderers,0-1,0,1,1,1,1,-1,A
2009-12-13,2009,Liverpool,Arsenal,1-2,1,2,1,1,3,-1,A
2009-12-15,2009,Birmingham City,Blackburn Rovers,2-1,2,1,1,1,3,1,H
2009-12-15,2009,Bolton Wanderers,West Ham United,3-1,3,1,1,1,4,2,H
2009-12-15,2009,Manchester United,Wolverhampton Wanderers,3-0,3,0,1,1,3,3,H
2009-12-15,2009,Sunderland,Aston Villa,0-2,0,2,1,1,2,-2,A
2009-12-16,2009,Burnley,Arsenal,1-1,1,1,1,1,2,0,D
2009-12-16,2009,Chelsea,Portsmouth,2-1,2,1,1,1,3,1,H
2009-12-16,2009,Liverpool,Wigan Athletic,2-1,2,1,1,1,3,1,H
2009-12-16,2009,Tottenham Hotspur,Manchester City,3-0,3,0,1,1,3,3,H
2009-12-19,2009,Arsenal,Hull City,3-0,3,0,1,1,3,3,H
2009-12-19,2009,Aston Villa,Stoke City,1-0,1,0,1,1,1,1,H
2009-12-19,2009,Blackburn Rovers,Tottenham Hotspur,0-2,0,2,1,1,2,-2,A
2009-12-19,2009,Fulham,Manchester United,3-0,3,0,1,1,3,3,H
2009-12-19,2009,Manchester City,Sunderland,4-3,4,3,1,1,7,1,H
2009-12-19,2009,Portsmouth,Liverpool,2-0,2,0,1,1,2,2,H
2009-12-20,2009,Everton,Birmingham City,1-1,1,1,1,1,2,0,D
2009-12-20,2009,West Ham United,Chelsea,1-1,1,1,1,1,2,0,D
2009-12-20,2009,Wolverhampton Wanderers,Burnley,2-0,2,0,1,1,2,2,H
2009-12-26,2009,Birmingham City,Chelsea,0-0,0,0,1,1,0,0,D
2009-12-26,2009,Burnley,Bolton Wanderers,1-1,1,1,1,1,2,0,D
2009-12-26,2009,Fulham,Tottenham Hotspur,0-0,0,0,1,1,0,0,D
2009-12-26,2009,Liverpool,Wolverhampton Wanderers,2-0,2,0,1,1,2,2,H
2009-12-26,2009,Manchester City,Stoke City,2-0,2,0,1,1,2,2,H
2009-12-26,2009,Sunderland,Everton,1-1,1,1,1,1,2,0,D
2009-12-26,2009,West Ham United,Portsmouth,2-0,2,0,1,1,2,2,H
2009-12-26,2009,Wigan Athletic,Blackburn Rovers,1-1,1,1,1,1,2,0,D
2009-12-27,2009,Arsenal,Aston Villa,3-0,3,0,1,1,3,3,H
2009-12-27,2009,Hull City,Manchester United,1-3,1,3,1,1,4,-2,A
2009-12-28,2009,Blackburn Rovers,Sunderland,2-2,2,2,1,1,4,0,D
2009-12-28,2009,Chelsea,Fulham,2-1,2,1,1,1,3,1,H
2009-12-28,2009,Everton,Burnley,2-0,2,0,1,1,2,2,H
2009-12-28,2009,Stoke City,Birmingham City,0-1,0,1,1,1,1,-1,A
2009-12-28,2009,Tottenham Hotspur,West Ham United,2-0,2,0,1,1,2,2,H
2009-12-28,2009,Wolverhampton Wanderers,Manchester City,0-3,0,3,1,1,3,-3,A
2009-12-29,2009,Aston Villa,Liverpool,0-1,0,1,1,1,1,-1,A
2009-12-29,2009,Bolton Wanderers,Hull City,2-2,2,2,1,1,4,0,D
2009-12-30,2009,Manchester United,Wigan Athletic,5-0,5,0,1,1,5,5,H
2009-12-30,2009,Portsmouth,Arsenal,1-4,1,4,1,1,5,-3,A
2010-01-05,2009,Stoke City,Fulham,3-2,3,2,1,1,5,1,H
2010-01-09,2009,Arsenal,Everton,2-2,2,2,1,1,4,0,D
2010-01-09,2009,Birmingham City,Manchester United,1-1,1,1,1,1,2,0,D
2010-01-11,2009,Manchester City,Blackburn Rovers,4-1,4,1,1,1,5,3,H
2010-01-16,2009,Chelsea,Sunderland,7-2,7,2,1,1,9,5,H
2010-01-16,2009,Everton,Manchester City,2-0,2,0,1,1,2,2,H
2010-01-16,2009,Manchester United,Burnley,3-0,3,0,1,1,3,3,H
2010-01-16,2009,Stoke City,Liverpool,1-1,1,1,1,1,2,0,D
2010-01-16,2009,Tottenham Hotspur,Hull City,0-0,0,0,1,1,0,0,D
2010-01-16,2009,Wolverhampton Wanderers,Wigan Athletic,0-2,0,2,1,1,2,-2,A
2010-01-17,2009,Aston Villa,West Ham United,0-0,0,0,1,1,0,0,D
2010-01-17,2009,Blackburn Rovers,Fulham,2-0,2,0,1,1,2,2,H
2010-01-17,2009,Bolton Wanderers,Arsenal,0-2,0,2,1,1,2,-2,A
2010-01-20,2009,Arsenal,Bolton Wanderers,4-2,4,2,1,1,6,2,H
2010-01-20,2009,Liverpool,Tottenham Hotspur,2-0,2,0,1,1,2,2,H
2010-01-23,2009,Manchester United,Hull City,4-0,4,0,1,1,4,4,H
2010-01-26,2009,Bolton Wanderers,Burnley,1-0,1,0,1,1,1,1,H
2010-01-26,2009,Portsmouth,West Ham United,1-1,1,1,1,1,2,0,D
2010-01-26,2009,Tottenham Hotspur,Fulham,2-0,2,0,1,1,2,2,H
2010-01-26,2009,Wolverhampton Wanderers,Liverpool,0-0,0,0,1,1,0,0,D
2010-01-27,2009,Aston Villa,Arsenal,0-0,0,0,1,1,0,0,D
2010-01-27,2009,Blackburn Rovers,Wigan Athletic,2-1,2,1,1,1,3,1,H
2010-01-27,2009,Chelsea,Birmingham City,3-0,3,0,1,1,3,3,H
2010-01-27,2009,Everton,Sunderland,2-0,2,0,1,1,2,2,H
2010-01-30,2009,Birmingham City,Tottenham Hotspur,1-1,1,1,1,1,2,0,D
2010-01-30,2009,Burnley,Chelsea,1-2,1,2,1,1,3,-1,A
2010-01-30,2009,Fulham,Aston Villa,0-2,0,2,1,1,2,-2,A
2010-01-30,2009,Hull City,Wolverhampton Wanderers,2-2,2,2,1,1,4,0,D
2010-01-30,2009,Liverpool,Bolton Wanderers,2-0,2,0,1,1,2,2,H
2010-01-30,2009,West Ham United,Blackburn Rovers,0-0,0,0,1,1,0,0,D
2010-01-30,2009,Wigan Athletic,Everton,0-1,0,1,1,1,1,-1,A
2010-01-31,2009,Arsenal,Manchester United,1-3,1,3,1,1,4,-2,A
2010-01-31,2009,Manchester City,Portsmouth,2-0,2,0,1,1,2,2,H
2010-02-01,2009,Sunderland,Stoke City,0-0,0,0,1,1,0,0,D
2010-02-02,2009,Hull City,Chelsea,1-1,1,1,1,1,2,0,D
2010-02-03,2009,Fulham,Portsmouth,1-0,1,0,1,1,1,1,H
2010-02-06,2009,Bolton Wanderers,Fulham,0-0,0,0,1,1,0,0,D
2010-02-06,2009,Burnley,West Ham United,2-1,2,1,1,1,3,1,H
2010-02-06,2009,Hull City,Manchester City,2-1,2,1,1,1,3,1,H
2010-02-06,2009,Liverpool,Everton,1-0,1,0,1,1,1,1,H
2010-02-06,2009,Manchester United,Portsmouth,5-0,5,0,1,1,5,5,H
2010-02-06,2009,Stoke City,Blackburn Rovers,3-0,3,0,1,1,3,3,H
2010-02-06,2009,Sunderland,Wigan Athletic,1-1,1,1,1,1,2,0,D
2010-02-06,2009,Tottenham Hotspur,Aston Villa,0-0,0,0,1,1,0,0,D
2010-02-07,2009,Birmingham City,Wolverhampton Wanderers,2-1,2,1,1,1,3,1,H
2010-02-07,2009,Chelsea,Arsenal,2-0,2,0,1,1,2,2,H
2010-02-09,2009,Fulham,Burnley,3-0,3,0,1,1,3,3,H
2010-02-09,2009,Manchester City,Bolton Wanderers,2-0,2,0,1,1,2,2,H
2010-02-09,2009,Portsmouth,Sunderland,1-1,1,1,1,1,2,0,D
2010-02-09,2009,Wigan Athletic,Stoke City,1-1,1,1,1,1,2,0,D
2010-02-10,2009,Arsenal,Liverpool,1-0,1,0,1,1,1,1,H
2010-02-10,2009,Aston Villa,Manchester United,1-1,1,1,1,1,2,0,D
2010-02-10,2009,Blackburn Rovers,Hull City,1-0,1,0,1,1,1,1,H
2010-02-10,2009,Everton,Chelsea,2-1,2,1,1,1,3,1,H
2010-02-10,2009,West Ham United,Birmingham City,2-0,2,0,1,1,2,2,H
2010-02-10,2009,Wolverhampton Wanderers,Tottenham Hotspur,1-0,1,0,1,1,1,1,H
2010-02-16,2009,Stoke City,Manchester City,1-1,1,1,1,1,2,0,D
2010-02-17,2009,Wigan Athletic,Bolton Wanderers,0-0,0,0,1,1,0,0,D
2010-02-20,2009,Arsenal,Sunderland,2-0,2,0,1,1,2,2,H
2010-02-20,2009,Everton,Manchester United,3-1,3,1,1,1,4,2,H
2010-02-20,2009,Portsmouth,Stoke City,1-2,1,2,1,1,3,-1,A
2010-02-20,2009,West Ham United,Hull City,3-0,3,0,1,1,3,3,H
2010-02-20,2009,Wolverhampton Wanderers,Chelsea,0-2,0,2,1,1,2,-2,A
2010-02-21,2009,Aston Villa,Burnley,5-2,5,2,1,1,7,3,H
2010-02-21,2009,Blackburn Rovers,Bolton Wanderers,3-0,3,0,1,1,3,3,H
2010-02-21,2009,Fulham,Birmingham City,2-1,2,1,1,1,3,1,H
2010-02-21,2009,Manchester City,Liverpool,0-0,0,0,1,1,0,0,D
2010-02-21,2009,Wigan Athletic,Tottenham Hotspur,0-3,0,3,1,1,3,-3,A
2010-02-23,2009,Manchester United,West Ham United,3-0,3,0,1,1,3,3,H
2010-02-27,2009,Birmingham City,Wigan Athletic,1-0,1,0,1,1,1,1,H
2010-02-27,2009,Bolton Wanderers,Wolverhampton Wanderers,1-0,1,0,1,1,1,1,H
2010-02-27,2009,Burnley,Portsmouth,1-2,1,2,1,1,3,-1,A
2010-02-27,2009,Chelsea,Manchester City,2-4,2,4,1,1,6,-2,A
2010-02-27,2009,Stoke City,Arsenal,1-3,1,3,1,1,4,-2,A
2010-02-28,2009,Liverpool,Blackburn Rovers,2-1,2,1,1,1,3,1,H
2010-02-28,2009,Sunderland,Fulham,0-0,0,0,1,1,0,0,D
2010-02-28,2009,Tottenham Hotspur,Everton,2-1,2,1,1,1,3,1,H
2010-03-06,2009,Arsenal,Burnley,3-1,3,1,1,1,4,2,H
2010-03-06,2009,West Ham United,Bolton Wanderers,1-2,1,2,1,1,3,-1,A
2010-03-06,2009,Wolverhampton Wanderers,Manchester United,0-1,0,1,1,1,1,-1,A
2010-03-07,2009,Everton,Hull City,5-1,5,1,1,1,6,4,H
2010-03-08,2009,Wigan Athletic,Liverpool,1-0,1,0,1,1,1,1,H
2010-03-09,2009,Portsmouth,Birmingham City,1-2,1,2,1,1,3,-1,A
2010-03-09,2009,Sunderland,Bolton Wanderers,4-0,4,0,1,1,4,4,H
2010-03-10,2009,Burnley,Stoke City,1-1,1,1,1,1,2,0,D
2010-03-13,2009,Birmingham City,Everton,2-2,2,2,1,1,4,0,D
2010-03-13,2009,Bolton Wanderers,Wigan Athletic,4-0,4,0,1,1,4,4,H
2010-03-13,2009,Burnley,Wolverhampton Wanderers,1-2,1,2,1,1,3,-1,A
2010-03-13,2009,Chelsea,West Ham United,4-1,4,1,1,1,5,3,H
2010-03-13,2009,Hull City,Arsenal,1-2,1,2,1,1,3,-1,A
2010-03-13,2009,Stoke City,Aston Villa,0-0,0,0,1,1,0,0,D
2010-03-13,2009,Tottenham Hotspur,Blackburn Rovers,3-1,3,1,1,1,4,2,H
2010-03-14,2009,Manchester United,Fulham,3-0,3,0,1,1,3,3,H
2010-03-14,2009,Sunderland,Manchester City,1-1,1,1,1,1,2,0,D
2010-03-15,2009,Liverpool,Portsmouth,4-1,4,1,1,1,5,3,H
2010-03-16,2009,Wigan Athletic,Aston Villa,1-2,1,2,1,1,3,-1,A
2010-03-20,2009,Arsenal,West Ham United,2-0,2,0,1,1,2,2,H
2010-03-20,2009,Aston Villa,Wolverhampton Wanderers,2-2,2,2,1,1,4,0,D
2010-03-20,2009,Everton,Bolton Wanderers,2-0,2,0,1,1,2,2,H
2010-03-20,2009,Portsmouth,Hull City,3-2,3,2,1,1,5,1,H
2010-03-20,2009,Stoke City,Tottenham Hotspur,1-2,1,2,1,1,3,-1,A
2010-03-20,2009,Sunderland,Birmingham City,3-1,3,1,1,1,4,2,H
2010-03-20,2009,Wigan Athletic,Burnley,1-0,1,0,1,1,1,1,H
2010-03-21,2009,Blackburn Rovers,Chelsea,1-1,1,1,1,1,2,0,D
2010-03-21,2009,Fulham,Manchester City,1-2,1,2,1,1,3,-1,A
2010-03-21,2009,Manchester United,Liverpool,2-1,2,1,1,1,3,1,H
2010-03-23,2009,West Ham United,Wolverhampton Wanderers,1-3,1,3,1,1,4,-2,A
2010-03-24,2009,Aston Villa,Sunderland,1-1,1,1,1,1,2,0,D
2010-03-24,2009,Blackburn Rovers,Birmingham City,2-1,2,1,1,1,3,1,H
2010-03-24,2009,Manchester City,Everton,0-2,0,2,1,1,2,-2,A
2010-03-24,2009,Portsmouth,Chelsea,0-5,0,5,1,1,5,-5,A
2010-03-27,2009,Birmingham City,Arsenal,1-1,1,1,1,1,2,0,D
2010-03-27,2009,Bolton Wanderers,Manchester United,0-4,0,4,1,1,4,-4,A
2010-03-27,2009,Chelsea,Aston Villa,7-1,7,1,1,1,8,6,H
2010-03-27,2009,Hull City,Fulham,2-0,2,0,1,1,2,2,H
2010-03-27,2009,Tottenham Hotspur,Portsmouth,2-0,2,0,1,1,2,2,H
2010-03-27,2009,West Ham United,Stoke City,0-1,0,1,1,1,1,-1,A
2010-03-27,2009,Wolverhampton Wanderers,Everton,0-0,0,0,1,1,0,0,D
2010-03-28,2009,Burnley,Blackburn Rovers,0-1,0,1,1,1,1,-1,A
2010-03-28,2009,Liverpool,Sunderland,3-0,3,0,1,1,3,3,H
2010-03-29,2009,Manchester City,Wigan Athletic,3-0,3,0,1,1,3,3,H
2010-04-03,2009,Arsenal,Wolverhampton Wanderers,1-0,1,0,1,1,1,1,H
2010-04-03,2009,Bolton Wanderers,Aston Villa,0-1,0,1,1,1,1,-1,A
2010-04-03,2009,Burnley,Manchester City,1-6,1,6,1,1,7,-5,A
2010-04-03,2009,Manchester United,Chelsea,1-2,1,2,1,1,3,-1,A
2010-04-03,2009,Portsmouth,Blackburn Rovers,0-0,0,0,1,1,0,0,D
2010-04-03,2009,Stoke City,Hull City,2-0,2,0,1,1,2,2,H
2010-04-03,2009,Sunderland,Tottenham Hotspur,3-1,3,1,1,1,4,2,H
2010-04-04,2009,Birmingham City,Liverpool,1-1,1,1,1,1,2,0,D
2010-04-04,2009,Everton,West Ham United,2-2,2,2,1,1,4,0,D
2010-04-04,2009,Fulham,Wigan Athletic,2-1,2,1,1,1,3,1,H
2010-04-10,2009,Hull City,Burnley,1-4,1,4,1,1,5,-3,A
2010-04-10,2009,West Ham United,Sunderland,1-0,1,0,1,1,1,1,H
2010-04-11,2009,Blackburn Rovers,Manchester United,0-0,0,0,1,1,0,0,D
2010-04-11,2009,Liverpool,Fulham,0-0,0,0,1,1,0,0,D
2010-04-11,2009,Manchester City,Birmingham City,5-1,5,1,1,1,6,4,H
2010-04-11,2009,Wolverhampton Wanderers,Stoke City,0-0,0,0,1,1,0,0,D
2010-04-13,2009,Chelsea,Bolton Wanderers,1-0,1,0,1,1,1,1,H
2010-04-14,2009,Aston Villa,Everton,2-2,2,2,1,1,4,0,D
2010-04-14,2009,Tottenham Hotspur,Arsenal,2-1,2,1,1,1,3,1,H
2010-04-14,2009,Wigan Athletic,Portsmouth,0-0,0,0,1,1,0,0,D
2010-04-17,2009,Birmingham City,Hull City,0-0,0,0,1,1,0,0,D
2010-04-17,2009,Blackburn Rovers,Everton,2-3,2,3,1,1,5,-1,A
2010-04-17,2009,Fulham,Wolverhampton Wanderers,0-0,0,0,1,1,0,0,D
2010-04-17,2009,Manchester City,Manchester United,0-1,0,1,1,1,1,-1,A
2010-04-17,2009,Stoke City,Bolton Wanderers,1-2,1,2,1,1,3,-1,A
2010-04-17,2009,Sunderland,Burnley,2-1,2,1,1,1,3,1,H
2010-04-17,2009,Tottenham Hotspur,Chelsea,2-1,2,1,1,1,3,1,H
2010-04-18,2009,Portsmouth,Aston Villa,1-2,1,2,1,1,3,-1,A
2010-04-18,2009,Wigan Athletic,Arsenal,3-2,3,2,1,1,5,1,H
2010-04-19,2009,Liverpool,West Ham United,3-0,3,0,1,1,3,3,H
2010-04-21,2009,Hull City,Aston Villa,0-2,0,2,1,1,2,-2,A
2010-04-24,2009,Arsenal,Manchester City,0-0,0,0,1,1,0,0,D
2010-04-24,2009,Bolton Wanderers,Portsmouth,2-2,2,2,1,1,4,0,D
2010-04-24,2009,Hull City,Sunderland,0-1,0,1,1,1,1,-1,A
2010-04-24,2009,Manchester United,Tottenham Hotspur,3-1,3,1,1,1,4,2,H
2010-04-24,2009,West Ham United,Wigan Athletic,3-2,3,2,1,1,5,1,H
2010-04-24,2009,Wolverhampton Wanderers,Blackburn Rovers,1-1,1,1,1,1,2,0,D
2010-04-25,2009,Aston Villa,Birmingham City,1-0,1,0,1,1,1,1,H
2010-04-25,2009,Burnley,Liverpool,0-4,0,4,1,1,4,-4,A
2010-04-25,2009,Chelsea,Stoke City,7-0,7,0,1,1,7,7,H
2010-04-25,2009,Everton,Fulham,2-1,2,1,1,1,3,1,H
2010-05-01,2009,Birmingham City,Burnley,2-1,2,1,1,1,3,1,H
2010-05-01,2009,Manchester City,Aston Villa,3-1,3,1,1,1,4,2,H
2010-05-01,2009,Portsmouth,Wolverhampton Wanderers,3-1,3,1,1,1,4,2,H
2010-05-01,2009,Stoke City,Everton,0-0,0,0,1,1,0,0,D
2010-05-01,2009,Tottenham Hotspur,Bolton Wanderers,1-0,1,0,1,1,1,1,H
2010-05-02,2009,Fulham,West Ham United,3-2,3,2,1,1,5,1,H
2010-05-02,2009,Liverpool,Chelsea,0-2,0,2,1,1,2,-2,A
2010-05-02,2009,Sunderland,Manchester United,0-1,0,1,1,1,1,-1,A
2010-05-03,2009,Blackburn Rovers,Arsenal,2-1,2,1,1,1,3,1,H
2010-05-03,2009,Wigan Athletic,Hull City,2-2,2,2,1,1,4,0,D
2010-05-05,2009,Fulham,Stoke City,0-1,0,1,1,1,1,-1,A
2010-05-05,2009,Manchester City,Tottenham Hotspur,0-1,0,1,1,1,1,-1,A
2010-05-09,2009,Arsenal,Fulham,4-0,4,0,1,1,4,4,H
2010-05-09,2009,Aston Villa,Blackburn Rovers,0-1,0,1,1,1,1,-1,A
2010-05-09,2009,Bolton Wanderers,Birmingham City,2-1,2,1,1,1,3,1,H
2010-05-09,2009,Burnley,Tottenham Hotspur,4-2,4,2,1,1,6,2,H
2010-05-09,2009,Chelsea,Wigan Athletic,8-0,8,0,1,1,8,8,H
2010-05-09,2009,Everton,Portsmouth,1-0,1,0,1,1,1,1,H
2010-05-09,2009,Hull City,Liverpool,0-0,0,0,1,1,0,0,D
2010-05-09,2009,Manchester United,Stoke City,4-0,4,0,1,1,4,4,H
2010-05-09,2009,West Ham United,Manchester City,1-1,1,1,1,1,2,0,D
2010-05-09,2009,Wolverhampton Wanderers,Sunderland,2-1,2,1,1,1,3,1,H
2010-08-14,2010,Aston Villa,West Ham United,3-0,3,0,1,1,3,3,H
2010-08-14,2010,Blackburn Rovers,Everton,1-0,1,0,1,1,1,1,H
2010-08-14,2010,Bolton Wanderers,Fulham,0-0,0,0,1,1,0,0,D
2010-08-14,2010,Chelsea,West Bromwich Albion,6-0,6,0,1,1,6,6,H
2010-08-14,2010,Sunderland,Birmingham City,2-2,2,2,1,1,4,0,D
2010-08-14,2010,Tottenham Hotspur,Manchester City,0-0,0,0,1,1,0,0,D
2010-08-14,2010,Wigan Athletic,Blackpool,0-4,0,4,1,1,4,-4,A
2010-08-14,2010,Wolverhampton Wanderers,Stoke City,2-1,2,1,1,1,3,1,H
2010-08-15,2010,Liverpool,Arsenal,1-1,1,1,1,1,2,0,D
2010-08-16,2010,Manchester United,Newcastle United,3-0,3,0,1,1,3,3,H
2010-08-21,2010,Arsenal,Blackpool,6-0,6,0,1,1,6,6,H
2010-08-21,2010,Birmingham City,Blackburn Rovers,2-1,2,1,1,1,3,1,H
2010-08-21,2010,Everton,Wolverhampton Wanderers,1-1,1,1,1,1,2,0,D
2010-08-21,2010,Stoke City,Tottenham Hotspur,1-2,1,2,1,1,3,-1,A
2010-08-21,2010,West Bromwich Albion,Sunderland,1-0,1,0,1,1,1,1,H
2010-08-21,2010,West Ham United,Bolton Wanderers,1-3,1,3,1,1,4,-2,A
2010-08-21,2010,Wigan Athletic,Chelsea,0-6,0,6,1,1,6,-6,A
2010-08-22,2010,Fulham,Manchester United,2-2,2,2,1,1,4,0,D
2010-08-22,2010,Newcastle United,Aston Villa,6-0,6,0,1,1,6,6,H
2010-08-23,2010,Manchester City,Liverpool,3-0,3,0,1,1,3,3,H
2010-08-28,2010,Blackburn Rovers,Arsenal,1-2,1,2,1,1,3,-1,A
2010-08-28,2010,Blackpool,Fulham,2-2,2,2,1,1,4,0,D
2010-08-28,2010,Chelsea,Stoke City,2-0,2,0,1,1,2,2,H
2010-08-28,2010,Manchester United,West Ham United,3-0,3,0,1,1,3,3,H
2010-08-28,2010,Tottenham Hotspur,Wigan Athletic,0-1,0,1,1,1,1,-1,A
2010-08-28,2010,Wolverhampton Wanderers,Newcastle United,1-1,1,1,1,1,2,0,D
2010-08-29,2010,Aston Villa,Everton,1-0,1,0,1,1,1,1,H
2010-08-29,2010,Bolton Wanderers,Birmingham City,2-2,2,2,1,1,4,0,D
2010-08-29,2010,Liverpool,West Bromwich Albion,1-0,1,0,1,1,1,1,H
2010-08-29,2010,Sunderland,Manchester City,1-0,1,0,1,1,1,1,H
2010-09-11,2010,Arsenal,Bolton Wanderers,4-1,4,1,1,1,5,3,H
2010-09-11,2010,Everton,Manchester United,3-3,3,3,1,1,6,0,D
2010-09-11,2010,Fulham,Wolverhampton Wanderers,2-1,2,1,1,1,3,1,H
2010-09-11,2010,Manchester City,Blackburn Rovers,1-1,1,1,1,1,2,0,D
2010-09-11,2010,Newcastle United,Blackpool,0-2,0,2,1,1,2,-2,A
2010-09-11,2010,West Bromwich Albion,Tottenham Hotspur,1-1,1,1,1,1,2,0,D
2010-09-11,2010,West Ham United,Chelsea,1-3,1,3,1,1,4,-2,A
2010-09-11,2010,Wigan Athletic,Sunderland,1-1,1,1,1,1,2,0,D
2010-09-12,2010,Birmingham City,Liverpool,0-0,0,0,1,1,0,0,D
2010-09-13,2010,Stoke City,Aston Villa,2-1,2,1,1,1,3,1,H
2010-09-18,2010,Aston Villa,Bolton Wanderers,1-1,1,1,1,1,2,0,D
2010-09-18,2010,Blackburn Rovers,Fulham,1-1,1,1,1,1,2,0,D
2010-09-18,2010,Everton,Newcastle United,0-1,0,1,1,1,1,-1,A
2010-09-18,2010,Stoke City,West Ham United,1-1,1,1,1,1,2,0,D
2010-09-18,2010,Sunderland,Arsenal,1-1,1,1,1,1,2,0,D
2010-09-18,2010,Tottenham Hotspur,Wolverhampton Wanderers,3-1,3,1,1,1,4,2,H
2010-09-18,2010,West Bromwich Albion,Birmingham City,3-1,3,1,1,1,4,2,H
2010-09-19,2010,Chelsea,Blackpool,4-0,4,0,1,1,4,4,H
2010-09-19,2010,Manchester United,Liverpool,3-2,3,2,1,1,5,1,H
2010-09-19,2010,Wigan Athletic,Manchester City,0-2,0,2,1,1,2,-2,A
2010-09-25,2010,Arsenal,West Bromwich Albion,2-3,2,3,1,1,5,-1,A
2010-09-25,2010,Birmingham City,Wigan Athletic,0-0,0,0,1,1,0,0,D
2010-09-25,2010,Blackpool,Blackburn Rovers,1-2,1,2,1,1,3,-1,A
2010-09-25,2010,Fulham,Everton,0-0,0,0,1,1,0,0,D
2010-09-25,2010,Liverpool,Sunderland,2-2,2,2,1,1,4,0,D
2010-09-25,2010,Manchester City,Chelsea,1-0,1,0,1,1,1,1,H
2010-09-25,2010,West Ham United,Tottenham Hotspur,1-0,1,0,1,1,1,1,H
2010-09-26,2010,Bolton Wanderers,Manchester United,2-2,2,2,1,1,4,0,D
2010-09-26,2010,Newcastle United,Stoke City,1-2,1,2,1,1,3,-1,A
2010-09-26,2010,Wolverhampton Wanderers,Aston Villa,1-2,1,2,1,1,3,-1,A
2010-10-02,2010,Birmingham City,Everton,0-2,0,2,1,1,2,-2,A
2010-10-02,2010,Stoke City,Blackburn Rovers,1-0,1,0,1,1,1,1,H
2010-10-02,2010,Sunderland,Manchester United,0-0,0,0,1,1,0,0,D
2010-10-02,2010,Tottenham Hotspur,Aston Villa,2-1,2,1,1,1,3,1,H
2010-10-02,2010,West Bromwich Albion,Bolton Wanderers,1-1,1,1,1,1,2,0,D
2010-10-02,2010,West Ham United,Fulham,1-1,1,1,1,1,2,0,D
2010-10-02,2010,Wigan Athletic,Wolverhampton Wanderers,2-0,2,0,1,1,2,2,H
2010-10-03,2010,Chelsea,Arsenal,2-0,2,0,1,1,2,2,H
2010-10-03,2010,Liverpool,Blackpool,1-2,1,2,1,1,3,-1,A
2010-10-03,2010,Manchester City,Newcastle United,2-1,2,1,1,1,3,1,H
2010-10-16,2010,Arsenal,Birmingham City,2-1,2,1,1,1,3,1,H
2010-10-16,2010,Aston Villa,Chelsea,0-0,0,0,1,1,0,0,D
2010-10-16,2010,Bolton Wanderers,Stoke City,2-1,2,1,1,1,3,1,H
2010-10-16,2010,Fulham,Tottenham Hotspur,1-2,1,2,1,1,3,-1,A
2010-10-16,2010,Manchester United,West Bromwich Albion,2-2,2,2,1,1,4,0,D
2010-10-16,2010,Newcastle United,Wigan Athletic,2-2,2,2,1,1,4,0,D
2010-10-16,2010,Wolverhampton Wanderers,West Ham United,1-1,1,1,1,1,2,0,D
2010-10-17,2010,Blackpool,Manchester City,2-3,2,3,1,1,5,-1,A
2010-10-17,2010,Everton,Liverpool,2-0,2,0,1,1,2,2,H
2010-10-18,2010,Blackburn Rovers,Sunderland,0-0,0,0,1,1,0,0,D
2010-10-23,2010,Birmingham City,Blackpool,2-0,2,0,1,1,2,2,H
2010-10-23,2010,Chelsea,Wolverhampton Wanderers,2-0,2,0,1,1,2,2,H
2010-10-23,2010,Sunderland,Aston Villa,1-0,1,0,1,1,1,1,H
2010-10-23,2010,Tottenham Hotspur,Everton,1-1,1,1,1,1,2,0,D
2010-10-23,2010,West Bromwich Albion,Fulham,2-1,2,1,1,1,3,1,H
2010-10-23,2010,West Ham United,Newcastle United,1-2,1,2,1,1,3,-1,A
2010-10-23,2010,Wigan Athletic,Bolton Wanderers,1-1,1,1,1,1,2,0,D
2010-10-24,2010,Liverpool,Blackburn Rovers,2-1,2,1,1,1,3,1,H
2010-10-24,2010,Manchester City,Arsenal,0-3,0,3,1,1,3,-3,A
2010-10-24,2010,Stoke City,Manchester United,1-2,1,2,1,1,3,-1,A
2010-10-30,2010,Arsenal,West Ham United,1-0,1,0,1,1,1,1,H
2010-10-30,2010,Blackburn Rovers,Chelsea,1-2,1,2,1,1,3,-1,A
2010-10-30,2010,Everton,Stoke City,1-0,1,0,1,1,1,1,H
2010-10-30,2010,Fulham,Wigan Athletic,2-0,2,0,1,1,2,2,H
2010-10-30,2010,Manchester United,Tottenham Hotspur,2-0,2,0,1,1,2,2,H
2010-10-30,2010,Wolverhampton Wanderers,Manchester City,2-1,2,1,1,1,3,1,H
2010-10-31,2010,Aston Villa,Birmingham City,0-0,0,0,1,1,0,0,D
2010-10-31,2010,Bolton Wanderers,Liverpool,0-1,0,1,1,1,1,-1,A
2010-10-31,2010,Newcastle United,Sunderland,5-1,5,1,1,1,6,4,H
2010-11-01,2010,Blackpool,West Bromwich Albion,2-1,2,1,1,1,3,1,H
2010-11-06,2010,Birmingham City,West Ham United,2-2,2,2,1,1,4,0,D
2010-11-06,2010,Blackburn Rovers,Wigan Athletic,2-1,2,1,1,1,3,1,H
2010-11-06,2010,Blackpool,Everton,2-2,2,2,1,1,4,0,D
2010-11-06,2010,Bolton Wanderers,Tottenham Hotspur,4-2,4,2,1,1,6,2,H
2010-11-06,2010,Fulham,Aston Villa,1-1,1,1,1,1,2,0,D
2010-11-06,2010,Manchester United,Wolverhampton Wanderers,2-1,2,1,1,1,3,1,H
2010-11-06,2010,Sunderland,Stoke City,2-0,2,0,1,1,2,2,H
2010-11-07,2010,Arsenal,Newcastle United,0-1,0,1,1,1,1,-1,A
2010-11-07,2010,Liverpool,Chelsea,2-0,2,0,1,1,2,2,H
2010-11-07,2010,West Bromwich Albion,Manchester City,0-2,0,2,1,1,2,-2,A
2010-11-09,2010,Stoke City,Birmingham City,3-2,3,2,1,1,5,1,H
2010-11-09,2010,Tottenham Hotspur,Sunderland,1-1,1,1,1,1,2,0,D
2010-11-10,2010,Aston Villa,Blackpool,3-2,3,2,1,1,5,1,H
2010-11-10,2010,Chelsea,Fulham,1-0,1,0,1,1,1,1,H
2010-11-10,2010,Everton,Bolton Wanderers,1-1,1,1,1,1,2,0,D
2010-11-10,2010,Manchester City,Manchester United,0-0,0,0,1,1,0,0,D
2010-11-10,2010,Newcastle United,Blackburn Rovers,1-2,1,2,1,1,3,-1,A
2010-11-10,2010,West Ham United,West Bromwich Albion,2-2,2,2,1,1,4,0,D
2010-11-10,2010,Wigan Athletic,Liverpool,1-1,1,1,1,1,2,0,D
2010-11-10,2010,Wolverhampton Wanderers,Arsenal,0-2,0,2,1,1,2,-2,A
2010-11-13,2010,Aston Villa,Manchester United,2-2,2,2,1,1,4,0,D
2010-11-13,2010,Manchester City,Birmingham City,0-0,0,0,1,1,0,0,D
2010-11-13,2010,Newcastle United,Fulham,0-0,0,0,1,1,0,0,D
2010-11-13,2010,Stoke City,Liverpool,2-0,2,0,1,1,2,2,H
2010-11-13,2010,Tottenham Hotspur,Blackburn Rovers,4-2,4,2,1,1,6,2,H
2010-11-13,2010,West Ham United,Blackpool,0-0,0,0,1,1,0,0,D
2010-11-13,2010,Wigan Athletic,West Bromwich Albion,1-0,1,0,1,1,1,1,H
2010-11-13,2010,Wolverhampton Wanderers,Bolton Wanderers,2-3,2,3,1,1,5,-1,A
2010-11-14,2010,Chelsea,Sunderland,0-3,0,3,1,1,3,-3,A
2010-11-14,2010,Everton,Arsenal,1-2,1,2,1,1,3,-1,A
2010-11-20,2010,Arsenal,Tottenham Hotspur,2-3,2,3,1,1,5,-1,A
2010-11-20,2010,Birmingham City,Chelsea,1-0,1,0,1,1,1,1,H
2010-11-20,2010,Blackpool,Wolverhampton Wanderers,2-1,2,1,1,1,3,1,H
2010-11-20,2010,Bolton Wanderers,Newcastle United,5-1,5,1,1,1,6,4,H
2010-11-20,2010,Liverpool,West Ham United,3-0,3,0,1,1,3,3,H
2010-11-20,2010,Manchester United,Wigan Athletic,2-0,2,0,1,1,2,2,H
2010-11-20,2010,West Bromwich Albion,Stoke City,0-3,0,3,1,1,3,-3,A
2010-11-21,2010,Blackburn Rovers,Aston Villa,2-0,2,0,1,1,2,2,H
2010-11-21,2010,Fulham,Manchester City,1-4,1,4,1,1,5,-3,A
2010-11-22,2010,Sunderland,Everton,2-2,2,2,1,1,4,0,D
2010-11-27,2010,Aston Villa,Arsenal,2-4,2,4,1,1,6,-2,A
2010-11-27,2010,Bolton Wanderers,Blackpool,2-2,2,2,1,1,4,0,D
2010-11-27,2010,Everton,West Bromwich Albion,1-4,1,4,1,1,5,-3,A
2010-11-27,2010,Fulham,Birmingham City,1-1,1,1,1,1,2,0,D
2010-11-27,2010,Manchester United,Blackburn Rovers,7-1,7,1,1,1,8,6,H
2010-11-27,2010,Stoke City,Manchester City,1-1,1,1,1,1,2,0,D
2010-11-27,2010,West Ham United,Wigan Athletic,3-1,3,1,1,1,4,2,H
2010-11-27,2010,Wolverhampton Wanderers,Sunderland,3-2,3,2,1,1,5,1,H
2010-11-28,2010,Newcastle United,Chelsea,1-1,1,1,1,1,2,0,D
2010-11-28,2010,Tottenham Hotspur,Liverpool,2-1,2,1,1,1,3,1,H
2010-12-04,2010,Arsenal,Fulham,2-1,2,1,1,1,3,1,H
2010-12-04,2010,Birmingham City,Tottenham Hotspur,1-1,1,1,1,1,2,0,D
2010-12-04,2010,Blackburn Rovers,Wolverhampton Wanderers,3-0,3,0,1,1,3,3,H
2010-12-04,2010,Chelsea,Everton,1-1,1,1,1,1,2,0,D
2010-12-04,2010,Manchester City,Bolton Wanderers,1-0,1,0,1,1,1,1,H
2010-12-04,2010,Wigan Athletic,Stoke City,2-2,2,2,1,1,4,0,D
2010-12-05,2010,Sunderland,West Ham United,1-0,1,0,1,1,1,1,H
2010-12-05,2010,West Bromwich Albion,Newcastle United,3-1,3,1,1,1,4,2,H
2010-12-06,2010,Liverpool,Aston Villa,3-0,3,0,1,1,3,3,H
2010-12-11,2010,Aston Villa,West Bromwich Albion,2-1,2,1,1,1,3,1,H
2010-12-11,2010,Everton,Wigan Athletic,0-0,0,0,1,1,0,0,D
2010-12-11,2010,Fulham,Sunderland,0-0,0,0,1,1,0,0,D
2010-12-11,2010,Newcastle United,Liverpool,3-1,3,1,1,1,4,2,H
2010-12-11,2010,Stoke City,Blackpool,0-1,0,1,1,1,1,-1,A
2010-12-11,2010,West Ham United,Manchester City,1-3,1,3,1,1,4,-2,A
2010-12-12,2010,Bolton Wanderers,Blackburn Rovers,2-1,2,1,1,1,3,1,H
2010-12-12,2010,Tottenham Hotspur,Chelsea,1-1,1,1,1,1,2,0,D
2010-12-12,2010,Wolverhampton Wanderers,Birmingham City,1-0,1,0,1,1,1,1,H
2010-12-13,2010,Manchester United,Arsenal,1-0,1,0,1,1,1,1,H
2010-12-18,2010,Blackburn Rovers,West Ham United,1-1,1,1,1,1,2,0,D
2010-12-18,2010,Sunderland,Bolton Wanderers,1-0,1,0,1,1,1,1,H
2010-12-20,2010,Manchester City,Everton,1-2,1,2,1,1,3,-1,A
2010-12-26,2010,Aston Villa,Tottenham Hotspur,1-2,1,2,1,1,3,-1,A
2010-12-26,2010,Blackburn Rovers,Stoke City,0-2,0,2,1,1,2,-2,A
2010-12-26,2010,Bolton Wanderers,West Bromwich Albion,2-0,2,0,1,1,2,2,H
2010-12-26,2010,Fulham,West Ham United,1-3,1,3,1,1,4,-2,A
2010-12-26,2010,Manchester United,Sunderland,2-0,2,0,1,1,2,2,H
2010-12-26,2010,Newcastle United,Manchester City,1-3,1,3,1,1,4,-2,A
2010-12-26,2010,Wolverhampton Wanderers,Wigan Athletic,1-2,1,2,1,1,3,-1,A
2010-12-27,2010,Arsenal,Chelsea,3-1,3,1,1,1,4,2,H
2010-12-28,2010,Birmingham City,Manchester United,1-1,1,1,1,1,2,0,D
2010-12-28,2010,Manchester City,Aston Villa,4-0,4,0,1,1,4,4,H
2010-12-28,2010,Stoke City,Fulham,0-2,0,2,1,1,2,-2,A
2010-12-28,2010,Sunderland,Blackpool,0-2,0,2,1,1,2,-2,A
2010-12-28,2010,Tottenham Hotspur,Newcastle United,2-0,2,0,1,1,2,2,H
2010-12-28,2010,West Bromwich Albion,Blackburn Rovers,1-3,1,3,1,1,4,-2,A
2010-12-28,2010,West Ham United,Everton,1-1,1,1,1,1,2,0,D
2010-12-29,2010,Chelsea,Bolton Wanderers,1-0,1,0,1,1,1,1,H
2010-12-29,2010,Liverpool,Wolverhampton Wanderers,0-1,0,1,1,1,1,-1,A
2010-12-29,2010,Wigan Athletic,Arsenal,2-2,2,2,1,1,4,0,D
2011-01-01,2010,Birmingham City,Arsenal,0-3,0,3,1,1,3,-3,A
2011-01-01,2010,Liverpool,Bolton Wanderers,2-1,2,1,1,1,3,1,H
2011-01-01,2010,Manchester City,Blackpool,1-0,1,0,1,1,1,1,H
2011-01-01,2010,Stoke City,Everton,2-0,2,0,1,1,2,2,H
2011-01-01,2010,Sunderland,Blackburn Rovers,3-0,3,0,1,1,3,3,H
2011-01-01,2010,Tottenham Hotspur,Fulham,1-0,1,0,1,1,1,1,H
2011-01-01,2010,West Bromwich Albion,Manchester United,1-2,1,2,1,1,3,-1,A
2011-01-01,2010,West Ham United,Wolverhampton Wanderers,2-0,2,0,1,1,2,2,H
2011-01-02,2010,Chelsea,Aston Villa,3-3,3,3,1,1,6,0,D
2011-01-02,2010,Wigan Athletic,Newcastle United,0-1,0,1,1,1,1,-1,A
2011-01-04,2010,Blackpool,Birmingham City,1-2,1,2,1,1,3,-1,A
2011-01-04,2010,Fulham,West Bromwich Albion,3-0,3,0,1,1,3,3,H
2011-01-04,2010,Manchester United,Stoke City,2-1,2,1,1,1,3,1,H
2011-01-05,2010,Arsenal,Manchester City,0-0,0,0,1,1,0,0,D
2011-01-05,2010,Aston Villa,Sunderland,0-1,0,1,1,1,1,-1,A
2011-01-05,2010,Blackburn Rovers,Liverpool,3-1,3,1,1,1,4,2,H
2011-01-05,2010,Bolton Wanderers,Wigan Athletic,1-1,1,1,1,1,2,0,D
2011-01-05,2010,Everton,Tottenham Hotspur,2-1,2,1,1,1,3,1,H
2011-01-05,2010,Newcastle United,West Ham United,5-0,5,0,1,1,5,5,H
2011-01-05,2010,Wolverhampton Wanderers,Chelsea,1-0,1,0,1,1,1,1,H
2011-01-12,2010,Blackpool,Liverpool,2-1,2,1,1,1,3,1,H
2011-01-15,2010,Chelsea,Blackburn Rovers,2-0,2,0,1,1,2,2,H
2011-01-15,2010,Manchester City,Wolverhampton Wanderers,4-3,4,3,1,1,7,1,H
2011-01-15,2010,Stoke City,Bolton Wanderers,2-0,2,0,1,1,2,2,H
2011-01-15,2010,West Bromwich Albion,Blackpool,3-2,3,2,1,1,5,1,H
2011-01-15,2010,West Ham United,Arsenal,0-3,0,3,1,1,3,-3,A
2011-01-15,2010,Wigan Athletic,Fulham,1-1,1,1,1,1,2,0,D
2011-01-16,2010,Birmingham City,Aston Villa,1-1,1,1,1,1,2,0,D
2011-01-16,2010,Liverpool,Everton,2-2,2,2,1,1,4,0,D
2011-01-16,2010,Sunderland,Newcastle United,1-1,1,1,1,1,2,0,D
2011-01-16,2010,Tottenham Hotspur,Manchester United,0-0,0,0,1,1,0,0,D
2011-01-22,2010,Arsenal,Wigan Athletic,3-0,3,0,1,1,3,3,H
2011-01-22,2010,Aston Villa,Manchester City,1-0,1,0,1,1,1,1,H
2011-01-22,2010,Blackpool,Sunderland,1-2,1,2,1,1,3,-1,A
2011-01-22,2010,Everton,West Ham United,2-2,2,2,1,1,4,0,D
2011-01-22,2010,Fulham,Stoke City,2-0,2,0,1,1,2,2,H
2011-01-22,2010,Manchester United,Birmingham City,5-0,5,0,1,1,5,5,H
2011-01-22,2010,Newcastle United,Tottenham Hotspur,1-1,1,1,1,1,2,0,D
2011-01-22,2010,Wolverhampton Wanderers,Liverpool,0-3,0,3,1,1,3,-3,A
2011-01-23,2010,Blackburn Rovers,West Bromwich Albion,2-0,2,0,1,1,2,2,H
2011-01-24,2010,Bolton Wanderers,Chelsea,0-4,0,4,1,1,4,-4,A
2011-01-25,2010,Blackpool,Manchester United,2-3,2,3,1,1,5,-1,A
2011-01-25,2010,Wigan Athletic,Aston Villa,1-2,1,2,1,1,3,-1,A
2011-01-26,2010,Liverpool,Fulham,1-0,1,0,1,1,1,1,H
2011-02-01,2010,Arsenal,Everton,2-1,2,1,1,1,3,1,H
2011-02-01,2010,Manchester United,Aston Villa,3-1,3,1,1,1,4,2,H
2011-02-01,2010,Sunderland,Chelsea,2-4,2,4,1,1,6,-2,A
2011-02-01,2010,West Bromwich Albion,Wigan Athletic,2-2,2,2,1,1,4,0,D
2011-02-02,2010,Birmingham City,Manchester City,2-2,2,2,1,1,4,0,D
2011-02-02,2010,Blackburn Rovers,Tottenham Hotspur,0-1,0,1,1,1,1,-1,A
2011-02-02,2010,Blackpool,West Ham United,1-3,1,3,1,1,4,-2,A
2011-02-02,2010,Bolton Wanderers,Wolverhampton Wanderers,1-0,1,0,1,1,1,1,H
2011-02-02,2010,Fulham,Newcastle United,1-0,1,0,1,1,1,1,H
2011-02-02,2010,Liverpool,Stoke City,2-0,2,0,1,1,2,2,H
2011-02-05,2010,Aston Villa,Fulham,2-2,2,2,1,1,4,0,D
2011-02-05,2010,Everton,Blackpool,5-3,5,3,1,1,8,2,H
2011-02-05,2010,Manchester City,West Bromwich Albion,3-0,3,0,1,1,3,3,H
2011-02-05,2010,Newcastle United,Arsenal,4-4,4,4,1,1,8,0,D
2011-02-05,2010,Stoke City,Sunderland,3-2,3,2,1,1,5,1,H
2011-02-05,2010,Tottenham Hotspur,Bolton Wanderers,2-1,2,1,1,1,3,1,H
2011-02-05,2010,Wigan Athletic,Blackburn Rovers,4-3,4,3,1,1,7,1,H
2011-02-05,2010,Wolverhampton Wanderers,Manchester United,2-1,2,1,1,1,3,1,H
2011-02-06,2010,Chelsea,Liverpool,0-1,0,1,1,1,1,-1,A
2011-02-06,2010,West Ham United,Birmingham City,0-1,0,1,1,1,1,-1,A
2011-02-12,2010,Arsenal,Wolverhampton Wanderers,2-0,2,0,1,1,2,2,H
2011-02-12,2010,Birmingham City,Stoke City,1-0,1,0,1,1,1,1,H
2011-02-12,2010,Blackburn Rovers,Newcastle United,0-0,0,0,1,1,0,0,D
2011-02-12,2010,Blackpool,Aston Villa,1-1,1,1,1,1,2,0,D
2011-02-12,2010,Liverpool,Wigan Athletic,1-1,1,1,1,1,2,0,D
2011-02-12,2010,Manchester United,Manchester City,2-1,2,1,1,1,3,1,H
2011-02-12,2010,Sunderland,Tottenham Hotspur,1-2,1,2,1,1,3,-1,A
2011-02-12,2010,West Bromwich Albion,West Ham United,3-3,3,3,1,1,6,0,D
2011-02-13,2010,Bolton Wanderers,Everton,2-0,2,0,1,1,2,2,H
2011-02-14,2010,Fulham,Chelsea,0-0,0,0,1,1,0,0,D
2011-02-15,2010,Birmingham City,Newcastle United,0-2,0,2,1,1,2,-2,A
2011-02-20,2010,West Bromwich Albion,Wolverhampton Wanderers,1-1,1,1,1,1,2,0,D
2011-02-22,2010,Blackpool,Tottenham Hotspur,3-1,3,1,1,1,4,2,H
2011-02-23,2010,Arsenal,Stoke City,1-0,1,0,1,1,1,1,H
2011-02-26,2010,Aston Villa,Blackburn Rovers,4-1,4,1,1,1,5,3,H
2011-02-26,2010,Everton,Sunderland,2-0,2,0,1,1,2,2,H
2011-02-26,2010,Newcastle United,Bolton Wanderers,1-1,1,1,1,1,2,0,D
2011-02-26,2010,Wigan Athletic,Manchester United,0-4,0,4,1,1,4,-4,A
2011-02-26,2010,Wolverhampton Wanderers,Blackpool,4-0,4,0,1,1,4,4,H
2011-02-27,2010,Manchester City,Fulham,1-1,1,1,1,1,2,0,D
2011-02-27,2010,West Ham United,Liverpool,3-1,3,1,1,1,4,2,H
2011-02-28,2010,Stoke City,West Bromwich Albion,1-1,1,1,1,1,2,0,D
2011-03-01,2010,Chelsea,Manchester United,2-1,2,1,1,1,3,1,H
2011-03-05,2010,Arsenal,Sunderland,0-0,0,0,1,1,0,0,D
2011-03-05,2010,Birmingham City,West Bromwich Albion,1-3,1,3,1,1,4,-2,A
2011-03-05,2010,Bolton Wanderers,Aston Villa,3-2,3,2,1,1,5,1,H
2011-03-05,2010,Fulham,Blackburn Rovers,3-2,3,2,1,1,5,1,H
2011-03-05,2010,Manchester City,Wigan Athletic,1-0,1,0,1,1,1,1,H
2011-03-05,2010,Newcastle United,Everton,1-2,1,2,1,1,3,-1,A
2011-03-05,2010,West Ham United,Stoke City,3-0,3,0,1,1,3,3,H
2011-03-06,2010,Liverpool,Manchester United,3-1,3,1,1,1,4,2,H
2011-03-06,2010,Wolverhampton Wanderers,Tottenham Hotspur,3-3,3,3,1,1,6,0,D
2011-03-07,2010,Blackpool,Chelsea,1-3,1,3,1,1,4,-2,A
2011-03-09,2010,Everton,Birmingham City,1-1,1,1,1,1,2,0,D
2011-03-19,2010,Aston Villa,Wolverhampton Wanderers,0-1,0,1,1,1,1,-1,A
2011-03-19,2010,Blackburn Rovers,Blackpool,2-2,2,2,1,1,4,0,D
2011-03-19,2010,Everton,Fulham,2-1,2,1,1,1,3,1,H
2011-03-19,2010,Manchester United,Bolton Wanderers,1-0,1,0,1,1,1,1,H
2011-03-19,2010,Stoke City,Newcastle United,4-0,4,0,1,1,4,4,H
2011-03-19,2010,Tottenham Hotspur,West Ham United,0-0,0,0,1,1,0,0,D
2011-03-19,2010,West Bromwich Albion,Arsenal,2-2,2,2,1,1,4,0,D
2011-03-19,2010,Wigan Athletic,Birmingham City,2-1,2,1,1,1,3,1,H
2011-03-20,2010,Chelsea,Manchester City,2-0,2,0,1,1,2,2,H
2011-03-20,2010,Sunderland,Liverpool,0-2,0,2,1,1,2,-2,A
2011-04-02,2010,Arsenal,Blackburn Rovers,0-0,0,0,1,1,0,0,D
2011-04-02,2010,Birmingham City,Bolton Wanderers,2-1,2,1,1,1,3,1,H
2011-04-02,2010,Everton,Aston Villa,2-2,2,2,1,1,4,0,D
2011-04-02,2010,Newcastle United,Wolverhampton Wanderers,4-1,4,1,1,1,5,3,H
2011-04-02,2010,Stoke City,Chelsea,1-1,1,1,1,1,2,0,D
2011-04-02,2010,West Bromwich Albion,Liverpool,2-1,2,1,1,1,3,1,H
2011-04-02,2010,West Ham United,Manchester United,2-4,2,4,1,1,6,-2,A
2011-04-02,2010,Wigan Athletic,Tottenham Hotspur,0-0,0,0,1,1,0,0,D
2011-04-03,2010,Fulham,Blackpool,3-0,3,0,1,1,3,3,H
2011-04-03,2010,Manchester City,Sunderland,5-0,5,0,1,1,5,5,H
2011-04-09,2010,Blackburn Rovers,Birmingham City,1-1,1,1,1,1,2,0,D
2011-04-09,2010,Bolton Wanderers,West Ham United,3-0,3,0,1,1,3,3,H
2011-04-09,2010,Chelsea,Wigan Athletic,1-0,1,0,1,1,1,1,H
2011-04-09,2010,Manchester United,Fulham,2-0,2,0,1,1,2,2,H
2011-04-09,2010,Sunderland,West Bromwich Albion,2-3,2,3,1,1,5,-1,A
2011-04-09,2010,Tottenham Hotspur,Stoke City,3-2,3,2,1,1,5,1,H
2011-04-09,2010,Wolverhampton Wanderers,Everton,0-3,0,3,1,1,3,-3,A
2011-04-10,2010,Aston Villa,Newcastle United,1-0,1,0,1,1,1,1,H
2011-04-10,2010,Blackpool,Arsenal,1-3,1,3,1,1,4,-2,A
2011-04-11,2010,Liverpool,Manchester City,3-0,3,0,1,1,3,3,H
2011-04-16,2010,Birmingham City,Sunderland,2-0,2,0,1,1,2,2,H
2011-04-16,2010,Blackpool,Wigan Athletic,1-3,1,3,1,1,4,-2,A
2011-04-16,2010,Everton,Blackburn Rovers,2-0,2,0,1,1,2,2,H
2011-04-16,2010,West Bromwich Albion,Chelsea,1-3,1,3,1,1,4,-2,A
2011-04-16,2010,West Ham United,Aston Villa,1-2,1,2,1,1,3,-1,A
2011-04-17,2010,Arsenal,Liverpool,1-1,1,1,1,1,2,0,D
2011-04-19,2010,Newcastle United,Manchester United,0-0,0,0,1,1,0,0,D
2011-04-20,2010,Chelsea,Birmingham City,3-1,3,1,1,1,4,2,H
2011-04-20,2010,Tottenham Hotspur,Arsenal,3-3,3,3,1,1,6,0,D
2011-04-23,2010,Aston Villa,Stoke City,1-1,1,1,1,1,2,0,D
2011-04-23,2010,Blackpool,Newcastle United,1-1,1,1,1,1,2,0,D
2011-04-23,2010,Chelsea,West Ham United,3-0,3,0,1,1,3,3,H
2011-04-23,2010,Liverpool,Birmingham City,5-0,5,0,1,1,5,5,H
2011-04-23,2010,Manchester United,Everton,1-0,1,0,1,1,1,1,H
2011-04-23,2010,Sunderland,Wigan Athletic,4-2,4,2,1,1,6,2,H
2011-04-23,2010,Tottenham Hotspur,West Bromwich Albion,2-2,2,2,1,1,4,0,D
2011-04-23,2010,Wolverhampton Wanderers,Fulham,1-1,1,1,1,1,2,0,D
2011-04-24,2010,Bolton Wanderers,Arsenal,2-1,2,1,1,1,3,1,H
2011-04-25,2010,Blackburn Rovers,Manchester City,0-1,0,1,1,1,1,-1,A
2011-04-26,2010,Stoke City,Wolverhampton Wanderers,3-0,3,0,1,1,3,3,H
2011-04-27,2010,Fulham,Bolton Wanderers,3-0,3,0,1,1,3,3,H
2011-04-30,2010,Blackburn Rovers,Bolton Wanderers,1-0,1,0,1,1,1,1,H
2011-04-30,2010,Blackpool,Stoke City,0-0,0,0,1,1,0,0,D
2011-04-30,2010,Chelsea,Tottenham Hotspur,2-1,2,1,1,1,3,1,H
2011-04-30,2010,Sunderland,Fulham,0-3,0,3,1,1,3,-3,A
2011-04-30,2010,West Bromwich Albion,Aston Villa,2-1,2,1,1,1,3,1,H
2011-04-30,2010,Wigan Athletic,Everton,1-1,1,1,1,1,2,0,D
2011-05-01,2010,Arsenal,Manchester United,1-0,1,0,1,1,1,1,H
2011-05-01,2010,Birmingham City,Wolverhampton Wanderers,1-1,1,1,1,1,2,0,D
2011-05-01,2010,Liverpool,Newcastle United,3-0,3,0,1,1,3,3,H
2011-05-01,2010,Manchester City,West Ham United,2-1,2,1,1,1,3,1,H
2011-05-07,2010,Aston Villa,Wigan Athletic,1-1,1,1,1,1,2,0,D
2011-05-07,2010,Bolton Wanderers,Sunderland,1-2,1,2,1,1,3,-1,A
2011-05-07,2010,Everton,Manchester City,2-1,2,1,1,1,3,1,H
2011-05-07,2010,Newcastle United,Birmingham City,2-1,2,1,1,1,3,1,H
2011-05-07,2010,Tottenham Hotspur,Blackpool,1-1,1,1,1,1,2,0,D
2011-05-07,2010,West Ham United,Blackburn Rovers,1-1,1,1,1,1,2,0,D
2011-05-08,2010,Manchester United,Chelsea,2-1,2,1,1,1,3,1,H
2011-05-08,2010,Stoke City,Arsenal,3-1,3,1,1,1,4,2,H
2011-05-08,2010,Wolverhampton Wanderers,West Bromwich Albion,3-1,3,1,1,1,4,2,H
2011-05-09,2010,Fulham,Liverpool,2-5,2,5,1,1,7,-3,A
2011-05-10,2010,Manchester City,Tottenham Hotspur,1-0,1,0,1,1,1,1,H
2011-05-14,2010,Blackburn Rovers,Manchester United,1-1,1,1,1,1,2,0,D
2011-05-14,2010,Blackpool,Bolton Wanderers,4-3,4,3,1,1,7,1,H
2011-05-14,2010,Sunderland,Wolverhampton Wanderers,1-3,1,3,1,1,4,-2,A
2011-05-14,2010,West Bromwich Albion,Everton,1-0,1,0,1,1,1,1,H
2011-05-15,2010,Arsenal,Aston Villa,1-2,1,2,1,1,3,-1,A
2011-05-15,2010,Birmingham City,Fulham,0-2,0,2,1,1,2,-2,A
2011-05-15,2010,Chelsea,Newcastle United,2-2,2,2,1,1,4,0,D
2011-05-15,2010,Liverpool,Tottenham Hotspur,0-2,0,2,1,1,2,-2,A
2011-05-15,2010,Wigan Athletic,West Ham United,3-2,3,2,1,1,5,1,H
2011-05-17,2010,Manchester City,Stoke City,3-0,3,0,1,1,3,3,H
2011-05-22,2010,Aston Villa,Liverpool,1-0,1,0,1,1,1,1,H
2011-05-22,2010,Bolton Wanderers,Manchester City,0-2,0,2,1,1,2,-2,A
2011-05-22,2010,Everton,Chelsea,1-0,1,0,1,1,1,1,H
2011-05-22,2010,Fulham,Arsenal,2-2,2,2,1,1,4,0,D
2011-05-22,2010,Manchester United,Blackpool,4-2,4,2,1,1,6,2,H
2011-05-22,2010,Newcastle United,West Bromwich Albion,3-3,3,3,1,1,6,0,D
2011-05-22,2010,Stoke City,Wigan Athletic,0-1,0,1,1,1,1,-1,A
2011-05-22,2010,Tottenham Hotspur,Birmingham City,2-1,2,1,1,1,3,1,H
2011-05-22,2010,West Ham United,Sunderland,0-3,0,3,1,1,3,-3,A
2011-05-22,2010,Wolverhampton Wanderers,Blackburn Rovers,2-3,2,3,1,1,5,-1,A
2011-08-13,2011,Blackburn Rovers,Wolverhampton Wanderers,1-2,1,2,1,1,3,-1,A
2011-08-13,2011,Fulham,Aston Villa,0-0,0,0,1,1,0,0,D
2011-08-13,2011,Liverpool,Sunderland,1-1,1,1,1,1,2,0,D
2011-08-13,2011,Newcastle United,Arsenal,0-0,0,0,1,1,0,0,D
2011-08-13,2011,Queens Park Rangers,Bolton Wanderers,0-4,0,4,1,1,4,-4,A
2011-08-13,2011,Wigan Athletic,Norwich City,1-1,1,1,1,1,2,0,D
2011-08-14,2011,Stoke City,Chelsea,0-0,0,0,1,1,0,0,D
2011-08-14,2011,West Bromwich Albion,Manchester United,1-2,1,2,1,1,3,-1,A
2011-08-15,2011,Manchester City,Swansea City,4-0,4,0,1,1,4,4,H
2011-08-20,2011,Arsenal,Liverpool,0-2,0,2,1,1,2,-2,A
2011-08-20,2011,Aston Villa,Blackburn Rovers,3-1,3,1,1,1,4,2,H
2011-08-20,2011,Chelsea,West Bromwich Albion,2-1,2,1,1,1,3,1,H
2011-08-20,2011,Everton,Queens Park Rangers,0-1,0,1,1,1,1,-1,A
2011-08-20,2011,Sunderland,Newcastle United,0-1,0,1,1,1,1,-1,A
2011-08-20,2011,Swansea City,Wigan Athletic,0-0,0,0,1,1,0,0,D
2011-08-21,2011,Bolton Wanderers,Manchester City,2-3,2,3,1,1,5,-1,A
2011-08-21,2011,Norwich City,Stoke City,1-1,1,1,1,1,2,0,D
2011-08-21,2011,Wolverhampton Wanderers,Fulham,2-0,2,0,1,1,2,2,H
2011-08-22,2011,Manchester United,Tottenham Hotspur,3-0,3,0,1,1,3,3,H
2011-08-27,2011,Aston Villa,Wolverhampton Wanderers,0-0,0,0,1,1,0,0,D
2011-08-27,2011,Blackburn Rovers,Everton,0-1,0,1,1,1,1,-1,A
2011-08-27,2011,Chelsea,Norwich City,3-1,3,1,1,1,4,2,H
2011-08-27,2011,Liverpool,Bolton Wanderers,3-1,3,1,1,1,4,2,H
2011-08-27,2011,Swansea City,Sunderland,0-0,0,0,1,1,0,0,D
2011-08-27,2011,Wigan Athletic,Queens Park Rangers,2-0,2,0,1,1,2,2,H
2011-08-28,2011,Manchester United,Arsenal,8-2,8,2,1,1,10,6,H
2011-08-28,2011,Newcastle United,Fulham,2-1,2,1,1,1,3,1,H
2011-08-28,2011,Tottenham Hotspur,Manchester City,1-5,1,5,1,1,6,-4,A
2011-08-28,2011,West Bromwich Albion,Stoke City,0-1,0,1,1,1,1,-1,A
2011-09-10,2011,Arsenal,Swansea City,1-0,1,0,1,1,1,1,H
2011-09-10,2011,Bolton Wanderers,Manchester United,0-5,0,5,1,1,5,-5,A
2011-09-10,2011,Everton,Aston Villa,2-2,2,2,1,1,4,0,D
2011-09-10,2011,Manchester City,Wigan Athletic,3-0,3,0,1,1,3,3,H
2011-09-10,2011,Stoke City,Liverpool,1-0,1,0,1,1,1,1,H
2011-09-10,2011,Sunderland,Chelsea,1-2,1,2,1,1,3,-1,A
2011-09-10,2011,Wolverhampton Wanderers,Tottenham Hotspur,0-2,0,2,1,1,2,-2,A
2011-09-11,2011,Fulham,Blackburn Rovers,1-1,1,1,1,1,2,0,D
2011-09-11,2011,Norwich City,West Bromwich Albion,0-1,0,1,1,1,1,-1,A
2011-09-12,2011,Queens Park Rangers,Newcastle United,0-0,0,0,1,1,0,0,D
2011-09-17,2011,Aston Villa,Newcastle United,1-1,1,1,1,1,2,0,D
2011-09-17,2011,Blackburn Rovers,Arsenal,4-3,4,3,1,1,7,1,H
2011-09-17,2011,Bolton Wanderers,Norwich City,1-2,1,2,1,1,3,-1,A
2011-09-17,2011,Everton,Wigan Athletic,3-1,3,1,1,1,4,2,H
2011-09-17,2011,Swansea City,West Bromwich Albion,3-0,3,0,1,1,3,3,H
2011-09-17,2011,Wolverhampton Wanderers,Queens Park Rangers,0-3,0,3,1,1,3,-3,A
2011-09-18,2011,Fulham,Manchester City,2-2,2,2,1,1,4,0,D
2011-09-18,2011,Manchester United,Chelsea,3-1,3,1,1,1,4,2,H
2011-09-18,2011,Sunderland,Stoke City,4-0,4,0,1,1,4,4,H
2011-09-18,2011,Tottenham Hotspur,Liverpool,4-0,4,0,1,1,4,4,H
2011-09-24,2011,Arsenal,Bolton Wanderers,3-0,3,0,1,1,3,3,H
2011-09-24,2011,Chelsea,Swansea City,4-1,4,1,1,1,5,3,H
2011-09-24,2011,Liverpool,Wolverhampton Wanderers,2-1,2,1,1,1,3,1,H
2011-09-24,2011,Manchester City,Everton,2-0,2,0,1,1,2,2,H
2011-09-24,2011,Newcastle United,Blackburn Rovers,3-1,3,1,1,1,4,2,H
2011-09-24,2011,Stoke City,Manchester United,1-1,1,1,1,1,2,0,D
2011-09-24,2011,West Bromwich Albion,Fulham,0-0,0,0,1,1,0,0,D
2011-09-24,2011,Wigan Athletic,Tottenham Hotspur,1-2,1,2,1,1,3,-1,A
2011-09-25,2011,Queens Park Rangers,Aston Villa,1-1,1,1,1,1,2,0,D
2011-09-26,2011,Norwich City,Sunderland,2-1,2,1,1,1,3,1,H
2011-10-01,2011,Aston Villa,Wigan Athletic,2-0,2,0,1,1,2,2,H
2011-10-01,2011,Blackburn Rovers,Manchester City,0-4,0,4,1,1,4,-4,A
2011-10-01,2011,Everton,Liverpool,0-2,0,2,1,1,2,-2,A
2011-10-01,2011,Manchester United,Norwich City,2-0,2,0,1,1,2,2,H
2011-10-01,2011,Sunderland,West Bromwich Albion,2-2,2,2,1,1,4,0,D
2011-10-01,2011,Wolverhampton Wanderers,Newcastle United,1-2,1,2,1,1,3,-1,A
2011-10-02,2011,Bolton Wanderers,Chelsea,1-5,1,5,1,1,6,-4,A
2011-10-02,2011,Fulham,Queens Park Rangers,6-0,6,0,1,1,6,6,H
2011-10-02,2011,Swansea City,Stoke City,2-0,2,0,1,1,2,2,H
2011-10-02,2011,Tottenham Hotspur,Arsenal,2-1,2,1,1,1,3,1,H
2011-10-15,2011,Chelsea,Everton,3-1,3,1,1,1,4,2,H
2011-10-15,2011,Liverpool,Manchester United,1-1,1,1,1,1,2,0,D
2011-10-15,2011,Manchester City,Aston Villa,4-1,4,1,1,1,5,3,H
2011-10-15,2011,Norwich City,Swansea City,3-1,3,1,1,1,4,2,H
2011-10-15,2011,Queens Park Rangers,Blackburn Rovers,1-1,1,1,1,1,2,0,D
2011-10-15,2011,Stoke City,Fulham,2-0,2,0,1,1,2,2,H
2011-10-15,2011,Wigan Athletic,Bolton Wanderers,1-3,1,3,1,1,4,-2,A
2011-10-16,2011,Arsenal,Sunderland,2-1,2,1,1,1,3,1,H
2011-10-16,2011,Newcastle United,Tottenham Hotspur,2-2,2,2,1,1,4,0,D
2011-10-16,2011,West Bromwich Albion,Wolverhampton Wanderers,2-0,2,0,1,1,2,2,H
2011-10-22,2011,Aston Villa,West Bromwich Albion,1-2,1,2,1,1,3,-1,A
2011-10-22,2011,Bolton Wanderers,Sunderland,0-2,0,2,1,1,2,-2,A
2011-10-22,2011,Liverpool,Norwich City,1-1,1,1,1,1,2,0,D
2011-10-22,2011,Newcastle United,Wigan Athletic,1-0,1,0,1,1,1,1,H
2011-10-22,2011,Wolverhampton Wanderers,Swansea City,2-2,2,2,1,1,4,0,D
2011-10-23,2011,Arsenal,Stoke City,3-1,3,1,1,1,4,2,H
2011-10-23,2011,Blackburn Rovers,Tottenham Hotspur,1-2,1,2,1,1,3,-1,A
2011-10-23,2011,Fulham,Everton,1-3,1,3,1,1,4,-2,A
2011-10-23,2011,Manchester United,Manchester City,1-6,1,6,1,1,7,-5,A
2011-10-23,2011,Queens Park Rangers,Chelsea,1-0,1,0,1,1,1,1,H
2011-10-29,2011,Chelsea,Arsenal,3-5,3,5,1,1,8,-2,A
2011-10-29,2011,Everton,Manchester United,0-1,0,1,1,1,1,-1,A
2011-10-29,2011,Manchester City,Wolverhampton Wanderers,3-1,3,1,1,1,4,2,H
2011-10-29,2011,Norwich City,Blackburn Rovers,3-3,3,3,1,1,6,0,D
2011-10-29,2011,Sunderland,Aston Villa,2-2,2,2,1,1,4,0,D
2011-10-29,2011,Swansea City,Bolton Wanderers,3-1,3,1,1,1,4,2,H
2011-10-29,2011,West Bromwich Albion,Liverpool,0-2,0,2,1,1,2,-2,A
2011-10-29,2011,Wigan Athletic,Fulham,0-2,0,2,1,1,2,-2,A
2011-10-30,2011,Tottenham Hotspur,Queens Park Rangers,3-1,3,1,1,1,4,2,H
2011-10-31,2011,Stoke City,Newcastle United,1-3,1,3,1,1,4,-2,A
2011-11-05,2011,Arsenal,West Bromwich Albion,3-0,3,0,1,1,3,3,H
2011-11-05,2011,Aston Villa,Norwich City,3-2,3,2,1,1,5,1,H
2011-11-05,2011,Blackburn Rovers,Chelsea,0-1,0,1,1,1,1,-1,A
2011-11-05,2011,Liverpool,Swansea City,0-0,0,0,1,1,0,0,D
2011-11-05,2011,Manchester United,Sunderland,1-0,1,0,1,1,1,1,H
2011-11-05,2011,Newcastle United,Everton,2-1,2,1,1,1,3,1,H
2011-11-05,2011,Queens Park Rangers,Manchester City,2-3,2,3,1,1,5,-1,A
2011-11-06,2011,Bolton Wanderers,Stoke City,5-0,5,0,1,1,5,5,H
2011-11-06,2011,Fulham,Tottenham Hotspur,1-3,1,3,1,1,4,-2,A
2011-11-06,2011,Wolverhampton Wanderers,Wigan Athletic,3-1,3,1,1,1,4,2,H
2011-11-19,2011,Everton,Wolverhampton Wanderers,2-1,2,1,1,1,3,1,H
2011-11-19,2011,Manchester City,Newcastle United,3-1,3,1,1,1,4,2,H
2011-11-19,2011,Norwich City,Arsenal,1-2,1,2,1,1,3,-1,A
2011-11-19,2011,Stoke City,Queens Park Rangers,2-3,2,3,1,1,5,-1,A
2011-11-19,2011,Sunderland,Fulham,0-0,0,0,1,1,0,0,D
2011-11-19,2011,Swansea City,Manchester United,0-1,0,1,1,1,1,-1,A
2011-11-19,2011,West Bromwich Albion,Bolton Wanderers,2-1,2,1,1,1,3,1,H
2011-11-19,2011,Wigan Athletic,Blackburn Rovers,3-3,3,3,1,1,6,0,D
2011-11-20,2011,Chelsea,Liverpool,1-2,1,2,1,1,3,-1,A
2011-11-21,2011,Tottenham Hotspur,Aston Villa,2-0,2,0,1,1,2,2,H
2011-11-26,2011,Arsenal,Fulham,1-1,1,1,1,1,2,0,D
2011-11-26,2011,Bolton Wanderers,Everton,0-2,0,2,1,1,2,-2,A
2011-11-26,2011,Chelsea,Wolverhampton Wanderers,3-0,3,0,1,1,3,3,H
2011-11-26,2011,Manchester United,Newcastle United,1-1,1,1,1,1,2,0,D
2011-11-26,2011,Norwich City,Queens Park Rangers,2-1,2,1,1,1,3,1,H
2011-11-26,2011,Stoke City,Blackburn Rovers,3-1,3,1,1,1,4,2,H
2011-11-26,2011,Sunderland,Wigan Athletic,1-2,1,2,1,1,3,-1,A
2011-11-26,2011,West Bromwich Albion,Tottenham Hotspur,1-3,1,3,1,1,4,-2,A
2011-11-27,2011,Liverpool,Manchester City,1-1,1,1,1,1,2,0,D
2011-11-27,2011,Swansea City,Aston Villa,0-0,0,0,1,1,0,0,D
2011-12-03,2011,Aston Villa,Manchester United,0-1,0,1,1,1,1,-1,A
2011-12-03,2011,Blackburn Rovers,Swansea City,4-2,4,2,1,1,6,2,H
2011-12-03,2011,Manchester City,Norwich City,5-1,5,1,1,1,6,4,H
2011-12-03,2011,Newcastle United,Chelsea,0-3,0,3,1,1,3,-3,A
2011-12-03,2011,Queens Park Rangers,West Bromwich Albion,1-1,1,1,1,1,2,0,D
2011-12-03,2011,Tottenham Hotspur,Bolton Wanderers,3-0,3,0,1,1,3,3,H
2011-12-03,2011,Wigan Athletic,Arsenal,0-4,0,4,1,1,4,-4,A
2011-12-04,2011,Everton,Stoke City,0-1,0,1,1,1,1,-1,A
2011-12-04,2011,Wolverhampton Wanderers,Sunderland,2-1,2,1,1,1,3,1,H
2011-12-05,2011,Fulham,Liverpool,1-0,1,0,1,1,1,1,H
2011-12-10,2011,Arsenal,Everton,1-0,1,0,1,1,1,1,H
2011-12-10,2011,Bolton Wanderers,Aston Villa,1-2,1,2,1,1,3,-1,A
2011-12-10,2011,Liverpool,Queens Park Rangers,1-0,1,0,1,1,1,1,H
2011-12-10,2011,Manchester United,Wolverhampton Wanderers,4-1,4,1,1,1,5,3,H
2011-12-10,2011,Norwich City,Newcastle United,4-2,4,2,1,1,6,2,H
2011-12-10,2011,Swansea City,Fulham,2-0,2,0,1,1,2,2,H
2011-12-10,2011,West Bromwich Albion,Wigan Athletic,1-2,1,2,1,1,3,-1,A
2011-12-11,2011,Stoke City,Tottenham Hotspur,2-1,2,1,1,1,3,1,H
2011-12-11,2011,Sunderland,Blackburn Rovers,2-1,2,1,1,1,3,1,H
2011-12-12,2011,Chelsea,Manchester City,2-1,2,1,1,1,3,1,H
2011-12-17,2011,Blackburn Rovers,West Bromwich Albion,1-2,1,2,1,1,3,-1,A
2011-12-17,2011,Everton,Norwich City,1-1,1,1,1,1,2,0,D
2011-12-17,2011,Fulham,Bolton Wanderers,2-0,2,0,1,1,2,2,H
2011-12-17,2011,Newcastle United,Swansea City,0-0,0,0,1,1,0,0,D
2011-12-17,2011,Wigan Athletic,Chelsea,1-1,1,1,1,1,2,0,D
2011-12-17,2011,Wolverhampton Wanderers,Stoke City,1-2,1,2,1,1,3,-1,A
2011-12-18,2011,Aston Villa,Liverpool,0-2,0,2,1,1,2,-2,A
2011-12-18,2011,Manchester City,Arsenal,1-0,1,0,1,1,1,1,H
2011-12-18,2011,Queens Park Rangers,Manchester United,0-2,0,2,1,1,2,-2,A
2011-12-18,2011,Tottenham Hotspur,Sunderland,1-0,1,0,1,1,1,1,H
2011-12-20,2011,Blackburn Rovers,Bolton Wanderers,1-2,1,2,1,1,3,-1,A
2011-12-20,2011,Wolverhampton Wanderers,Norwich City,2-2,2,2,1,1,4,0,D
2011-12-21,2011,Aston Villa,Arsenal,1-2,1,2,1,1,3,-1,A
2011-12-21,2011,Everton,Swansea City,1-0,1,0,1,1,1,1,H
2011-12-21,2011,Fulham,Manchester United,0-5,0,5,1,1,5,-5,A
2011-12-21,2011,Manchester City,Stoke City,3-0,3,0,1,1,3,3,H
2011-12-21,2011,Newcastle United,West Bromwich Albion,2-3,2,3,1,1,5,-1,A
2011-12-21,2011,Queens Park Rangers,Sunderland,2-3,2,3,1,1,5,-1,A
2011-12-21,2011,Wigan Athletic,Liverpool,0-0,0,0,1,1,0,0,D
2011-12-22,2011,Tottenham Hotspur,Chelsea,1-1,1,1,1,1,2,0,D
2011-12-26,2011,Bolton Wanderers,Newcastle United,0-2,0,2,1,1,2,-2,A
2011-12-26,2011,Chelsea,Fulham,1-1,1,1,1,1,2,0,D
2011-12-26,2011,Liverpool,Blackburn Rovers,1-1,1,1,1,1,2,0,D
2011-12-26,2011,Manchester United,Wigan Athletic,5-0,5,0,1,1,5,5,H
2011-12-26,2011,Stoke City,Aston Villa,0-0,0,0,1,1,0,0,D
2011-12-26,2011,Sunderland,Everton,1-1,1,1,1,1,2,0,D
2011-12-26,2011,West Bromwich Albion,Manchester City,0-0,0,0,1,1,0,0,D
2011-12-27,2011,Arsenal,Wolverhampton Wanderers,1-1,1,1,1,1,2,0,D
2011-12-27,2011,Norwich City,Tottenham Hotspur,0-2,0,2,1,1,2,-2,A
2011-12-27,2011,Swansea City,Queens Park Rangers,1-1,1,1,1,1,2,0,D
2011-12-30,2011,Liverpool,Newcastle United,3-1,3,1,1,1,4,2,H
2011-12-31,2011,Arsenal,Queens Park Rangers,1-0,1,0,1,1,1,1,H
2011-12-31,2011,Bolton Wanderers,Wolverhampton Wanderers,1-1,1,1,1,1,2,0,D
2011-12-31,2011,Chelsea,Aston Villa,1-3,1,3,1,1,4,-2,A
2011-12-31,2011,Manchester United,Blackburn Rovers,2-3,2,3,1,1,5,-1,A
2011-12-31,2011,Norwich City,Fulham,1-1,1,1,1,1,2,0,D
2011-12-31,2011,Stoke City,Wigan Athletic,2-2,2,2,1,1,4,0,D
2011-12-31,2011,Swansea City,Tottenham Hotspur,1-1,1,1,1,1,2,0,D
2012-01-01,2011,Sunderland,Manchester City,1-0,1,0,1,1,1,1,H
2012-01-01,2011,West Bromwich Albion,Everton,0-1,0,1,1,1,1,-1,A
2012-01-02,2011,Aston Villa,Swansea City,0-2,0,2,1,1,2,-2,A
2012-01-02,2011,Blackburn Rovers,Stoke City,1-2,1,2,1,1,3,-1,A
2012-01-02,2011,Fulham,Arsenal,2-1,2,1,1,1,3,1,H
2012-01-02,2011,Queens Park Rangers,Norwich City,1-2,1,2,1,1,3,-1,A
2012-01-02,2011,Wolverhampton Wanderers,Chelsea,1-2,1,2,1,1,3,-1,A
2012-01-03,2011,Manchester City,Liverpool,3-0,3,0,1,1,3,3,H
2012-01-03,2011,Tottenham Hotspur,West Bromwich Albion,1-0,1,0,1,1,1,1,H
2012-01-03,2011,Wigan Athletic,Sunderland,1-4,1,4,1,1,5,-3,A
2012-01-04,2011,Everton,Bolton Wanderers,1-2,1,2,1,1,3,-1,A
2012-01-04,2011,Newcastle United,Manchester United,3-0,3,0,1,1,3,3,H
2012-01-11,2011,Tottenham Hotspur,Everton,2-0,2,0,1,1,2,2,H
2012-01-14,2011,Aston Villa,Everton,1-1,1,1,1,1,2,0,D
2012-01-14,2011,Blackburn Rovers,Fulham,3-1,3,1,1,1,4,2,H
2012-01-14,2011,Chelsea,Sunderland,1-0,1,0,1,1,1,1,H
2012-01-14,2011,Liverpool,Stoke City,0-0,0,0,1,1,0,0,D
2012-01-14,2011,Manchester United,Bolton Wanderers,3-0,3,0,1,1,3,3,H
2012-01-14,2011,Tottenham Hotspur,Wolverhampton Wanderers,1-1,1,1,1,1,2,0,D
2012-01-14,2011,West Bromwich Albion,Norwich City,1-2,1,2,1,1,3,-1,A
2012-01-15,2011,Newcastle United,Queens Park Rangers,1-0,1,0,1,1,1,1,H
2012-01-15,2011,Swansea City,Arsenal,3-2,3,2,1,1,5,1,H
2012-01-16,2011,Wigan Athletic,Manchester City,0-1,0,1,1,1,1,-1,A
2012-01-21,2011,Bolton Wanderers,Liverpool,3-1,3,1,1,1,4,2,H
2012-01-21,2011,Everton,Blackburn Rovers,1-1,1,1,1,1,2,0,D
2012-01-21,2011,Fulham,Newcastle United,5-2,5,2,1,1,7,3,H
2012-01-21,2011,Norwich City,Chelsea,0-0,0,0,1,1,0,0,D
2012-01-21,2011,Queens Park Rangers,Wigan Athletic,3-1,3,1,1,1,4,2,H
2012-01-21,2011,Stoke City,West Bromwich Albion,1-2,1,2,1,1,3,-1,A
2012-01-21,2011,Sunderland,Swansea City,2-0,2,0,1,1,2,2,H
2012-01-21,2011,Wolverhampton Wanderers,Aston Villa,2-3,2,3,1,1,5,-1,A
2012-01-22,2011,Arsenal,Manchester United,1-2,1,2,1,1,3,-1,A
2012-01-22,2011,Manchester City,Tottenham Hotspur,3-2,3,2,1,1,5,1,H
2012-01-31,2011,Everton,Manchester City,1-0,1,0,1,1,1,1,H
2012-01-31,2011,Manchester United,Stoke City,2-0,2,0,1,1,2,2,H
2012-01-31,2011,Swansea City,Chelsea,1-1,1,1,1,1,2,0,D
2012-01-31,2011,Tottenham Hotspur,Wigan Athletic,3-1,3,1,1,1,4,2,H
2012-01-31,2011,Wolverhampton Wanderers,Liverpool,0-3,0,3,1,1,3,-3,A
2012-02-01,2011,Aston Villa,Queens Park Rangers,2-2,2,2,1,1,4,0,D
2012-02-01,2011,Blackburn Rovers,Newcastle United,0-2,0,2,1,1,2,-2,A
2012-02-01,2011,Bolton Wanderers,Arsenal,0-0,0,0,1,1,0,0,D
2012-02-01,2011,Fulham,West Bromwich Albion,1-1,1,1,1,1,2,0,D
2012-02-01,2011,Sunderland,Norwich City,3-0,3,0,1,1,3,3,H
2012-02-04,2011,Arsenal,Blackburn Rovers,7-1,7,1,1,1,8,6,H
2012-02-04,2011,Manchester City,Fulham,3-0,3,0,1,1,3,3,H
2012-02-04,2011,Norwich City,Bolton Wanderers,2-0,2,0,1,1,2,2,H
2012-02-04,2011,Queens Park Rangers,Wolverhampton Wanderers,1-2,1,2,1,1,3,-1,A
2012-02-04,2011,Stoke City,Sunderland,0-1,0,1,1,1,1,-1,A
2012-02-04,2011,West Bromwich Albion,Swansea City,1-2,1,2,1,1,3,-1,A
2012-02-04,2011,Wigan Athletic,Everton,1-1,1,1,1,1,2,0,D
2012-02-05,2011,Chelsea,Manchester United,3-3,3,3,1,1,6,0,D
2012-02-05,2011,Newcastle United,Aston Villa,2-1,2,1,1,1,3,1,H
2012-02-06,2011,Liverpool,Tottenham Hotspur,0-0,0,0,1,1,0,0,D
2012-02-11,2011,Blackburn Rovers,Queens Park Rangers,3-2,3,2,1,1,5,1,H
2012-02-11,2011,Bolton Wanderers,Wigan Athletic,1-2,1,2,1,1,3,-1,A
2012-02-11,2011,Everton,Chelsea,2-0,2,0,1,1,2,2,H
2012-02-11,2011,Fulham,Stoke City,2-1,2,1,1,1,3,1,H
2012-02-11,2011,Manchester United,Liverpool,2-1,2,1,1,1,3,1,H
2012-02-11,2011,Sunderland,Arsenal,1-2,1,2,1,1,3,-1,A
2012-02-11,2011,Swansea City,Norwich City,2-3,2,3,1,1,5,-1,A
2012-02-11,2011,Tottenham Hotspur,Newcastle United,5-0,5,0,1,1,5,5,H
2012-02-12,2011,Aston Villa,Manchester City,0-1,0,1,1,1,1,-1,A
2012-02-12,2011,Wolverhampton Wanderers,West Bromwich Albion,1-5,1,5,1,1,6,-4,A
2012-02-25,2011,Chelsea,Bolton Wanderers,3-0,3,0,1,1,3,3,H
2012-02-25,2011,Manchester City,Blackburn Rovers,3-0,3,0,1,1,3,3,H
2012-02-25,2011,Newcastle United,Wolverhampton Wanderers,2-2,2,2,1,1,4,0,D
2012-02-25,2011,Queens Park Rangers,Fulham,0-1,0,1,1,1,1,-1,A
2012-02-25,2011,West Bromwich Albion,Sunderland,4-0,4,0,1,1,4,4,H
2012-02-25,2011,Wigan Athletic,Aston Villa,0-0,0,0,1,1,0,0,D
2012-02-26,2011,Arsenal,Tottenham Hotspur,5-2,5,2,1,1,7,3,H
2012-02-26,2011,Norwich City,Manchester United,1-2,1,2,1,1,3,-1,A
2012-02-26,2011,Stoke City,Swansea City,2-0,2,0,1,1,2,2,H
2012-03-03,2011,Blackburn Rovers,Aston Villa,1-1,1,1,1,1,2,0,D
2012-03-03,2011,Liverpool,Arsenal,1-2,1,2,1,1,3,-1,A
2012-03-03,2011,Manchester City,Bolton Wanderers,2-0,2,0,1,1,2,2,H
2012-03-03,2011,Queens Park Rangers,Everton,1-1,1,1,1,1,2,0,D
2012-03-03,2011,Stoke City,Norwich City,1-0,1,0,1,1,1,1,H
2012-03-03,2011,West Bromwich Albion,Chelsea,1-0,1,0,1,1,1,1,H
2012-03-03,2011,Wigan Athletic,Swansea City,0-2,0,2,1,1,2,-2,A
2012-03-04,2011,Fulham,Wolverhampton Wanderers,5-0,5,0,1,1,5,5,H
2012-03-04,2011,Newcastle United,Sunderland,1-1,1,1,1,1,2,0,D
2012-03-04,2011,Tottenham Hotspur,Manchester United,1-3,1,3,1,1,4,-2,A
2012-03-10,2011,Aston Villa,Fulham,1-0,1,0,1,1,1,1,H
2012-03-10,2011,Bolton Wanderers,Queens Park Rangers,2-1,2,1,1,1,3,1,H
2012-03-10,2011,Chelsea,Stoke City,1-0,1,0,1,1,1,1,H
2012-03-10,2011,Everton,Tottenham Hotspur,1-0,1,0,1,1,1,1,H
2012-03-10,2011,Sunderland,Liverpool,1-0,1,0,1,1,1,1,H
2012-03-10,2011,Wolverhampton Wanderers,Blackburn Rovers,0-2,0,2,1,1,2,-2,A
2012-03-11,2011,Manchester United,West Bromwich Albion,2-0,2,0,1,1,2,2,H
2012-03-11,2011,Norwich City,Wigan Athletic,1-1,1,1,1,1,2,0,D
2012-03-11,2011,Swansea City,Manchester City,1-0,1,0,1,1,1,1,H
2012-03-12,2011,Arsenal,Newcastle United,2-1,2,1,1,1,3,1,H
2012-03-13,2011,Liverpool,Everton,3-0,3,0,1,1,3,3,H
2012-03-17,2011,Fulham,Swansea City,0-3,0,3,1,1,3,-3,A
2012-03-17,2011,Wigan Athletic,West Bromwich Albion,1-1,1,1,1,1,2,0,D
2012-03-18,2011,Newcastle United,Norwich City,1-0,1,0,1,1,1,1,H
2012-03-18,2011,Wolverhampton Wanderers,Manchester United,0-5,0,5,1,1,5,-5,A
2012-03-20,2011,Blackburn Rovers,Sunderland,2-0,2,0,1,1,2,2,H
2012-03-21,2011,Everton,Arsenal,0-1,0,1,1,1,1,-1,A
2012-03-21,2011,Manchester City,Chelsea,2-1,2,1,1,1,3,1,H
2012-03-21,2011,Queens Park Rangers,Liverpool,3-2,3,2,1,1,5,1,H
2012-03-21,2011,Tottenham Hotspur,Stoke City,1-1,1,1,1,1,2,0,D
2012-03-24,2011,Arsenal,Aston Villa,3-0,3,0,1,1,3,3,H
2012-03-24,2011,Bolton Wanderers,Blackburn Rovers,2-1,2,1,1,1,3,1,H
2012-03-24,2011,Chelsea,Tottenham Hotspur,0-0,0,0,1,1,0,0,D
2012-03-24,2011,Liverpool,Wigan Athletic,1-2,1,2,1,1,3,-1,A
2012-03-24,2011,Norwich City,Wolverhampton Wanderers,2-1,2,1,1,1,3,1,H
2012-03-24,2011,Stoke City,Manchester City,1-1,1,1,1,1,2,0,D
2012-03-24,2011,Sunderland,Queens Park Rangers,3-1,3,1,1,1,4,2,H
2012-03-24,2011,Swansea City,Everton,0-2,0,2,1,1,2,-2,A
2012-03-25,2011,West Bromwich Albion,Newcastle United,1-3,1,3,1,1,4,-2,A
2012-03-26,2011,Manchester United,Fulham,1-0,1,0,1,1,1,1,H
2012-03-31,2011,Aston Villa,Chelsea,2-4,2,4,1,1,6,-2,A
2012-03-31,2011,Everton,West Bromwich Albion,2-0,2,0,1,1,2,2,H
2012-03-31,2011,Fulham,Norwich City,2-1,2,1,1,1,3,1,H
2012-03-31,2011,Manchester City,Sunderland,3-3,3,3,1,1,6,0,D
2012-03-31,2011,Queens Park Rangers,Arsenal,2-1,2,1,1,1,3,1,H
2012-03-31,2011,Wigan Athletic,Stoke City,2-0,2,0,1,1,2,2,H
2012-03-31,2011,Wolverhampton Wanderers,Bolton Wanderers,2-3,2,3,1,1,5,-1,A
2012-04-01,2011,Newcastle United,Liverpool,2-0,2,0,1,1,2,2,H
2012-04-01,2011,Tottenham Hotspur,Swansea City,3-1,3,1,1,1,4,2,H
2012-04-02,2011,Blackburn Rovers,Manchester United,0-2,0,2,1,1,2,-2,A
2012-04-06,2011,Swansea City,Newcastle United,0-2,0,2,1,1,2,-2,A
2012-04-07,2011,Bolton Wanderers,Fulham,0-3,0,3,1,1,3,-3,A
2012-04-07,2011,Chelsea,Wigan Athletic,2-1,2,1,1,1,3,1,H
2012-04-07,2011,Liverpool,Aston Villa,1-1,1,1,1,1,2,0,D
2012-04-07,2011,Norwich City,Everton,2-2,2,2,1,1,4,0,D
2012-04-07,2011,Stoke City,Wolverhampton Wanderers,2-1,2,1,1,1,3,1,H
2012-04-07,2011,Sunderland,Tottenham Hotspur,0-0,0,0,1,1,0,0,D
2012-04-07,2011,West Bromwich Albion,Blackburn Rovers,3-0,3,0,1,1,3,3,H
2012-04-08,2011,Arsenal,Manchester City,1-0,1,0,1,1,1,1,H
2012-04-08,2011,Manchester United,Queens Park Rangers,2-0,2,0,1,1,2,2,H
2012-04-09,2011,Aston Villa,Stoke City,1-1,1,1,1,1,2,0,D
2012-04-09,2011,Everton,Sunderland,4-0,4,0,1,1,4,4,H
2012-04-09,2011,Fulham,Chelsea,1-1,1,1,1,1,2,0,D
2012-04-09,2011,Newcastle United,Bolton Wanderers,2-0,2,0,1,1,2,2,H
2012-04-09,2011,Tottenham Hotspur,Norwich City,1-2,1,2,1,1,3,-1,A
2012-04-10,2011,Blackburn Rovers,Liverpool,2-3,2,3,1,1,5,-1,A
2012-04-11,2011,Manchester City,West Bromwich Albion,4-0,4,0,1,1,4,4,H
2012-04-11,2011,Queens Park Rangers,Swansea City,3-0,3,0,1,1,3,3,H
2012-04-11,2011,Wigan Athletic,Manchester United,1-0,1,0,1,1,1,1,H
2012-04-11,2011,Wolverhampton Wanderers,Arsenal,0-3,0,3,1,1,3,-3,A
2012-04-14,2011,Norwich City,Manchester City,1-6,1,6,1,1,7,-5,A
2012-04-14,2011,Sunderland,Wolverhampton Wanderers,0-0,0,0,1,1,0,0,D
2012-04-14,2011,Swansea City,Blackburn Rovers,3-0,3,0,1,1,3,3,H
2012-04-14,2011,West Bromwich Albion,Queens Park Rangers,1-0,1,0,1,1,1,1,H
2012-04-15,2011,Manchester United,Aston Villa,4-0,4,0,1,1,4,4,H
2012-04-16,2011,Arsenal,Wigan Athletic,1-2,1,2,1,1,3,-1,A
2012-04-21,2011,Arsenal,Chelsea,0-0,0,0,1,1,0,0,D
2012-04-21,2011,Aston Villa,Sunderland,0-0,0,0,1,1,0,0,D
2012-04-21,2011,Blackburn Rovers,Norwich City,2-0,2,0,1,1,2,2,H
2012-04-21,2011,Bolton Wanderers,Swansea City,1-1,1,1,1,1,2,0,D
2012-04-21,2011,Fulham,Wigan Athletic,2-1,2,1,1,1,3,1,H
2012-04-21,2011,Newcastle United,Stoke City,3-0,3,0,1,1,3,3,H
2012-04-21,2011,Queens Park Rangers,Tottenham Hotspur,1-0,1,0,1,1,1,1,H
2012-04-22,2011,Liverpool,West Bromwich Albion,0-1,0,1,1,1,1,-1,A
2012-04-22,2011,Manchester United,Everton,4-4,4,4,1,1,8,0,D
2012-04-22,2011,Wolverhampton Wanderers,Manchester City,0-2,0,2,1,1,2,-2,A
2012-04-24,2011,Aston Villa,Bolton Wanderers,1-2,1,2,1,1,3,-1,A
2012-04-28,2011,Everton,Fulham,4-0,4,0,1,1,4,4,H
2012-04-28,2011,Norwich City,Liverpool,0-3,0,3,1,1,3,-3,A
2012-04-28,2011,Stoke City,Arsenal,1-1,1,1,1,1,2,0,D
2012-04-28,2011,Sunderland,Bolton Wanderers,2-2,2,2,1,1,4,0,D
2012-04-28,2011,Swansea City,Wolverhampton Wanderers,4-4,4,4,1,1,8,0,D
2012-04-28,2011,West Bromwich Albion,Aston Villa,0-0,0,0,1,1,0,0,D
2012-04-28,2011,Wigan Athletic,Newcastle United,4-0,4,0,1,1,4,4,H
2012-04-29,2011,Chelsea,Queens Park Rangers,6-1,6,1,1,1,7,5,H
2012-04-29,2011,Tottenham Hotspur,Blackburn Rovers,2-0,2,0,1,1,2,2,H
2012-04-30,2011,Manchester City,Manchester United,1-0,1,0,1,1,1,1,H
2012-05-01,2011,Liverpool,Fulham,0-1,0,1,1,1,1,-1,A
2012-05-01,2011,Stoke City,Everton,1-1,1,1,1,1,2,0,D
2012-05-02,2011,Bolton Wanderers,Tottenham Hotspur,1-4,1,4,1,1,5,-3,A
2012-05-02,2011,Chelsea,Newcastle United,0-2,0,2,1,1,2,-2,A
2012-05-05,2011,Arsenal,Norwich City,3-3,3,3,1,1,6,0,D
2012-05-06,2011,Aston Villa,Tottenham Hotspur,1-1,1,1,1,1,2,0,D
2012-05-06,2011,Bolton Wanderers,West Bromwich Albion,2-2,2,2,1,1,4,0,D
2012-05-06,2011,Fulham,Sunderland,2-1,2,1,1,1,3,1,H
2012-05-06,2011,Manchester United,Swansea City,2-0,2,0,1,1,2,2,H
2012-05-06,2011,Newcastle United,Manchester City,0-2,0,2,1,1,2,-2,A
2012-05-06,2011,Queens Park Rangers,Stoke City,1-0,1,0,1,1,1,1,H
2012-05-06,2011,Wolverhampton Wanderers,Everton,0-0,0,0,1,1,0,0,D
2012-05-07,2011,Blackburn Rovers,Wigan Athletic,0-1,0,1,1,1,1,-1,A
2012-05-08,2011,Liverpool,Chelsea,4-1,4,1,1,1,5,3,H
2012-05-13,2011,Chelsea,Blackburn Rovers,2-1,2,1,1,1,3,1,H
2012-05-13,2011,Everton,Newcastle United,3-1,3,1,1,1,4,2,H
2012-05-13,2011,Manchester City,Queens Park Rangers,3-2,3,2,1,1,5,1,H
2012-05-13,2011,Norwich City,Aston Villa,2-0,2,0,1,1,2,2,H
2012-05-13,2011,Stoke City,Bolton Wanderers,2-2,2,2,1,1,4,0,D
2012-05-13,2011,Sunderland,Manchester United,0-1,0,1,1,1,1,-1,A
2012-05-13,2011,Swansea City,Liverpool,1-0,1,0,1,1,1,1,H
2012-05-13,2011,Tottenham Hotspur,Fulham,2-0,2,0,1,1,2,2,H
2012-05-13,2011,West Bromwich Albion,Arsenal,2-3,2,3,1,1,5,-1,A
2012-05-13,2011,Wigan Athletic,Wolverhampton Wanderers,3-2,3,2,1,1,5,1,H
2012-08-18,2012,Arsenal,Sunderland,0-0,0,0,1,1,0,0,D
2012-08-18,2012,Fulham,Norwich City,5-0,5,0,1,1,5,5,H
2012-08-18,2012,Newcastle United,Tottenham Hotspur,2-1,2,1,1,1,3,1,H
2012-08-18,2012,Queens Park Rangers,Swansea City,0-5,0,5,1,1,5,-5,A
2012-08-18,2012,Reading,Stoke City,1-1,1,1,1,1,2,0,D
2012-08-18,2012,West Bromwich Albion,Liverpool,3-0,3,0,1,1,3,3,H
2012-08-18,2012,West Ham United,Aston Villa,1-0,1,0,1,1,1,1,H
2012-08-19,2012,Manchester City,Southampton,3-2,3,2,1,1,5,1,H
2012-08-19,2012,Wigan Athletic,Chelsea,0-2,0,2,1,1,2,-2,A
2012-08-20,2012,Everton,Manchester United,1-0,1,0,1,1,1,1,H
2012-08-22,2012,Chelsea,Reading,4-2,4,2,1,1,6,2,H
2012-08-25,2012,Aston Villa,Everton,1-3,1,3,1,1,4,-2,A
2012-08-25,2012,Chelsea,Newcastle United,2-0,2,0,1,1,2,2,H
2012-08-25,2012,Manchester United,Fulham,3-2,3,2,1,1,5,1,H
2012-08-25,2012,Norwich City,Queens Park Rangers,1-1,1,1,1,1,2,0,D
2012-08-25,2012,Southampton,Wigan Athletic,0-2,0,2,1,1,2,-2,A
2012-08-25,2012,Swansea City,West Ham United,3-0,3,0,1,1,3,3,H
2012-08-25,2012,Tottenham Hotspur,West Bromwich Albion,1-1,1,1,1,1,2,0,D
2012-08-26,2012,Liverpool,Manchester City,2-2,2,2,1,1,4,0,D
2012-08-26,2012,Stoke City,Arsenal,0-0,0,0,1,1,0,0,D
2012-09-01,2012,Manchester City,Queens Park Rangers,3-1,3,1,1,1,4,2,H
2012-09-01,2012,Swansea City,Sunderland,2-2,2,2,1,1,4,0,D
2012-09-01,2012,Tottenham Hotspur,Norwich City,1-1,1,1,1,1,2,0,D
2012-09-01,2012,West Bromwich Albion,Everton,2-0,2,0,1,1,2,2,H
2012-09-01,2012,West Ham United,Fulham,3-0,3,0,1,1,3,3,H
2012-09-01,2012,Wigan Athletic,Stoke City,2-2,2,2,1,1,4,0,D
2012-09-02,2012,Liverpool,Arsenal,0-2,0,2,1,1,2,-2,A
2012-09-02,2012,Newcastle United,Aston Villa,1-1,1,1,1,1,2,0,D
2012-09-02,2012,Southampton,Manchester United,2-3,2,3,1,1,5,-1,A
2012-09-15,2012,Arsenal,Southampton,6-1,6,1,1,1,7,5,H
2012-09-15,2012,Aston Villa,Swansea City,2-0,2,0,1,1,2,2,H
2012-09-15,2012,Fulham,West Bromwich Albion,3-0,3,0,1,1,3,3,H
2012-09-15,2012,Manchester United,Wigan Athletic,4-0,4,0,1,1,4,4,H
2012-09-15,2012,Norwich City,West Ham United,0-0,0,0,1,1,0,0,D
2012-09-15,2012,Queens Park Rangers,Chelsea,0-0,0,0,1,1,0,0,D
2012-09-15,2012,Stoke City,Manchester City,1-1,1,1,1,1,2,0,D
2012-09-15,2012,Sunderland,Liverpool,1-1,1,1,1,1,2,0,D
2012-09-16,2012,Reading,Tottenham Hotspur,1-3,1,3,1,1,4,-2,A
2012-09-17,2012,Everton,Newcastle United,2-2,2,2,1,1,4,0,D
2012-09-22,2012,Chelsea,Stoke City,1-0,1,0,1,1,1,1,H
2012-09-22,2012,Southampton,Aston Villa,4-1,4,1,1,1,5,3,H
2012-09-22,2012,Swansea City,Everton,0-3,0,3,1,1,3,-3,A
2012-09-22,2012,West Bromwich Albion,Reading,1-0,1,0,1,1,1,1,H
2012-09-22,2012,West Ham United,Sunderland,1-1,1,1,1,1,2,0,D
2012-09-22,2012,Wigan Athletic,Fulham,1-2,1,2,1,1,3,-1,A
2012-09-23,2012,Liverpool,Manchester United,1-2,1,2,1,1,3,-1,A
2012-09-23,2012,Manchester City,Arsenal,1-1,1,1,1,1,2,0,D
2012-09-23,2012,Newcastle United,Norwich City,1-0,1,0,1,1,1,1,H
2012-09-23,2012,Tottenham Hotspur,Queens Park Rangers,2-1,2,1,1,1,3,1,H
2012-09-29,2012,Arsenal,Chelsea,1-2,1,2,1,1,3,-1,A
2012-09-29,2012,Everton,Southampton,3-1,3,1,1,1,4,2,H
2012-09-29,2012,Fulham,Manchester City,1-2,1,2,1,1,3,-1,A
2012-09-29,2012,Manchester United,Tottenham Hotspur,2-3,2,3,1,1,5,-1,A
2012-09-29,2012,Norwich City,Liverpool,2-5,2,5,1,1,7,-3,A
2012-09-29,2012,Reading,Newcastle United,2-2,2,2,1,1,4,0,D
2012-09-29,2012,Stoke City,Swansea City,2-0,2,0,1,1,2,2,H
2012-09-29,2012,Sunderland,Wigan Athletic,1-0,1,0,1,1,1,1,H
2012-09-30,2012,Aston Villa,West Bromwich Albion,1-1,1,1,1,1,2,0,D
2012-10-01,2012,Queens Park Rangers,West Ham United,1-2,1,2,1,1,3,-1,A
2012-10-06,2012,Chelsea,Norwich City,4-1,4,1,1,1,5,3,H
2012-10-06,2012,Manchester City,Sunderland,3-0,3,0,1,1,3,3,H
2012-10-06,2012,Swansea City,Reading,2-2,2,2,1,1,4,0,D
2012-10-06,2012,West Bromwich Albion,Queens Park Rangers,3-2,3,2,1,1,5,1,H
2012-10-06,2012,West Ham United,Arsenal,1-3,1,3,1,1,4,-2,A
2012-10-06,2012,Wigan Athletic,Everton,2-2,2,2,1,1,4,0,D
2012-10-07,2012,Liverpool,Stoke City,0-0,0,0,1,1,0,0,D
2012-10-07,2012,Newcastle United,Manchester United,0-3,0,3,1,1,3,-3,A
2012-10-07,2012,Southampton,Fulham,2-2,2,2,1,1,4,0,D
2012-10-07,2012,Tottenham Hotspur,Aston Villa,2-0,2,0,1,1,2,2,H
2012-10-20,2012,Fulham,Aston Villa,1-0,1,0,1,1,1,1,H
2012-10-20,2012,Liverpool,Reading,1-0,1,0,1,1,1,1,H
2012-10-20,2012,Manchester United,Stoke City,4-2,4,2,1,1,6,2,H
2012-10-20,2012,Norwich City,Arsenal,1-0,1,0,1,1,1,1,H
2012-10-20,2012,Swansea City,Wigan Athletic,2-1,2,1,1,1,3,1,H
2012-10-20,2012,Tottenham Hotspur,Chelsea,2-4,2,4,1,1,6,-2,A
2012-10-20,2012,West Bromwich Albion,Manchester City,1-2,1,2,1,1,3,-1,A
2012-10-20,2012,West Ham United,Southampton,4-1,4,1,1,1,5,3,H
2012-10-21,2012,Queens Park Rangers,Everton,1-1,1,1,1,1,2,0,D
2012-10-21,2012,Sunderland,Newcastle United,1-1,1,1,1,1,2,0,D
2012-10-27,2012,Arsenal,Queens Park Rangers,1-0,1,0,1,1,1,1,H
2012-10-27,2012,Aston Villa,Norwich City,1-1,1,1,1,1,2,0,D
2012-10-27,2012,Manchester City,Swansea City,1-0,1,0,1,1,1,1,H
2012-10-27,2012,Reading,Fulham,3-3,3,3,1,1,6,0,D
2012-10-27,2012,Stoke City,Sunderland,0-0,0,0,1,1,0,0,D
2012-10-27,2012,Wigan Athletic,West Ham United,2-1,2,1,1,1,3,1,H
2012-10-28,2012,Chelsea,Manchester United,2-3,2,3,1,1,5,-1,A
2012-10-28,2012,Everton,Liverpool,2-2,2,2,1,1,4,0,D
2012-10-28,2012,Newcastle United,West Bromwich Albion,2-1,2,1,1,1,3,1,H
2012-10-28,2012,Southampton,Tottenham Hotspur,1-2,1,2,1,1,3,-1,A
2012-11-03,2012,Fulham,Everton,2-2,2,2,1,1,4,0,D
2012-11-03,2012,Manchester United,Arsenal,2-1,2,1,1,1,3,1,H
2012-11-03,2012,Norwich City,Stoke City,1-0,1,0,1,1,1,1,H
2012-11-03,2012,Sunderland,Aston Villa,0-1,0,1,1,1,1,-1,A
2012-11-03,2012,Swansea City,Chelsea,1-1,1,1,1,1,2,0,D
2012-11-03,2012,Tottenham Hotspur,Wigan Athletic,0-1,0,1,1,1,1,-1,A
2012-11-03,2012,West Ham United,Manchester City,0-0,0,0,1,1,0,0,D
2012-11-04,2012,Liverpool,Newcastle United,1-1,1,1,1,1,2,0,D
2012-11-04,2012,Queens Park Rangers,Reading,1-1,1,1,1,1,2,0,D
2012-11-05,2012,West Bromwich Albion,Southampton,2-0,2,0,1,1,2,2,H
2012-11-10,2012,Arsenal,Fulham,3-3,3,3,1,1,6,0,D
2012-11-10,2012,Aston Villa,Manchester United,2-3,2,3,1,1,5,-1,A
2012-11-10,2012,Everton,Sunderland,2-1,2,1,1,1,3,1,H
2012-11-10,2012,Reading,Norwich City,0-0,0,0,1,1,0,0,D
2012-11-10,2012,Southampton,Swansea City,1-1,1,1,1,1,2,0,D
2012-11-10,2012,Stoke City,Queens Park Rangers,1-0,1,0,1,1,1,1,H
2012-11-10,2012,Wigan Athletic,West Bromwich Albion,1-2,1,2,1,1,3,-1,A
2012-11-11,2012,Chelsea,Liverpool,1-1,1,1,1,1,2,0,D
2012-11-11,2012,Manchester City,Tottenham Hotspur,2-1,2,1,1,1,3,1,H
2012-11-11,2012,Newcastle United,West Ham United,0-1,0,1,1,1,1,-1,A
2012-11-17,2012,Arsenal,Tottenham Hotspur,5-2,5,2,1,1,7,3,H
2012-11-17,2012,Liverpool,Wigan Athletic,3-0,3,0,1,1,3,3,H
2012-11-17,2012,Manchester City,Aston Villa,5-0,5,0,1,1,5,5,H
2012-11-17,2012,Newcastle United,Swansea City,1-2,1,2,1,1,3,-1,A
2012-11-17,2012,Norwich City,Manchester United,1-0,1,0,1,1,1,1,H
2012-11-17,2012,Queens Park Rangers,Southampton,1-3,1,3,1,1,4,-2,A
2012-11-17,2012,Reading,Everton,2-1,2,1,1,1,3,1,H
2012-11-17,2012,West Bromwich Albion,Chelsea,2-1,2,1,1,1,3,1,H
2012-11-18,2012,Fulham,Sunderland,1-3,1,3,1,1,4,-2,A
2012-11-19,2012,West Ham United,Stoke City,1-1,1,1,1,1,2,0,D
2012-11-24,2012,Aston Villa,Arsenal,0-0,0,0,1,1,0,0,D
2012-11-24,2012,Everton,Norwich City,1-1,1,1,1,1,2,0,D
2012-11-24,2012,Manchester United,Queens Park Rangers,3-1,3,1,1,1,4,2,H
2012-11-24,2012,Stoke City,Fulham,1-0,1,0,1,1,1,1,H
2012-11-24,2012,Sunderland,West Bromwich Albion,2-4,2,4,1,1,6,-2,A
2012-11-24,2012,Wigan Athletic,Reading,3-2,3,2,1,1,5,1,H
2012-11-25,2012,Chelsea,Manchester City,0-0,0,0,1,1,0,0,D
2012-11-25,2012,Southampton,Newcastle United,2-0,2,0,1,1,2,2,H
2012-11-25,2012,Swansea City,Liverpool,0-0,0,0,1,1,0,0,D
2012-11-25,2012,Tottenham Hotspur,West Ham United,3-1,3,1,1,1,4,2,H
2012-11-27,2012,Aston Villa,Reading,1-0,1,0,1,1,1,1,H
2012-11-27,2012,Sunderland,Queens Park Rangers,0-0,0,0,1,1,0,0,D
2012-11-28,2012,Chelsea,Fulham,0-0,0,0,1,1,0,0,D
2012-11-28,2012,Everton,Arsenal,1-1,1,1,1,1,2,0,D
2012-11-28,2012,Manchester United,West Ham United,1-0,1,0,1,1,1,1,H
2012-11-28,2012,Southampton,Norwich City,1-1,1,1,1,1,2,0,D
2012-11-28,2012,Stoke City,Newcastle United,2-1,2,1,1,1,3,1,H
2012-11-28,2012,Swansea City,West Bromwich Albion,3-1,3,1,1,1,4,2,H
2012-11-28,2012,Tottenham Hotspur,Liverpool,2-1,2,1,1,1,3,1,H
2012-11-28,2012,Wigan Athletic,Manchester City,0-2,0,2,1,1,2,-2,A
2012-12-01,2012,Arsenal,Swansea City,0-2,0,2,1,1,2,-2,A
2012-12-01,2012,Fulham,Tottenham Hotspur,0-3,0,3,1,1,3,-3,A
2012-12-01,2012,Liverpool,Southampton,1-0,1,0,1,1,1,1,H
2012-12-01,2012,Manchester City,Everton,1-1,1,1,1,1,2,0,D
2012-12-01,2012,Queens Park Rangers,Aston Villa,1-1,1,1,1,1,2,0,D
2012-12-01,2012,Reading,Manchester United,3-4,3,4,1,1,7,-1,A
2012-12-01,2012,West Bromwich Albion,Stoke City,0-1,0,1,1,1,1,-1,A
2012-12-01,2012,West Ham United,Chelsea,3-1,3,1,1,1,4,2,H
2012-12-02,2012,Norwich City,Sunderland,2-1,2,1,1,1,3,1,H
2012-12-03,2012,Newcastle United,Wigan Athletic,3-0,3,0,1,1,3,3,H
2012-12-08,2012,Arsenal,West Bromwich Albion,2-0,2,0,1,1,2,2,H
2012-12-08,2012,Aston Villa,Stoke City,0-0,0,0,1,1,0,0,D
2012-12-08,2012,Southampton,Reading,1-0,1,0,1,1,1,1,H
2012-12-08,2012,Sunderland,Chelsea,1-3,1,3,1,1,4,-2,A
2012-12-08,2012,Swansea City,Norwich City,3-4,3,4,1,1,7,-1,A
2012-12-08,2012,Wigan Athletic,Queens Park Rangers,2-2,2,2,1,1,4,0,D
2012-12-09,2012,Everton,Tottenham Hotspur,2-1,2,1,1,1,3,1,H
2012-12-09,2012,Manchester City,Manchester United,2-3,2,3,1,1,5,-1,A
2012-12-09,2012,West Ham United,Liverpool,2-3,2,3,1,1,5,-1,A
2012-12-10,2012,Fulham,Newcastle United,2-1,2,1,1,1,3,1,H
2012-12-11,2012,Sunderland,Reading,3-0,3,0,1,1,3,3,H
2012-12-15,2012,Liverpool,Aston Villa,1-3,1,3,1,1,4,-2,A
2012-12-15,2012,Manchester United,Sunderland,3-1,3,1,1,1,4,2,H
2012-12-15,2012,Newcastle United,Manchester City,1-3,1,3,1,1,4,-2,A
2012-12-15,2012,Norwich City,Wigan Athletic,2-1,2,1,1,1,3,1,H
2012-12-15,2012,Queens Park Rangers,Fulham,2-1,2,1,1,1,3,1,H
2012-12-15,2012,Stoke City,Everton,1-1,1,1,1,1,2,0,D
2012-12-16,2012,Tottenham Hotspur,Swansea City,1-0,1,0,1,1,1,1,H
2012-12-16,2012,West Bromwich Albion,West Ham United,0-0,0,0,1,1,0,0,D
2012-12-17,2012,Reading,Arsenal,2-5,2,5,1,1,7,-3,A
2012-12-22,2012,Liverpool,Fulham,4-0,4,0,1,1,4,4,H
2012-12-22,2012,Manchester City,Reading,1-0,1,0,1,1,1,1,H
2012-12-22,2012,Newcastle United,Queens Park Rangers,1-0,1,0,1,1,1,1,H
2012-12-22,2012,Southampton,Sunderland,0-1,0,1,1,1,1,-1,A
2012-12-22,2012,Tottenham Hotspur,Stoke City,0-0,0,0,1,1,0,0,D
2012-12-22,2012,West Bromwich Albion,Norwich City,2-1,2,1,1,1,3,1,H
2012-12-22,2012,West Ham United,Everton,1-2,1,2,1,1,3,-1,A
2012-12-22,2012,Wigan Athletic,Arsenal,0-1,0,1,1,1,1,-1,A
2012-12-23,2012,Chelsea,Aston Villa,8-0,8,0,1,1,8,8,H
2012-12-23,2012,Swansea City,Manchester United,1-1,1,1,1,1,2,0,D
2012-12-26,2012,Aston Villa,Tottenham Hotspur,0-4,0,4,1,1,4,-4,A
2012-12-26,2012,Everton,Wigan Athletic,2-1,2,1,1,1,3,1,H
2012-12-26,2012,Fulham,Southampton,1-1,1,1,1,1,2,0,D
2012-12-26,2012,Manchester United,Newcastle United,4-3,4,3,1,1,7,1,H
2012-12-26,2012,Norwich City,Chelsea,0-1,0,1,1,1,1,-1,A
2012-12-26,2012,Queens Park Rangers,West Bromwich Albion,1-2,1,2,1,1,3,-1,A
2012-12-26,2012,Reading,Swansea City,0-0,0,0,1,1,0,0,D
2012-12-26,2012,Stoke City,Liverpool,3-1,3,1,1,1,4,2,H
2012-12-26,2012,Sunderland,Manchester City,1-0,1,0,1,1,1,1,H
2012-12-29,2012,Arsenal,Newcastle United,7-3,7,3,1,1,10,4,H
2012-12-29,2012,Aston Villa,Wigan Athletic,0-3,0,3,1,1,3,-3,A
2012-12-29,2012,Fulham,Swansea City,1-2,1,2,1,1,3,-1,A
2012-12-29,2012,Manchester United,West Bromwich Albion,2-0,2,0,1,1,2,2,H
2012-12-29,2012,Norwich City,Manchester City,3-4,3,4,1,1,7,-1,A
2012-12-29,2012,Reading,West Ham United,1-0,1,0,1,1,1,1,H
2012-12-29,2012,Stoke City,Southampton,3-3,3,3,1,1,6,0,D
2012-12-29,2012,Sunderland,Tottenham Hotspur,1-2,1,2,1,1,3,-1,A
2012-12-30,2012,Everton,Chelsea,1-2,1,2,1,1,3,-1,A
2012-12-30,2012,Queens Park Rangers,Liverpool,0-3,0,3,1,1,3,-3,A
2013-01-01,2012,Manchester City,Stoke City,3-0,3,0,1,1,3,3,H
2013-01-01,2012,Southampton,Arsenal,1-1,1,1,1,1,2,0,D
2013-01-01,2012,Swansea City,Aston Villa,2-2,2,2,1,1,4,0,D
2013-01-01,2012,Tottenham Hotspur,Reading,3-1,3,1,1,1,4,2,H
2013-01-01,2012,West Bromwich Albion,Fulham,1-2,1,2,1,1,3,-1,A
2013-01-01,2012,West Ham United,Norwich City,2-1,2,1,1,1,3,1,H
2013-01-01,2012,Wigan Athletic,Manchester United,0-4,0,4,1,1,4,-4,A
2013-01-02,2012,Chelsea,Queens Park Rangers,0-1,0,1,1,1,1,-1,A
2013-01-02,2012,Liverpool,Sunderland,3-0,3,0,1,1,3,3,H
2013-01-02,2012,Newcastle United,Everton,1-2,1,2,1,1,3,-1,A
2013-01-12,2012,Aston Villa,Southampton,0-1,0,1,1,1,1,-1,A
2013-01-12,2012,Everton,Swansea City,0-0,0,0,1,1,0,0,D
2013-01-12,2012,Fulham,Wigan Athletic,1-1,1,1,1,1,2,0,D
2013-01-12,2012,Norwich City,Newcastle United,0-0,0,0,1,1,0,0,D
2013-01-12,2012,Queens Park Rangers,Tottenham Hotspur,0-0,0,0,1,1,0,0,D
2013-01-12,2012,Reading,West Bromwich Albion,3-2,3,2,1,1,5,1,H
2013-01-12,2012,Stoke City,Chelsea,0-4,0,4,1,1,4,-4,A
2013-01-12,2012,Sunderland,West Ham United,3-0,3,0,1,1,3,3,H
2013-01-13,2012,Arsenal,Manchester City,0-2,0,2,1,1,2,-2,A
2013-01-13,2012,Manchester United,Liverpool,2-1,2,1,1,1,3,1,H
2013-01-16,2012,Chelsea,Southampton,2-2,2,2,1,1,4,0,D
2013-01-19,2012,Liverpool,Norwich City,5-0,5,0,1,1,5,5,H
2013-01-19,2012,Manchester City,Fulham,2-0,2,0,1,1,2,2,H
2013-01-19,2012,Newcastle United,Reading,1-2,1,2,1,1,3,-1,A
2013-01-19,2012,Swansea City,Stoke City,3-1,3,1,1,1,4,2,H
2013-01-19,2012,West Bromwich Albion,Aston Villa,2-2,2,2,1,1,4,0,D
2013-01-19,2012,West Ham United,Queens Park Rangers,1-1,1,1,1,1,2,0,D
2013-01-19,2012,Wigan Athletic,Sunderland,2-3,2,3,1,1,5,-1,A
2013-01-20,2012,Chelsea,Arsenal,2-1,2,1,1,1,3,1,H
2013-01-20,2012,Tottenham Hotspur,Manchester United,1-1,1,1,1,1,2,0,D
2013-01-21,2012,Southampton,Everton,0-0,0,0,1,1,0,0,D
2013-01-23,2012,Arsenal,West Ham United,5-1,5,1,1,1,6,4,H
2013-01-29,2012,Aston Villa,Newcastle United,1-2,1,2,1,1,3,-1,A
2013-01-29,2012,Queens Park Rangers,Manchester City,0-0,0,0,1,1,0,0,D
2013-01-29,2012,Stoke City,Wigan Athletic,2-2,2,2,1,1,4,0,D
2013-01-29,2012,Sunderland,Swansea City,0-0,0,0,1,1,0,0,D
2013-01-30,2012,Arsenal,Liverpool,2-2,2,2,1,1,4,0,D
2013-01-30,2012,Everton,West Bromwich Albion,2-1,2,1,1,1,3,1,H
2013-01-30,2012,Fulham,West Ham United,3-1,3,1,1,1,4,2,H
2013-01-30,2012,Manchester United,Southampton,2-1,2,1,1,1,3,1,H
2013-01-30,2012,Norwich City,Tottenham Hotspur,1-1,1,1,1,1,2,0,D
2013-01-30,2012,Reading,Chelsea,2-2,2,2,1,1,4,0,D
2013-02-02,2012,Arsenal,Stoke City,1-0,1,0,1,1,1,1,H
2013-02-02,2012,Everton,Aston Villa,3-3,3,3,1,1,6,0,D
2013-02-02,2012,Fulham,Manchester United,0-1,0,1,1,1,1,-1,A
2013-02-02,2012,Newcastle United,Chelsea,3-2,3,2,1,1,5,1,H
2013-02-02,2012,Queens Park Rangers,Norwich City,0-0,0,0,1,1,0,0,D
2013-02-02,2012,Reading,Sunderland,2-1,2,1,1,1,3,1,H
2013-02-02,2012,West Ham United,Swansea City,1-0,1,0,1,1,1,1,H
2013-02-02,2012,Wigan Athletic,Southampton,2-2,2,2,1,1,4,0,D
2013-02-03,2012,Manchester City,Liverpool,2-2,2,2,1,1,4,0,D
2013-02-03,2012,West Bromwich Albion,Tottenham Hotspur,0-1,0,1,1,1,1,-1,A
2013-02-09,2012,Chelsea,Wigan Athletic,4-1,4,1,1,1,5,3,H
2013-02-09,2012,Norwich City,Fulham,0-0,0,0,1,1,0,0,D
2013-02-09,2012,Southampton,Manchester City,3-1,3,1,1,1,4,2,H
2013-02-09,2012,Stoke City,Reading,2-1,2,1,1,1,3,1,H
2013-02-09,2012,Sunderland,Arsenal,0-1,0,1,1,1,1,-1,A
2013-02-09,2012,Swansea City,Queens Park Rangers,4-1,4,1,1,1,5,3,H
2013-02-09,2012,Tottenham Hotspur,Newcastle United,2-1,2,1,1,1,3,1,H
2013-02-10,2012,Aston Villa,West Ham United,2-1,2,1,1,1,3,1,H
2013-02-10,2012,Manchester United,Everton,2-0,2,0,1,1,2,2,H
2013-02-11,2012,Liverpool,West Bromwich Albion,0-2,0,2,1,1,2,-2,A
2013-02-17,2012,Liverpool,Swansea City,5-0,5,0,1,1,5,5,H
2013-02-23,2012,Arsenal,Aston Villa,2-1,2,1,1,1,3,1,H
2013-02-23,2012,Fulham,Stoke City,1-0,1,0,1,1,1,1,H
2013-02-23,2012,Norwich City,Everton,2-1,2,1,1,1,3,1,H
2013-02-23,2012,Queens Park Rangers,Manchester United,0-2,0,2,1,1,2,-2,A
2013-02-23,2012,Reading,Wigan Athletic,0-3,0,3,1,1,3,-3,A
2013-02-23,2012,West Bromwich Albion,Sunderland,2-1,2,1,1,1,3,1,H
2013-02-24,2012,Manchester City,Chelsea,2-0,2,0,1,1,2,2,H
2013-02-24,2012,Newcastle United,Southampton,4-2,4,2,1,1,6,2,H
2013-02-25,2012,West Ham United,Tottenham Hotspur,2-3,2,3,1,1,5,-1,A
2013-03-02,2012,Chelsea,West Bromwich Albion,1-0,1,0,1,1,1,1,H
2013-03-02,2012,Everton,Reading,3-1,3,1,1,1,4,2,H
2013-03-02,2012,Manchester United,Norwich City,4-0,4,0,1,1,4,4,H
2013-03-02,2012,Southampton,Queens Park Rangers,1-2,1,2,1,1,3,-1,A
2013-03-02,2012,Stoke City,West Ham United,0-1,0,1,1,1,1,-1,A
2013-03-02,2012,Sunderland,Fulham,2-2,2,2,1,1,4,0,D
2013-03-02,2012,Swansea City,Newcastle United,1-0,1,0,1,1,1,1,H
2013-03-02,2012,Wigan Athletic,Liverpool,0-4,0,4,1,1,4,-4,A
2013-03-03,2012,Tottenham Hotspur,Arsenal,2-1,2,1,1,1,3,1,H
2013-03-04,2012,Aston Villa,Manchester City,0-1,0,1,1,1,1,-1,A
2013-03-09,2012,Norwich City,Southampton,0-0,0,0,1,1,0,0,D
2013-03-09,2012,Queens Park Rangers,Sunderland,3-1,3,1,1,1,4,2,H
2013-03-09,2012,Reading,Aston Villa,1-2,1,2,1,1,3,-1,A
2013-03-09,2012,West Bromwich Albion,Swansea City,2-1,2,1,1,1,3,1,H
2013-03-10,2012,Liverpool,Tottenham Hotspur,3-2,3,2,1,1,5,1,H
2013-03-10,2012,Newcastle United,Stoke City,2-1,2,1,1,1,3,1,H
2013-03-16,2012,Aston Villa,Queens Park Rangers,3-2,3,2,1,1,5,1,H
2013-03-16,2012,Everton,Manchester City,2-0,2,0,1,1,2,2,H
2013-03-16,2012,Manchester United,Reading,1-0,1,0,1,1,1,1,H
2013-03-16,2012,Southampton,Liverpool,3-1,3,1,1,1,4,2,H
2013-03-16,2012,Stoke City,West Bromwich Albion,0-0,0,0,1,1,0,0,D
2013-03-16,2012,Swansea City,Arsenal,0-2,0,2,1,1,2,-2,A
2013-03-17,2012,Chelsea,West Ham United,2-0,2,0,1,1,2,2,H
2013-03-17,2012,Sunderland,Norwich City,1-1,1,1,1,1,2,0,D
2013-03-17,2012,Tottenham Hotspur,Fulham,0-1,0,1,1,1,1,-1,A
2013-03-17,2012,Wigan Athletic,Newcastle United,2-1,2,1,1,1,3,1,H
2013-03-30,2012,Arsenal,Reading,4-1,4,1,1,1,5,3,H
2013-03-30,2012,Everton,Stoke City,1-0,1,0,1,1,1,1,H
2013-03-30,2012,Manchester City,Newcastle United,4-0,4,0,1,1,4,4,H
2013-03-30,2012,Southampton,Chelsea,2-1,2,1,1,1,3,1,H
2013-03-30,2012,Sunderland,Manchester United,0-1,0,1,1,1,1,-1,A
2013-03-30,2012,Swansea City,Tottenham Hotspur,1-2,1,2,1,1,3,-1,A
2013-03-30,2012,West Ham United,West Bromwich Albion,3-1,3,1,1,1,4,2,H
2013-03-30,2012,Wigan Athletic,Norwich City,1-0,1,0,1,1,1,1,H
2013-03-31,2012,Aston Villa,Liverpool,1-2,1,2,1,1,3,-1,A
2013-04-01,2012,Fulham,Queens Park Rangers,3-2,3,2,1,1,5,1,H
2013-04-06,2012,Norwich City,Swansea City,2-2,2,2,1,1,4,0,D
2013-04-06,2012,Reading,Southampton,0-2,0,2,1,1,2,-2,A
2013-04-06,2012,Stoke City,Aston Villa,1-3,1,3,1,1,4,-2,A
2013-04-06,2012,West Bromwich Albion,Arsenal,1-2,1,2,1,1,3,-1,A
2013-04-07,2012,Chelsea,Sunderland,2-1,2,1,1,1,3,1,H
2013-04-07,2012,Liverpool,West Ham United,0-0,0,0,1,1,0,0,D
2013-04-07,2012,Newcastle United,Fulham,1-0,1,0,1,1,1,1,H
2013-04-07,2012,Queens Park Rangers,Wigan Athletic,1-1,1,1,1,1,2,0,D
2013-04-07,2012,Tottenham Hotspur,Everton,2-2,2,2,1,1,4,0,D
2013-04-08,2012,Manchester United,Manchester City,1-2,1,2,1,1,3,-1,A
2013-04-13,2012,Arsenal,Norwich City,3-1,3,1,1,1,4,2,H
2013-04-13,2012,Aston Villa,Fulham,1-1,1,1,1,1,2,0,D
2013-04-13,2012,Everton,Queens Park Rangers,2-0,2,0,1,1,2,2,H
2013-04-13,2012,Reading,Liverpool,0-0,0,0,1,1,0,0,D
2013-04-13,2012,Southampton,West Ham United,1-1,1,1,1,1,2,0,D
2013-04-14,2012,Newcastle United,Sunderland,0-3,0,3,1,1,3,-3,A
2013-04-14,2012,Stoke City,Manchester United,0-2,0,2,1,1,2,-2,A
2013-04-16,2012,Arsenal,Everton,0-0,0,0,1,1,0,0,D
2013-04-17,2012,Fulham,Chelsea,0-3,0,3,1,1,3,-3,A
2013-04-17,2012,Manchester City,Wigan Athletic,1-0,1,0,1,1,1,1,H
2013-04-17,2012,West Ham United,Manchester United,2-2,2,2,1,1,4,0,D
2013-04-20,2012,Fulham,Arsenal,0-1,0,1,1,1,1,-1,A
2013-04-20,2012,Norwich City,Reading,2-1,2,1,1,1,3,1,H
2013-04-20,2012,Queens Park Rangers,Stoke City,0-2,0,2,1,1,2,-2,A
2013-04-20,2012,Sunderland,Everton,1-0,1,0,1,1,1,1,H
2013-04-20,2012,Swansea City,Southampton,0-0,0,0,1,1,0,0,D
2013-04-20,2012,West Bromwich Albion,Newcastle United,1-1,1,1,1,1,2,0,D
2013-04-20,2012,West Ham United,Wigan Athletic,2-0,2,0,1,1,2,2,H
2013-04-21,2012,Liverpool,Chelsea,2-2,2,2,1,1,4,0,D
2013-04-21,2012,Tottenham Hotspur,Manchester City,3-1,3,1,1,1,4,2,H
2013-04-22,2012,Manchester United,Aston Villa,3-0,3,0,1,1,3,3,H
2013-04-27,2012,Everton,Fulham,1-0,1,0,1,1,1,1,H
2013-04-27,2012,Manchester City,West Ham United,2-1,2,1,1,1,3,1,H
2013-04-27,2012,Newcastle United,Liverpool,0-6,0,6,1,1,6,-6,A
2013-04-27,2012,Southampton,West Bromwich Albion,0-3,0,3,1,1,3,-3,A
2013-04-27,2012,Stoke City,Norwich City,1-0,1,0,1,1,1,1,H
2013-04-27,2012,Wigan Athletic,Tottenham Hotspur,2-2,2,2,1,1,4,0,D
2013-04-28,2012,Arsenal,Manchester United,1-1,1,1,1,1,2,0,D
2013-04-28,2012,Chelsea,Swansea City,2-0,2,0,1,1,2,2,H
2013-04-28,2012,Reading,Queens Park Rangers,0-0,0,0,1,1,0,0,D
2013-04-29,2012,Aston Villa,Sunderland,6-1,6,1,1,1,7,5,H
2013-05-04,2012,Fulham,Reading,2-4,2,4,1,1,6,-2,A
2013-05-04,2012,Norwich City,Aston Villa,1-2,1,2,1,1,3,-1,A
2013-05-04,2012,Queens Park Rangers,Arsenal,0-1,0,1,1,1,1,-1,A
2013-05-04,2012,Swansea City,Manchester City,0-0,0,0,1,1,0,0,D
2013-05-04,2012,Tottenham Hotspur,Southampton,1-0,1,0,1,1,1,1,H
2013-05-04,2012,West Bromwich Albion,Wigan Athletic,2-3,2,3,1,1,5,-1,A
2013-05-04,2012,West Ham United,Newcastle United,0-0,0,0,1,1,0,0,D
2013-05-05,2012,Liverpool,Everton,0-0,0,0,1,1,0,0,D
2013-05-05,2012,Manchester United,Chelsea,0-1,0,1,1,1,1,-1,A
2013-05-06,2012,Sunderland,Stoke City,1-1,1,1,1,1,2,0,D
2013-05-07,2012,Manchester City,West Bromwich Albion,1-0,1,0,1,1,1,1,H
2013-05-07,2012,Wigan Athletic,Swansea City,2-3,2,3,1,1,5,-1,A
2013-05-08,2012,Chelsea,Tottenham Hotspur,2-2,2,2,1,1,4,0,D
2013-05-11,2012,Aston Villa,Chelsea,1-2,1,2,1,1,3,-1,A
2013-05-12,2012,Everton,West Ham United,2-0,2,0,1,1,2,2,H
2013-05-12,2012,Fulham,Liverpool,1-3,1,3,1,1,4,-2,A
2013-05-12,2012,Manchester United,Swansea City,2-1,2,1,1,1,3,1,H
2013-05-12,2012,Norwich City,West Bromwich Albion,4-0,4,0,1,1,4,4,H
2013-05-12,2012,Queens Park Rangers,Newcastle United,1-2,1,2,1,1,3,-1,A
2013-05-12,2012,Stoke City,Tottenham Hotspur,1-2,1,2,1,1,3,-1,A
2013-05-12,2012,Sunderland,Southampton,1-1,1,1,1,1,2,0,D
2013-05-14,2012,Arsenal,Wigan Athletic,4-1,4,1,1,1,5,3,H
2013-05-14,2012,Reading,Manchester City,0-2,0,2,1,1,2,-2,A
2013-05-19,2012,Chelsea,Everton,2-1,2,1,1,1,3,1,H
2013-05-19,2012,Liverpool,Queens Park Rangers,1-0,1,0,1,1,1,1,H
2013-05-19,2012,Manchester City,Norwich City,2-3,2,3,1,1,5,-1,A
2013-05-19,2012,Newcastle United,Arsenal,0-1,0,1,1,1,1,-1,A
2013-05-19,2012,Southampton,Stoke City,1-1,1,1,1,1,2,0,D
2013-05-19,2012,Swansea City,Fulham,0-3,0,3,1,1,3,-3,A
2013-05-19,2012,Tottenham Hotspur,Sunderland,1-0,1,0,1,1,1,1,H
2013-05-19,2012,West Bromwich Albion,Manchester United,5-5,5,5,1,1,10,0,D
2013-05-19,2012,West Ham United,Reading,4-2,4,2,1,1,6,2,H
2013-05-19,2012,Wigan Athletic,Aston Villa,2-2,2,2,1,1,4,0,D
2013-08-17,2013,Arsenal,Aston Villa,1-3,1,3,1,1,4,-2,A
2013-08-17,2013,Liverpool,Stoke City,1-0,1,0,1,1,1,1,H
2013-08-17,2013,Norwich City,Everton,2-2,2,2,1,1,4,0,D
2013-08-17,2013,Sunderland,Fulham,0-1,0,1,1,1,1,-1,A
2013-08-17,2013,Swansea City,Manchester United,1-4,1,4,1,1,5,-3,A
2013-08-17,2013,West Bromwich Albion,Southampton,0-1,0,1,1,1,1,-1,A
2013-08-17,2013,West Ham United,Cardiff City,2-0,2,0,1,1,2,2,H
2013-08-18,2013,Chelsea,Hull City,2-0,2,0,1,1,2,2,H
2013-08-18,2013,Crystal Palace,Tottenham Hotspur,0-1,0,1,1,1,1,-1,A
2013-08-19,2013,Manchester City,Newcastle United,4-0,4,0,1,1,4,4,H
2013-08-21,2013,Chelsea,Aston Villa,2-1,2,1,1,1,3,1,H
2013-08-24,2013,Aston Villa,Liverpool,0-1,0,1,1,1,1,-1,A
2013-08-24,2013,Everton,West Bromwich Albion,0-0,0,0,1,1,0,0,D
2013-08-24,2013,Fulham,Arsenal,1-3,1,3,1,1,4,-2,A
2013-08-24,2013,Hull City,Norwich City,1-0,1,0,1,1,1,1,H
2013-08-24,2013,Newcastle United,West Ham United,0-0,0,0,1,1,0,0,D
2013-08-24,2013,Southampton,Sunderland,1-1,1,1,1,1,2,0,D
2013-08-24,2013,Stoke City,Crystal Palace,2-1,2,1,1,1,3,1,H
2013-08-25,2013,Cardiff City,Manchester City,3-2,3,2,1,1,5,1,H
2013-08-25,2013,Tottenham Hotspur,Swansea City,1-0,1,0,1,1,1,1,H
2013-08-26,2013,Manchester United,Chelsea,0-0,0,0,1,1,0,0,D
2013-08-31,2013,Cardiff City,Everton,0-0,0,0,1,1,0,0,D
2013-08-31,2013,Crystal Palace,Sunderland,3-1,3,1,1,1,4,2,H
2013-08-31,2013,Manchester City,Hull City,2-0,2,0,1,1,2,2,H
2013-08-31,2013,Newcastle United,Fulham,1-0,1,0,1,1,1,1,H
2013-08-31,2013,Norwich City,Southampton,1-0,1,0,1,1,1,1,H
2013-08-31,2013,West Ham United,Stoke City,0-1,0,1,1,1,1,-1,A
2013-09-01,2013,Arsenal,Tottenham Hotspur,1-0,1,0,1,1,1,1,H
2013-09-01,2013,Liverpool,Manchester United,1-0,1,0,1,1,1,1,H
2013-09-01,2013,West Bromwich Albion,Swansea City,0-2,0,2,1,1,2,-2,A
2013-09-14,2013,Aston Villa,Newcastle United,1-2,1,2,1,1,3,-1,A
2013-09-14,2013,Everton,Chelsea,1-0,1,0,1,1,1,1,H
2013-09-14,2013,Fulham,West Bromwich Albion,1-1,1,1,1,1,2,0,D
2013-09-14,2013,Hull City,Cardiff City,1-1,1,1,1,1,2,0,D
2013-09-14,2013,Manchester United,Crystal Palace,2-0,2,0,1,1,2,2,H
2013-09-14,2013,Stoke City,Manchester City,0-0,0,0,1,1,0,0,D
2013-09-14,2013,Sunderland,Arsenal,1-3,1,3,1,1,4,-2,A
2013-09-14,2013,Tottenham Hotspur,Norwich City,2-0,2,0,1,1,2,2,H
2013-09-15,2013,Southampton,West Ham United,0-0,0,0,1,1,0,0,D
2013-09-16,2013,Swansea City,Liverpool,2-2,2,2,1,1,4,0,D
2013-09-21,2013,Chelsea,Fulham,2-0,2,0,1,1,2,2,H
2013-09-21,2013,Liverpool,Southampton,0-1,0,1,1,1,1,-1,A
2013-09-21,2013,Newcastle United,Hull City,2-3,2,3,1,1,5,-1,A
2013-09-21,2013,Norwich City,Aston Villa,0-1,0,1,1,1,1,-1,A
2013-09-21,2013,West Bromwich Albion,Sunderland,3-0,3,0,1,1,3,3,H
2013-09-21,2013,West Ham United,Everton,2-3,2,3,1,1,5,-1,A
2013-09-22,2013,Arsenal,Stoke City,3-1,3,1,1,1,4,2,H
2013-09-22,2013,Cardiff City,Tottenham Hotspur,0-1,0,1,1,1,1,-1,A
2013-09-22,2013,Crystal Palace,Swansea City,0-2,0,2,1,1,2,-2,A
2013-09-22,2013,Manchester City,Manchester United,4-1,4,1,1,1,5,3,H
2013-09-28,2013,Aston Villa,Manchester City,3-2,3,2,1,1,5,1,H
2013-09-28,2013,Fulham,Cardiff City,1-2,1,2,1,1,3,-1,A
2013-09-28,2013,Hull City,West Ham United,1-0,1,0,1,1,1,1,H
2013-09-28,2013,Manchester United,West Bromwich Albion,1-2,1,2,1,1,3,-1,A
2013-09-28,2013,Southampton,Crystal Palace,2-0,2,0,1,1,2,2,H
2013-09-28,2013,Swansea City,Arsenal,1-2,1,2,1,1,3,-1,A
2013-09-28,2013,Tottenham Hotspur,Chelsea,1-1,1,1,1,1,2,0,D
2013-09-29,2013,Stoke City,Norwich City,0-1,0,1,1,1,1,-1,A
2013-09-29,2013,Sunderland,Liverpool,1-3,1,3,1,1,4,-2,A
2013-09-30,2013,Everton,Newcastle United,3-2,3,2,1,1,5,1,H
2013-10-05,2013,Cardiff City,Newcastle United,1-2,1,2,1,1,3,-1,A
2013-10-05,2013,Fulham,Stoke City,1-0,1,0,1,1,1,1,H
2013-10-05,2013,Hull City,Aston Villa,0-0,0,0,1,1,0,0,D
2013-10-05,2013,Liverpool,Crystal Palace,3-1,3,1,1,1,4,2,H
2013-10-05,2013,Manchester City,Everton,3-1,3,1,1,1,4,2,H
2013-10-05,2013,Sunderland,Manchester United,1-2,1,2,1,1,3,-1,A
2013-10-06,2013,Norwich City,Chelsea,1-3,1,3,1,1,4,-2,A
2013-10-06,2013,Southampton,Swansea City,2-0,2,0,1,1,2,2,H
2013-10-06,2013,Tottenham Hotspur,West Ham United,0-3,0,3,1,1,3,-3,A
2013-10-06,2013,West Bromwich Albion,Arsenal,1-1,1,1,1,1,2,0,D
2013-10-19,2013,Arsenal,Norwich City,4-1,4,1,1,1,5,3,H
2013-10-19,2013,Chelsea,Cardiff City,4-1,4,1,1,1,5,3,H
2013-10-19,2013,Everton,Hull City,2-1,2,1,1,1,3,1,H
2013-10-19,2013,Manchester United,Southampton,1-1,1,1,1,1,2,0,D
2013-10-19,2013,Newcastle United,Liverpool,2-2,2,2,1,1,4,0,D
2013-10-19,2013,Stoke City,West Bromwich Albion,0-0,0,0,1,1,0,0,D
2013-10-19,2013,Swansea City,Sunderland,4-0,4,0,1,1,4,4,H
2013-10-19,2013,West Ham United,Manchester City,1-3,1,3,1,1,4,-2,A
2013-10-20,2013,Aston Villa,Tottenham Hotspur,0-2,0,2,1,1,2,-2,A
2013-10-21,2013,Crystal Palace,Fulham,1-4,1,4,1,1,5,-3,A
2013-10-26,2013,Aston Villa,Everton,0-2,0,2,1,1,2,-2,A
2013-10-26,2013,Crystal Palace,Arsenal,0-2,0,2,1,1,2,-2,A
2013-10-26,2013,Liverpool,West Bromwich Albion,4-1,4,1,1,1,5,3,H
2013-10-26,2013,Manchester United,Stoke City,3-2,3,2,1,1,5,1,H
2013-10-26,2013,Norwich City,Cardiff City,0-0,0,0,1,1,0,0,D
2013-10-26,2013,Southampton,Fulham,2-0,2,0,1,1,2,2,H
2013-10-27,2013,Chelsea,Manchester City,2-1,2,1,1,1,3,1,H
2013-10-27,2013,Sunderland,Newcastle United,2-1,2,1,1,1,3,1,H
2013-10-27,2013,Swansea City,West Ham United,0-0,0,0,1,1,0,0,D
2013-10-27,2013,Tottenham Hotspur,Hull City,1-0,1,0,1,1,1,1,H
2013-11-02,2013,Arsenal,Liverpool,2-0,2,0,1,1,2,2,H
2013-11-02,2013,Fulham,Manchester United,1-3,1,3,1,1,4,-2,A
2013-11-02,2013,Hull City,Sunderland,1-0,1,0,1,1,1,1,H
2013-11-02,2013,Manchester City,Norwich City,7-0,7,0,1,1,7,7,H
2013-11-02,2013,Newcastle United,Chelsea,2-0,2,0,1,1,2,2,H
2013-11-02,2013,Stoke City,Southampton,1-1,1,1,1,1,2,0,D
2013-11-02,2013,West Bromwich Albion,Crystal Palace,2-0,2,0,1,1,2,2,H
2013-11-02,2013,West Ham United,Aston Villa,0-0,0,0,1,1,0,0,D
2013-11-03,2013,Cardiff City,Swansea City,1-0,1,0,1,1,1,1,H
2013-11-03,2013,Everton,Tottenham Hotspur,0-0,0,0,1,1,0,0,D
2013-11-09,2013,Aston Villa,Cardiff City,2-0,2,0,1,1,2,2,H
2013-11-09,2013,Chelsea,West Bromwich Albion,2-2,2,2,1,1,4,0,D
2013-11-09,2013,Crystal Palace,Everton,0-0,0,0,1,1,0,0,D
2013-11-09,2013,Liverpool,Fulham,4-0,4,0,1,1,4,4,H
2013-11-09,2013,Norwich City,West Ham United,3-1,3,1,1,1,4,2,H
2013-11-09,2013,Southampton,Hull City,4-1,4,1,1,1,5,3,H
2013-11-10,2013,Manchester United,Arsenal,1-0,1,0,1,1,1,1,H
2013-11-10,2013,Sunderland,Manchester City,1-0,1,0,1,1,1,1,H
2013-11-10,2013,Swansea City,Stoke City,3-3,3,3,1,1,6,0,D
2013-11-10,2013,Tottenham Hotspur,Newcastle United,0-1,0,1,1,1,1,-1,A
2013-11-23,2013,Arsenal,Southampton,2-0,2,0,1,1,2,2,H
2013-11-23,2013,Everton,Liverpool,3-3,3,3,1,1,6,0,D
2013-11-23,2013,Fulham,Swansea City,1-2,1,2,1,1,3,-1,A
2013-11-23,2013,Hull City,Crystal Palace,0-1,0,1,1,1,1,-1,A
2013-11-23,2013,Newcastle United,Norwich City,2-1,2,1,1,1,3,1,H
2013-11-23,2013,Stoke City,Sunderland,2-0,2,0,1,1,2,2,H
2013-11-23,2013,West Ham United,Chelsea,0-3,0,3,1,1,3,-3,A
2013-11-24,2013,Cardiff City,Manchester United,2-2,2,2,1,1,4,0,D
2013-11-24,2013,Manchester City,Tottenham Hotspur,6-0,6,0,1,1,6,6,H
2013-11-25,2013,West Bromwich Albion,Aston Villa,2-2,2,2,1,1,4,0,D
2013-11-30,2013,Aston Villa,Sunderland,0-0,0,0,1,1,0,0,D
2013-11-30,2013,Cardiff City,Arsenal,0-3,0,3,1,1,3,-3,A
2013-11-30,2013,Everton,Stoke City,4-0,4,0,1,1,4,4,H
2013-11-30,2013,Newcastle United,West Bromwich Albion,2-1,2,1,1,1,3,1,H
2013-11-30,2013,Norwich City,Crystal Palace,1-0,1,0,1,1,1,1,H
2013-11-30,2013,West Ham United,Fulham,3-0,3,0,1,1,3,3,H
2013-12-01,2013,Chelsea,Southampton,3-1,3,1,1,1,4,2,H
2013-12-01,2013,Hull City,Liverpool,3-1,3,1,1,1,4,2,H
2013-12-01,2013,Manchester City,Swansea City,3-0,3,0,1,1,3,3,H
2013-12-01,2013,Tottenham Hotspur,Manchester United,2-2,2,2,1,1,4,0,D
2013-12-03,2013,Crystal Palace,West Ham United,1-0,1,0,1,1,1,1,H
2013-12-04,2013,Arsenal,Hull City,2-0,2,0,1,1,2,2,H
2013-12-04,2013,Fulham,Tottenham Hotspur,1-2,1,2,1,1,3,-1,A
2013-12-04,2013,Liverpool,Norwich City,5-1,5,1,1,1,6,4,H
2013-12-04,2013,Manchester United,Everton,0-1,0,1,1,1,1,-1,A
2013-12-04,2013,Southampton,Aston Villa,2-3,2,3,1,1,5,-1,A
2013-12-04,2013,Stoke City,Cardiff City,0-0,0,0,1,1,0,0,D
2013-12-04,2013,Sunderland,Chelsea,3-4,3,4,1,1,7,-1,A
2013-12-04,2013,Swansea City,Newcastle United,3-0,3,0,1,1,3,3,H
2013-12-04,2013,West Bromwich Albion,Manchester City,2-3,2,3,1,1,5,-1,A
2013-12-07,2013,Crystal Palace,Cardiff City,2-0,2,0,1,1,2,2,H
2013-12-07,2013,Liverpool,West Ham United,4-1,4,1,1,1,5,3,H
2013-12-07,2013,Manchester United,Newcastle United,0-1,0,1,1,1,1,-1,A
2013-12-07,2013,Southampton,Manchester City,1-1,1,1,1,1,2,0,D
2013-12-07,2013,Stoke City,Chelsea,3-2,3,2,1,1,5,1,H
2013-12-07,2013,Sunderland,Tottenham Hotspur,1-2,1,2,1,1,3,-1,A
2013-12-07,2013,West Bromwich Albion,Norwich City,0-2,0,2,1,1,2,-2,A
2013-12-08,2013,Arsenal,Everton,1-1,1,1,1,1,2,0,D
2013-12-08,2013,Fulham,Aston Villa,2-0,2,0,1,1,2,2,H
2013-12-09,2013,Swansea City,Hull City,1-1,1,1,1,1,2,0,D
2013-12-14,2013,Cardiff City,West Bromwich Albion,1-0,1,0,1,1,1,1,H
2013-12-14,2013,Chelsea,Crystal Palace,2-1,2,1,1,1,3,1,H
2013-12-14,2013,Everton,Fulham,4-1,4,1,1,1,5,3,H
2013-12-14,2013,Hull City,Stoke City,0-0,0,0,1,1,0,0,D
2013-12-14,2013,Manchester City,Arsenal,6-3,6,3,1,1,9,3,H
2013-12-14,2013,Newcastle United,Southampton,1-1,1,1,1,1,2,0,D
2013-12-14,2013,West Ham United,Sunderland,0-0,0,0,1,1,0,0,D
2013-12-15,2013,Aston Villa,Manchester United,0-3,0,3,1,1,3,-3,A
2013-12-15,2013,Norwich City,Swansea City,1-1,1,1,1,1,2,0,D
2013-12-15,2013,Tottenham Hotspur,Liverpool,0-5,0,5,1,1,5,-5,A
2013-12-21,2013,Crystal Palace,Newcastle United,0-3,0,3,1,1,3,-3,A
2013-12-21,2013,Fulham,Manchester City,2-4,2,4,1,1,6,-2,A
2013-12-21,2013,Liverpool,Cardiff City,3-1,3,1,1,1,4,2,H
2013-12-21,2013,Manchester United,West Ham United,3-1,3,1,1,1,4,2,H
2013-12-21,2013,Stoke City,Aston Villa,2-1,2,1,1,1,3,1,H
2013-12-21,2013,Sunderland,Norwich City,0-0,0,0,1,1,0,0,D
2013-12-21,2013,West Bromwich Albion,Hull City,1-1,1,1,1,1,2,0,D
2013-12-22,2013,Southampton,Tottenham Hotspur,2-3,2,3,1,1,5,-1,A
2013-12-22,2013,Swansea City,Everton,1-2,1,2,1,1,3,-1,A
2013-12-23,2013,Arsenal,Chelsea,0-0,0,0,1,1,0,0,D
2013-12-26,2013,Aston Villa,Crystal Palace,0-1,0,1,1,1,1,-1,A
2013-12-26,2013,Cardiff City,Southampton,0-3,0,3,1,1,3,-3,A
2013-12-26,2013,Chelsea,Swansea City,1-0,1,0,1,1,1,1,H
2013-12-26,2013,Everton,Sunderland,0-1,0,1,1,1,1,-1,A
2013-12-26,2013,Hull City,Manchester United,2-3,2,3,1,1,5,-1,A
2013-12-26,2013,Manchester City,Liverpool,2-1,2,1,1,1,3,1,H
2013-12-26,2013,Newcastle United,Stoke City,5-1,5,1,1,1,6,4,H
2013-12-26,2013,Norwich City,Fulham,1-2,1,2,1,1,3,-1,A
2013-12-26,2013,Tottenham Hotspur,West Bromwich Albion,1-1,1,1,1,1,2,0,D
2013-12-26,2013,West Ham United,Arsenal,1-3,1,3,1,1,4,-2,A
2013-12-28,2013,Aston Villa,Swansea City,1-1,1,1,1,1,2,0,D
2013-12-28,2013,Cardiff City,Sunderland,2-2,2,2,1,1,4,0,D
2013-12-28,2013,Hull City,Fulham,6-0,6,0,1,1,6,6,H
2013-12-28,2013,Manchester City,Crystal Palace,1-0,1,0,1,1,1,1,H
2013-12-28,2013,Norwich City,Manchester United,0-1,0,1,1,1,1,-1,A
2013-12-28,2013,West Ham United,West Bromwich Albion,3-3,3,3,1,1,6,0,D
2013-12-29,2013,Chelsea,Liverpool,2-1,2,1,1,1,3,1,H
2013-12-29,2013,Everton,Southampton,2-1,2,1,1,1,3,1,H
2013-12-29,2013,Newcastle United,Arsenal,0-1,0,1,1,1,1,-1,A
2013-12-29,2013,Tottenham Hotspur,Stoke City,3-0,3,0,1,1,3,3,H
2014-01-01,2013,Arsenal,Cardiff City,2-0,2,0,1,1,2,2,H
2014-01-01,2013,Crystal Palace,Norwich City,1-1,1,1,1,1,2,0,D
2014-01-01,2013,Fulham,West Ham United,2-1,2,1,1,1,3,1,H
2014-01-01,2013,Liverpool,Hull City,2-0,2,0,1,1,2,2,H
2014-01-01,2013,Manchester United,Tottenham Hotspur,1-2,1,2,1,1,3,-1,A
2014-01-01,2013,Southampton,Chelsea,0-3,0,3,1,1,3,-3,A
2014-01-01,2013,Stoke City,Everton,1-1,1,1,1,1,2,0,D
2014-01-01,2013,Sunderland,Aston Villa,0-1,0,1,1,1,1,-1,A
2014-01-01,2013,Swansea City,Manchester City,2-3,2,3,1,1,5,-1,A
2014-01-01,2013,West Bromwich Albion,Newcastle United,1-0,1,0,1,1,1,1,H
2014-01-11,2013,Cardiff City,West Ham United,0-2,0,2,1,1,2,-2,A
2014-01-11,2013,Everton,Norwich City,2-0,2,0,1,1,2,2,H
2014-01-11,2013,Fulham,Sunderland,1-4,1,4,1,1,5,-3,A
2014-01-11,2013,Hull City,Chelsea,0-2,0,2,1,1,2,-2,A
2014-01-11,2013,Manchester United,Swansea City,2-0,2,0,1,1,2,2,H
2014-01-11,2013,Southampton,West Bromwich Albion,1-0,1,0,1,1,1,1,H
2014-01-11,2013,Tottenham Hotspur,Crystal Palace,2-0,2,0,1,1,2,2,H
2014-01-12,2013,Newcastle United,Manchester City,0-2,0,2,1,1,2,-2,A
2014-01-12,2013,Stoke City,Liverpool,3-5,3,5,1,1,8,-2,A
2014-01-13,2013,Aston Villa,Arsenal,1-2,1,2,1,1,3,-1,A
2014-01-18,2013,Arsenal,Fulham,2-0,2,0,1,1,2,2,H
2014-01-18,2013,Crystal Palace,Stoke City,1-0,1,0,1,1,1,1,H
2014-01-18,2013,Liverpool,Aston Villa,2-2,2,2,1,1,4,0,D
2014-01-18,2013,Manchester City,Cardiff City,4-2,4,2,1,1,6,2,H
2014-01-18,2013,Norwich City,Hull City,1-0,1,0,1,1,1,1,H
2014-01-18,2013,Sunderland,Southampton,2-2,2,2,1,1,4,0,D
2014-01-18,2013,West Ham United,Newcastle United,1-3,1,3,1,1,4,-2,A
2014-01-19,2013,Chelsea,Manchester United,3-1,3,1,1,1,4,2,H
2014-01-19,2013,Swansea City,Tottenham Hotspur,1-3,1,3,1,1,4,-2,A
2014-01-20,2013,West Bromwich Albion,Everton,1-1,1,1,1,1,2,0,D
2014-01-28,2013,Crystal Palace,Hull City,1-0,1,0,1,1,1,1,H
2014-01-28,2013,Liverpool,Everton,4-0,4,0,1,1,4,4,H
2014-01-28,2013,Manchester United,Cardiff City,2-0,2,0,1,1,2,2,H
2014-01-28,2013,Norwich City,Newcastle United,0-0,0,0,1,1,0,0,D
2014-01-28,2013,Southampton,Arsenal,2-2,2,2,1,1,4,0,D
2014-01-28,2013,Swansea City,Fulham,2-0,2,0,1,1,2,2,H
2014-01-29,2013,Aston Villa,West Bromwich Albion,4-3,4,3,1,1,7,1,H
2014-01-29,2013,Chelsea,West Ham United,0-0,0,0,1,1,0,0,D
2014-01-29,2013,Sunderland,Stoke City,1-0,1,0,1,1,1,1,H
2014-01-29,2013,Tottenham Hotspur,Manchester City,1-5,1,5,1,1,6,-4,A
2014-02-01,2013,Cardiff City,Norwich City,2-1,2,1,1,1,3,1,H
2014-02-01,2013,Everton,Aston Villa,2-1,2,1,1,1,3,1,H
2014-02-01,2013,Fulham,Southampton,0-3,0,3,1,1,3,-3,A
2014-02-01,2013,Hull City,Tottenham Hotspur,1-1,1,1,1,1,2,0,D
2014-02-01,2013,Newcastle United,Sunderland,0-3,0,3,1,1,3,-3,A
2014-02-01,2013,Stoke City,Manchester United,2-1,2,1,1,1,3,1,H
2014-02-01,2013,West Ham United,Swansea City,2-0,2,0,1,1,2,2,H
2014-02-02,2013,Arsenal,Crystal Palace,2-0,2,0,1,1,2,2,H
2014-02-02,2013,West Bromwich Albion,Liverpool,1-1,1,1,1,1,2,0,D
2014-02-03,2013,Manchester City,Chelsea,0-1,0,1,1,1,1,-1,A
2014-02-08,2013,Aston Villa,West Ham United,0-2,0,2,1,1,2,-2,A
2014-02-08,2013,Chelsea,Newcastle United,3-0,3,0,1,1,3,3,H
2014-02-08,2013,Crystal Palace,West Bromwich Albion,3-1,3,1,1,1,4,2,H
2014-02-08,2013,Liverpool,Arsenal,5-1,5,1,1,1,6,4,H
2014-02-08,2013,Norwich City,Manchester City,0-0,0,0,1,1,0,0,D
2014-02-08,2013,Southampton,Stoke City,2-2,2,2,1,1,4,0,D
2014-02-08,2013,Sunderland,Hull City,0-2,0,2,1,1,2,-2,A
2014-02-08,2013,Swansea City,Cardiff City,3-0,3,0,1,1,3,3,H
2014-02-09,2013,Manchester United,Fulham,2-2,2,2,1,1,4,0,D
2014-02-09,2013,Tottenham Hotspur,Everton,1-0,1,0,1,1,1,1,H
2014-02-11,2013,Cardiff City,Aston Villa,0-0,0,0,1,1,0,0,D
2014-02-11,2013,Hull City,Southampton,0-1,0,1,1,1,1,-1,A
2014-02-11,2013,West Bromwich Albion,Chelsea,1-1,1,1,1,1,2,0,D
2014-02-11,2013,West Ham United,Norwich City,2-0,2,0,1,1,2,2,H
2014-02-12,2013,Arsenal,Manchester United,0-0,0,0,1,1,0,0,D
2014-02-12,2013,Fulham,Liverpool,2-3,2,3,1,1,5,-1,A
2014-02-12,2013,Newcastle United,Tottenham Hotspur,0-4,0,4,1,1,4,-4,A
2014-02-12,2013,Stoke City,Swansea City,1-1,1,1,1,1,2,0,D
2014-02-22,2013,Arsenal,Sunderland,4-1,4,1,1,1,5,3,H
2014-02-22,2013,Cardiff City,Hull City,0-4,0,4,1,1,4,-4,A
2014-02-22,2013,Chelsea,Everton,1-0,1,0,1,1,1,1,H
2014-02-22,2013,Crystal Palace,Manchester United,0-2,0,2,1,1,2,-2,A
2014-02-22,2013,Manchester City,Stoke City,1-0,1,0,1,1,1,1,H
2014-02-22,2013,West Bromwich Albion,Fulham,1-1,1,1,1,1,2,0,D
2014-02-22,2013,West Ham United,Southampton,3-1,3,1,1,1,4,2,H
2014-02-23,2013,Liverpool,Swansea City,4-3,4,3,1,1,7,1,H
2014-02-23,2013,Newcastle United,Aston Villa,1-0,1,0,1,1,1,1,H
2014-02-23,2013,Norwich City,Tottenham Hotspur,1-0,1,0,1,1,1,1,H
2014-03-01,2013,Everton,West Ham United,1-0,1,0,1,1,1,1,H
2014-03-01,2013,Fulham,Chelsea,1-3,1,3,1,1,4,-2,A
2014-03-01,2013,Hull City,Newcastle United,1-4,1,4,1,1,5,-3,A
2014-03-01,2013,Southampton,Liverpool,0-3,0,3,1,1,3,-3,A
2014-03-01,2013,Stoke City,Arsenal,1-0,1,0,1,1,1,1,H
2014-03-02,2013,Aston Villa,Norwich City,4-1,4,1,1,1,5,3,H
2014-03-02,2013,Swansea City,Crystal Palace,1-1,1,1,1,1,2,0,D
2014-03-02,2013,Tottenham Hotspur,Cardiff City,1-0,1,0,1,1,1,1,H
2014-03-08,2013,Cardiff City,Fulham,3-1,3,1,1,1,4,2,H
2014-03-08,2013,Chelsea,Tottenham Hotspur,4-0,4,0,1,1,4,4,H
2014-03-08,2013,Crystal Palace,Southampton,0-1,0,1,1,1,1,-1,A
2014-03-08,2013,Norwich City,Stoke City,1-1,1,1,1,1,2,0,D
2014-03-08,2013,West Bromwich Albion,Manchester United,0-3,0,3,1,1,3,-3,A
2014-03-15,2013,Aston Villa,Chelsea,1-0,1,0,1,1,1,1,H
2014-03-15,2013,Everton,Cardiff City,2-1,2,1,1,1,3,1,H
2014-03-15,2013,Fulham,Newcastle United,1-0,1,0,1,1,1,1,H
2014-03-15,2013,Hull City,Manchester City,0-2,0,2,1,1,2,-2,A
2014-03-15,2013,Southampton,Norwich City,4-2,4,2,1,1,6,2,H
2014-03-15,2013,Stoke City,West Ham United,3-1,3,1,1,1,4,2,H
2014-03-15,2013,Sunderland,Crystal Palace,0-0,0,0,1,1,0,0,D
2014-03-15,2013,Swansea City,West Bromwich Albion,1-2,1,2,1,1,3,-1,A
2014-03-16,2013,Manchester United,Liverpool,0-3,0,3,1,1,3,-3,A
2014-03-16,2013,Tottenham Hotspur,Arsenal,0-1,0,1,1,1,1,-1,A
2014-03-22,2013,Cardiff City,Liverpool,3-6,3,6,1,1,9,-3,A
2014-03-22,2013,Chelsea,Arsenal,6-0,6,0,1,1,6,6,H
2014-03-22,2013,Everton,Swansea City,3-2,3,2,1,1,5,1,H
2014-03-22,2013,Hull City,West Bromwich Albion,2-0,2,0,1,1,2,2,H
2014-03-22,2013,Manchester City,Fulham,5-0,5,0,1,1,5,5,H
2014-03-22,2013,Newcastle United,Crystal Palace,1-0,1,0,1,1,1,1,H
2014-03-22,2013,Norwich City,Sunderland,2-0,2,0,1,1,2,2,H
2014-03-22,2013,West Ham United,Manchester United,0-2,0,2,1,1,2,-2,A
2014-03-23,2013,Aston Villa,Stoke City,1-4,1,4,1,1,5,-3,A
2014-03-23,2013,Tottenham Hotspur,Southampton,3-2,3,2,1,1,5,1,H
2014-03-25,2013,Arsenal,Swansea City,2-2,2,2,1,1,4,0,D
2014-03-25,2013,Manchester United,Manchester City,0-3,0,3,1,1,3,-3,A
2014-03-25,2013,Newcastle United,Everton,0-3,0,3,1,1,3,-3,A
2014-03-26,2013,Liverpool,Sunderland,2-1,2,1,1,1,3,1,H
2014-03-26,2013,West Ham United,Hull City,2-1,2,1,1,1,3,1,H
2014-03-29,2013,Arsenal,Manchester City,1-1,1,1,1,1,2,0,D
2014-03-29,2013,Crystal Palace,Chelsea,1-0,1,0,1,1,1,1,H
2014-03-29,2013,Manchester United,Aston Villa,4-1,4,1,1,1,5,3,H
2014-03-29,2013,Southampton,Newcastle United,4-0,4,0,1,1,4,4,H
2014-03-29,2013,Stoke City,Hull City,1-0,1,0,1,1,1,1,H
2014-03-29,2013,Swansea City,Norwich City,3-0,3,0,1,1,3,3,H
2014-03-29,2013,West Bromwich Albion,Cardiff City,3-3,3,3,1,1,6,0,D
2014-03-30,2013,Fulham,Everton,1-3,1,3,1,1,4,-2,A
2014-03-30,2013,Liverpool,Tottenham Hotspur,4-0,4,0,1,1,4,4,H
2014-03-31,2013,Sunderland,West Ham United,1-2,1,2,1,1,3,-1,A
2014-04-05,2013,Aston Villa,Fulham,1-2,1,2,1,1,3,-1,A
2014-04-05,2013,Cardiff City,Crystal Palace,0-3,0,3,1,1,3,-3,A
2014-04-05,2013,Chelsea,Stoke City,3-0,3,0,1,1,3,3,H
2014-04-05,2013,Hull City,Swansea City,1-0,1,0,1,1,1,1,H
2014-04-05,2013,Manchester City,Southampton,4-1,4,1,1,1,5,3,H
2014-04-05,2013,Newcastle United,Manchester United,0-4,0,4,1,1,4,-4,A
2014-04-05,2013,Norwich City,West Bromwich Albion,0-1,0,1,1,1,1,-1,A
2014-04-06,2013,Everton,Arsenal,3-0,3,0,1,1,3,3,H
2014-04-06,2013,West Ham United,Liverpool,1-2,1,2,1,1,3,-1,A
2014-04-07,2013,Tottenham Hotspur,Sunderland,5-1,5,1,1,1,6,4,H
2014-04-12,2013,Crystal Palace,Aston Villa,1-0,1,0,1,1,1,1,H
2014-04-12,2013,Fulham,Norwich City,1-0,1,0,1,1,1,1,H
2014-04-12,2013,Southampton,Cardiff City,0-1,0,1,1,1,1,-1,A
2014-04-12,2013,Stoke City,Newcastle United,1-0,1,0,1,1,1,1,H
2014-04-12,2013,Sunderland,Everton,0-1,0,1,1,1,1,-1,A
2014-04-12,2013,West Bromwich Albion,Tottenham Hotspur,3-3,3,3,1,1,6,0,D
2014-04-13,2013,Liverpool,Manchester City,3-2,3,2,1,1,5,1,H
2014-04-13,2013,Swansea City,Chelsea,0-1,0,1,1,1,1,-1,A
2014-04-15,2013,Arsenal,West Ham United,3-1,3,1,1,1,4,2,H
2014-04-16,2013,Everton,Crystal Palace,2-3,2,3,1,1,5,-1,A
2014-04-16,2013,Manchester City,Sunderland,2-2,2,2,1,1,4,0,D
2014-04-19,2013,Aston Villa,Southampton,0-0,0,0,1,1,0,0,D
2014-04-19,2013,Cardiff City,Stoke City,1-1,1,1,1,1,2,0,D
2014-04-19,2013,Chelsea,Sunderland,1-2,1,2,1,1,3,-1,A
2014-04-19,2013,Newcastle United,Swansea City,1-2,1,2,1,1,3,-1,A
2014-04-19,2013,Tottenham Hotspur,Fulham,3-1,3,1,1,1,4,2,H
2014-04-19,2013,West Ham United,Crystal Palace,0-1,0,1,1,1,1,-1,A
2014-04-20,2013,Everton,Manchester United,2-0,2,0,1,1,2,2,H
2014-04-20,2013,Hull City,Arsenal,0-3,0,3,1,1,3,-3,A
2014-04-20,2013,Norwich City,Liverpool,2-3,2,3,1,1,5,-1,A
2014-04-21,2013,Manchester City,West Bromwich Albion,3-1,3,1,1,1,4,2,H
2014-04-26,2013,Fulham,Hull City,2-2,2,2,1,1,4,0,D
2014-04-26,2013,Manchester United,Norwich City,4-0,4,0,1,1,4,4,H
2014-04-26,2013,Southampton,Everton,2-0,2,0,1,1,2,2,H
2014-04-26,2013,Stoke City,Tottenham Hotspur,0-1,0,1,1,1,1,-1,A
2014-04-26,2013,Swansea City,Aston Villa,4-1,4,1,1,1,5,3,H
2014-04-26,2013,West Bromwich Albion,West Ham United,1-0,1,0,1,1,1,1,H
2014-04-27,2013,Crystal Palace,Manchester City,0-2,0,2,1,1,2,-2,A
2014-04-27,2013,Liverpool,Chelsea,0-2,0,2,1,1,2,-2,A
2014-04-27,2013,Sunderland,Cardiff City,4-0,4,0,1,1,4,4,H
2014-04-28,2013,Arsenal,Newcastle United,3-0,3,0,1,1,3,3,H
2014-05-03,2013,Aston Villa,Hull City,3-1,3,1,1,1,4,2,H
2014-05-03,2013,Everton,Manchester City,2-3,2,3,1,1,5,-1,A
2014-05-03,2013,Manchester United,Sunderland,0-1,0,1,1,1,1,-1,A
2014-05-03,2013,Newcastle United,Cardiff City,3-0,3,0,1,1,3,3,H
2014-05-03,2013,Stoke City,Fulham,4-1,4,1,1,1,5,3,H
2014-05-03,2013,Swansea City,Southampton,0-1,0,1,1,1,1,-1,A
2014-05-03,2013,West Ham United,Tottenham Hotspur,2-0,2,0,1,1,2,2,H
2014-05-04,2013,Arsenal,West Bromwich Albion,1-0,1,0,1,1,1,1,H
2014-05-04,2013,Chelsea,Norwich City,0-0,0,0,1,1,0,0,D
2014-05-05,2013,Crystal Palace,Liverpool,3-3,3,3,1,1,6,0,D
2014-05-06,2013,Manchester United,Hull City,3-1,3,1,1,1,4,2,H
2014-05-07,2013,Manchester City,Aston Villa,4-0,4,0,1,1,4,4,H
2014-05-07,2013,Sunderland,West Bromwich Albion,2-0,2,0,1,1,2,2,H
2014-05-11,2013,Cardiff City,Chelsea,1-2,1,2,1,1,3,-1,A
2014-05-11,2013,Fulham,Crystal Palace,2-2,2,2,1,1,4,0,D
2014-05-11,2013,Hull City,Everton,0-2,0,2,1,1,2,-2,A
2014-05-11,2013,Liverpool,Newcastle United,2-1,2,1,1,1,3,1,H
2014-05-11,2013,Manchester City,West Ham United,2-0,2,0,1,1,2,2,H
2014-05-11,2013,Norwich City,Arsenal,0-2,0,2,1,1,2,-2,A
2014-05-11,2013,Southampton,Manchester United,1-1,1,1,1,1,2,0,D
2014-05-11,2013,Sunderland,Swansea City,1-3,1,3,1,1,4,-2,A
2014-05-11,2013,Tottenham Hotspur,Aston Villa,3-0,3,0,1,1,3,3,H
2014-05-11,2013,West Bromwich Albion,Stoke City,1-2,1,2,1,1,3,-1,A
2014-08-16,2014,Manchester United,Swansea City,1-2,1,2,1,1,3,-1,A
2014-08-16,2014,Leicester City,Everton,2-2,2,2,1,1,4,0,D
2014-08-16,2014,Queens Park Rangers,Hull City,0-1,0,1,1,1,1,-1,A
2014-08-16,2014,Stoke City,Aston Villa,0-1,0,1,1,1,1,-1,A
2014-08-16,2014,West Bromwich Albion,Sunderland,2-2,2,2,1,1,4,0,D
2014-08-16,2014,West Ham United,Tottenham Hotspur,0-1,0,1,1,1,1,-1,A
2014-08-16,2014,Arsenal,Crystal Palace,2-1,2,1,1,1,3,1,H
2014-08-17,2014,Liverpool,Southampton,2-1,2,1,1,1,3,1,H
2014-08-17,2014,Newcastle United,Manchester City,0-2,0,2,1,1,2,-2,A
2014-08-18,2014,Burnley,Chelsea,1-3,1,3,1,1,4,-2,A
2014-08-23,2014,Aston Villa,Newcastle United,0-0,0,0,1,1,0,0,D
2014-08-23,2014,Chelsea,Leicester City,2-0,2,0,1,1,2,2,H
2014-08-23,2014,Crystal Palace,West Ham United,1-3,1,3,1,1,4,-2,A
2014-08-23,2014,Southampton,West Bromwich Albion,0-0,0,0,1,1,0,0,D
2014-08-23,2014,Swansea City,Burnley,1-0,1,0,1,1,1,1,H
2014-08-23,2014,Everton,Arsenal,2-2,2,2,1,1,4,0,D
2014-08-24,2014,Hull City,Stoke City,1-1,1,1,1,1,2,0,D
2014-08-24,2014,Tottenham Hotspur,Queens Park Rangers,4-0,4,0,1,1,4,4,H
2014-08-24,2014,Sunderland,Manchester United,1-1,1,1,1,1,2,0,D
2014-08-25,2014,Manchester City,Liverpool,3-1,3,1,1,1,4,2,H
2014-08-30,2014,Burnley,Manchester United,0-0,0,0,1,1,0,0,D
2014-08-30,2014,Manchester City,Stoke City,0-1,0,1,1,1,1,-1,A
2014-08-30,2014,Newcastle United,Crystal Palace,3-3,3,3,1,1,6,0,D
2014-08-30,2014,Queens Park Rangers,Sunderland,1-0,1,0,1,1,1,1,H
2014-08-30,2014,Swansea City,West Bromwich Albion,3-0,3,0,1,1,3,3,H
2014-08-30,2014,West Ham United,Southampton,1-3,1,3,1,1,4,-2,A
2014-08-30,2014,Everton,Chelsea,3-6,3,6,1,1,9,-3,A
2014-08-31,2014,Aston Villa,Hull City,2-1,2,1,1,1,3,1,H
2014-08-31,2014,Tottenham Hotspur,Liverpool,0-3,0,3,1,1,3,-3,A
2014-08-31,2014,Leicester City,Arsenal,1-1,1,1,1,1,2,0,D
2014-09-13,2014,Arsenal,Manchester City,2-2,2,2,1,1,4,0,D
2014-09-13,2014,Chelsea,Swansea City,4-2,4,2,1,1,6,2,H
2014-09-13,2014,Crystal Palace,Burnley,0-0,0,0,1,1,0,0,D
2014-09-13,2014,Southampton,Newcastle United,4-0,4,0,1,1,4,4,H
2014-09-13,2014,Stoke City,Leicester City,0-1,0,1,1,1,1,-1,A
2014-09-13,2014,Sunderland,Tottenham Hotspur,2-2,2,2,1,1,4,0,D
2014-09-13,2014,West Bromwich Albion,Everton,0-2,0,2,1,1,2,-2,A
2014-09-13,2014,Liverpool,Aston Villa,0-1,0,1,1,1,1,-1,A
2014-09-14,2014,Manchester United,Queens Park Rangers,4-0,4,0,1,1,4,4,H
2014-09-15,2014,Hull City,West Ham United,2-2,2,2,1,1,4,0,D
2014-09-20,2014,Queens Park Rangers,Stoke City,2-2,2,2,1,1,4,0,D
2014-09-20,2014,Aston Villa,Arsenal,0-3,0,3,1,1,3,-3,A
2014-09-20,2014,Burnley,Sunderland,0-0,0,0,1,1,0,0,D
2014-09-20,2014,Newcastle United,Hull City,2-2,2,2,1,1,4,0,D
2014-09-20,2014,Swansea City,Southampton,0-1,0,1,1,1,1,-1,A
2014-09-20,2014,West Ham United,Liverpool,3-1,3,1,1,1,4,2,H
2014-09-21,2014,Leicester City,Manchester United,5-3,5,3,1,1,8,2,H
2014-09-21,2014,Tottenham Hotspur,West Bromwich Albion,0-1,0,1,1,1,1,-1,A
2014-09-21,2014,Everton,Crystal Palace,2-3,2,3,1,1,5,-1,A
2014-09-21,2014,Manchester City,Chelsea,1-1,1,1,1,1,2,0,D
2014-09-27,2014,Liverpool,Everton,1-1,1,1,1,1,2,0,D
2014-09-27,2014,Chelsea,Aston Villa,3-0,3,0,1,1,3,3,H
2014-09-27,2014,Crystal Palace,Leicester City,2-0,2,0,1,1,2,2,H
2014-09-27,2014,Hull City,Manchester City,2-4,2,4,1,1,6,-2,A
2014-09-27,2014,Manchester United,West Ham United,2-1,2,1,1,1,3,1,H
2014-09-27,2014,Southampton,Queens Park Rangers,2-1,2,1,1,1,3,1,H
2014-09-27,2014,Sunderland,Swansea City,0-0,0,0,1,1,0,0,D
2014-09-27,2014,Arsenal,Tottenham Hotspur,1-1,1,1,1,1,2,0,D
2014-09-28,2014,West Bromwich Albion,Burnley,4-0,4,0,1,1,4,4,H
2014-09-29,2014,Stoke City,Newcastle United,1-0,1,0,1,1,1,1,H
2014-10-04,2014,Hull City,Crystal Palace,2-0,2,0,1,1,2,2,H
2014-10-04,2014,Leicester City,Burnley,2-2,2,2,1,1,4,0,D
2014-10-04,2014,Liverpool,West Bromwich Albion,2-1,2,1,1,1,3,1,H
2014-10-04,2014,Sunderland,Stoke City,3-1,3,1,1,1,4,2,H
2014-10-04,2014,Swansea City,Newcastle United,2-2,2,2,1,1,4,0,D
2014-10-04,2014,Aston Villa,Manchester City,0-2,0,2,1,1,2,-2,A
2014-10-05,2014,Manchester United,Everton,2-1,2,1,1,1,3,1,H
2014-10-05,2014,Tottenham Hotspur,Southampton,1-0,1,0,1,1,1,1,H
2014-10-05,2014,Chelsea,Arsenal,2-0,2,0,1,1,2,2,H
2014-10-05,2014,West Ham United,Queens Park Rangers,2-0,2,0,1,1,2,2,H
2014-10-18,2014,Manchester City,Tottenham Hotspur,4-1,4,1,1,1,5,3,H
2014-10-18,2014,Arsenal,Hull City,2-2,2,2,1,1,4,0,D
2014-10-18,2014,Burnley,West Ham United,1-3,1,3,1,1,4,-2,A
2014-10-18,2014,Crystal Palace,Chelsea,1-2,1,2,1,1,3,-1,A
2014-10-18,2014,Everton,Aston Villa,3-0,3,0,1,1,3,3,H
2014-10-18,2014,Southampton,Sunderland,8-0,8,0,1,1,8,8,H
2014-10-18,2014,Newcastle United,Leicester City,1-0,1,0,1,1,1,1,H
2014-10-19,2014,Queens Park Rangers,Liverpool,2-3,2,3,1,1,5,-1,A
2014-10-19,2014,Stoke City,Swansea City,2-1,2,1,1,1,3,1,H
2014-10-20,2014,West Bromwich Albion,Manchester United,2-2,2,2,1,1,4,0,D
2014-10-25,2014,West Ham United,Manchester City,2-1,2,1,1,1,3,1,H
2014-10-25,2014,Liverpool,Hull City,0-0,0,0,1,1,0,0,D
2014-10-25,2014,Southampton,Stoke City,1-0,1,0,1,1,1,1,H
2014-10-25,2014,Sunderland,Arsenal,0-2,0,2,1,1,2,-2,A
2014-10-25,2014,West Bromwich Albion,Crystal Palace,2-2,2,2,1,1,4,0,D
2014-10-25,2014,Swansea City,Leicester City,2-0,2,0,1,1,2,2,H
2014-10-26,2014,Burnley,Everton,1-3,1,3,1,1,4,-2,A
2014-10-26,2014,Tottenham Hotspur,Newcastle United,1-2,1,2,1,1,3,-1,A
2014-10-26,2014,Manchester United,Chelsea,1-1,1,1,1,1,2,0,D
2014-10-27,2014,Queens Park Rangers,Aston Villa,2-0,2,0,1,1,2,2,H
2014-11-01,2014,Newcastle United,Liverpool,1-0,1,0,1,1,1,1,H
2014-11-01,2014,Arsenal,Burnley,3-0,3,0,1,1,3,3,H
2014-11-01,2014,Chelsea,Queens Park Rangers,2-1,2,1,1,1,3,1,H
2014-11-01,2014,Everton,Swansea City,0-0,0,0,1,1,0,0,D
2014-11-01,2014,Hull City,Southampton,0-1,0,1,1,1,1,-1,A
2014-11-01,2014,Leicester City,West Bromwich Albion,0-1,0,1,1,1,1,-1,A
2014-11-01,2014,Stoke City,West Ham United,2-2,2,2,1,1,4,0,D
2014-11-02,2014,Manchester City,Manchester United,1-0,1,0,1,1,1,1,H
2014-11-02,2014,Aston Villa,Tottenham Hotspur,1-2,1,2,1,1,3,-1,A
2014-11-03,2014,Crystal Palace,Sunderland,1-3,1,3,1,1,4,-2,A
2014-11-08,2014,Liverpool,Chelsea,1-2,1,2,1,1,3,-1,A
2014-11-08,2014,Burnley,Hull City,1-0,1,0,1,1,1,1,H
2014-11-08,2014,Manchester United,Crystal Palace,1-0,1,0,1,1,1,1,H
2014-11-08,2014,Southampton,Leicester City,2-0,2,0,1,1,2,2,H
2014-11-08,2014,West Ham United,Aston Villa,0-0,0,0,1,1,0,0,D
2014-11-08,2014,Queens Park Rangers,Manchester City,2-2,2,2,1,1,4,0,D
2014-11-09,2014,Sunderland,Everton,1-1,1,1,1,1,2,0,D
2014-11-09,2014,Tottenham Hotspur,Stoke City,1-2,1,2,1,1,3,-1,A
2014-11-09,2014,West Bromwich Albion,Newcastle United,0-2,0,2,1,1,2,-2,A
2014-11-09,2014,Swansea City,Arsenal,2-1,2,1,1,1,3,1,H
2014-11-22,2014,Chelsea,West Bromwich Albion,2-0,2,0,1,1,2,2,H
2014-11-22,2014,Everton,West Ham United,2-1,2,1,1,1,3,1,H
2014-11-22,2014,Leicester City,Sunderland,0-0,0,0,1,1,0,0,D
2014-11-22,2014,Manchester City,Swansea City,2-1,2,1,1,1,3,1,H
2014-11-22,2014,Newcastle United,Queens Park Rangers,1-0,1,0,1,1,1,1,H
2014-11-22,2014,Stoke City,Burnley,1-2,1,2,1,1,3,-1,A
2014-11-22,2014,Arsenal,Manchester United,1-2,1,2,1,1,3,-1,A
2014-11-23,2014,Crystal Palace,Liverpool,3-1,3,1,1,1,4,2,H
2014-11-23,2014,Hull City,Tottenham Hotspur,1-2,1,2,1,1,3,-1,A
2014-11-24,2014,Aston Villa,Southampton,1-1,1,1,1,1,2,0,D
2014-11-29,2014,West Bromwich Albion,Arsenal,0-1,0,1,1,1,1,-1,A
2014-11-29,2014,Burnley,Aston Villa,1-1,1,1,1,1,2,0,D
2014-11-29,2014,Liverpool,Stoke City,1-0,1,0,1,1,1,1,H
2014-11-29,2014,Manchester United,Hull City,3-0,3,0,1,1,3,3,H
2014-11-29,2014,Queens Park Rangers,Leicester City,3-2,3,2,1,1,5,1,H
2014-11-29,2014,Swansea City,Crystal Palace,1-1,1,1,1,1,2,0,D
2014-11-29,2014,West Ham United,Newcastle United,1-0,1,0,1,1,1,1,H
2014-11-29,2014,Sunderland,Chelsea,0-0,0,0,1,1,0,0,D
2014-11-30,2014,Southampton,Manchester City,0-3,0,3,1,1,3,-3,A
2014-11-30,2014,Tottenham Hotspur,Everton,2-1,2,1,1,1,3,1,H
2014-12-02,2014,Burnley,Newcastle United,1-1,1,1,1,1,2,0,D
2014-12-02,2014,Leicester City,Liverpool,1-3,1,3,1,1,4,-2,A
2014-12-02,2014,Manchester United,Stoke City,2-1,2,1,1,1,3,1,H
2014-12-02,2014,Swansea City,Queens Park Rangers,2-0,2,0,1,1,2,2,H
2014-12-02,2014,Crystal Palace,Aston Villa,0-1,0,1,1,1,1,-1,A
2014-12-02,2014,West Bromwich Albion,West Ham United,1-2,1,2,1,1,3,-1,A
2014-12-03,2014,Arsenal,Southampton,1-0,1,0,1,1,1,1,H
2014-12-03,2014,Chelsea,Tottenham Hotspur,3-0,3,0,1,1,3,3,H
2014-12-03,2014,Everton,Hull City,1-1,1,1,1,1,2,0,D
2014-12-03,2014,Sunderland,Manchester City,1-4,1,4,1,1,5,-3,A
2014-12-06,2014,Newcastle United,Chelsea,2-1,2,1,1,1,3,1,H
2014-12-06,2014,Hull City,West Bromwich Albion,0-0,0,0,1,1,0,0,D
2014-12-06,2014,Liverpool,Sunderland,0-0,0,0,1,1,0,0,D
2014-12-06,2014,Queens Park Rangers,Burnley,2-0,2,0,1,1,2,2,H
2014-12-06,2014,Stoke City,Arsenal,3-2,3,2,1,1,5,1,H
2014-12-06,2014,Tottenham Hotspur,Crystal Palace,0-0,0,0,1,1,0,0,D
2014-12-06,2014,Manchester City,Everton,1-0,1,0,1,1,1,1,H
2014-12-07,2014,West Ham United,Swansea City,3-1,3,1,1,1,4,2,H
2014-12-07,2014,Aston Villa,Leicester City,2-1,2,1,1,1,3,1,H
2014-12-08,2014,Southampton,Manchester United,1-2,1,2,1,1,3,-1,A
2014-12-13,2014,Burnley,Southampton,1-0,1,0,1,1,1,1,H
2014-12-13,2014,Chelsea,Hull City,2-0,2,0,1,1,2,2,H
2014-12-13,2014,Crystal Palace,Stoke City,1-1,1,1,1,1,2,0,D
2014-12-13,2014,Leicester City,Manchester City,0-1,0,1,1,1,1,-1,A
2014-12-13,2014,Sunderland,West Ham United,1-1,1,1,1,1,2,0,D
2014-12-13,2014,West Bromwich Albion,Aston Villa,1-0,1,0,1,1,1,1,H
2014-12-13,2014,Arsenal,Newcastle United,4-1,4,1,1,1,5,3,H
2014-12-14,2014,Manchester United,Liverpool,3-0,3,0,1,1,3,3,H
2014-12-14,2014,Swansea City,Tottenham Hotspur,1-2,1,2,1,1,3,-1,A
2014-12-15,2014,Everton,Queens Park Rangers,3-1,3,1,1,1,4,2,H
2014-12-20,2014,Manchester City,Crystal Palace,3-0,3,0,1,1,3,3,H
2014-12-20,2014,Aston Villa,Manchester United,1-1,1,1,1,1,2,0,D
2014-12-20,2014,Hull City,Swansea City,0-1,0,1,1,1,1,-1,A
2014-12-20,2014,Queens Park Rangers,West Bromwich Albion,3-2,3,2,1,1,5,1,H
2014-12-20,2014,Southampton,Everton,3-0,3,0,1,1,3,3,H
2014-12-20,2014,Tottenham Hotspur,Burnley,2-1,2,1,1,1,3,1,H
2014-12-20,2014,West Ham United,Leicester City,2-0,2,0,1,1,2,2,H
2014-12-21,2014,Newcastle United,Sunderland,0-1,0,1,1,1,1,-1,A
2014-12-21,2014,Liverpool,Arsenal,2-2,2,2,1,1,4,0,D
2014-12-22,2014,Stoke City,Chelsea,0-2,0,2,1,1,2,-2,A
2014-12-26,2014,Chelsea,West Ham United,2-0,2,0,1,1,2,2,H
2014-12-26,2014,Burnley,Liverpool,0-1,0,1,1,1,1,-1,A
2014-12-26,2014,Crystal Palace,Southampton,1-3,1,3,1,1,4,-2,A
2014-12-26,2014,Everton,Stoke City,0-1,0,1,1,1,1,-1,A
2014-12-26,2014,Leicester City,Tottenham Hotspur,1-2,1,2,1,1,3,-1,A
2014-12-26,2014,Manchester United,Newcastle United,3-1,3,1,1,1,4,2,H
2014-12-26,2014,Sunderland,Hull City,1-3,1,3,1,1,4,-2,A
2014-12-26,2014,Swansea City,Aston Villa,1-0,1,0,1,1,1,1,H
2014-12-26,2014,West Bromwich Albion,Manchester City,1-3,1,3,1,1,4,-2,A
2014-12-26,2014,Arsenal,Queens Park Rangers,2-1,2,1,1,1,3,1,H
2014-12-28,2014,Tottenham Hotspur,Manchester United,0-0,0,0,1,1,0,0,D
2014-12-28,2014,Southampton,Chelsea,1-1,1,1,1,1,2,0,D
2014-12-28,2014,Aston Villa,Sunderland,0-0,0,0,1,1,0,0,D
2014-12-28,2014,Hull City,Leicester City,0-1,0,1,1,1,1,-1,A
2014-12-28,2014,Manchester City,Burnley,2-2,2,2,1,1,4,0,D
2014-12-28,2014,Queens Park Rangers,Crystal Palace,0-0,0,0,1,1,0,0,D
2014-12-28,2014,Stoke City,West Bromwich Albion,2-0,2,0,1,1,2,2,H
2014-12-28,2014,West Ham United,Arsenal,1-2,1,2,1,1,3,-1,A
2014-12-28,2014,Newcastle United,Everton,3-2,3,2,1,1,5,1,H
2014-12-29,2014,Liverpool,Swansea City,4-1,4,1,1,1,5,3,H
2015-01-01,2014,Stoke City,Manchester United,1-1,1,1,1,1,2,0,D
2015-01-01,2014,Aston Villa,Crystal Palace,0-0,0,0,1,1,0,0,D
2015-01-01,2014,Hull City,Everton,2-0,2,0,1,1,2,2,H
2015-01-01,2014,Liverpool,Leicester City,2-2,2,2,1,1,4,0,D
2015-01-01,2014,Manchester City,Sunderland,3-2,3,2,1,1,5,1,H
2015-01-01,2014,Newcastle United,Burnley,3-3,3,3,1,1,6,0,D
2015-01-01,2014,Queens Park Rangers,Swansea City,1-1,1,1,1,1,2,0,D
2015-01-01,2014,Southampton,Arsenal,2-0,2,0,1,1,2,2,H
2015-01-01,2014,West Ham United,West Bromwich Albion,1-1,1,1,1,1,2,0,D
2015-01-01,2014,Tottenham Hotspur,Chelsea,5-3,5,3,1,1,8,2,H
2015-01-10,2014,Sunderland,Liverpool,0-1,0,1,1,1,1,-1,A
2015-01-10,2014,Burnley,Queens Park Rangers,2-1,2,1,1,1,3,1,H
2015-01-10,2014,Chelsea,Newcastle United,2-0,2,0,1,1,2,2,H
2015-01-10,2014,Everton,Manchester City,1-1,1,1,1,1,2,0,D
2015-01-10,2014,Leicester City,Aston Villa,1-0,1,0,1,1,1,1,H
2015-01-10,2014,Swansea City,West Ham United,1-1,1,1,1,1,2,0,D
2015-01-10,2014,West Bromwich Albion,Hull City,1-0,1,0,1,1,1,1,H
2015-01-10,2014,Crystal Palace,Tottenham Hotspur,2-1,2,1,1,1,3,1,H
2015-01-11,2014,Arsenal,Stoke City,3-0,3,0,1,1,3,3,H
2015-01-11,2014,Manchester United,Southampton,0-1,0,1,1,1,1,-1,A
2015-01-17,2014,Aston Villa,Liverpool,0-2,0,2,1,1,2,-2,A
2015-01-17,2014,Burnley,Crystal Palace,2-3,2,3,1,1,5,-1,A
2015-01-17,2014,Leicester City,Stoke City,0-1,0,1,1,1,1,-1,A
2015-01-17,2014,Queens Park Rangers,Manchester United,0-2,0,2,1,1,2,-2,A
2015-01-17,2014,Swansea City,Chelsea,0-5,0,5,1,1,5,-5,A
2015-01-17,2014,Tottenham Hotspur,Sunderland,2-1,2,1,1,1,3,1,H
2015-01-17,2014,Newcastle United,Southampton,1-2,1,2,1,1,3,-1,A
2015-01-18,2014,West Ham United,Hull City,3-0,3,0,1,1,3,3,H
2015-01-18,2014,Manchester City,Arsenal,0-2,0,2,1,1,2,-2,A
2015-01-19,2014,Everton,West Bromwich Albion,0-0,0,0,1,1,0,0,D
2015-01-31,2014,Hull City,Newcastle United,0-3,0,3,1,1,3,-3,A
2015-01-31,2014,Crystal Palace,Everton,0-1,0,1,1,1,1,-1,A
2015-01-31,2014,Liverpool,West Ham United,2-0,2,0,1,1,2,2,H
2015-01-31,2014,Manchester United,Leicester City,3-1,3,1,1,1,4,2,H
2015-01-31,2014,Stoke City,Queens Park Rangers,3-1,3,1,1,1,4,2,H
2015-01-31,2014,Sunderland,Burnley,2-0,2,0,1,1,2,2,H
2015-01-31,2014,West Bromwich Albion,Tottenham Hotspur,0-3,0,3,1,1,3,-3,A
2015-01-31,2014,Chelsea,Manchester City,1-1,1,1,1,1,2,0,D
2015-02-01,2014,Arsenal,Aston Villa,5-0,5,0,1,1,5,5,H
2015-02-01,2014,Southampton,Swansea City,0-1,0,1,1,1,1,-1,A
2015-02-07,2014,Tottenham Hotspur,Arsenal,2-1,2,1,1,1,3,1,H
2015-02-07,2014,Aston Villa,Chelsea,1-2,1,2,1,1,3,-1,A
2015-02-07,2014,Leicester City,Crystal Palace,0-1,0,1,1,1,1,-1,A
2015-02-07,2014,Manchester City,Hull City,1-1,1,1,1,1,2,0,D
2015-02-07,2014,Queens Park Rangers,Southampton,0-1,0,1,1,1,1,-1,A
2015-02-07,2014,Swansea City,Sunderland,1-1,1,1,1,1,2,0,D
2015-02-07,2014,Everton,Liverpool,0-0,0,0,1,1,0,0,D
2015-02-08,2014,Burnley,West Bromwich Albion,2-2,2,2,1,1,4,0,D
2015-02-08,2014,Newcastle United,Stoke City,1-1,1,1,1,1,2,0,D
2015-02-08,2014,West Ham United,Manchester United,1-1,1,1,1,1,2,0,D
2015-02-10,2014,Arsenal,Leicester City,2-1,2,1,1,1,3,1,H
2015-02-10,2014,Hull City,Aston Villa,2-0,2,0,1,1,2,2,H
2015-02-10,2014,Sunderland,Queens Park Rangers,0-2,0,2,1,1,2,-2,A
2015-02-10,2014,Liverpool,Tottenham Hotspur,3-2,3,2,1,1,5,1,H
2015-02-11,2014,Manchester United,Burnley,3-1,3,1,1,1,4,2,H
2015-02-11,2014,Southampton,West Ham United,0-0,0,0,1,1,0,0,D
2015-02-11,2014,Chelsea,Everton,1-0,1,0,1,1,1,1,H
2015-02-11,2014,Stoke City,Manchester City,1-4,1,4,1,1,5,-3,A
2015-02-11,2014,Crystal Palace,Newcastle United,1-1,1,1,1,1,2,0,D
2015-02-11,2014,West Bromwich Albion,Swansea City,2-0,2,0,1,1,2,2,H
2015-02-21,2014,Aston Villa,Stoke City,1-2,1,2,1,1,3,-1,A
2015-02-21,2014,Chelsea,Burnley,1-1,1,1,1,1,2,0,D
2015-02-21,2014,Crystal Palace,Arsenal,1-2,1,2,1,1,3,-1,A
2015-02-21,2014,Hull City,Queens Park Rangers,2-1,2,1,1,1,3,1,H
2015-02-21,2014,Sunderland,West Bromwich Albion,0-0,0,0,1,1,0,0,D
2015-02-21,2014,Swansea City,Manchester United,2-1,2,1,1,1,3,1,H
2015-02-21,2014,Manchester City,Newcastle United,5-0,5,0,1,1,5,5,H
2015-02-22,2014,Tottenham Hotspur,West Ham United,2-2,2,2,1,1,4,0,D
2015-02-22,2014,Everton,Leicester City,2-2,2,2,1,1,4,0,D
2015-02-22,2014,Southampton,Liverpool,0-2,0,2,1,1,2,-2,A
2015-02-28,2014,West Ham United,Crystal Palace,1-3,1,3,1,1,4,-2,A
2015-02-28,2014,Burnley,Swansea City,0-1,0,1,1,1,1,-1,A
2015-02-28,2014,Manchester United,Sunderland,2-0,2,0,1,1,2,2,H
2015-02-28,2014,Newcastle United,Aston Villa,1-0,1,0,1,1,1,1,H
2015-02-28,2014,Stoke City,Hull City,1-0,1,0,1,1,1,1,H
2015-02-28,2014,West Bromwich Albion,Southampton,1-0,1,0,1,1,1,1,H
2015-03-01,2014,Liverpool,Manchester City,2-1,2,1,1,1,3,1,H
2015-03-01,2014,Arsenal,Everton,2-0,2,0,1,1,2,2,H
2015-03-03,2014,Aston Villa,West Bromwich Albion,2-1,2,1,1,1,3,1,H
2015-03-03,2014,Hull City,Sunderland,1-1,1,1,1,1,2,0,D
2015-03-03,2014,Southampton,Crystal Palace,1-0,1,0,1,1,1,1,H
2015-03-04,2014,Queens Park Rangers,Arsenal,1-2,1,2,1,1,3,-1,A
2015-03-04,2014,West Ham United,Chelsea,0-1,0,1,1,1,1,-1,A
2015-03-04,2014,Manchester City,Leicester City,2-0,2,0,1,1,2,2,H
2015-03-04,2014,Newcastle United,Manchester United,0-1,0,1,1,1,1,-1,A
2015-03-04,2014,Stoke City,Everton,2-0,2,0,1,1,2,2,H
2015-03-04,2014,Tottenham Hotspur,Swansea City,3-2,3,2,1,1,5,1,H
2015-03-04,2014,Liverpool,Burnley,2-0,2,0,1,1,2,2,H
2015-03-07,2014,Queens Park Rangers,Tottenham Hotspur,1-2,1,2,1,1,3,-1,A
2015-03-14,2014,Crystal Palace,Queens Park Rangers,3-1,3,1,1,1,4,2,H
2015-03-14,2014,Arsenal,West Ham United,3-0,3,0,1,1,3,3,H
2015-03-14,2014,Leicester City,Hull City,0-0,0,0,1,1,0,0,D
2015-03-14,2014,Sunderland,Aston Villa,0-4,0,4,1,1,4,-4,A
2015-03-14,2014,West Bromwich Albion,Stoke City,1-0,1,0,1,1,1,1,H
2015-03-14,2014,Burnley,Manchester City,1-0,1,0,1,1,1,1,H
2015-03-15,2014,Chelsea,Southampton,1-1,1,1,1,1,2,0,D
2015-03-15,2014,Everton,Newcastle United,3-0,3,0,1,1,3,3,H
2015-03-15,2014,Manchester United,Tottenham Hotspur,3-0,3,0,1,1,3,3,H
2015-03-16,2014,Swansea City,Liverpool,0-1,0,1,1,1,1,-1,A
2015-03-21,2014,Manchester City,West Bromwich Albion,3-0,3,0,1,1,3,3,H
2015-03-21,2014,Aston Villa,Swansea City,0-1,0,1,1,1,1,-1,A
2015-03-21,2014,Newcastle United,Arsenal,1-2,1,2,1,1,3,-1,A
2015-03-21,2014,Southampton,Burnley,2-0,2,0,1,1,2,2,H
2015-03-21,2014,Stoke City,Crystal Palace,1-2,1,2,1,1,3,-1,A
2015-03-21,2014,Tottenham Hotspur,Leicester City,4-3,4,3,1,1,7,1,H
2015-03-21,2014,West Ham United,Sunderland,1-0,1,0,1,1,1,1,H
2015-03-22,2014,Liverpool,Manchester United,1-2,1,2,1,1,3,-1,A
2015-03-22,2014,Hull City,Chelsea,2-3,2,3,1,1,5,-1,A
2015-03-22,2014,Queens Park Rangers,Everton,1-2,1,2,1,1,3,-1,A
2015-04-04,2014,Arsenal,Liverpool,4-1,4,1,1,1,5,3,H
2015-04-04,2014,Everton,Southampton,1-0,1,0,1,1,1,1,H
2015-04-04,2014,Leicester City,West Ham United,2-1,2,1,1,1,3,1,H
2015-04-04,2014,Manchester United,Aston Villa,3-1,3,1,1,1,4,2,H
2015-04-04,2014,Swansea City,Hull City,3-1,3,1,1,1,4,2,H
2015-04-04,2014,West Bromwich Albion,Queens Park Rangers,1-4,1,4,1,1,5,-3,A
2015-04-04,2014,Chelsea,Stoke City,2-1,2,1,1,1,3,1,H
2015-04-05,2014,Burnley,Tottenham Hotspur,0-0,0,0,1,1,0,0,D
2015-04-05,2014,Sunderland,Newcastle United,1-0,1,0,1,1,1,1,H
2015-04-06,2014,Crystal Palace,Manchester City,2-1,2,1,1,1,3,1,H
2015-04-07,2014,Aston Villa,Queens Park Rangers,3-3,3,3,1,1,6,0,D
2015-04-11,2014,Swansea City,Everton,1-1,1,1,1,1,2,0,D
2015-04-11,2014,Southampton,Hull City,2-0,2,0,1,1,2,2,H
2015-04-11,2014,Sunderland,Crystal Palace,1-4,1,4,1,1,5,-3,A
2015-04-11,2014,Tottenham Hotspur,Aston Villa,0-1,0,1,1,1,1,-1,A
2015-04-11,2014,West Bromwich Albion,Leicester City,2-3,2,3,1,1,5,-1,A
2015-04-11,2014,West Ham United,Stoke City,1-1,1,1,1,1,2,0,D
2015-04-11,2014,Burnley,Arsenal,0-1,0,1,1,1,1,-1,A
2015-04-12,2014,Queens Park Rangers,Chelsea,0-1,0,1,1,1,1,-1,A
2015-04-12,2014,Manchester United,Manchester City,4-2,4,2,1,1,6,2,H
2015-04-13,2014,Liverpool,Newcastle United,2-0,2,0,1,1,2,2,H
2015-04-18,2014,Crystal Palace,West Bromwich Albion,0-2,0,2,1,1,2,-2,A
2015-04-18,2014,Everton,Burnley,1-0,1,0,1,1,1,1,H
2015-04-18,2014,Leicester City,Swansea City,2-0,2,0,1,1,2,2,H
2015-04-18,2014,Stoke City,Southampton,2-1,2,1,1,1,3,1,H
2015-04-18,2014,Chelsea,Manchester United,1-0,1,0,1,1,1,1,H
2015-04-19,2014,Manchester City,West Ham United,2-0,2,0,1,1,2,2,H
2015-04-19,2014,Newcastle United,Tottenham Hotspur,1-3,1,3,1,1,4,-2,A
2015-04-25,2014,Southampton,Tottenham Hotspur,2-2,2,2,1,1,4,0,D
2015-04-25,2014,Burnley,Leicester City,0-1,0,1,1,1,1,-1,A
2015-04-25,2014,Crystal Palace,Hull City,0-2,0,2,1,1,2,-2,A
2015-04-25,2014,Newcastle United,Swansea City,2-3,2,3,1,1,5,-1,A
2015-04-25,2014,Queens Park Rangers,West Ham United,0-0,0,0,1,1,0,0,D
2015-04-25,2014,Stoke City,Sunderland,1-1,1,1,1,1,2,0,D
2015-04-25,2014,West Bromwich Albion,Liverpool,0-0,0,0,1,1,0,0,D
2015-04-25,2014,Manchester City,Aston Villa,3-2,3,2,1,1,5,1,H
2015-04-26,2014,Everton,Manchester United,3-0,3,0,1,1,3,3,H
2015-04-26,2014,Arsenal,Chelsea,0-0,0,0,1,1,0,0,D
2015-04-28,2014,Hull City,Liverpool,1-0,1,0,1,1,1,1,H
2015-04-29,2014,Leicester City,Chelsea,1-3,1,3,1,1,4,-2,A
2015-05-02,2014,Leicester City,Newcastle United,3-0,3,0,1,1,3,3,H
2015-05-02,2014,Aston Villa,Everton,3-2,3,2,1,1,5,1,H
2015-05-02,2014,Liverpool,Queens Park Rangers,2-1,2,1,1,1,3,1,H
2015-05-02,2014,Sunderland,Southampton,2-1,2,1,1,1,3,1,H
2015-05-02,2014,Swansea City,Stoke City,2-0,2,0,1,1,2,2,H
2015-05-02,2014,West Ham United,Burnley,1-0,1,0,1,1,1,1,H
2015-05-02,2014,Manchester United,West Bromwich Albion,0-1,0,1,1,1,1,-1,A
2015-05-03,2014,Chelsea,Crystal Palace,1-0,1,0,1,1,1,1,H
2015-05-03,2014,Tottenham Hotspur,Manchester City,0-1,0,1,1,1,1,-1,A
2015-05-04,2014,Hull City,Arsenal,1-3,1,3,1,1,4,-2,A
2015-05-09,2014,Everton,Sunderland,0-2,0,2,1,1,2,-2,A
2015-05-09,2014,Aston Villa,West Ham United,1-0,1,0,1,1,1,1,H
2015-05-09,2014,Hull City,Burnley,0-1,0,1,1,1,1,-1,A
2015-05-09,2014,Leicester City,Southampton,2-0,2,0,1,1,2,2,H
2015-05-09,2014,Newcastle United,West Bromwich Albion,1-1,1,1,1,1,2,0,D
2015-05-09,2014,Stoke City,Tottenham Hotspur,3-0,3,0,1,1,3,3,H
2015-05-09,2014,Crystal Palace,Manchester United,1-2,1,2,1,1,3,-1,A
2015-05-10,2014,Manchester City,Queens Park Rangers,6-0,6,0,1,1,6,6,H
2015-05-10,2014,Chelsea,Liverpool,1-1,1,1,1,1,2,0,D
2015-05-11,2014,Arsenal,Swansea City,0-1,0,1,1,1,1,-1,A
2015-05-16,2014,Southampton,Aston Villa,6-1,6,1,1,1,7,5,H
2015-05-16,2014,Burnley,Stoke City,0-0,0,0,1,1,0,0,D
2015-05-16,2014,Queens Park Rangers,Newcastle United,2-1,2,1,1,1,3,1,H
2015-05-16,2014,Sunderland,Leicester City,0-0,0,0,1,1,0,0,D
2015-05-16,2014,Tottenham Hotspur,Hull City,2-0,2,0,1,1,2,2,H
2015-05-16,2014,West Ham United,Everton,1-2,1,2,1,1,3,-1,A
2015-05-16,2014,Liverpool,Crystal Palace,1-3,1,3,1,1,4,-2,A
2015-05-17,2014,Swansea City,Manchester City,2-4,2,4,1,1,6,-2,A
2015-05-17,2014,Manchester United,Arsenal,1-1,1,1,1,1,2,0,D
2015-05-18,2014,West Bromwich Albion,Chelsea,3-0,3,0,1,1,3,3,H
2015-05-20,2014,Arsenal,Sunderland,0-0,0,0,1,1,0,0,D
2015-05-24,2014,Arsenal,West Bromwich Albion,4-1,4,1,1,1,5,3,H
2015-05-24,2014,Aston Villa,Burnley,0-1,0,1,1,1,1,-1,A
2015-05-24,2014,Chelsea,Sunderland,3-1,3,1,1,1,4,2,H
2015-05-24,2014,Crystal Palace,Swansea City,1-0,1,0,1,1,1,1,H
2015-05-24,2014,Everton,Tottenham Hotspur,0-1,0,1,1,1,1,-1,A
2015-05-24,2014,Hull City,Manchester United,0-0,0,0,1,1,0,0,D
2015-05-24,2014,Leicester City,Queens Park Rangers,5-1,5,1,1,1,6,4,H
2015-05-24,2014,Manchester City,Southampton,2-0,2,0,1,1,2,2,H
2015-05-24,2014,Newcastle United,West Ham United,2-0,2,0,1,1,2,2,H
2015-05-24,2014,Stoke City,Liverpool,6-1,6,1,1,1,7,5,H
2015-08-08,2015,Manchester United,Tottenham Hotspur,1-0,1,0,1,1,1,1,H
2015-08-08,2015,AFC Bournemouth,Aston Villa,0-1,0,1,1,1,1,-1,A
2015-08-08,2015,Everton,Watford,2-2,2,2,1,1,4,0,D
2015-08-08,2015,Leicester City,Sunderland,4-2,4,2,1,1,6,2,H
2015-08-08,2015,Norwich City,Crystal Palace,1-3,1,3,1,1,4,-2,A
2015-08-08,2015,Chelsea,Swansea City,2-2,2,2,1,1,4,0,D
2015-08-09,2015,Arsenal,West Ham United,0-2,0,2,1,1,2,-2,A
2015-08-09,2015,Newcastle United,Southampton,2-2,2,2,1,1,4,0,D
2015-08-09,2015,Stoke City,Liverpool,0-1,0,1,1,1,1,-1,A
2015-08-10,2015,West Bromwich Albion,Manchester City,0-3,0,3,1,1,3,-3,A
2015-08-14,2015,Aston Villa,Manchester United,0-1,0,1,1,1,1,-1,A
2015-08-15,2015,Southampton,Everton,0-3,0,3,1,1,3,-3,A
2015-08-15,2015,Sunderland,Norwich City,1-3,1,3,1,1,4,-2,A
2015-08-15,2015,Swansea City,Newcastle United,2-0,2,0,1,1,2,2,H
2015-08-15,2015,Tottenham Hotspur,Stoke City,2-2,2,2,1,1,4,0,D
2015-08-15,2015,Watford,West Bromwich Albion,0-0,0,0,1,1,0,0,D
2015-08-15,2015,West Ham United,Leicester City,1-2,1,2,1,1,3,-1,A
2015-08-16,2015,Crystal Palace,Arsenal,1-2,1,2,1,1,3,-1,A
2015-08-16,2015,Manchester City,Chelsea,3-0,3,0,1,1,3,3,H
2015-08-17,2015,Liverpool,AFC Bournemouth,1-0,1,0,1,1,1,1,H
2015-08-22,2015,Manchester United,Newcastle United,0-0,0,0,1,1,0,0,D
2015-08-22,2015,Crystal Palace,Aston Villa,2-1,2,1,1,1,3,1,H
2015-08-22,2015,Leicester City,Tottenham Hotspur,1-1,1,1,1,1,2,0,D
2015-08-22,2015,Norwich City,Stoke City,1-1,1,1,1,1,2,0,D
2015-08-22,2015,Sunderland,Swansea City,1-1,1,1,1,1,2,0,D
2015-08-22,2015,West Ham United,AFC Bournemouth,3-4,3,4,1,1,7,-1,A
2015-08-23,2015,West Bromwich Albion,Chelsea,2-3,2,3,1,1,5,-1,A
2015-08-23,2015,Everton,Manchester City,0-2,0,2,1,1,2,-2,A
2015-08-23,2015,Watford,Southampton,0-0,0,0,1,1,0,0,D
2015-08-24,2015,Arsenal,Liverpool,0-0,0,0,1,1,0,0,D
2015-08-29,2015,Newcastle United,Arsenal,0-1,0,1,1,1,1,-1,A
2015-08-29,2015,AFC Bournemouth,Leicester City,1-1,1,1,1,1,2,0,D
2015-08-29,2015,Aston Villa,Sunderland,2-2,2,2,1,1,4,0,D
2015-08-29,2015,Chelsea,Crystal Palace,1-2,1,2,1,1,3,-1,A
2015-08-29,2015,Liverpool,West Ham United,0-3,0,3,1,1,3,-3,A
2015-08-29,2015,Manchester City,Watford,2-0,2,0,1,1,2,2,H
2015-08-29,2015,Stoke City,West Bromwich Albion,0-1,0,1,1,1,1,-1,A
2015-08-29,2015,Tottenham Hotspur,Everton,0-0,0,0,1,1,0,0,D
2015-08-30,2015,Southampton,Norwich City,3-0,3,0,1,1,3,3,H
2015-08-30,2015,Swansea City,Manchester United,2-1,2,1,1,1,3,1,H
2015-09-12,2015,Everton,Chelsea,3-1,3,1,1,1,4,2,H
2015-09-12,2015,Arsenal,Stoke City,2-0,2,0,1,1,2,2,H
2015-09-12,2015,Crystal Palace,Manchester City,0-1,0,1,1,1,1,-1,A
2015-09-12,2015,Norwich City,AFC Bournemouth,3-1,3,1,1,1,4,2,H
2015-09-12,2015,Watford,Swansea City,1-0,1,0,1,1,1,1,H
2015-09-12,2015,West Bromwich Albion,Southampton,0-0,0,0,1,1,0,0,D
2015-09-12,2015,Manchester United,Liverpool,3-1,3,1,1,1,4,2,H
2015-09-13,2015,Sunderland,Tottenham Hotspur,0-1,0,1,1,1,1,-1,A
2015-09-13,2015,Leicester City,Aston Villa,3-2,3,2,1,1,5,1,H
2015-09-14,2015,West Ham United,Newcastle United,2-0,2,0,1,1,2,2,H
2015-09-19,2015,Chelsea,Arsenal,2-0,2,0,1,1,2,2,H
2015-09-19,2015,AFC Bournemouth,Sunderland,2-0,2,0,1,1,2,2,H
2015-09-19,2015,Aston Villa,West Bromwich Albion,0-1,0,1,1,1,1,-1,A
2015-09-19,2015,Newcastle United,Watford,1-2,1,2,1,1,3,-1,A
2015-09-19,2015,Stoke City,Leicester City,2-2,2,2,1,1,4,0,D
2015-09-19,2015,Swansea City,Everton,0-0,0,0,1,1,0,0,D
2015-09-19,2015,Manchester City,West Ham United,1-2,1,2,1,1,3,-1,A
2015-09-20,2015,Tottenham Hotspur,Crystal Palace,1-0,1,0,1,1,1,1,H
2015-09-20,2015,Liverpool,Norwich City,1-1,1,1,1,1,2,0,D
2015-09-20,2015,Southampton,Manchester United,2-3,2,3,1,1,5,-1,A
2015-09-26,2015,Tottenham Hotspur,Manchester City,4-1,4,1,1,1,5,3,H
2015-09-26,2015,Leicester City,Arsenal,2-5,2,5,1,1,7,-3,A
2015-09-26,2015,Liverpool,Aston Villa,3-2,3,2,1,1,5,1,H
2015-09-26,2015,Manchester United,Sunderland,3-0,3,0,1,1,3,3,H
2015-09-26,2015,Southampton,Swansea City,3-1,3,1,1,1,4,2,H
2015-09-26,2015,Stoke City,AFC Bournemouth,2-1,2,1,1,1,3,1,H
2015-09-26,2015,West Ham United,Norwich City,2-2,2,2,1,1,4,0,D
2015-09-26,2015,Newcastle United,Chelsea,2-2,2,2,1,1,4,0,D
2015-09-27,2015,Watford,Crystal Palace,0-1,0,1,1,1,1,-1,A
2015-09-28,2015,West Bromwich Albion,Everton,2-3,2,3,1,1,5,-1,A
2015-10-03,2015,Crystal Palace,West Bromwich Albion,2-0,2,0,1,1,2,2,H
2015-10-03,2015,AFC Bournemouth,Watford,1-1,1,1,1,1,2,0,D
2015-10-03,2015,Aston Villa,Stoke City,0-1,0,1,1,1,1,-1,A
2015-10-03,2015,Manchester City,Newcastle United,6-1,6,1,1,1,7,5,H
2015-10-03,2015,Norwich City,Leicester City,1-2,1,2,1,1,3,-1,A
2015-10-03,2015,Sunderland,West Ham United,2-2,2,2,1,1,4,0,D
2015-10-03,2015,Chelsea,Southampton,1-3,1,3,1,1,4,-2,A
2015-10-04,2015,Everton,Liverpool,1-1,1,1,1,1,2,0,D
2015-10-04,2015,Arsenal,Manchester United,3-0,3,0,1,1,3,3,H
2015-10-04,2015,Swansea City,Tottenham Hotspur,2-2,2,2,1,1,4,0,D
2015-10-17,2015,Tottenham Hotspur,Liverpool,0-0,0,0,1,1,0,0,D
2015-10-17,2015,Chelsea,Aston Villa,2-0,2,0,1,1,2,2,H
2015-10-17,2015,Crystal Palace,West Ham United,1-3,1,3,1,1,4,-2,A
2015-10-17,2015,Everton,Manchester United,0-3,0,3,1,1,3,-3,A
2015-10-17,2015,Manchester City,AFC Bournemouth,5-1,5,1,1,1,6,4,H
2015-10-17,2015,Southampton,Leicester City,2-2,2,2,1,1,4,0,D
2015-10-17,2015,West Bromwich Albion,Sunderland,1-0,1,0,1,1,1,1,H
2015-10-17,2015,Watford,Arsenal,0-3,0,3,1,1,3,-3,A
2015-10-18,2015,Newcastle United,Norwich City,6-2,6,2,1,1,8,4,H
2015-10-19,2015,Swansea City,Stoke City,0-1,0,1,1,1,1,-1,A
2015-10-24,2015,Aston Villa,Swansea City,1-2,1,2,1,1,3,-1,A
2015-10-24,2015,Leicester City,Crystal Palace,1-0,1,0,1,1,1,1,H
2015-10-24,2015,Norwich City,West Bromwich Albion,0-1,0,1,1,1,1,-1,A
2015-10-24,2015,Stoke City,Watford,0-2,0,2,1,1,2,-2,A
2015-10-24,2015,West Ham United,Chelsea,2-1,2,1,1,1,3,1,H
2015-10-24,2015,Arsenal,Everton,2-1,2,1,1,1,3,1,H
2015-10-25,2015,Sunderland,Newcastle United,3-0,3,0,1,1,3,3,H
2015-10-25,2015,AFC Bournemouth,Tottenham Hotspur,1-5,1,5,1,1,6,-4,A
2015-10-25,2015,Manchester United,Manchester City,0-0,0,0,1,1,0,0,D
2015-10-25,2015,Liverpool,Southampton,1-1,1,1,1,1,2,0,D
2015-10-31,2015,Chelsea,Liverpool,1-3,1,3,1,1,4,-2,A
2015-10-31,2015,Crystal Palace,Manchester United,0-0,0,0,1,1,0,0,D
2015-10-31,2015,Manchester City,Norwich City,2-1,2,1,1,1,3,1,H
2015-10-31,2015,Newcastle United,Stoke City,0-0,0,0,1,1,0,0,D
2015-10-31,2015,Swansea City,Arsenal,0-3,0,3,1,1,3,-3,A
2015-10-31,2015,Watford,West Ham United,2-0,2,0,1,1,2,2,H
2015-10-31,2015,West Bromwich Albion,Leicester City,2-3,2,3,1,1,5,-1,A
2015-11-01,2015,Everton,Sunderland,6-2,6,2,1,1,8,4,H
2015-11-01,2015,Southampton,AFC Bournemouth,2-0,2,0,1,1,2,2,H
2015-11-02,2015,Tottenham Hotspur,Aston Villa,3-1,3,1,1,1,4,2,H
2015-11-07,2015,AFC Bournemouth,Newcastle United,0-1,0,1,1,1,1,-1,A
2015-11-07,2015,Leicester City,Watford,2-1,2,1,1,1,3,1,H
2015-11-07,2015,Manchester United,West Bromwich Albion,2-0,2,0,1,1,2,2,H
2015-11-07,2015,Norwich City,Swansea City,1-0,1,0,1,1,1,1,H
2015-11-07,2015,Sunderland,Southampton,0-1,0,1,1,1,1,-1,A
2015-11-07,2015,West Ham United,Everton,1-1,1,1,1,1,2,0,D
2015-11-07,2015,Stoke City,Chelsea,1-0,1,0,1,1,1,1,H
2015-11-08,2015,Aston Villa,Manchester City,0-0,0,0,1,1,0,0,D
2015-11-08,2015,Arsenal,Tottenham Hotspur,1-1,1,1,1,1,2,0,D
2015-11-08,2015,Liverpool,Crystal Palace,1-2,1,2,1,1,3,-1,A
2015-11-21,2015,Watford,Manchester United,1-2,1,2,1,1,3,-1,A
2015-11-21,2015,Chelsea,Norwich City,1-0,1,0,1,1,1,1,H
2015-11-21,2015,Everton,Aston Villa,4-0,4,0,1,1,4,4,H
2015-11-21,2015,Newcastle United,Leicester City,0-3,0,3,1,1,3,-3,A
2015-11-21,2015,Southampton,Stoke City,0-1,0,1,1,1,1,-1,A
2015-11-21,2015,Swansea City,AFC Bournemouth,2-2,2,2,1,1,4,0,D
2015-11-21,2015,West Bromwich Albion,Arsenal,2-1,2,1,1,1,3,1,H
2015-11-21,2015,Manchester City,Liverpool,1-4,1,4,1,1,5,-3,A
2015-11-22,2015,Tottenham Hotspur,West Ham United,4-1,4,1,1,1,5,3,H
2015-11-23,2015,Crystal Palace,Sunderland,0-1,0,1,1,1,1,-1,A
2015-11-28,2015,AFC Bournemouth,Everton,3-3,3,3,1,1,6,0,D
2015-11-28,2015,Aston Villa,Watford,2-3,2,3,1,1,5,-1,A
2015-11-28,2015,Crystal Palace,Newcastle United,5-1,5,1,1,1,6,4,H
2015-11-28,2015,Manchester City,Southampton,3-1,3,1,1,1,4,2,H
2015-11-28,2015,Sunderland,Stoke City,2-0,2,0,1,1,2,2,H
2015-11-28,2015,Leicester City,Manchester United,1-1,1,1,1,1,2,0,D
2015-11-29,2015,Tottenham Hotspur,Chelsea,0-0,0,0,1,1,0,0,D
2015-11-29,2015,West Ham United,West Bromwich Albion,1-1,1,1,1,1,2,0,D
2015-11-29,2015,Liverpool,Swansea City,1-0,1,0,1,1,1,1,H
2015-11-29,2015,Norwich City,Arsenal,1-1,1,1,1,1,2,0,D
2015-12-05,2015,Stoke City,Manchester City,2-0,2,0,1,1,2,2,H
2015-12-05,2015,Arsenal,Sunderland,3-1,3,1,1,1,4,2,H
2015-12-05,2015,Manchester United,West Ham United,0-0,0,0,1,1,0,0,D
2015-12-05,2015,Southampton,Aston Villa,1-1,1,1,1,1,2,0,D
2015-12-05,2015,Swansea City,Leicester City,0-3,0,3,1,1,3,-3,A
2015-12-05,2015,Watford,Norwich City,2-0,2,0,1,1,2,2,H
2015-12-05,2015,West Bromwich Albion,Tottenham Hotspur,1-1,1,1,1,1,2,0,D
2015-12-05,2015,Chelsea,AFC Bournemouth,0-1,0,1,1,1,1,-1,A
2015-12-06,2015,Newcastle United,Liverpool,2-0,2,0,1,1,2,2,H
2015-12-07,2015,Everton,Crystal Palace,1-1,1,1,1,1,2,0,D
2015-12-12,2015,Norwich City,Everton,1-1,1,1,1,1,2,0,D
2015-12-12,2015,Crystal Palace,Southampton,1-0,1,0,1,1,1,1,H
2015-12-12,2015,Manchester City,Swansea City,2-1,2,1,1,1,3,1,H
2015-12-12,2015,Sunderland,Watford,0-1,0,1,1,1,1,-1,A
2015-12-12,2015,West Ham United,Stoke City,0-0,0,0,1,1,0,0,D
2015-12-12,2015,AFC Bournemouth,Manchester United,2-1,2,1,1,1,3,1,H
2015-12-13,2015,Aston Villa,Arsenal,0-2,0,2,1,1,2,-2,A
2015-12-13,2015,Liverpool,West Bromwich Albion,2-2,2,2,1,1,4,0,D
2015-12-13,2015,Tottenham Hotspur,Newcastle United,1-2,1,2,1,1,3,-1,A
2015-12-14,2015,Leicester City,Chelsea,2-1,2,1,1,1,3,1,H
2015-12-19,2015,Chelsea,Sunderland,3-1,3,1,1,1,4,2,H
2015-12-19,2015,Everton,Leicester City,2-3,2,3,1,1,5,-1,A
2015-12-19,2015,Manchester United,Norwich City,1-2,1,2,1,1,3,-1,A
2015-12-19,2015,Southampton,Tottenham Hotspur,0-2,0,2,1,1,2,-2,A
2015-12-19,2015,Stoke City,Crystal Palace,1-2,1,2,1,1,3,-1,A
2015-12-19,2015,West Bromwich Albion,AFC Bournemouth,1-2,1,2,1,1,3,-1,A
2015-12-19,2015,Newcastle United,Aston Villa,1-1,1,1,1,1,2,0,D
2015-12-20,2015,Watford,Liverpool,3-0,3,0,1,1,3,3,H
2015-12-20,2015,Swansea City,West Ham United,0-0,0,0,1,1,0,0,D
2015-12-21,2015,Arsenal,Manchester City,2-1,2,1,1,1,3,1,H
2015-12-26,2015,Stoke City,Manchester United,2-0,2,0,1,1,2,2,H
2015-12-26,2015,AFC Bournemouth,Crystal Palace,0-0,0,0,1,1,0,0,D
2015-12-26,2015,Aston Villa,West Ham United,1-1,1,1,1,1,2,0,D
2015-12-26,2015,Chelsea,Watford,2-2,2,2,1,1,4,0,D
2015-12-26,2015,Liverpool,Leicester City,1-0,1,0,1,1,1,1,H
2015-12-26,2015,Manchester City,Sunderland,4-1,4,1,1,1,5,3,H
2015-12-26,2015,Swansea City,West Bromwich Albion,1-0,1,0,1,1,1,1,H
2015-12-26,2015,Tottenham Hotspur,Norwich City,3-0,3,0,1,1,3,3,H
2015-12-26,2015,Newcastle United,Everton,0-1,0,1,1,1,1,-1,A
2015-12-26,2015,Southampton,Arsenal,4-0,4,0,1,1,4,4,H
2015-12-28,2015,Crystal Palace,Swansea City,0-0,0,0,1,1,0,0,D
2015-12-28,2015,Everton,Stoke City,3-4,3,4,1,1,7,-1,A
2015-12-28,2015,Norwich City,Aston Villa,2-0,2,0,1,1,2,2,H
2015-12-28,2015,Watford,Tottenham Hotspur,1-2,1,2,1,1,3,-1,A
2015-12-28,2015,West Bromwich Albion,Newcastle United,1-0,1,0,1,1,1,1,H
2015-12-28,2015,Arsenal,AFC Bournemouth,2-0,2,0,1,1,2,2,H
2015-12-28,2015,Manchester United,Chelsea,0-0,0,0,1,1,0,0,D
2015-12-28,2015,West Ham United,Southampton,2-1,2,1,1,1,3,1,H
2015-12-29,2015,Leicester City,Manchester City,0-0,0,0,1,1,0,0,D
2015-12-30,2015,Sunderland,Liverpool,0-1,0,1,1,1,1,-1,A
2016-01-02,2015,West Ham United,Liverpool,2-0,2,0,1,1,2,2,H
2016-01-02,2015,Arsenal,Newcastle United,1-0,1,0,1,1,1,1,H
2016-01-02,2015,Leicester City,AFC Bournemouth,0-0,0,0,1,1,0,0,D
2016-01-02,2015,Manchester United,Swansea City,2-1,2,1,1,1,3,1,H
2016-01-02,2015,Norwich City,Southampton,1-0,1,0,1,1,1,1,H
2016-01-02,2015,Sunderland,Aston Villa,3-1,3,1,1,1,4,2,H
2016-01-02,2015,West Bromwich Albion,Stoke City,2-1,2,1,1,1,3,1,H
2016-01-02,2015,Watford,Manchester City,1-2,1,2,1,1,3,-1,A
2016-01-03,2015,Crystal Palace,Chelsea,0-3,0,3,1,1,3,-3,A
2016-01-03,2015,Everton,Tottenham Hotspur,1-1,1,1,1,1,2,0,D
2016-01-12,2015,AFC Bournemouth,West Ham United,1-3,1,3,1,1,4,-2,A
2016-01-12,2015,Aston Villa,Crystal Palace,1-0,1,0,1,1,1,1,H
2016-01-12,2015,Newcastle United,Manchester United,3-3,3,3,1,1,6,0,D
2016-01-13,2015,Swansea City,Sunderland,2-4,2,4,1,1,6,-2,A
2016-01-13,2015,Chelsea,West Bromwich Albion,2-2,2,2,1,1,4,0,D
2016-01-13,2015,Manchester City,Everton,0-0,0,0,1,1,0,0,D
2016-01-13,2015,Southampton,Watford,2-0,2,0,1,1,2,2,H
2016-01-13,2015,Stoke City,Norwich City,3-1,3,1,1,1,4,2,H
2016-01-13,2015,Liverpool,Arsenal,3-3,3,3,1,1,6,0,D
2016-01-13,2015,Tottenham Hotspur,Leicester City,0-1,0,1,1,1,1,-1,A
2016-01-16,2015,Tottenham Hotspur,Sunderland,4-1,4,1,1,1,5,3,H
2016-01-16,2015,AFC Bournemouth,Norwich City,3-0,3,0,1,1,3,3,H
2016-01-16,2015,Chelsea,Everton,3-3,3,3,1,1,6,0,D
2016-01-16,2015,Manchester City,Crystal Palace,4-0,4,0,1,1,4,4,H
2016-01-16,2015,Newcastle United,West Ham United,2-1,2,1,1,1,3,1,H
2016-01-16,2015,Southampton,West Bromwich Albion,3-0,3,0,1,1,3,3,H
2016-01-16,2015,Aston Villa,Leicester City,1-1,1,1,1,1,2,0,D
2016-01-17,2015,Liverpool,Manchester United,0-1,0,1,1,1,1,-1,A
2016-01-17,2015,Stoke City,Arsenal,0-0,0,0,1,1,0,0,D
2016-01-18,2015,Swansea City,Watford,1-0,1,0,1,1,1,1,H
2016-01-23,2015,Norwich City,Liverpool,4-5,4,5,1,1,9,-1,A
2016-01-23,2015,Crystal Palace,Tottenham Hotspur,1-3,1,3,1,1,4,-2,A
2016-01-23,2015,Leicester City,Stoke City,3-0,3,0,1,1,3,3,H
2016-01-23,2015,Manchester United,Southampton,0-1,0,1,1,1,1,-1,A
2016-01-23,2015,Sunderland,AFC Bournemouth,1-1,1,1,1,1,2,0,D
2016-01-23,2015,Watford,Newcastle United,2-1,2,1,1,1,3,1,H
2016-01-23,2015,West Bromwich Albion,Aston Villa,0-0,0,0,1,1,0,0,D
2016-01-23,2015,West Ham United,Manchester City,2-2,2,2,1,1,4,0,D
2016-01-24,2015,Everton,Swansea City,1-2,1,2,1,1,3,-1,A
2016-01-24,2015,Arsenal,Chelsea,0-1,0,1,1,1,1,-1,A
2016-02-02,2015,Arsenal,Southampton,0-0,0,0,1,1,0,0,D
2016-02-02,2015,Leicester City,Liverpool,2-0,2,0,1,1,2,2,H
2016-02-02,2015,Norwich City,Tottenham Hotspur,0-3,0,3,1,1,3,-3,A
2016-02-02,2015,Sunderland,Manchester City,0-1,0,1,1,1,1,-1,A
2016-02-02,2015,West Ham United,Aston Villa,2-0,2,0,1,1,2,2,H
2016-02-02,2015,Crystal Palace,AFC Bournemouth,1-2,1,2,1,1,3,-1,A
2016-02-02,2015,Manchester United,Stoke City,3-0,3,0,1,1,3,3,H
2016-02-02,2015,West Bromwich Albion,Swansea City,1-1,1,1,1,1,2,0,D
2016-02-03,2015,Watford,Chelsea,0-0,0,0,1,1,0,0,D
2016-02-03,2015,Everton,Newcastle United,3-0,3,0,1,1,3,3,H
2016-02-06,2015,Manchester City,Leicester City,1-3,1,3,1,1,4,-2,A
2016-02-06,2015,Aston Villa,Norwich City,2-0,2,0,1,1,2,2,H
2016-02-06,2015,Liverpool,Sunderland,2-2,2,2,1,1,4,0,D
2016-02-06,2015,Newcastle United,West Bromwich Albion,1-0,1,0,1,1,1,1,H
2016-02-06,2015,Stoke City,Everton,0-3,0,3,1,1,3,-3,A
2016-02-06,2015,Swansea City,Crystal Palace,1-1,1,1,1,1,2,0,D
2016-02-06,2015,Tottenham Hotspur,Watford,1-0,1,0,1,1,1,1,H
2016-02-06,2015,Southampton,West Ham United,1-0,1,0,1,1,1,1,H
2016-02-07,2015,AFC Bournemouth,Arsenal,0-2,0,2,1,1,2,-2,A
2016-02-07,2015,Chelsea,Manchester United,1-1,1,1,1,1,2,0,D
2016-02-13,2015,Sunderland,Manchester United,2-1,2,1,1,1,3,1,H
2016-02-13,2015,AFC Bournemouth,Stoke City,1-3,1,3,1,1,4,-2,A
2016-02-13,2015,Crystal Palace,Watford,1-2,1,2,1,1,3,-1,A
2016-02-13,2015,Everton,West Bromwich Albion,0-1,0,1,1,1,1,-1,A
2016-02-13,2015,Norwich City,West Ham United,2-2,2,2,1,1,4,0,D
2016-02-13,2015,Swansea City,Southampton,0-1,0,1,1,1,1,-1,A
2016-02-13,2015,Chelsea,Newcastle United,5-1,5,1,1,1,6,4,H
2016-02-14,2015,Arsenal,Leicester City,2-1,2,1,1,1,3,1,H
2016-02-14,2015,Aston Villa,Liverpool,0-6,0,6,1,1,6,-6,A
2016-02-14,2015,Manchester City,Tottenham Hotspur,1-2,1,2,1,1,3,-1,A
2016-02-27,2015,West Ham United,Sunderland,1-0,1,0,1,1,1,1,H
2016-02-27,2015,Leicester City,Norwich City,1-0,1,0,1,1,1,1,H
2016-02-27,2015,Southampton,Chelsea,1-2,1,2,1,1,3,-1,A
2016-02-27,2015,Stoke City,Aston Villa,2-1,2,1,1,1,3,1,H
2016-02-27,2015,Watford,AFC Bournemouth,0-0,0,0,1,1,0,0,D
2016-02-27,2015,West Bromwich Albion,Crystal Palace,3-2,3,2,1,1,5,1,H
2016-02-28,2015,Manchester United,Arsenal,3-2,3,2,1,1,5,1,H
2016-02-28,2015,Tottenham Hotspur,Swansea City,2-1,2,1,1,1,3,1,H
2016-03-01,2015,AFC Bournemouth,Southampton,2-0,2,0,1,1,2,2,H
2016-03-01,2015,Aston Villa,Everton,1-3,1,3,1,1,4,-2,A
2016-03-01,2015,Leicester City,West Bromwich Albion,2-2,2,2,1,1,4,0,D
2016-03-01,2015,Norwich City,Chelsea,1-2,1,2,1,1,3,-1,A
2016-03-01,2015,Sunderland,Crystal Palace,2-2,2,2,1,1,4,0,D
2016-03-02,2015,Arsenal,Swansea City,1-2,1,2,1,1,3,-1,A
2016-03-02,2015,West Ham United,Tottenham Hotspur,1-0,1,0,1,1,1,1,H
2016-03-02,2015,Stoke City,Newcastle United,1-0,1,0,1,1,1,1,H
2016-03-02,2015,Liverpool,Manchester City,3-0,3,0,1,1,3,3,H
2016-03-02,2015,Manchester United,Watford,1-0,1,0,1,1,1,1,H
2016-03-05,2015,Tottenham Hotspur,Arsenal,2-2,2,2,1,1,4,0,D
2016-03-05,2015,Chelsea,Stoke City,1-1,1,1,1,1,2,0,D
2016-03-05,2015,Everton,West Ham United,2-3,2,3,1,1,5,-1,A
2016-03-05,2015,Manchester City,Aston Villa,4-0,4,0,1,1,4,4,H
2016-03-05,2015,Newcastle United,AFC Bournemouth,1-3,1,3,1,1,4,-2,A
2016-03-05,2015,Southampton,Sunderland,1-1,1,1,1,1,2,0,D
2016-03-05,2015,Swansea City,Norwich City,1-0,1,0,1,1,1,1,H
2016-03-05,2015,Watford,Leicester City,0-1,0,1,1,1,1,-1,A
2016-03-06,2015,Crystal Palace,Liverpool,1-2,1,2,1,1,3,-1,A
2016-03-06,2015,West Bromwich Albion,Manchester United,1-0,1,0,1,1,1,1,H
2016-03-12,2015,Norwich City,Manchester City,0-0,0,0,1,1,0,0,D
2016-03-12,2015,AFC Bournemouth,Swansea City,3-2,3,2,1,1,5,1,H
2016-03-12,2015,Stoke City,Southampton,1-2,1,2,1,1,3,-1,A
2016-03-13,2015,Aston Villa,Tottenham Hotspur,0-2,0,2,1,1,2,-2,A
2016-03-14,2015,Leicester City,Newcastle United,1-0,1,0,1,1,1,1,H
2016-03-19,2015,Everton,Arsenal,0-2,0,2,1,1,2,-2,A
2016-03-19,2015,Chelsea,West Ham United,2-2,2,2,1,1,4,0,D
2016-03-19,2015,Crystal Palace,Leicester City,0-1,0,1,1,1,1,-1,A
2016-03-19,2015,Watford,Stoke City,1-2,1,2,1,1,3,-1,A
2016-03-19,2015,West Bromwich Albion,Norwich City,0-1,0,1,1,1,1,-1,A
2016-03-19,2015,Swansea City,Aston Villa,1-0,1,0,1,1,1,1,H
2016-03-20,2015,Newcastle United,Sunderland,1-1,1,1,1,1,2,0,D
2016-03-20,2015,Southampton,Liverpool,3-2,3,2,1,1,5,1,H
2016-03-20,2015,Manchester City,Manchester United,0-1,0,1,1,1,1,-1,A
2016-03-20,2015,Tottenham Hotspur,AFC Bournemouth,3-0,3,0,1,1,3,3,H
2016-04-02,2015,Aston Villa,Chelsea,0-4,0,4,1,1,4,-4,A
2016-04-02,2015,AFC Bournemouth,Manchester City,0-4,0,4,1,1,4,-4,A
2016-04-02,2015,Arsenal,Watford,4-0,4,0,1,1,4,4,H
2016-04-02,2015,Norwich City,Newcastle United,3-2,3,2,1,1,5,1,H
2016-04-02,2015,Stoke City,Swansea City,2-2,2,2,1,1,4,0,D
2016-04-02,2015,Sunderland,West Bromwich Albion,0-0,0,0,1,1,0,0,D
2016-04-02,2015,West Ham United,Crystal Palace,2-2,2,2,1,1,4,0,D
2016-04-02,2015,Liverpool,Tottenham Hotspur,1-1,1,1,1,1,2,0,D
2016-04-03,2015,Leicester City,Southampton,1-0,1,0,1,1,1,1,H
2016-04-03,2015,Manchester United,Everton,1-0,1,0,1,1,1,1,H
2016-04-09,2015,West Ham United,Arsenal,3-3,3,3,1,1,6,0,D
2016-04-09,2015,Aston Villa,AFC Bournemouth,1-2,1,2,1,1,3,-1,A
2016-04-09,2015,Crystal Palace,Norwich City,1-0,1,0,1,1,1,1,H
2016-04-09,2015,Southampton,Newcastle United,3-1,3,1,1,1,4,2,H
2016-04-09,2015,Swansea City,Chelsea,1-0,1,0,1,1,1,1,H
2016-04-09,2015,Watford,Everton,1-1,1,1,1,1,2,0,D
2016-04-09,2015,Manchester City,West Bromwich Albion,2-1,2,1,1,1,3,1,H
2016-04-10,2015,Sunderland,Leicester City,0-2,0,2,1,1,2,-2,A
2016-04-10,2015,Liverpool,Stoke City,4-1,4,1,1,1,5,3,H
2016-04-10,2015,Tottenham Hotspur,Manchester United,3-0,3,0,1,1,3,3,H
2016-04-13,2015,Crystal Palace,Everton,0-0,0,0,1,1,0,0,D
2016-04-16,2015,Norwich City,Sunderland,0-3,0,3,1,1,3,-3,A
2016-04-16,2015,Everton,Southampton,1-1,1,1,1,1,2,0,D
2016-04-16,2015,Manchester United,Aston Villa,1-0,1,0,1,1,1,1,H
2016-04-16,2015,Newcastle United,Swansea City,3-0,3,0,1,1,3,3,H
2016-04-16,2015,West Bromwich Albion,Watford,0-1,0,1,1,1,1,-1,A
2016-04-16,2015,Chelsea,Manchester City,0-3,0,3,1,1,3,-3,A
2016-04-17,2015,AFC Bournemouth,Liverpool,1-2,1,2,1,1,3,-1,A
2016-04-17,2015,Leicester City,West Ham United,2-2,2,2,1,1,4,0,D
2016-04-17,2015,Arsenal,Crystal Palace,1-1,1,1,1,1,2,0,D
2016-04-18,2015,Stoke City,Tottenham Hotspur,0-4,0,4,1,1,4,-4,A
2016-04-19,2015,Newcastle United,Manchester City,1-1,1,1,1,1,2,0,D
2016-04-20,2015,Liverpool,Everton,4-0,4,0,1,1,4,4,H
2016-04-20,2015,West Ham United,Watford,3-1,3,1,1,1,4,2,H
2016-04-20,2015,Manchester United,Crystal Palace,2-0,2,0,1,1,2,2,H
2016-04-21,2015,Arsenal,West Bromwich Albion,2-0,2,0,1,1,2,2,H
2016-04-23,2015,Manchester City,Stoke City,4-0,4,0,1,1,4,4,H
2016-04-23,2015,AFC Bournemouth,Chelsea,1-4,1,4,1,1,5,-3,A
2016-04-23,2015,Aston Villa,Southampton,2-4,2,4,1,1,6,-2,A
2016-04-23,2015,Liverpool,Newcastle United,2-2,2,2,1,1,4,0,D
2016-04-24,2015,Sunderland,Arsenal,0-0,0,0,1,1,0,0,D
2016-04-24,2015,Leicester City,Swansea City,4-0,4,0,1,1,4,4,H
2016-04-25,2015,Tottenham Hotspur,West Bromwich Albion,1-1,1,1,1,1,2,0,D
2016-04-30,2015,Everton,AFC Bournemouth,2-1,2,1,1,1,3,1,H
2016-04-30,2015,Newcastle United,Crystal Palace,1-0,1,0,1,1,1,1,H
2016-04-30,2015,Stoke City,Sunderland,1-1,1,1,1,1,2,0,D
2016-04-30,2015,Watford,Aston Villa,3-2,3,2,1,1,5,1,H
2016-04-30,2015,West Bromwich Albion,West Ham United,0-3,0,3,1,1,3,-3,A
2016-04-30,2015,Arsenal,Norwich City,1-0,1,0,1,1,1,1,H
2016-05-01,2015,Swansea City,Liverpool,3-1,3,1,1,1,4,2,H
2016-05-01,2015,Manchester United,Leicester City,1-1,1,1,1,1,2,0,D
2016-05-01,2015,Southampton,Manchester City,4-2,4,2,1,1,6,2,H
2016-05-02,2015,Chelsea,Tottenham Hotspur,2-2,2,2,1,1,4,0,D
2016-05-07,2015,Norwich City,Manchester United,0-1,0,1,1,1,1,-1,A
2016-05-07,2015,AFC Bournemouth,West Bromwich Albion,1-1,1,1,1,1,2,0,D
2016-05-07,2015,Aston Villa,Newcastle United,0-0,0,0,1,1,0,0,D
2016-05-07,2015,Crystal Palace,Stoke City,2-1,2,1,1,1,3,1,H
2016-05-07,2015,Sunderland,Chelsea,3-2,3,2,1,1,5,1,H
2016-05-07,2015,West Ham United,Swansea City,1-4,1,4,1,1,5,-3,A
2016-05-07,2015,Leicester City,Everton,3-1,3,1,1,1,4,2,H
2016-05-08,2015,Tottenham Hotspur,Southampton,1-2,1,2,1,1,3,-1,A
2016-05-08,2015,Liverpool,Watford,2-0,2,0,1,1,2,2,H
2016-05-08,2015,Manchester City,Arsenal,2-2,2,2,1,1,4,0,D
2016-05-10,2015,West Ham United,Manchester United,3-2,3,2,1,1,5,1,H
2016-05-11,2015,Sunderland,Everton,3-0,3,0,1,1,3,3,H
2016-05-11,2015,Liverpool,Chelsea,1-1,1,1,1,1,2,0,D
2016-05-11,2015,Norwich City,Watford,4-2,4,2,1,1,6,2,H
2016-05-15,2015,Arsenal,Aston Villa,4-0,4,0,1,1,4,4,H
2016-05-15,2015,Chelsea,Leicester City,1-1,1,1,1,1,2,0,D
2016-05-15,2015,Everton,Norwich City,3-0,3,0,1,1,3,3,H
2016-05-15,2015,Newcastle United,Tottenham Hotspur,5-1,5,1,1,1,6,4,H
2016-05-15,2015,Southampton,Crystal Palace,4-1,4,1,1,1,5,3,H
2016-05-15,2015,Stoke City,West Ham United,2-1,2,1,1,1,3,1,H
2016-05-15,2015,Swansea City,Manchester City,1-1,1,1,1,1,2,0,D
2016-05-15,2015,Watford,Sunderland,2-2,2,2,1,1,4,0,D
2016-05-15,2015,West Bromwich Albion,Liverpool,1-1,1,1,1,1,2,0,D
2016-05-16,2015,Manchester United,AFC Bournemouth,3-1,3,1,1,1,4,2,H
2016-08-13,2016,Burnley,Swansea City,0-1,0,1,1,1,1,-1,A
2016-08-13,2016,Crystal Palace,West Bromwich Albion,0-1,0,1,1,1,1,-1,A
2016-08-13,2016,Everton,Tottenham Hotspur,1-1,1,1,1,1,2,0,D
2016-08-13,2016,Hull City,Leicester City,2-1,2,1,1,1,3,1,H
2016-08-13,2016,Manchester City,Sunderland,2-1,2,1,1,1,3,1,H
2016-08-13,2016,Middlesbrough,Stoke City,1-1,1,1,1,1,2,0,D
2016-08-13,2016,Southampton,Watford,1-1,1,1,1,1,2,0,D
2016-08-14,2016,Arsenal,Liverpool,3-4,3,4,1,1,7,-1,A
2016-08-14,2016,AFC Bournemouth,Manchester United,1-3,1,3,1,1,4,-2,A
2016-08-15,2016,Chelsea,West Ham United,2-1,2,1,1,1,3,1,H
2016-08-19,2016,Manchester United,Southampton,2-0,2,0,1,1,2,2,H
2016-08-20,2016,Burnley,Liverpool,2-0,2,0,1,1,2,2,H
2016-08-20,2016,Leicester City,Arsenal,0-0,0,0,1,1,0,0,D
2016-08-20,2016,Stoke City,Manchester City,1-4,1,4,1,1,5,-3,A
2016-08-20,2016,Swansea City,Hull City,0-2,0,2,1,1,2,-2,A
2016-08-20,2016,Tottenham Hotspur,Crystal Palace,1-0,1,0,1,1,1,1,H
2016-08-20,2016,Watford,Chelsea,1-2,1,2,1,1,3,-1,A
2016-08-20,2016,West Bromwich Albion,Everton,1-2,1,2,1,1,3,-1,A
2016-08-21,2016,Sunderland,Middlesbrough,1-2,1,2,1,1,3,-1,A
2016-08-21,2016,West Ham United,AFC Bournemouth,1-0,1,0,1,1,1,1,H
2016-08-27,2016,Chelsea,Burnley,3-0,3,0,1,1,3,3,H
2016-08-27,2016,Crystal Palace,AFC Bournemouth,1-1,1,1,1,1,2,0,D
2016-08-27,2016,Everton,Stoke City,1-0,1,0,1,1,1,1,H
2016-08-27,2016,Hull City,Manchester United,0-1,0,1,1,1,1,-1,A
2016-08-27,2016,Leicester City,Swansea City,2-1,2,1,1,1,3,1,H
2016-08-27,2016,Southampton,Sunderland,1-1,1,1,1,1,2,0,D
2016-08-27,2016,Tottenham Hotspur,Liverpool,1-1,1,1,1,1,2,0,D
2016-08-27,2016,Watford,Arsenal,1-3,1,3,1,1,4,-2,A
2016-08-28,2016,Manchester City,West Ham United,3-1,3,1,1,1,4,2,H
2016-08-28,2016,West Bromwich Albion,Middlesbrough,0-0,0,0,1,1,0,0,D
2016-09-10,2016,Arsenal,Southampton,2-1,2,1,1,1,3,1,H
2016-09-10,2016,AFC Bournemouth,West Bromwich Albion,1-0,1,0,1,1,1,1,H
2016-09-10,2016,Burnley,Hull City,1-1,1,1,1,1,2,0,D
2016-09-10,2016,Liverpool,Leicester City,4-1,4,1,1,1,5,3,H
2016-09-10,2016,Manchester United,Manchester City,1-2,1,2,1,1,3,-1,A
2016-09-10,2016,Middlesbrough,Crystal Palace,1-2,1,2,1,1,3,-1,A
2016-09-10,2016,Stoke City,Tottenham Hotspur,0-4,0,4,1,1,4,-4,A
2016-09-10,2016,West Ham United,Watford,2-4,2,4,1,1,6,-2,A
2016-09-11,2016,Swansea City,Chelsea,2-2,2,2,1,1,4,0,D
2016-09-12,2016,Sunderland,Everton,0-3,0,3,1,1,3,-3,A
2016-09-16,2016,Chelsea,Liverpool,1-2,1,2,1,1,3,-1,A
2016-09-17,2016,Everton,Middlesbrough,3-1,3,1,1,1,4,2,H
2016-09-17,2016,Hull City,Arsenal,1-4,1,4,1,1,5,-3,A
2016-09-17,2016,Leicester City,Burnley,3-0,3,0,1,1,3,3,H
2016-09-17,2016,Manchester City,AFC Bournemouth,4-0,4,0,1,1,4,4,H
2016-09-17,2016,West Bromwich Albion,West Ham United,4-2,4,2,1,1,6,2,H
2016-09-18,2016,Crystal Palace,Stoke City,4-1,4,1,1,1,5,3,H
2016-09-18,2016,Southampton,Swansea City,1-0,1,0,1,1,1,1,H
2016-09-18,2016,Tottenham Hotspur,Sunderland,1-0,1,0,1,1,1,1,H
2016-09-18,2016,Watford,Manchester United,3-1,3,1,1,1,4,2,H
2016-09-24,2016,Arsenal,Chelsea,3-0,3,0,1,1,3,3,H
2016-09-24,2016,AFC Bournemouth,Everton,1-0,1,0,1,1,1,1,H
2016-09-24,2016,Liverpool,Hull City,5-1,5,1,1,1,6,4,H
2016-09-24,2016,Manchester United,Leicester City,4-1,4,1,1,1,5,3,H
2016-09-24,2016,Middlesbrough,Tottenham Hotspur,1-2,1,2,1,1,3,-1,A
2016-09-24,2016,Stoke City,West Bromwich Albion,1-1,1,1,1,1,2,0,D
2016-09-24,2016,Sunderland,Crystal Palace,2-3,2,3,1,1,5,-1,A
2016-09-24,2016,Swansea City,Manchester City,1-3,1,3,1,1,4,-2,A
2016-09-25,2016,West Ham United,Southampton,0-3,0,3,1,1,3,-3,A
2016-09-26,2016,Burnley,Watford,2-0,2,0,1,1,2,2,H
2016-09-30,2016,Everton,Crystal Palace,1-1,1,1,1,1,2,0,D
2016-10-01,2016,Hull City,Chelsea,0-2,0,2,1,1,2,-2,A
2016-10-01,2016,Sunderland,West Bromwich Albion,1-1,1,1,1,1,2,0,D
2016-10-01,2016,Swansea City,Liverpool,1-2,1,2,1,1,3,-1,A
2016-10-01,2016,Watford,AFC Bournemouth,2-2,2,2,1,1,4,0,D
2016-10-01,2016,West Ham United,Middlesbrough,1-1,1,1,1,1,2,0,D
2016-10-02,2016,Burnley,Arsenal,0-1,0,1,1,1,1,-1,A
2016-10-02,2016,Leicester City,Southampton,0-0,0,0,1,1,0,0,D
2016-10-02,2016,Manchester United,Stoke City,1-1,1,1,1,1,2,0,D
2016-10-02,2016,Tottenham Hotspur,Manchester City,2-0,2,0,1,1,2,2,H
2016-10-15,2016,Arsenal,Swansea City,3-2,3,2,1,1,5,1,H
2016-10-15,2016,AFC Bournemouth,Hull City,6-1,6,1,1,1,7,5,H
2016-10-15,2016,Chelsea,Leicester City,3-0,3,0,1,1,3,3,H
2016-10-15,2016,Crystal Palace,West Ham United,0-1,0,1,1,1,1,-1,A
2016-10-15,2016,Manchester City,Everton,1-1,1,1,1,1,2,0,D
2016-10-15,2016,Stoke City,Sunderland,2-0,2,0,1,1,2,2,H
2016-10-15,2016,West Bromwich Albion,Tottenham Hotspur,1-1,1,1,1,1,2,0,D
2016-10-16,2016,Middlesbrough,Watford,0-1,0,1,1,1,1,-1,A
2016-10-16,2016,Southampton,Burnley,3-1,3,1,1,1,4,2,H
2016-10-17,2016,Liverpool,Manchester United,0-0,0,0,1,1,0,0,D
2016-10-22,2016,Arsenal,Middlesbrough,0-0,0,0,1,1,0,0,D
2016-10-22,2016,AFC Bournemouth,Tottenham Hotspur,0-0,0,0,1,1,0,0,D
2016-10-22,2016,Burnley,Everton,2-1,2,1,1,1,3,1,H
2016-10-22,2016,Hull City,Stoke City,0-2,0,2,1,1,2,-2,A
2016-10-22,2016,Leicester City,Crystal Palace,3-1,3,1,1,1,4,2,H
2016-10-22,2016,Liverpool,West Bromwich Albion,2-1,2,1,1,1,3,1,H
2016-10-22,2016,Swansea City,Watford,0-0,0,0,1,1,0,0,D
2016-10-22,2016,West Ham United,Sunderland,1-0,1,0,1,1,1,1,H
2016-10-23,2016,Chelsea,Manchester United,4-0,4,0,1,1,4,4,H
2016-10-23,2016,Manchester City,Southampton,1-1,1,1,1,1,2,0,D
2016-10-29,2016,Crystal Palace,Liverpool,2-4,2,4,1,1,6,-2,A
2016-10-29,2016,Manchester United,Burnley,0-0,0,0,1,1,0,0,D
2016-10-29,2016,Middlesbrough,AFC Bournemouth,2-0,2,0,1,1,2,2,H
2016-10-29,2016,Sunderland,Arsenal,1-4,1,4,1,1,5,-3,A
2016-10-29,2016,Tottenham Hotspur,Leicester City,1-1,1,1,1,1,2,0,D
2016-10-29,2016,Watford,Hull City,1-0,1,0,1,1,1,1,H
2016-10-29,2016,West Bromwich Albion,Manchester City,0-4,0,4,1,1,4,-4,A
2016-10-30,2016,Everton,West Ham United,2-0,2,0,1,1,2,2,H
2016-10-30,2016,Southampton,Chelsea,0-2,0,2,1,1,2,-2,A
2016-10-31,2016,Stoke City,Swansea City,3-1,3,1,1,1,4,2,H
2016-11-05,2016,AFC Bournemouth,Sunderland,1-2,1,2,1,1,3,-1,A
2016-11-05,2016,Burnley,Crystal Palace,3-2,3,2,1,1,5,1,H
2016-11-05,2016,Chelsea,Everton,5-0,5,0,1,1,5,5,H
2016-11-05,2016,Manchester City,Middlesbrough,1-1,1,1,1,1,2,0,D
2016-11-05,2016,West Ham United,Stoke City,1-1,1,1,1,1,2,0,D
2016-11-06,2016,Arsenal,Tottenham Hotspur,1-1,1,1,1,1,2,0,D
2016-11-06,2016,Hull City,Southampton,2-1,2,1,1,1,3,1,H
2016-11-06,2016,Leicester City,West Bromwich Albion,1-2,1,2,1,1,3,-1,A
2016-11-06,2016,Liverpool,Watford,6-1,6,1,1,1,7,5,H
2016-11-06,2016,Swansea City,Manchester United,1-3,1,3,1,1,4,-2,A
2016-11-19,2016,Crystal Palace,Manchester City,1-2,1,2,1,1,3,-1,A
2016-11-19,2016,Everton,Swansea City,1-1,1,1,1,1,2,0,D
2016-11-19,2016,Manchester United,Arsenal,1-1,1,1,1,1,2,0,D
2016-11-19,2016,Southampton,Liverpool,0-0,0,0,1,1,0,0,D
2016-11-19,2016,Stoke City,AFC Bournemouth,0-1,0,1,1,1,1,-1,A
2016-11-19,2016,Sunderland,Hull City,3-0,3,0,1,1,3,3,H
2016-11-19,2016,Tottenham Hotspur,West Ham United,3-2,3,2,1,1,5,1,H
2016-11-19,2016,Watford,Leicester City,2-1,2,1,1,1,3,1,H
2016-11-20,2016,Middlesbrough,Chelsea,0-1,0,1,1,1,1,-1,A
2016-11-21,2016,West Bromwich Albion,Burnley,4-0,4,0,1,1,4,4,H
2016-11-26,2016,Burnley,Manchester City,1-2,1,2,1,1,3,-1,A
2016-11-26,2016,Chelsea,Tottenham Hotspur,2-1,2,1,1,1,3,1,H
2016-11-26,2016,Hull City,West Bromwich Albion,1-1,1,1,1,1,2,0,D
2016-11-26,2016,Leicester City,Middlesbrough,2-2,2,2,1,1,4,0,D
2016-11-26,2016,Liverpool,Sunderland,2-0,2,0,1,1,2,2,H
2016-11-26,2016,Swansea City,Crystal Palace,5-4,5,4,1,1,9,1,H
2016-11-27,2016,Arsenal,AFC Bournemouth,3-1,3,1,1,1,4,2,H
2016-11-27,2016,Manchester United,West Ham United,1-1,1,1,1,1,2,0,D
2016-11-27,2016,Southampton,Everton,1-0,1,0,1,1,1,1,H
2016-11-27,2016,Watford,Stoke City,0-1,0,1,1,1,1,-1,A
2016-12-03,2016,Crystal Palace,Southampton,3-0,3,0,1,1,3,3,H
2016-12-03,2016,Manchester City,Chelsea,1-3,1,3,1,1,4,-2,A
2016-12-03,2016,Stoke City,Burnley,2-0,2,0,1,1,2,2,H
2016-12-03,2016,Sunderland,Leicester City,2-1,2,1,1,1,3,1,H
2016-12-03,2016,Tottenham Hotspur,Swansea City,5-0,5,0,1,1,5,5,H
2016-12-03,2016,West Bromwich Albion,Watford,3-1,3,1,1,1,4,2,H
2016-12-03,2016,West Ham United,Arsenal,1-5,1,5,1,1,6,-4,A
2016-12-04,2016,AFC Bournemouth,Liverpool,4-3,4,3,1,1,7,1,H
2016-12-04,2016,Everton,Manchester United,1-1,1,1,1,1,2,0,D
2016-12-05,2016,Middlesbrough,Hull City,1-0,1,0,1,1,1,1,H
2016-12-10,2016,Arsenal,Stoke City,3-1,3,1,1,1,4,2,H
2016-12-10,2016,Burnley,AFC Bournemouth,3-2,3,2,1,1,5,1,H
2016-12-10,2016,Hull City,Crystal Palace,3-3,3,3,1,1,6,0,D
2016-12-10,2016,Leicester City,Manchester City,4-2,4,2,1,1,6,2,H
2016-12-10,2016,Swansea City,Sunderland,3-0,3,0,1,1,3,3,H
2016-12-10,2016,Watford,Everton,3-2,3,2,1,1,5,1,H
2016-12-11,2016,Chelsea,West Bromwich Albion,1-0,1,0,1,1,1,1,H
2016-12-11,2016,Liverpool,West Ham United,2-2,2,2,1,1,4,0,D
2016-12-11,2016,Manchester United,Tottenham Hotspur,1-0,1,0,1,1,1,1,H
2016-12-11,2016,Southampton,Middlesbrough,1-0,1,0,1,1,1,1,H
2016-12-13,2016,AFC Bournemouth,Leicester City,1-0,1,0,1,1,1,1,H
2016-12-13,2016,Everton,Arsenal,2-1,2,1,1,1,3,1,H
2016-12-14,2016,Crystal Palace,Manchester United,1-2,1,2,1,1,3,-1,A
2016-12-14,2016,Manchester City,Watford,2-0,2,0,1,1,2,2,H
2016-12-14,2016,Middlesbrough,Liverpool,0-3,0,3,1,1,3,-3,A
2016-12-14,2016,Stoke City,Southampton,0-0,0,0,1,1,0,0,D
2016-12-14,2016,Sunderland,Chelsea,0-1,0,1,1,1,1,-1,A
2016-12-14,2016,Tottenham Hotspur,Hull City,3-0,3,0,1,1,3,3,H
2016-12-14,2016,West Bromwich Albion,Swansea City,3-1,3,1,1,1,4,2,H
2016-12-14,2016,West Ham United,Burnley,1-0,1,0,1,1,1,1,H
2016-12-17,2016,Crystal Palace,Chelsea,0-1,0,1,1,1,1,-1,A
2016-12-17,2016,Middlesbrough,Swansea City,3-0,3,0,1,1,3,3,H
2016-12-17,2016,Stoke City,Leicester City,2-2,2,2,1,1,4,0,D
2016-12-17,2016,Sunderland,Watford,1-0,1,0,1,1,1,1,H
2016-12-17,2016,West Bromwich Albion,Manchester United,0-2,0,2,1,1,2,-2,A
2016-12-17,2016,West Ham United,Hull City,1-0,1,0,1,1,1,1,H
2016-12-18,2016,AFC Bournemouth,Southampton,1-3,1,3,1,1,4,-2,A
2016-12-18,2016,Manchester City,Arsenal,2-1,2,1,1,1,3,1,H
2016-12-18,2016,Tottenham Hotspur,Burnley,2-1,2,1,1,1,3,1,H
2016-12-19,2016,Everton,Liverpool,0-1,0,1,1,1,1,-1,A
2016-12-26,2016,Arsenal,West Bromwich Albion,1-0,1,0,1,1,1,1,H
2016-12-26,2016,Burnley,Middlesbrough,1-0,1,0,1,1,1,1,H
2016-12-26,2016,Chelsea,AFC Bournemouth,3-0,3,0,1,1,3,3,H
2016-12-26,2016,Hull City,Manchester City,0-3,0,3,1,1,3,-3,A
2016-12-26,2016,Leicester City,Everton,0-2,0,2,1,1,2,-2,A
2016-12-26,2016,Manchester United,Sunderland,3-1,3,1,1,1,4,2,H
2016-12-26,2016,Swansea City,West Ham United,1-4,1,4,1,1,5,-3,A
2016-12-26,2016,Watford,Crystal Palace,1-1,1,1,1,1,2,0,D
2016-12-27,2016,Liverpool,Stoke City,4-1,4,1,1,1,5,3,H
2016-12-28,2016,Southampton,Tottenham Hotspur,1-4,1,4,1,1,5,-3,A
2016-12-30,2016,Hull City,Everton,2-2,2,2,1,1,4,0,D
2016-12-31,2016,Burnley,Sunderland,4-1,4,1,1,1,5,3,H
2016-12-31,2016,Chelsea,Stoke City,4-2,4,2,1,1,6,2,H
2016-12-31,2016,Leicester City,West Ham United,1-0,1,0,1,1,1,1,H
2016-12-31,2016,Liverpool,Manchester City,1-0,1,0,1,1,1,1,H
2016-12-31,2016,Manchester United,Middlesbrough,2-1,2,1,1,1,3,1,H
2016-12-31,2016,Southampton,West Bromwich Albion,1-2,1,2,1,1,3,-1,A
2016-12-31,2016,Swansea City,AFC Bournemouth,0-3,0,3,1,1,3,-3,A
2017-01-01,2016,Arsenal,Crystal Palace,2-0,2,0,1,1,2,2,H
2017-01-01,2016,Watford,Tottenham Hotspur,1-4,1,4,1,1,5,-3,A
2017-01-02,2016,Everton,Southampton,3-0,3,0,1,1,3,3,H
2017-01-02,2016,Manchester City,Burnley,2-1,2,1,1,1,3,1,H
2017-01-02,2016,Middlesbrough,Leicester City,0-0,0,0,1,1,0,0,D
2017-01-02,2016,Sunderland,Liverpool,2-2,2,2,1,1,4,0,D
2017-01-02,2016,West Bromwich Albion,Hull City,3-1,3,1,1,1,4,2,H
2017-01-02,2016,West Ham United,Manchester United,0-2,0,2,1,1,2,-2,A
2017-01-03,2016,AFC Bournemouth,Arsenal,3-3,3,3,1,1,6,0,D
2017-01-03,2016,Crystal Palace,Swansea City,1-2,1,2,1,1,3,-1,A
2017-01-03,2016,Stoke City,Watford,2-0,2,0,1,1,2,2,H
2017-01-04,2016,Tottenham Hotspur,Chelsea,2-0,2,0,1,1,2,2,H
2017-01-14,2016,Burnley,Southampton,1-0,1,0,1,1,1,1,H
2017-01-14,2016,Hull City,AFC Bournemouth,3-1,3,1,1,1,4,2,H
2017-01-14,2016,Leicester City,Chelsea,0-3,0,3,1,1,3,-3,A
2017-01-14,2016,Sunderland,Stoke City,1-3,1,3,1,1,4,-2,A
2017-01-14,2016,Swansea City,Arsenal,0-4,0,4,1,1,4,-4,A
2017-01-14,2016,Tottenham Hotspur,West Bromwich Albion,4-0,4,0,1,1,4,4,H
2017-01-14,2016,Watford,Middlesbrough,0-0,0,0,1,1,0,0,D
2017-01-14,2016,West Ham United,Crystal Palace,3-0,3,0,1,1,3,3,H
2017-01-15,2016,Everton,Manchester City,4-0,4,0,1,1,4,4,H
2017-01-15,2016,Manchester United,Liverpool,1-1,1,1,1,1,2,0,D
2017-01-21,2016,AFC Bournemouth,Watford,2-2,2,2,1,1,4,0,D
2017-01-21,2016,Crystal Palace,Everton,0-1,0,1,1,1,1,-1,A
2017-01-21,2016,Liverpool,Swansea City,2-3,2,3,1,1,5,-1,A
2017-01-21,2016,Manchester City,Tottenham Hotspur,2-2,2,2,1,1,4,0,D
2017-01-21,2016,Middlesbrough,West Ham United,1-3,1,3,1,1,4,-2,A
2017-01-21,2016,Stoke City,Manchester United,1-1,1,1,1,1,2,0,D
2017-01-21,2016,West Bromwich Albion,Sunderland,2-0,2,0,1,1,2,2,H
2017-01-22,2016,Arsenal,Burnley,2-1,2,1,1,1,3,1,H
2017-01-22,2016,Chelsea,Hull City,2-0,2,0,1,1,2,2,H
2017-01-22,2016,Southampton,Leicester City,3-0,3,0,1,1,3,3,H
2017-01-31,2016,Arsenal,Watford,1-2,1,2,1,1,3,-1,A
2017-01-31,2016,AFC Bournemouth,Crystal Palace,0-2,0,2,1,1,2,-2,A
2017-01-31,2016,Burnley,Leicester City,1-0,1,0,1,1,1,1,H
2017-01-31,2016,Liverpool,Chelsea,1-1,1,1,1,1,2,0,D
2017-01-31,2016,Middlesbrough,West Bromwich Albion,1-1,1,1,1,1,2,0,D
2017-01-31,2016,Sunderland,Tottenham Hotspur,0-0,0,0,1,1,0,0,D
2017-01-31,2016,Swansea City,Southampton,2-1,2,1,1,1,3,1,H
2017-02-01,2016,Manchester United,Hull City,0-0,0,0,1,1,0,0,D
2017-02-01,2016,Stoke City,Everton,1-1,1,1,1,1,2,0,D
2017-02-01,2016,West Ham United,Manchester City,0-4,0,4,1,1,4,-4,A
2017-02-04,2016,Chelsea,Arsenal,3-1,3,1,1,1,4,2,H
2017-02-04,2016,Crystal Palace,Sunderland,0-4,0,4,1,1,4,-4,A
2017-02-04,2016,Everton,AFC Bournemouth,6-3,6,3,1,1,9,3,H
2017-02-04,2016,Hull City,Liverpool,2-0,2,0,1,1,2,2,H
2017-02-04,2016,Southampton,West Ham United,1-3,1,3,1,1,4,-2,A
2017-02-04,2016,Tottenham Hotspur,Middlesbrough,1-0,1,0,1,1,1,1,H
2017-02-04,2016,Watford,Burnley,2-1,2,1,1,1,3,1,H
2017-02-04,2016,West Bromwich Albion,Stoke City,1-0,1,0,1,1,1,1,H
2017-02-05,2016,Leicester City,Manchester United,0-3,0,3,1,1,3,-3,A
2017-02-05,2016,Manchester City,Swansea City,2-1,2,1,1,1,3,1,H
2017-02-11,2016,Arsenal,Hull City,2-0,2,0,1,1,2,2,H
2017-02-11,2016,Liverpool,Tottenham Hotspur,2-0,2,0,1,1,2,2,H
2017-02-11,2016,Manchester United,Watford,2-0,2,0,1,1,2,2,H
2017-02-11,2016,Middlesbrough,Everton,0-0,0,0,1,1,0,0,D
2017-02-11,2016,Stoke City,Crystal Palace,1-0,1,0,1,1,1,1,H
2017-02-11,2016,Sunderland,Southampton,0-4,0,4,1,1,4,-4,A
2017-02-11,2016,West Ham United,West Bromwich Albion,2-2,2,2,1,1,4,0,D
2017-02-12,2016,Burnley,Chelsea,1-1,1,1,1,1,2,0,D
2017-02-12,2016,Swansea City,Leicester City,2-0,2,0,1,1,2,2,H
2017-02-13,2016,AFC Bournemouth,Manchester City,0-2,0,2,1,1,2,-2,A
2017-02-25,2016,Chelsea,Swansea City,3-1,3,1,1,1,4,2,H
2017-02-25,2016,Crystal Palace,Middlesbrough,1-0,1,0,1,1,1,1,H
2017-02-25,2016,Everton,Sunderland,2-0,2,0,1,1,2,2,H
2017-02-25,2016,Hull City,Burnley,1-1,1,1,1,1,2,0,D
2017-02-25,2016,Watford,West Ham United,1-1,1,1,1,1,2,0,D
2017-02-25,2016,West Bromwich Albion,AFC Bournemouth,2-1,2,1,1,1,3,1,H
2017-02-26,2016,Tottenham Hotspur,Stoke City,4-0,4,0,1,1,4,4,H
2017-02-27,2016,Leicester City,Liverpool,3-1,3,1,1,1,4,2,H
2017-03-04,2016,Leicester City,Hull City,3-1,3,1,1,1,4,2,H
2017-03-04,2016,Liverpool,Arsenal,3-1,3,1,1,1,4,2,H
2017-03-04,2016,Manchester United,AFC Bournemouth,1-1,1,1,1,1,2,0,D
2017-03-04,2016,Stoke City,Middlesbrough,2-0,2,0,1,1,2,2,H
2017-03-04,2016,Swansea City,Burnley,3-2,3,2,1,1,5,1,H
2017-03-04,2016,Watford,Southampton,3-4,3,4,1,1,7,-1,A
2017-03-04,2016,West Bromwich Albion,Crystal Palace,0-2,0,2,1,1,2,-2,A
2017-03-05,2016,Sunderland,Manchester City,0-2,0,2,1,1,2,-2,A
2017-03-05,2016,Tottenham Hotspur,Everton,3-2,3,2,1,1,5,1,H
2017-03-06,2016,West Ham United,Chelsea,1-2,1,2,1,1,3,-1,A
2017-03-08,2016,Manchester City,Stoke City,0-0,0,0,1,1,0,0,D
2017-03-11,2016,AFC Bournemouth,West Ham United,3-2,3,2,1,1,5,1,H
2017-03-11,2016,Everton,West Bromwich Albion,3-0,3,0,1,1,3,3,H
2017-03-11,2016,Hull City,Swansea City,2-1,2,1,1,1,3,1,H
2017-03-12,2016,Liverpool,Burnley,2-1,2,1,1,1,3,1,H
2017-03-18,2016,AFC Bournemouth,Swansea City,2-0,2,0,1,1,2,2,H
2017-03-18,2016,Crystal Palace,Watford,1-0,1,0,1,1,1,1,H
2017-03-18,2016,Everton,Hull City,4-0,4,0,1,1,4,4,H
2017-03-18,2016,Stoke City,Chelsea,1-2,1,2,1,1,3,-1,A
2017-03-18,2016,Sunderland,Burnley,0-0,0,0,1,1,0,0,D
2017-03-18,2016,West Bromwich Albion,Arsenal,3-1,3,1,1,1,4,2,H
2017-03-18,2016,West Ham United,Leicester City,2-3,2,3,1,1,5,-1,A
2017-03-19,2016,Manchester City,Liverpool,1-1,1,1,1,1,2,0,D
2017-03-19,2016,Middlesbrough,Manchester United,1-3,1,3,1,1,4,-2,A
2017-03-19,2016,Tottenham Hotspur,Southampton,2-1,2,1,1,1,3,1,H
2017-04-01,2016,Burnley,Tottenham Hotspur,0-2,0,2,1,1,2,-2,A
2017-04-01,2016,Chelsea,Crystal Palace,1-2,1,2,1,1,3,-1,A
2017-04-01,2016,Hull City,West Ham United,2-1,2,1,1,1,3,1,H
2017-04-01,2016,Leicester City,Stoke City,2-0,2,0,1,1,2,2,H
2017-04-01,2016,Liverpool,Everton,3-1,3,1,1,1,4,2,H
2017-04-01,2016,Manchester United,West Bromwich Albion,0-0,0,0,1,1,0,0,D
2017-04-01,2016,Southampton,AFC Bournemouth,0-0,0,0,1,1,0,0,D
2017-04-01,2016,Watford,Sunderland,1-0,1,0,1,1,1,1,H
2017-04-02,2016,Arsenal,Manchester City,2-2,2,2,1,1,4,0,D
2017-04-02,2016,Swansea City,Middlesbrough,0-0,0,0,1,1,0,0,D
2017-04-04,2016,Burnley,Stoke City,1-0,1,0,1,1,1,1,H
2017-04-04,2016,Leicester City,Sunderland,2-0,2,0,1,1,2,2,H
2017-04-04,2016,Manchester United,Everton,1-1,1,1,1,1,2,0,D
2017-04-04,2016,Watford,West Bromwich Albion,2-0,2,0,1,1,2,2,H
2017-04-05,2016,Arsenal,West Ham United,3-0,3,0,1,1,3,3,H
2017-04-05,2016,Chelsea,Manchester City,2-1,2,1,1,1,3,1,H
2017-04-05,2016,Hull City,Middlesbrough,4-2,4,2,1,1,6,2,H
2017-04-05,2016,Liverpool,AFC Bournemouth,2-2,2,2,1,1,4,0,D
2017-04-05,2016,Southampton,Crystal Palace,3-1,3,1,1,1,4,2,H
2017-04-05,2016,Swansea City,Tottenham Hotspur,1-3,1,3,1,1,4,-2,A
2017-04-08,2016,AFC Bournemouth,Chelsea,1-3,1,3,1,1,4,-2,A
2017-04-08,2016,Manchester City,Hull City,3-1,3,1,1,1,4,2,H
2017-04-08,2016,Middlesbrough,Burnley,0-0,0,0,1,1,0,0,D
2017-04-08,2016,Stoke City,Liverpool,1-2,1,2,1,1,3,-1,A
2017-04-08,2016,Tottenham Hotspur,Watford,4-0,4,0,1,1,4,4,H
2017-04-08,2016,West Bromwich Albion,Southampton,0-1,0,1,1,1,1,-1,A
2017-04-08,2016,West Ham United,Swansea City,1-0,1,0,1,1,1,1,H
2017-04-09,2016,Everton,Leicester City,4-2,4,2,1,1,6,2,H
2017-04-09,2016,Sunderland,Manchester United,0-3,0,3,1,1,3,-3,A
2017-04-10,2016,Crystal Palace,Arsenal,3-0,3,0,1,1,3,3,H
2017-04-15,2016,Crystal Palace,Leicester City,2-2,2,2,1,1,4,0,D
2017-04-15,2016,Everton,Burnley,3-1,3,1,1,1,4,2,H
2017-04-15,2016,Southampton,Manchester City,0-3,0,3,1,1,3,-3,A
2017-04-15,2016,Stoke City,Hull City,3-1,3,1,1,1,4,2,H
2017-04-15,2016,Sunderland,West Ham United,2-2,2,2,1,1,4,0,D
2017-04-15,2016,Tottenham Hotspur,AFC Bournemouth,4-0,4,0,1,1,4,4,H
2017-04-15,2016,Watford,Swansea City,1-0,1,0,1,1,1,1,H
2017-04-16,2016,Manchester United,Chelsea,2-0,2,0,1,1,2,2,H
2017-04-16,2016,West Bromwich Albion,Liverpool,0-1,0,1,1,1,1,-1,A
2017-04-17,2016,Middlesbrough,Arsenal,1-2,1,2,1,1,3,-1,A
2017-04-22,2016,AFC Bournemouth,Middlesbrough,4-0,4,0,1,1,4,4,H
2017-04-22,2016,Hull City,Watford,2-0,2,0,1,1,2,2,H
2017-04-22,2016,Swansea City,Stoke City,2-0,2,0,1,1,2,2,H
2017-04-22,2016,West Ham United,Everton,0-0,0,0,1,1,0,0,D
2017-04-23,2016,Burnley,Manchester United,0-2,0,2,1,1,2,-2,A
2017-04-23,2016,Liverpool,Crystal Palace,1-2,1,2,1,1,3,-1,A
2017-04-25,2016,Chelsea,Southampton,4-2,4,2,1,1,6,2,H
2017-04-26,2016,Arsenal,Leicester City,1-0,1,0,1,1,1,1,H
2017-04-26,2016,Crystal Palace,Tottenham Hotspur,0-1,0,1,1,1,1,-1,A
2017-04-26,2016,Middlesbrough,Sunderland,1-0,1,0,1,1,1,1,H
2017-04-27,2016,Manchester City,Manchester United,0-0,0,0,1,1,0,0,D
2017-04-29,2016,Crystal Palace,Burnley,0-2,0,2,1,1,2,-2,A
2017-04-29,2016,Southampton,Hull City,0-0,0,0,1,1,0,0,D
2017-04-29,2016,Stoke City,West Ham United,0-0,0,0,1,1,0,0,D
2017-04-29,2016,Sunderland,AFC Bournemouth,0-1,0,1,1,1,1,-1,A
2017-04-29,2016,West Bromwich Albion,Leicester City,0-1,0,1,1,1,1,-1,A
2017-04-30,2016,Everton,Chelsea,0-3,0,3,1,1,3,-3,A
2017-04-30,2016,Manchester United,Swansea City,1-1,1,1,1,1,2,0,D
2017-04-30,2016,Middlesbrough,Manchester City,2-2,2,2,1,1,4,0,D
2017-04-30,2016,Tottenham Hotspur,Arsenal,2-0,2,0,1,1,2,2,H
2017-05-01,2016,Watford,Liverpool,0-1,0,1,1,1,1,-1,A
2017-05-05,2016,West Ham United,Tottenham Hotspur,1-0,1,0,1,1,1,1,H
2017-05-06,2016,AFC Bournemouth,Stoke City,2-2,2,2,1,1,4,0,D
2017-05-06,2016,Burnley,West Bromwich Albion,2-2,2,2,1,1,4,0,D
2017-05-06,2016,Hull City,Sunderland,0-2,0,2,1,1,2,-2,A
2017-05-06,2016,Leicester City,Watford,3-0,3,0,1,1,3,3,H
2017-05-06,2016,Manchester City,Crystal Palace,5-0,5,0,1,1,5,5,H
2017-05-06,2016,Swansea City,Everton,1-0,1,0,1,1,1,1,H
2017-05-07,2016,Arsenal,Manchester United,2-0,2,0,1,1,2,2,H
2017-05-07,2016,Liverpool,Southampton,0-0,0,0,1,1,0,0,D
2017-05-08,2016,Chelsea,Middlesbrough,3-0,3,0,1,1,3,3,H
2017-05-10,2016,Southampton,Arsenal,0-2,0,2,1,1,2,-2,A
2017-05-12,2016,Everton,Watford,1-0,1,0,1,1,1,1,H
2017-05-12,2016,West Bromwich Albion,Chelsea,0-1,0,1,1,1,1,-1,A
2017-05-13,2016,AFC Bournemouth,Burnley,2-1,2,1,1,1,3,1,H
2017-05-13,2016,Manchester City,Leicester City,2-1,2,1,1,1,3,1,H
2017-05-13,2016,Middlesbrough,Southampton,1-2,1,2,1,1,3,-1,A
2017-05-13,2016,Stoke City,Arsenal,1-4,1,4,1,1,5,-3,A
2017-05-13,2016,Sunderland,Swansea City,0-2,0,2,1,1,2,-2,A
2017-05-14,2016,Crystal Palace,Hull City,4-0,4,0,1,1,4,4,H
2017-05-14,2016,Tottenham Hotspur,Manchester United,2-1,2,1,1,1,3,1,H
2017-05-14,2016,West Ham United,Liverpool,0-4,0,4,1,1,4,-4,A
2017-05-15,2016,Chelsea,Watford,4-3,4,3,1,1,7,1,H
2017-05-16,2016,Arsenal,Sunderland,2-0,2,0,1,1,2,2,H
2017-05-16,2016,Manchester City,West Bromwich Albion,3-1,3,1,1,1,4,2,H
2017-05-17,2016,Southampton,Manchester United,0-0,0,0,1,1,0,0,D
2017-05-18,2016,Leicester City,Tottenham Hotspur,1-6,1,6,1,1,7,-5,A
2017-05-21,2016,Arsenal,Everton,3-1,3,1,1,1,4,2,H
2017-05-21,2016,Burnley,West Ham United,1-2,1,2,1,1,3,-1,A
2017-05-21,2016,Chelsea,Sunderland,5-1,5,1,1,1,6,4,H
2017-05-21,2016,Hull City,Tottenham Hotspur,1-7,1,7,1,1,8,-6,A
2017-05-21,2016,Leicester City,AFC Bournemouth,1-1,1,1,1,1,2,0,D
2017-05-21,2016,Liverpool,Middlesbrough,3-0,3,0,1,1,3,3,H
2017-05-21,2016,Manchester United,Crystal Palace,2-0,2,0,1,1,2,2,H
2017-05-21,2016,Southampton,Stoke City,0-1,0,1,1,1,1,-1,A
2017-05-21,2016,Swansea City,West Bromwich Albion,2-1,2,1,1,1,3,1,H
2017-05-21,2016,Watford,Manchester City,0-5,0,5,1,1,5,-5,A
2017-08-11,2017,Arsenal,Leicester City,4-3,4,3,1,1,7,1,H
2017-08-12,2017,Brighton & Hove Albion,Manchester City,0-2,0,2,1,1,2,-2,A
2017-08-12,2017,Chelsea,Burnley,2-3,2,3,1,1,5,-1,A
2017-08-12,2017,Crystal Palace,Huddersfield Town,0-3,0,3,1,1,3,-3,A
2017-08-12,2017,Everton,Stoke City,1-0,1,0,1,1,1,1,H
2017-08-12,2017,Southampton,Swansea City,0-0,0,0,1,1,0,0,D
2017-08-12,2017,Watford,Liverpool,3-3,3,3,1,1,6,0,D
2017-08-12,2017,West Bromwich Albion,AFC Bournemouth,1-0,1,0,1,1,1,1,H
2017-08-13,2017,Manchester United,West Ham United,4-0,4,0,1,1,4,4,H
2017-08-13,2017,Newcastle United,Tottenham Hotspur,0-2,0,2,1,1,2,-2,A
2017-08-19,2017,AFC Bournemouth,Watford,0-2,0,2,1,1,2,-2,A
2017-08-19,2017,Burnley,West Bromwich Albion,0-1,0,1,1,1,1,-1,A
2017-08-19,2017,Leicester City,Brighton & Hove Albion,2-0,2,0,1,1,2,2,H
2017-08-19,2017,Liverpool,Crystal Palace,1-0,1,0,1,1,1,1,H
2017-08-19,2017,Southampton,West Ham United,3-2,3,2,1,1,5,1,H
2017-08-19,2017,Stoke City,Arsenal,1-0,1,0,1,1,1,1,H
2017-08-19,2017,Swansea City,Manchester United,0-4,0,4,1,1,4,-4,A
2017-08-20,2017,Huddersfield Town,Newcastle United,1-0,1,0,1,1,1,1,H
2017-08-20,2017,Tottenham Hotspur,Chelsea,1-2,1,2,1,1,3,-1,A
2017-08-21,2017,Manchester City,Everton,1-1,1,1,1,1,2,0,D
2017-08-26,2017,AFC Bournemouth,Manchester City,1-2,1,2,1,1,3,-1,A
2017-08-26,2017,Crystal Palace,Swansea City,0-2,0,2,1,1,2,-2,A
2017-08-26,2017,Huddersfield Town,Southampton,0-0,0,0,1,1,0,0,D
2017-08-26,2017,Manchester United,Leicester City,2-0,2,0,1,1,2,2,H
2017-08-26,2017,Newcastle United,West Ham United,3-0,3,0,1,1,3,3,H
2017-08-26,2017,Watford,Brighton & Hove Albion,0-0,0,0,1,1,0,0,D
2017-08-27,2017,Chelsea,Everton,2-0,2,0,1,1,2,2,H
2017-08-27,2017,Liverpool,Arsenal,4-0,4,0,1,1,4,4,H
2017-08-27,2017,Tottenham Hotspur,Burnley,1-1,1,1,1,1,2,0,D
2017-08-27,2017,West Bromwich Albion,Stoke City,1-1,1,1,1,1,2,0,D
2017-09-09,2017,Arsenal,AFC Bournemouth,3-0,3,0,1,1,3,3,H
2017-09-09,2017,Brighton & Hove Albion,West Bromwich Albion,3-1,3,1,1,1,4,2,H
2017-09-09,2017,Everton,Tottenham Hotspur,0-3,0,3,1,1,3,-3,A
2017-09-09,2017,Leicester City,Chelsea,1-2,1,2,1,1,3,-1,A
2017-09-09,2017,Manchester City,Liverpool,5-0,5,0,1,1,5,5,H
2017-09-09,2017,Southampton,Watford,0-2,0,2,1,1,2,-2,A
2017-09-09,2017,Stoke City,Manchester United,2-2,2,2,1,1,4,0,D
2017-09-10,2017,Burnley,Crystal Palace,1-0,1,0,1,1,1,1,H
2017-09-10,2017,Swansea City,Newcastle United,0-1,0,1,1,1,1,-1,A
2017-09-11,2017,West Ham United,Huddersfield Town,2-0,2,0,1,1,2,2,H
2017-09-15,2017,AFC Bournemouth,Brighton & Hove Albion,2-1,2,1,1,1,3,1,H
2017-09-16,2017,Crystal Palace,Southampton,0-1,0,1,1,1,1,-1,A
2017-09-16,2017,Huddersfield Town,Leicester City,1-1,1,1,1,1,2,0,D
2017-09-16,2017,Liverpool,Burnley,1-1,1,1,1,1,2,0,D
2017-09-16,2017,Newcastle United,Stoke City,2-1,2,1,1,1,3,1,H
2017-09-16,2017,Tottenham Hotspur,Swansea City,0-0,0,0,1,1,0,0,D
2017-09-16,2017,Watford,Manchester City,0-6,0,6,1,1,6,-6,A
2017-09-16,2017,West Bromwich Albion,West Ham United,0-0,0,0,1,1,0,0,D
2017-09-17,2017,Chelsea,Arsenal,0-0,0,0,1,1,0,0,D
2017-09-17,2017,Manchester United,Everton,4-0,4,0,1,1,4,4,H
2017-09-23,2017,Burnley,Huddersfield Town,0-0,0,0,1,1,0,0,D
2017-09-23,2017,Everton,AFC Bournemouth,2-1,2,1,1,1,3,1,H
2017-09-23,2017,Leicester City,Liverpool,2-3,2,3,1,1,5,-1,A
2017-09-23,2017,Manchester City,Crystal Palace,5-0,5,0,1,1,5,5,H
2017-09-23,2017,Southampton,Manchester United,0-1,0,1,1,1,1,-1,A
2017-09-23,2017,Stoke City,Chelsea,0-4,0,4,1,1,4,-4,A
2017-09-23,2017,Swansea City,Watford,1-2,1,2,1,1,3,-1,A
2017-09-23,2017,West Ham United,Tottenham Hotspur,2-3,2,3,1,1,5,-1,A
2017-09-24,2017,Brighton & Hove Albion,Newcastle United,1-0,1,0,1,1,1,1,H
2017-09-25,2017,Arsenal,West Bromwich Albion,2-0,2,0,1,1,2,2,H
2017-09-30,2017,AFC Bournemouth,Leicester City,0-0,0,0,1,1,0,0,D
2017-09-30,2017,Chelsea,Manchester City,0-1,0,1,1,1,1,-1,A
2017-09-30,2017,Huddersfield Town,Tottenham Hotspur,0-4,0,4,1,1,4,-4,A
2017-09-30,2017,Manchester United,Crystal Palace,4-0,4,0,1,1,4,4,H
2017-09-30,2017,Stoke City,Southampton,2-1,2,1,1,1,3,1,H
2017-09-30,2017,West Bromwich Albion,Watford,2-2,2,2,1,1,4,0,D
2017-09-30,2017,West Ham United,Swansea City,1-0,1,0,1,1,1,1,H
2017-10-01,2017,Arsenal,Brighton & Hove Albion,2-0,2,0,1,1,2,2,H
2017-10-01,2017,Everton,Burnley,0-1,0,1,1,1,1,-1,A
2017-10-01,2017,Newcastle United,Liverpool,1-1,1,1,1,1,2,0,D
2017-10-14,2017,Burnley,West Ham United,1-1,1,1,1,1,2,0,D
2017-10-14,2017,Crystal Palace,Chelsea,2-1,2,1,1,1,3,1,H
2017-10-14,2017,Liverpool,Manchester United,0-0,0,0,1,1,0,0,D
2017-10-14,2017,Manchester City,Stoke City,7-2,7,2,1,1,9,5,H
2017-10-14,2017,Swansea City,Huddersfield Town,2-0,2,0,1,1,2,2,H
2017-10-14,2017,Tottenham Hotspur,AFC Bournemouth,1-0,1,0,1,1,1,1,H
2017-10-14,2017,Watford,Arsenal,2-1,2,1,1,1,3,1,H
2017-10-15,2017,Brighton & Hove Albion,Everton,1-1,1,1,1,1,2,0,D
2017-10-15,2017,Southampton,Newcastle United,2-2,2,2,1,1,4,0,D
2017-10-16,2017,Leicester City,West Bromwich Albion,1-1,1,1,1,1,2,0,D
2017-10-20,2017,West Ham United,Brighton & Hove Albion,0-3,0,3,1,1,3,-3,A
2017-10-21,2017,Chelsea,Watford,4-2,4,2,1,1,6,2,H
2017-10-21,2017,Huddersfield Town,Manchester United,2-1,2,1,1,1,3,1,H
2017-10-21,2017,Manchester City,Burnley,3-0,3,0,1,1,3,3,H
2017-10-21,2017,Newcastle United,Crystal Palace,1-0,1,0,1,1,1,1,H
2017-10-21,2017,Southampton,West Bromwich Albion,1-0,1,0,1,1,1,1,H
2017-10-21,2017,Stoke City,AFC Bournemouth,1-2,1,2,1,1,3,-1,A
2017-10-21,2017,Swansea City,Leicester City,1-2,1,2,1,1,3,-1,A
2017-10-22,2017,Everton,Arsenal,2-5,2,5,1,1,7,-3,A
2017-10-22,2017,Tottenham Hotspur,Liverpool,4-1,4,1,1,1,5,3,H
2017-10-28,2017,Arsenal,Swansea City,2-1,2,1,1,1,3,1,H
2017-10-28,2017,AFC Bournemouth,Chelsea,0-1,0,1,1,1,1,-1,A
2017-10-28,2017,Crystal Palace,West Ham United,2-2,2,2,1,1,4,0,D
2017-10-28,2017,Liverpool,Huddersfield Town,3-0,3,0,1,1,3,3,H
2017-10-28,2017,Manchester United,Tottenham Hotspur,1-0,1,0,1,1,1,1,H
2017-10-28,2017,Watford,Stoke City,0-1,0,1,1,1,1,-1,A
2017-10-28,2017,West Bromwich Albion,Manchester City,2-3,2,3,1,1,5,-1,A
2017-10-29,2017,Brighton & Hove Albion,Southampton,1-1,1,1,1,1,2,0,D
2017-10-29,2017,Leicester City,Everton,2-0,2,0,1,1,2,2,H
2017-10-30,2017,Burnley,Newcastle United,1-0,1,0,1,1,1,1,H
2017-11-04,2017,Huddersfield Town,West Bromwich Albion,1-0,1,0,1,1,1,1,H
2017-11-04,2017,Newcastle United,AFC Bournemouth,0-1,0,1,1,1,1,-1,A
2017-11-04,2017,Southampton,Burnley,0-1,0,1,1,1,1,-1,A
2017-11-04,2017,Stoke City,Leicester City,2-2,2,2,1,1,4,0,D
2017-11-04,2017,Swansea City,Brighton & Hove Albion,0-1,0,1,1,1,1,-1,A
2017-11-04,2017,West Ham United,Liverpool,1-4,1,4,1,1,5,-3,A
2017-11-05,2017,Chelsea,Manchester United,1-0,1,0,1,1,1,1,H
2017-11-05,2017,Everton,Watford,3-2,3,2,1,1,5,1,H
2017-11-05,2017,Manchester City,Arsenal,3-1,3,1,1,1,4,2,H
2017-11-05,2017,Tottenham Hotspur,Crystal Palace,1-0,1,0,1,1,1,1,H
2017-11-18,2017,Arsenal,Tottenham Hotspur,2-0,2,0,1,1,2,2,H
2017-11-18,2017,AFC Bournemouth,Huddersfield Town,4-0,4,0,1,1,4,4,H
2017-11-18,2017,Burnley,Swansea City,2-0,2,0,1,1,2,2,H
2017-11-18,2017,Crystal Palace,Everton,2-2,2,2,1,1,4,0,D
2017-11-18,2017,Leicester City,Manchester City,0-2,0,2,1,1,2,-2,A
2017-11-18,2017,Liverpool,Southampton,3-0,3,0,1,1,3,3,H
2017-11-18,2017,Manchester United,Newcastle United,4-1,4,1,1,1,5,3,H
2017-11-18,2017,West Bromwich Albion,Chelsea,0-4,0,4,1,1,4,-4,A
2017-11-19,2017,Watford,West Ham United,2-0,2,0,1,1,2,2,H
2017-11-20,2017,Brighton & Hove Albion,Stoke City,2-2,2,2,1,1,4,0,D
2017-11-24,2017,West Ham United,Leicester City,1-1,1,1,1,1,2,0,D
2017-11-25,2017,Crystal Palace,Stoke City,2-1,2,1,1,1,3,1,H
2017-11-25,2017,Liverpool,Chelsea,1-1,1,1,1,1,2,0,D
2017-11-25,2017,Manchester United,Brighton & Hove Albion,1-0,1,0,1,1,1,1,H
2017-11-25,2017,Newcastle United,Watford,0-3,0,3,1,1,3,-3,A
2017-11-25,2017,Swansea City,AFC Bournemouth,0-0,0,0,1,1,0,0,D
2017-11-25,2017,Tottenham Hotspur,West Bromwich Albion,1-1,1,1,1,1,2,0,D
2017-11-26,2017,Burnley,Arsenal,0-1,0,1,1,1,1,-1,A
2017-11-26,2017,Huddersfield Town,Manchester City,1-2,1,2,1,1,3,-1,A
2017-11-26,2017,Southampton,Everton,4-1,4,1,1,1,5,3,H
2017-11-28,2017,Brighton & Hove Albion,Crystal Palace,0-0,0,0,1,1,0,0,D
2017-11-28,2017,Leicester City,Tottenham Hotspur,2-1,2,1,1,1,3,1,H
2017-11-28,2017,Watford,Manchester United,2-4,2,4,1,1,6,-2,A
2017-11-28,2017,West Bromwich Albion,Newcastle United,2-2,2,2,1,1,4,0,D
2017-11-29,2017,Arsenal,Huddersfield Town,5-0,5,0,1,1,5,5,H
2017-11-29,2017,AFC Bournemouth,Burnley,1-2,1,2,1,1,3,-1,A
2017-11-29,2017,Chelsea,Swansea City,1-0,1,0,1,1,1,1,H
2017-11-29,2017,Everton,West Ham United,4-0,4,0,1,1,4,4,H
2017-11-29,2017,Manchester City,Southampton,2-1,2,1,1,1,3,1,H
2017-11-29,2017,Stoke City,Liverpool,0-3,0,3,1,1,3,-3,A
2017-12-02,2017,Arsenal,Manchester United,1-3,1,3,1,1,4,-2,A
2017-12-02,2017,Brighton & Hove Albion,Liverpool,1-5,1,5,1,1,6,-4,A
2017-12-02,2017,Chelsea,Newcastle United,3-1,3,1,1,1,4,2,H
2017-12-02,2017,Everton,Huddersfield Town,2-0,2,0,1,1,2,2,H
2017-12-02,2017,Leicester City,Burnley,1-0,1,0,1,1,1,1,H
2017-12-02,2017,Stoke City,Swansea City,2-1,2,1,1,1,3,1,H
2017-12-02,2017,Watford,Tottenham Hotspur,1-1,1,1,1,1,2,0,D
2017-12-02,2017,West Bromwich Albion,Crystal Palace,0-0,0,0,1,1,0,0,D
2017-12-03,2017,AFC Bournemouth,Southampton,1-1,1,1,1,1,2,0,D
2017-12-03,2017,Manchester City,West Ham United,2-1,2,1,1,1,3,1,H
2017-12-09,2017,Burnley,Watford,1-0,1,0,1,1,1,1,H
2017-12-09,2017,Crystal Palace,AFC Bournemouth,2-2,2,2,1,1,4,0,D
2017-12-09,2017,Huddersfield Town,Brighton & Hove Albion,2-0,2,0,1,1,2,2,H
2017-12-09,2017,Newcastle United,Leicester City,2-3,2,3,1,1,5,-1,A
2017-12-09,2017,Swansea City,West Bromwich Albion,1-0,1,0,1,1,1,1,H
2017-12-09,2017,Tottenham Hotspur,Stoke City,5-1,5,1,1,1,6,4,H
2017-12-09,2017,West Ham United,Chelsea,1-0,1,0,1,1,1,1,H
2017-12-10,2017,Liverpool,Everton,1-1,1,1,1,1,2,0,D
2017-12-10,2017,Manchester United,Manchester City,1-2,1,2,1,1,3,-1,A
2017-12-10,2017,Southampton,Arsenal,1-1,1,1,1,1,2,0,D
2017-12-12,2017,Burnley,Stoke City,1-0,1,0,1,1,1,1,H
2017-12-12,2017,Crystal Palace,Watford,2-1,2,1,1,1,3,1,H
2017-12-12,2017,Huddersfield Town,Chelsea,1-3,1,3,1,1,4,-2,A
2017-12-13,2017,Liverpool,West Bromwich Albion,0-0,0,0,1,1,0,0,D
2017-12-13,2017,Manchester United,AFC Bournemouth,1-0,1,0,1,1,1,1,H
2017-12-13,2017,Newcastle United,Everton,0-1,0,1,1,1,1,-1,A
2017-12-13,2017,Southampton,Leicester City,1-4,1,4,1,1,5,-3,A
2017-12-13,2017,Swansea City,Manchester City,0-4,0,4,1,1,4,-4,A
2017-12-13,2017,Tottenham Hotspur,Brighton & Hove Albion,2-0,2,0,1,1,2,2,H
2017-12-13,2017,West Ham United,Arsenal,0-0,0,0,1,1,0,0,D
2017-12-16,2017,Arsenal,Newcastle United,1-0,1,0,1,1,1,1,H
2017-12-16,2017,Brighton & Hove Albion,Burnley,0-0,0,0,1,1,0,0,D
2017-12-16,2017,Chelsea,Southampton,1-0,1,0,1,1,1,1,H
2017-12-16,2017,Leicester City,Crystal Palace,0-3,0,3,1,1,3,-3,A
2017-12-16,2017,Manchester City,Tottenham Hotspur,4-1,4,1,1,1,5,3,H
2017-12-16,2017,Stoke City,West Ham United,0-3,0,3,1,1,3,-3,A
2017-12-16,2017,Watford,Huddersfield Town,1-4,1,4,1,1,5,-3,A
2017-12-17,2017,AFC Bournemouth,Liverpool,0-4,0,4,1,1,4,-4,A
2017-12-17,2017,West Bromwich Albion,Manchester United,1-2,1,2,1,1,3,-1,A
2017-12-18,2017,Everton,Swansea City,3-1,3,1,1,1,4,2,H
2017-12-22,2017,Arsenal,Liverpool,3-3,3,3,1,1,6,0,D
2017-12-23,2017,Brighton & Hove Albion,Watford,1-0,1,0,1,1,1,1,H
2017-12-23,2017,Burnley,Tottenham Hotspur,0-3,0,3,1,1,3,-3,A
2017-12-23,2017,Everton,Chelsea,0-0,0,0,1,1,0,0,D
2017-12-23,2017,Leicester City,Manchester United,2-2,2,2,1,1,4,0,D
2017-12-23,2017,Manchester City,AFC Bournemouth,4-0,4,0,1,1,4,4,H
2017-12-23,2017,Southampton,Huddersfield Town,1-1,1,1,1,1,2,0,D
2017-12-23,2017,Stoke City,West Bromwich Albion,3-1,3,1,1,1,4,2,H
2017-12-23,2017,Swansea City,Crystal Palace,1-1,1,1,1,1,2,0,D
2017-12-23,2017,West Ham United,Newcastle United,2-3,2,3,1,1,5,-1,A
2017-12-26,2017,AFC Bournemouth,West Ham United,3-3,3,3,1,1,6,0,D
2017-12-26,2017,Chelsea,Brighton & Hove Albion,2-0,2,0,1,1,2,2,H
2017-12-26,2017,Huddersfield Town,Stoke City,1-1,1,1,1,1,2,0,D
2017-12-26,2017,Liverpool,Swansea City,5-0,5,0,1,1,5,5,H
2017-12-26,2017,Manchester United,Burnley,2-2,2,2,1,1,4,0,D
2017-12-26,2017,Tottenham Hotspur,Southampton,5-2,5,2,1,1,7,3,H
2017-12-26,2017,Watford,Leicester City,2-1,2,1,1,1,3,1,H
2017-12-26,2017,West Bromwich Albion,Everton,0-0,0,0,1,1,0,0,D
2017-12-27,2017,Newcastle United,Manchester City,0-1,0,1,1,1,1,-1,A
2017-12-28,2017,Crystal Palace,Arsenal,2-3,2,3,1,1,5,-1,A
2017-12-30,2017,AFC Bournemouth,Everton,2-1,2,1,1,1,3,1,H
2017-12-30,2017,Chelsea,Stoke City,5-0,5,0,1,1,5,5,H
2017-12-30,2017,Huddersfield Town,Burnley,0-0,0,0,1,1,0,0,D
2017-12-30,2017,Liverpool,Leicester City,2-1,2,1,1,1,3,1,H
2017-12-30,2017,Manchester United,Southampton,0-0,0,0,1,1,0,0,D
2017-12-30,2017,Newcastle United,Brighton & Hove Albion,0-0,0,0,1,1,0,0,D
2017-12-30,2017,Watford,Swansea City,1-2,1,2,1,1,3,-1,A
2017-12-31,2017,Crystal Palace,Manchester City,0-0,0,0,1,1,0,0,D
2017-12-31,2017,West Bromwich Albion,Arsenal,1-1,1,1,1,1,2,0,D
2018-01-01,2017,Brighton & Hove Albion,AFC Bournemouth,2-2,2,2,1,1,4,0,D
2018-01-01,2017,Burnley,Liverpool,1-2,1,2,1,1,3,-1,A
2018-01-01,2017,Everton,Manchester United,0-2,0,2,1,1,2,-2,A
2018-01-01,2017,Leicester City,Huddersfield Town,3-0,3,0,1,1,3,3,H
2018-01-01,2017,Stoke City,Newcastle United,0-1,0,1,1,1,1,-1,A
2018-01-02,2017,Manchester City,Watford,3-1,3,1,1,1,4,2,H
2018-01-02,2017,Southampton,Crystal Palace,1-2,1,2,1,1,3,-1,A
2018-01-02,2017,Swansea City,Tottenham Hotspur,0-2,0,2,1,1,2,-2,A
2018-01-02,2017,West Ham United,West Bromwich Albion,2-1,2,1,1,1,3,1,H
2018-01-03,2017,Arsenal,Chelsea,2-2,2,2,1,1,4,0,D
2018-01-04,2017,Tottenham Hotspur,West Ham United,1-1,1,1,1,1,2,0,D
2018-01-13,2017,Chelsea,Leicester City,0-0,0,0,1,1,0,0,D
2018-01-13,2017,Crystal Palace,Burnley,1-0,1,0,1,1,1,1,H
2018-01-13,2017,Huddersfield Town,West Ham United,1-4,1,4,1,1,5,-3,A
2018-01-13,2017,Newcastle United,Swansea City,1-1,1,1,1,1,2,0,D
2018-01-13,2017,Tottenham Hotspur,Everton,4-0,4,0,1,1,4,4,H
2018-01-13,2017,Watford,Southampton,2-2,2,2,1,1,4,0,D
2018-01-13,2017,West Bromwich Albion,Brighton & Hove Albion,2-0,2,0,1,1,2,2,H
2018-01-14,2017,AFC Bournemouth,Arsenal,2-1,2,1,1,1,3,1,H
2018-01-14,2017,Liverpool,Manchester City,4-3,4,3,1,1,7,1,H
2018-01-15,2017,Manchester United,Stoke City,3-0,3,0,1,1,3,3,H
2018-01-20,2017,Arsenal,Crystal Palace,4-1,4,1,1,1,5,3,H
2018-01-20,2017,Brighton & Hove Albion,Chelsea,0-4,0,4,1,1,4,-4,A
2018-01-20,2017,Burnley,Manchester United,0-1,0,1,1,1,1,-1,A
2018-01-20,2017,Everton,West Bromwich Albion,1-1,1,1,1,1,2,0,D
2018-01-20,2017,Leicester City,Watford,2-0,2,0,1,1,2,2,H
2018-01-20,2017,Manchester City,Newcastle United,3-1,3,1,1,1,4,2,H
2018-01-20,2017,Stoke City,Huddersfield Town,2-0,2,0,1,1,2,2,H
2018-01-20,2017,West Ham United,AFC Bournemouth,1-1,1,1,1,1,2,0,D
2018-01-21,2017,Southampton,Tottenham Hotspur,1-1,1,1,1,1,2,0,D
2018-01-22,2017,Swansea City,Liverpool,1-0,1,0,1,1,1,1,H
2018-01-30,2017,Huddersfield Town,Liverpool,0-3,0,3,1,1,3,-3,A
2018-01-30,2017,Swansea City,Arsenal,3-1,3,1,1,1,4,2,H
2018-01-30,2017,West Ham United,Crystal Palace,1-1,1,1,1,1,2,0,D
2018-01-31,2017,Chelsea,AFC Bournemouth,0-3,0,3,1,1,3,-3,A
2018-01-31,2017,Everton,Leicester City,2-1,2,1,1,1,3,1,H
2018-01-31,2017,Manchester City,West Bromwich Albion,3-0,3,0,1,1,3,3,H
2018-01-31,2017,Newcastle United,Burnley,1-1,1,1,1,1,2,0,D
2018-01-31,2017,Southampton,Brighton & Hove Albion,1-1,1,1,1,1,2,0,D
2018-01-31,2017,Stoke City,Watford,0-0,0,0,1,1,0,0,D
2018-01-31,2017,Tottenham Hotspur,Manchester United,2-0,2,0,1,1,2,2,H
2018-02-03,2017,Arsenal,Everton,5-1,5,1,1,1,6,4,H
2018-02-03,2017,AFC Bournemouth,Stoke City,2-1,2,1,1,1,3,1,H
2018-02-03,2017,Brighton & Hove Albion,West Ham United,3-1,3,1,1,1,4,2,H
2018-02-03,2017,Burnley,Manchester City,1-1,1,1,1,1,2,0,D
2018-02-03,2017,Leicester City,Swansea City,1-1,1,1,1,1,2,0,D
2018-02-03,2017,Manchester United,Huddersfield Town,2-0,2,0,1,1,2,2,H
2018-02-03,2017,West Bromwich Albion,Southampton,2-3,2,3,1,1,5,-1,A
2018-02-04,2017,Crystal Palace,Newcastle United,1-1,1,1,1,1,2,0,D
2018-02-04,2017,Liverpool,Tottenham Hotspur,2-2,2,2,1,1,4,0,D
2018-02-05,2017,Watford,Chelsea,4-1,4,1,1,1,5,3,H
2018-02-10,2017,Everton,Crystal Palace,3-1,3,1,1,1,4,2,H
2018-02-10,2017,Manchester City,Leicester City,5-1,5,1,1,1,6,4,H
2018-02-10,2017,Stoke City,Brighton & Hove Albion,1-1,1,1,1,1,2,0,D
2018-02-10,2017,Swansea City,Burnley,1-0,1,0,1,1,1,1,H
2018-02-10,2017,Tottenham Hotspur,Arsenal,1-0,1,0,1,1,1,1,H
2018-02-10,2017,West Ham United,Watford,2-0,2,0,1,1,2,2,H
2018-02-11,2017,Huddersfield Town,AFC Bournemouth,4-1,4,1,1,1,5,3,H
2018-02-11,2017,Newcastle United,Manchester United,1-0,1,0,1,1,1,1,H
2018-02-11,2017,Southampton,Liverpool,0-2,0,2,1,1,2,-2,A
2018-02-12,2017,Chelsea,West Bromwich Albion,3-0,3,0,1,1,3,3,H
2018-02-24,2017,AFC Bournemouth,Newcastle United,2-2,2,2,1,1,4,0,D
2018-02-24,2017,Brighton & Hove Albion,Swansea City,4-1,4,1,1,1,5,3,H
2018-02-24,2017,Burnley,Southampton,1-1,1,1,1,1,2,0,D
2018-02-24,2017,Leicester City,Stoke City,1-1,1,1,1,1,2,0,D
2018-02-24,2017,Liverpool,West Ham United,4-1,4,1,1,1,5,3,H
2018-02-24,2017,Watford,Everton,1-0,1,0,1,1,1,1,H
2018-02-24,2017,West Bromwich Albion,Huddersfield Town,1-2,1,2,1,1,3,-1,A
2018-02-25,2017,Crystal Palace,Tottenham Hotspur,0-1,0,1,1,1,1,-1,A
2018-02-25,2017,Manchester United,Chelsea,2-1,2,1,1,1,3,1,H
2018-03-01,2017,Arsenal,Manchester City,0-3,0,3,1,1,3,-3,A
2018-03-03,2017,Burnley,Everton,2-1,2,1,1,1,3,1,H
2018-03-03,2017,Leicester City,AFC Bournemouth,1-1,1,1,1,1,2,0,D
2018-03-03,2017,Liverpool,Newcastle United,2-0,2,0,1,1,2,2,H
2018-03-03,2017,Southampton,Stoke City,0-0,0,0,1,1,0,0,D
2018-03-03,2017,Swansea City,West Ham United,4-1,4,1,1,1,5,3,H
2018-03-03,2017,Tottenham Hotspur,Huddersfield Town,2-0,2,0,1,1,2,2,H
2018-03-03,2017,Watford,West Bromwich Albion,1-0,1,0,1,1,1,1,H
2018-03-04,2017,Brighton & Hove Albion,Arsenal,2-1,2,1,1,1,3,1,H
2018-03-04,2017,Manchester City,Chelsea,1-0,1,0,1,1,1,1,H
2018-03-05,2017,Crystal Palace,Manchester United,2-3,2,3,1,1,5,-1,A
2018-03-10,2017,Chelsea,Crystal Palace,2-1,2,1,1,1,3,1,H
2018-03-10,2017,Everton,Brighton & Hove Albion,2-0,2,0,1,1,2,2,H
2018-03-10,2017,Huddersfield Town,Swansea City,0-0,0,0,1,1,0,0,D
2018-03-10,2017,Manchester United,Liverpool,2-1,2,1,1,1,3,1,H
2018-03-10,2017,Newcastle United,Southampton,3-0,3,0,1,1,3,3,H
2018-03-10,2017,West Bromwich Albion,Leicester City,1-4,1,4,1,1,5,-3,A
2018-03-10,2017,West Ham United,Burnley,0-3,0,3,1,1,3,-3,A
2018-03-11,2017,Arsenal,Watford,3-0,3,0,1,1,3,3,H
2018-03-11,2017,AFC Bournemouth,Tottenham Hotspur,1-4,1,4,1,1,5,-3,A
2018-03-12,2017,Stoke City,Manchester City,0-2,0,2,1,1,2,-2,A
2018-03-17,2017,AFC Bournemouth,West Bromwich Albion,2-1,2,1,1,1,3,1,H
2018-03-17,2017,Huddersfield Town,Crystal Palace,0-2,0,2,1,1,2,-2,A
2018-03-17,2017,Liverpool,Watford,5-0,5,0,1,1,5,5,H
2018-03-17,2017,Stoke City,Everton,1-2,1,2,1,1,3,-1,A
2018-03-31,2017,Brighton & Hove Albion,Leicester City,0-2,0,2,1,1,2,-2,A
2018-03-31,2017,Crystal Palace,Liverpool,1-2,1,2,1,1,3,-1,A
2018-03-31,2017,Everton,Manchester City,1-3,1,3,1,1,4,-2,A
2018-03-31,2017,Manchester United,Swansea City,2-0,2,0,1,1,2,2,H
2018-03-31,2017,Newcastle United,Huddersfield Town,1-0,1,0,1,1,1,1,H
2018-03-31,2017,Watford,AFC Bournemouth,2-2,2,2,1,1,4,0,D
2018-03-31,2017,West Bromwich Albion,Burnley,1-2,1,2,1,1,3,-1,A
2018-03-31,2017,West Ham United,Southampton,3-0,3,0,1,1,3,3,H
2018-04-01,2017,Arsenal,Stoke City,3-0,3,0,1,1,3,3,H
2018-04-01,2017,Chelsea,Tottenham Hotspur,1-3,1,3,1,1,4,-2,A
2018-04-07,2017,AFC Bournemouth,Crystal Palace,2-2,2,2,1,1,4,0,D
2018-04-07,2017,Brighton & Hove Albion,Huddersfield Town,1-1,1,1,1,1,2,0,D
2018-04-07,2017,Everton,Liverpool,0-0,0,0,1,1,0,0,D
2018-04-07,2017,Leicester City,Newcastle United,1-2,1,2,1,1,3,-1,A
2018-04-07,2017,Manchester City,Manchester United,2-3,2,3,1,1,5,-1,A
2018-04-07,2017,Stoke City,Tottenham Hotspur,1-2,1,2,1,1,3,-1,A
2018-04-07,2017,Watford,Burnley,1-2,1,2,1,1,3,-1,A
2018-04-07,2017,West Bromwich Albion,Swansea City,1-1,1,1,1,1,2,0,D
2018-04-08,2017,Arsenal,Southampton,3-2,3,2,1,1,5,1,H
2018-04-08,2017,Chelsea,West Ham United,1-1,1,1,1,1,2,0,D
2018-04-14,2017,Burnley,Leicester City,2-1,2,1,1,1,3,1,H
2018-04-14,2017,Crystal Palace,Brighton & Hove Albion,3-2,3,2,1,1,5,1,H
2018-04-14,2017,Huddersfield Town,Watford,1-0,1,0,1,1,1,1,H
2018-04-14,2017,Liverpool,AFC Bournemouth,3-0,3,0,1,1,3,3,H
2018-04-14,2017,Southampton,Chelsea,2-3,2,3,1,1,5,-1,A
2018-04-14,2017,Swansea City,Everton,1-1,1,1,1,1,2,0,D
2018-04-14,2017,Tottenham Hotspur,Manchester City,1-3,1,3,1,1,4,-2,A
2018-04-15,2017,Manchester United,West Bromwich Albion,0-1,0,1,1,1,1,-1,A
2018-04-15,2017,Newcastle United,Arsenal,2-1,2,1,1,1,3,1,H
2018-04-16,2017,West Ham United,Stoke City,1-1,1,1,1,1,2,0,D
2018-04-17,2017,Brighton & Hove Albion,Tottenham Hotspur,1-1,1,1,1,1,2,0,D
2018-04-18,2017,AFC Bournemouth,Manchester United,0-2,0,2,1,1,2,-2,A
2018-04-19,2017,Burnley,Chelsea,1-2,1,2,1,1,3,-1,A
2018-04-19,2017,Leicester City,Southampton,0-0,0,0,1,1,0,0,D
2018-04-21,2017,Watford,Crystal Palace,0-0,0,0,1,1,0,0,D
2018-04-21,2017,West Bromwich Albion,Liverpool,2-2,2,2,1,1,4,0,D
2018-04-22,2017,Arsenal,West Ham United,4-1,4,1,1,1,5,3,H
2018-04-22,2017,Manchester City,Swansea City,5-0,5,0,1,1,5,5,H
2018-04-22,2017,Stoke City,Burnley,1-1,1,1,1,1,2,0,D
2018-04-23,2017,Everton,Newcastle United,1-0,1,0,1,1,1,1,H
2018-04-28,2017,Burnley,Brighton & Hove Albion,0-0,0,0,1,1,0,0,D
2018-04-28,2017,Crystal Palace,Leicester City,5-0,5,0,1,1,5,5,H
2018-04-28,2017,Huddersfield Town,Everton,0-2,0,2,1,1,2,-2,A
2018-04-28,2017,Liverpool,Stoke City,0-0,0,0,1,1,0,0,D
2018-04-28,2017,Newcastle United,West Bromwich Albion,0-1,0,1,1,1,1,-1,A
2018-04-28,2017,Southampton,AFC Bournemouth,2-1,2,1,1,1,3,1,H
2018-04-28,2017,Swansea City,Chelsea,0-1,0,1,1,1,1,-1,A
2018-04-29,2017,Manchester United,Arsenal,2-1,2,1,1,1,3,1,H
2018-04-29,2017,West Ham United,Manchester City,1-4,1,4,1,1,5,-3,A
2018-04-30,2017,Tottenham Hotspur,Watford,2-0,2,0,1,1,2,2,H
2018-05-04,2017,Brighton & Hove Albion,Manchester United,1-0,1,0,1,1,1,1,H
2018-05-05,2017,AFC Bournemouth,Swansea City,1-0,1,0,1,1,1,1,H
2018-05-05,2017,Everton,Southampton,1-1,1,1,1,1,2,0,D
2018-05-05,2017,Leicester City,West Ham United,0-2,0,2,1,1,2,-2,A
2018-05-05,2017,Stoke City,Crystal Palace,1-2,1,2,1,1,3,-1,A
2018-05-05,2017,Watford,Newcastle United,2-1,2,1,1,1,3,1,H
2018-05-05,2017,West Bromwich Albion,Tottenham Hotspur,1-0,1,0,1,1,1,1,H
2018-05-06,2017,Arsenal,Burnley,5-0,5,0,1,1,5,5,H
2018-05-06,2017,Chelsea,Liverpool,1-0,1,0,1,1,1,1,H
2018-05-06,2017,Manchester City,Huddersfield Town,0-0,0,0,1,1,0,0,D
2018-05-08,2017,Swansea City,Southampton,0-1,0,1,1,1,1,-1,A
2018-05-09,2017,Chelsea,Huddersfield Town,1-1,1,1,1,1,2,0,D
2018-05-09,2017,Leicester City,Arsenal,3-1,3,1,1,1,4,2,H
2018-05-09,2017,Manchester City,Brighton & Hove Albion,3-1,3,1,1,1,4,2,H
2018-05-09,2017,Tottenham Hotspur,Newcastle United,1-0,1,0,1,1,1,1,H
2018-05-10,2017,West Ham United,Manchester United,0-0,0,0,1,1,0,0,D
2018-05-13,2017,Burnley,AFC Bournemouth,1-2,1,2,1,1,3,-1,A
2018-05-13,2017,Crystal Palace,West Bromwich Albion,2-0,2,0,1,1,2,2,H
2018-05-13,2017,Huddersfield Town,Arsenal,0-1,0,1,1,1,1,-1,A
2018-05-13,2017,Liverpool,Brighton & Hove Albion,4-0,4,0,1,1,4,4,H
2018-05-13,2017,Manchester United,Watford,1-0,1,0,1,1,1,1,H
2018-05-13,2017,Newcastle United,Chelsea,3-0,3,0,1,1,3,3,H
2018-05-13,2017,Southampton,Manchester City,0-1,0,1,1,1,1,-1,A
2018-05-13,2017,Swansea City,Stoke City,1-2,1,2,1,1,3,-1,A
2018-05-13,2017,Tottenham Hotspur,Leicester City,5-4,5,4,1,1,9,1,H
2018-05-13,2017,West Ham United,Everton,3-1,3,1,1,1,4,2,H
2018-08-10,2018,Manchester United,Leicester City,2-1,2,1,1,1,3,1,H
2018-08-11,2018,AFC Bournemouth,Cardiff City,2-0,2,0,1,1,2,2,H
2018-08-11,2018,Fulham,Crystal Palace,0-2,0,2,1,1,2,-2,A
2018-08-11,2018,Huddersfield Town,Chelsea,0-3,0,3,1,1,3,-3,A
2018-08-11,2018,Newcastle United,Tottenham Hotspur,1-2,1,2,1,1,3,-1,A
2018-08-11,2018,Watford,Brighton & Hove Albion,2-0,2,0,1,1,2,2,H
2018-08-11,2018,Wolverhampton Wanderers,Everton,2-2,2,2,1,1,4,0,D
2018-08-12,2018,Arsenal,Manchester City,0-2,0,2,1,1,2,-2,A
2018-08-12,2018,Liverpool,West Ham United,4-0,4,0,1,1,4,4,H
2018-08-12,2018,Southampton,Burnley,0-0,0,0,1,1,0,0,D
2018-08-18,2018,Cardiff City,Newcastle United,0-0,0,0,1,1,0,0,D
2018-08-18,2018,Chelsea,Arsenal,3-2,3,2,1,1,5,1,H
2018-08-18,2018,Everton,Southampton,2-1,2,1,1,1,3,1,H
2018-08-18,2018,Leicester City,Wolverhampton Wanderers,2-0,2,0,1,1,2,2,H
2018-08-18,2018,Tottenham Hotspur,Fulham,3-1,3,1,1,1,4,2,H
2018-08-18,2018,West Ham United,AFC Bournemouth,1-2,1,2,1,1,3,-1,A
2018-08-19,2018,Brighton & Hove Albion,Manchester United,3-2,3,2,1,1,5,1,H
2018-08-19,2018,Burnley,Watford,1-3,1,3,1,1,4,-2,A
2018-08-19,2018,Manchester City,Huddersfield Town,6-1,6,1,1,1,7,5,H
2018-08-20,2018,Crystal Palace,Liverpool,0-2,0,2,1,1,2,-2,A
2018-08-25,2018,Arsenal,West Ham United,3-1,3,1,1,1,4,2,H
2018-08-25,2018,AFC Bournemouth,Everton,2-2,2,2,1,1,4,0,D
2018-08-25,2018,Huddersfield Town,Cardiff City,0-0,0,0,1,1,0,0,D
2018-08-25,2018,Liverpool,Brighton & Hove Albion,1-0,1,0,1,1,1,1,H
2018-08-25,2018,Southampton,Leicester City,1-2,1,2,1,1,3,-1,A
2018-08-25,2018,Wolverhampton Wanderers,Manchester City,1-1,1,1,1,1,2,0,D
2018-08-26,2018,Fulham,Burnley,4-2,4,2,1,1,6,2,H
2018-08-26,2018,Newcastle United,Chelsea,1-2,1,2,1,1,3,-1,A
2018-08-26,2018,Watford,Crystal Palace,2-1,2,1,1,1,3,1,H
2018-08-27,2018,Manchester United,Tottenham Hotspur,0-3,0,3,1,1,3,-3,A
2018-09-01,2018,Brighton & Hove Albion,Fulham,2-2,2,2,1,1,4,0,D
2018-09-01,2018,Chelsea,AFC Bournemouth,2-0,2,0,1,1,2,2,H
2018-09-01,2018,Crystal Palace,Southampton,0-2,0,2,1,1,2,-2,A
2018-09-01,2018,Everton,Huddersfield Town,1-1,1,1,1,1,2,0,D
2018-09-01,2018,Leicester City,Liverpool,1-2,1,2,1,1,3,-1,A
2018-09-01,2018,Manchester City,Newcastle United,2-1,2,1,1,1,3,1,H
2018-09-01,2018,West Ham United,Wolverhampton Wanderers,0-1,0,1,1,1,1,-1,A
2018-09-02,2018,Burnley,Manchester United,0-2,0,2,1,1,2,-2,A
2018-09-02,2018,Cardiff City,Arsenal,2-3,2,3,1,1,5,-1,A
2018-09-02,2018,Watford,Tottenham Hotspur,2-1,2,1,1,1,3,1,H
2018-09-15,2018,AFC Bournemouth,Leicester City,4-2,4,2,1,1,6,2,H
2018-09-15,2018,Chelsea,Cardiff City,4-1,4,1,1,1,5,3,H
2018-09-15,2018,Huddersfield Town,Crystal Palace,0-1,0,1,1,1,1,-1,A
2018-09-15,2018,Manchester City,Fulham,3-0,3,0,1,1,3,3,H
2018-09-15,2018,Newcastle United,Arsenal,1-2,1,2,1,1,3,-1,A
2018-09-15,2018,Tottenham Hotspur,Liverpool,1-2,1,2,1,1,3,-1,A
2018-09-15,2018,Watford,Manchester United,1-2,1,2,1,1,3,-1,A
2018-09-16,2018,Everton,West Ham United,1-3,1,3,1,1,4,-2,A
2018-09-16,2018,Wolverhampton Wanderers,Burnley,1-0,1,0,1,1,1,1,H
2018-09-17,2018,Southampton,Brighton & Hove Albion,2-2,2,2,1,1,4,0,D
2018-09-22,2018,Brighton & Hove Albion,Tottenham Hotspur,1-2,1,2,1,1,3,-1,A
2018-09-22,2018,Burnley,AFC Bournemouth,4-0,4,0,1,1,4,4,H
2018-09-22,2018,Cardiff City,Manchester City,0-5,0,5,1,1,5,-5,A
2018-09-22,2018,Crystal Palace,Newcastle United,0-0,0,0,1,1,0,0,D
2018-09-22,2018,Fulham,Watford,1-1,1,1,1,1,2,0,D
2018-09-22,2018,Leicester City,Huddersfield Town,3-1,3,1,1,1,4,2,H
2018-09-22,2018,Liverpool,Southampton,3-0,3,0,1,1,3,3,H
2018-09-22,2018,Manchester United,Wolverhampton Wanderers,1-1,1,1,1,1,2,0,D
2018-09-23,2018,Arsenal,Everton,2-0,2,0,1,1,2,2,H
2018-09-23,2018,West Ham United,Chelsea,0-0,0,0,1,1,0,0,D
2018-09-29,2018,Arsenal,Watford,2-0,2,0,1,1,2,2,H
2018-09-29,2018,Chelsea,Liverpool,1-1,1,1,1,1,2,0,D
2018-09-29,2018,Everton,Fulham,3-0,3,0,1,1,3,3,H
2018-09-29,2018,Huddersfield Town,Tottenham Hotspur,0-2,0,2,1,1,2,-2,A
2018-09-29,2018,Manchester City,Brighton & Hove Albion,2-0,2,0,1,1,2,2,H
2018-09-29,2018,Newcastle United,Leicester City,0-2,0,2,1,1,2,-2,A
2018-09-29,2018,West Ham United,Manchester United,3-1,3,1,1,1,4,2,H
2018-09-29,2018,Wolverhampton Wanderers,Southampton,2-0,2,0,1,1,2,2,H
2018-09-30,2018,Cardiff City,Burnley,1-2,1,2,1,1,3,-1,A
2018-10-01,2018,AFC Bournemouth,Crystal Palace,2-1,2,1,1,1,3,1,H
2018-10-05,2018,Brighton & Hove Albion,West Ham United,1-0,1,0,1,1,1,1,H
2018-10-06,2018,Burnley,Huddersfield Town,1-1,1,1,1,1,2,0,D
2018-10-06,2018,Crystal Palace,Wolverhampton Wanderers,0-1,0,1,1,1,1,-1,A
2018-10-06,2018,Leicester City,Everton,1-2,1,2,1,1,3,-1,A
2018-10-06,2018,Manchester United,Newcastle United,3-2,3,2,1,1,5,1,H
2018-10-06,2018,Tottenham Hotspur,Cardiff City,1-0,1,0,1,1,1,1,H
2018-10-06,2018,Watford,AFC Bournemouth,0-4,0,4,1,1,4,-4,A
2018-10-07,2018,Fulham,Arsenal,1-5,1,5,1,1,6,-4,A
2018-10-07,2018,Liverpool,Manchester City,0-0,0,0,1,1,0,0,D
2018-10-07,2018,Southampton,Chelsea,0-3,0,3,1,1,3,-3,A
2018-10-20,2018,AFC Bournemouth,Southampton,0-0,0,0,1,1,0,0,D
2018-10-20,2018,Cardiff City,Fulham,4-2,4,2,1,1,6,2,H
2018-10-20,2018,Chelsea,Manchester United,2-2,2,2,1,1,4,0,D
2018-10-20,2018,Huddersfield Town,Liverpool,0-1,0,1,1,1,1,-1,A
2018-10-20,2018,Manchester City,Burnley,5-0,5,0,1,1,5,5,H
2018-10-20,2018,Newcastle United,Brighton & Hove Albion,0-1,0,1,1,1,1,-1,A
2018-10-20,2018,West Ham United,Tottenham Hotspur,0-1,0,1,1,1,1,-1,A
2018-10-20,2018,Wolverhampton Wanderers,Watford,0-2,0,2,1,1,2,-2,A
2018-10-21,2018,Everton,Crystal Palace,2-0,2,0,1,1,2,2,H
2018-10-22,2018,Arsenal,Leicester City,3-1,3,1,1,1,4,2,H
2018-10-27,2018,Brighton & Hove Albion,Wolverhampton Wanderers,1-0,1,0,1,1,1,1,H
2018-10-27,2018,Fulham,AFC Bournemouth,0-3,0,3,1,1,3,-3,A
2018-10-27,2018,Leicester City,West Ham United,1-1,1,1,1,1,2,0,D
2018-10-27,2018,Liverpool,Cardiff City,4-1,4,1,1,1,5,3,H
2018-10-27,2018,Southampton,Newcastle United,0-0,0,0,1,1,0,0,D
2018-10-27,2018,Watford,Huddersfield Town,3-0,3,0,1,1,3,3,H
2018-10-28,2018,Burnley,Chelsea,0-4,0,4,1,1,4,-4,A
2018-10-28,2018,Crystal Palace,Arsenal,2-2,2,2,1,1,4,0,D
2018-10-28,2018,Manchester United,Everton,2-1,2,1,1,1,3,1,H
2018-10-29,2018,Tottenham Hotspur,Manchester City,0-1,0,1,1,1,1,-1,A
2018-11-03,2018,Arsenal,Liverpool,1-1,1,1,1,1,2,0,D
2018-11-03,2018,AFC Bournemouth,Manchester United,1-2,1,2,1,1,3,-1,A
2018-11-03,2018,Cardiff City,Leicester City,0-1,0,1,1,1,1,-1,A
2018-11-03,2018,Everton,Brighton & Hove Albion,3-1,3,1,1,1,4,2,H
2018-11-03,2018,Newcastle United,Watford,1-0,1,0,1,1,1,1,H
2018-11-03,2018,West Ham United,Burnley,4-2,4,2,1,1,6,2,H
2018-11-03,2018,Wolverhampton Wanderers,Tottenham Hotspur,2-3,2,3,1,1,5,-1,A
2018-11-04,2018,Chelsea,Crystal Palace,3-1,3,1,1,1,4,2,H
2018-11-04,2018,Manchester City,Southampton,6-1,6,1,1,1,7,5,H
2018-11-05,2018,Huddersfield Town,Fulham,1-0,1,0,1,1,1,1,H
2018-11-10,2018,Cardiff City,Brighton & Hove Albion,2-1,2,1,1,1,3,1,H
2018-11-10,2018,Crystal Palace,Tottenham Hotspur,0-1,0,1,1,1,1,-1,A
2018-11-10,2018,Huddersfield Town,West Ham United,1-1,1,1,1,1,2,0,D
2018-11-10,2018,Leicester City,Burnley,0-0,0,0,1,1,0,0,D
2018-11-10,2018,Newcastle United,AFC Bournemouth,2-1,2,1,1,1,3,1,H
2018-11-10,2018,Southampton,Watford,1-1,1,1,1,1,2,0,D
2018-11-11,2018,Arsenal,Wolverhampton Wanderers,1-1,1,1,1,1,2,0,D
2018-11-11,2018,Chelsea,Everton,0-0,0,0,1,1,0,0,D
2018-11-11,2018,Liverpool,Fulham,2-0,2,0,1,1,2,2,H
2018-11-11,2018,Manchester City,Manchester United,3-1,3,1,1,1,4,2,H
2018-11-24,2018,Brighton & Hove Albion,Leicester City,1-1,1,1,1,1,2,0,D
2018-11-24,2018,Everton,Cardiff City,1-0,1,0,1,1,1,1,H
2018-11-24,2018,Fulham,Southampton,3-2,3,2,1,1,5,1,H
2018-11-24,2018,Manchester United,Crystal Palace,0-0,0,0,1,1,0,0,D
2018-11-24,2018,Tottenham Hotspur,Chelsea,3-1,3,1,1,1,4,2,H
2018-11-24,2018,Watford,Liverpool,0-3,0,3,1,1,3,-3,A
2018-11-24,2018,West Ham United,Manchester City,0-4,0,4,1,1,4,-4,A
2018-11-25,2018,AFC Bournemouth,Arsenal,1-2,1,2,1,1,3,-1,A
2018-11-25,2018,Wolverhampton Wanderers,Huddersfield Town,0-2,0,2,1,1,2,-2,A
2018-11-26,2018,Burnley,Newcastle United,1-2,1,2,1,1,3,-1,A
2018-11-30,2018,Cardiff City,Wolverhampton Wanderers,2-1,2,1,1,1,3,1,H
2018-12-01,2018,Crystal Palace,Burnley,2-0,2,0,1,1,2,2,H
2018-12-01,2018,Huddersfield Town,Brighton & Hove Albion,1-2,1,2,1,1,3,-1,A
2018-12-01,2018,Leicester City,Watford,2-0,2,0,1,1,2,2,H
2018-12-01,2018,Manchester City,AFC Bournemouth,3-1,3,1,1,1,4,2,H
2018-12-01,2018,Newcastle United,West Ham United,0-3,0,3,1,1,3,-3,A
2018-12-01,2018,Southampton,Manchester United,2-2,2,2,1,1,4,0,D
2018-12-02,2018,Arsenal,Tottenham Hotspur,4-2,4,2,1,1,6,2,H
2018-12-02,2018,Chelsea,Fulham,2-0,2,0,1,1,2,2,H
2018-12-02,2018,Liverpool,Everton,1-0,1,0,1,1,1,1,H
2018-12-04,2018,AFC Bournemouth,Huddersfield Town,2-1,2,1,1,1,3,1,H
2018-12-04,2018,Brighton & Hove Albion,Crystal Palace,3-1,3,1,1,1,4,2,H
2018-12-04,2018,Watford,Manchester City,1-2,1,2,1,1,3,-1,A
2018-12-04,2018,West Ham United,Cardiff City,3-1,3,1,1,1,4,2,H
2018-12-05,2018,Burnley,Liverpool,1-3,1,3,1,1,4,-2,A
2018-12-05,2018,Everton,Newcastle United,1-1,1,1,1,1,2,0,D
2018-12-05,2018,Fulham,Leicester City,1-1,1,1,1,1,2,0,D
2018-12-05,2018,Manchester United,Arsenal,2-2,2,2,1,1,4,0,D
2018-12-05,2018,Tottenham Hotspur,Southampton,3-1,3,1,1,1,4,2,H
2018-12-05,2018,Wolverhampton Wanderers,Chelsea,2-1,2,1,1,1,3,1,H
2018-12-08,2018,Arsenal,Huddersfield Town,1-0,1,0,1,1,1,1,H
2018-12-08,2018,AFC Bournemouth,Liverpool,0-4,0,4,1,1,4,-4,A
2018-12-08,2018,Burnley,Brighton & Hove Albion,1-0,1,0,1,1,1,1,H
2018-12-08,2018,Cardiff City,Southampton,1-0,1,0,1,1,1,1,H
2018-12-08,2018,Chelsea,Manchester City,2-0,2,0,1,1,2,2,H
2018-12-08,2018,Leicester City,Tottenham Hotspur,0-2,0,2,1,1,2,-2,A
2018-12-08,2018,Manchester United,Fulham,4-1,4,1,1,1,5,3,H
2018-12-08,2018,West Ham United,Crystal Palace,3-2,3,2,1,1,5,1,H
2018-12-09,2018,Newcastle United,Wolverhampton Wanderers,1-2,1,2,1,1,3,-1,A
2018-12-10,2018,Everton,Watford,2-2,2,2,1,1,4,0,D
2018-12-15,2018,Crystal Palace,Leicester City,1-0,1,0,1,1,1,1,H
2018-12-15,2018,Fulham,West Ham United,0-2,0,2,1,1,2,-2,A
2018-12-15,2018,Huddersfield Town,Newcastle United,0-1,0,1,1,1,1,-1,A
2018-12-15,2018,Manchester City,Everton,3-1,3,1,1,1,4,2,H
2018-12-15,2018,Tottenham Hotspur,Burnley,1-0,1,0,1,1,1,1,H
2018-12-15,2018,Watford,Cardiff City,3-2,3,2,1,1,5,1,H
2018-12-15,2018,Wolverhampton Wanderers,AFC Bournemouth,2-0,2,0,1,1,2,2,H
2018-12-16,2018,Brighton & Hove Albion,Chelsea,1-2,1,2,1,1,3,-1,A
2018-12-16,2018,Liverpool,Manchester United,3-1,3,1,1,1,4,2,H
2018-12-16,2018,Southampton,Arsenal,3-2,3,2,1,1,5,1,H
2018-12-21,2018,Wolverhampton Wanderers,Liverpool,0-2,0,2,1,1,2,-2,A
2018-12-22,2018,Arsenal,Burnley,3-1,3,1,1,1,4,2,H
2018-12-22,2018,AFC Bournemouth,Brighton & Hove Albion,2-0,2,0,1,1,2,2,H
2018-12-22,2018,Cardiff City,Manchester United,1-5,1,5,1,1,6,-4,A
2018-12-22,2018,Chelsea,Leicester City,0-1,0,1,1,1,1,-1,A
2018-12-22,2018,Huddersfield Town,Southampton,1-3,1,3,1,1,4,-2,A
2018-12-22,2018,Manchester City,Crystal Palace,2-3,2,3,1,1,5,-1,A
2018-12-22,2018,Newcastle United,Fulham,0-0,0,0,1,1,0,0,D
2018-12-22,2018,West Ham United,Watford,0-2,0,2,1,1,2,-2,A
2018-12-23,2018,Everton,Tottenham Hotspur,2-6,2,6,1,1,8,-4,A
2018-12-26,2018,Brighton & Hove Albion,Arsenal,1-1,1,1,1,1,2,0,D
2018-12-26,2018,Burnley,Everton,1-5,1,5,1,1,6,-4,A
2018-12-26,2018,Crystal Palace,Cardiff City,0-0,0,0,1,1,0,0,D
2018-12-26,2018,Fulham,Wolverhampton Wanderers,1-1,1,1,1,1,2,0,D
2018-12-26,2018,Leicester City,Manchester City,2-1,2,1,1,1,3,1,H
2018-12-26,2018,Liverpool,Newcastle United,4-0,4,0,1,1,4,4,H
2018-12-26,2018,Manchester United,Huddersfield Town,3-1,3,1,1,1,4,2,H
2018-12-26,2018,Tottenham Hotspur,AFC Bournemouth,5-0,5,0,1,1,5,5,H
2018-12-26,2018,Watford,Chelsea,1-2,1,2,1,1,3,-1,A
2018-12-27,2018,Southampton,West Ham United,1-2,1,2,1,1,3,-1,A
2018-12-29,2018,Brighton & Hove Albion,Everton,1-0,1,0,1,1,1,1,H
2018-12-29,2018,Fulham,Huddersfield Town,1-0,1,0,1,1,1,1,H
2018-12-29,2018,Leicester City,Cardiff City,0-1,0,1,1,1,1,-1,A
2018-12-29,2018,Liverpool,Arsenal,5-1,5,1,1,1,6,4,H
2018-12-29,2018,Tottenham Hotspur,Wolverhampton Wanderers,1-3,1,3,1,1,4,-2,A
2018-12-29,2018,Watford,Newcastle United,1-1,1,1,1,1,2,0,D
2018-12-30,2018,Burnley,West Ham United,2-0,2,0,1,1,2,2,H
2018-12-30,2018,Crystal Palace,Chelsea,0-1,0,1,1,1,1,-1,A
2018-12-30,2018,Manchester United,AFC Bournemouth,4-1,4,1,1,1,5,3,H
2018-12-30,2018,Southampton,Manchester City,1-3,1,3,1,1,4,-2,A
2019-01-01,2018,Arsenal,Fulham,4-1,4,1,1,1,5,3,H
2019-01-01,2018,Cardiff City,Tottenham Hotspur,0-3,0,3,1,1,3,-3,A
2019-01-01,2018,Everton,Leicester City,0-1,0,1,1,1,1,-1,A
2019-01-02,2018,AFC Bournemouth,Watford,3-3,3,3,1,1,6,0,D
2019-01-02,2018,Chelsea,Southampton,0-0,0,0,1,1,0,0,D
2019-01-02,2018,Huddersfield Town,Burnley,1-2,1,2,1,1,3,-1,A
2019-01-02,2018,Newcastle United,Manchester United,0-2,0,2,1,1,2,-2,A
2019-01-02,2018,West Ham United,Brighton & Hove Albion,2-2,2,2,1,1,4,0,D
2019-01-02,2018,Wolverhampton Wanderers,Crystal Palace,0-2,0,2,1,1,2,-2,A
2019-01-03,2018,Manchester City,Liverpool,2-1,2,1,1,1,3,1,H
2019-01-12,2018,Brighton & Hove Albion,Liverpool,0-1,0,1,1,1,1,-1,A
2019-01-12,2018,Burnley,Fulham,2-1,2,1,1,1,3,1,H
2019-01-12,2018,Cardiff City,Huddersfield Town,0-0,0,0,1,1,0,0,D
2019-01-12,2018,Chelsea,Newcastle United,2-1,2,1,1,1,3,1,H
2019-01-12,2018,Crystal Palace,Watford,1-2,1,2,1,1,3,-1,A
2019-01-12,2018,Leicester City,Southampton,1-2,1,2,1,1,3,-1,A
2019-01-12,2018,West Ham United,Arsenal,1-0,1,0,1,1,1,1,H
2019-01-13,2018,Everton,AFC Bournemouth,2-0,2,0,1,1,2,2,H
2019-01-13,2018,Tottenham Hotspur,Manchester United,0-1,0,1,1,1,1,-1,A
2019-01-14,2018,Manchester City,Wolverhampton Wanderers,3-0,3,0,1,1,3,3,H
2019-01-19,2018,Arsenal,Chelsea,2-0,2,0,1,1,2,2,H
2019-01-19,2018,AFC Bournemouth,West Ham United,2-0,2,0,1,1,2,2,H
2019-01-19,2018,Liverpool,Crystal Palace,4-3,4,3,1,1,7,1,H
2019-01-19,2018,Manchester United,Brighton & Hove Albion,2-1,2,1,1,1,3,1,H
2019-01-19,2018,Newcastle United,Cardiff City,3-0,3,0,1,1,3,3,H
2019-01-19,2018,Southampton,Everton,2-1,2,1,1,1,3,1,H
2019-01-19,2018,Watford,Burnley,0-0,0,0,1,1,0,0,D
2019-01-19,2018,Wolverhampton Wanderers,Leicester City,4-3,4,3,1,1,7,1,H
2019-01-20,2018,Fulham,Tottenham Hotspur,1-2,1,2,1,1,3,-1,A
2019-01-20,2018,Huddersfield Town,Manchester City,0-3,0,3,1,1,3,-3,A
2019-01-29,2018,Arsenal,Cardiff City,2-1,2,1,1,1,3,1,H
2019-01-29,2018,Fulham,Brighton & Hove Albion,4-2,4,2,1,1,6,2,H
2019-01-29,2018,Huddersfield Town,Everton,0-1,0,1,1,1,1,-1,A
2019-01-29,2018,Manchester United,Burnley,2-2,2,2,1,1,4,0,D
2019-01-29,2018,Newcastle United,Manchester City,2-1,2,1,1,1,3,1,H
2019-01-29,2018,Wolverhampton Wanderers,West Ham United,3-0,3,0,1,1,3,3,H
2019-01-30,2018,AFC Bournemouth,Chelsea,4-0,4,0,1,1,4,4,H
2019-01-30,2018,Liverpool,Leicester City,1-1,1,1,1,1,2,0,D
2019-01-30,2018,Southampton,Crystal Palace,1-1,1,1,1,1,2,0,D
2019-01-30,2018,Tottenham Hotspur,Watford,2-1,2,1,1,1,3,1,H
2019-02-02,2018,Brighton & Hove Albion,Watford,0-0,0,0,1,1,0,0,D
2019-02-02,2018,Burnley,Southampton,1-1,1,1,1,1,2,0,D
2019-02-02,2018,Cardiff City,AFC Bournemouth,2-0,2,0,1,1,2,2,H
2019-02-02,2018,Chelsea,Huddersfield Town,5-0,5,0,1,1,5,5,H
2019-02-02,2018,Crystal Palace,Fulham,2-0,2,0,1,1,2,2,H
2019-02-02,2018,Everton,Wolverhampton Wanderers,1-3,1,3,1,1,4,-2,A
2019-02-02,2018,Tottenham Hotspur,Newcastle United,1-0,1,0,1,1,1,1,H
2019-02-03,2018,Leicester City,Manchester United,0-1,0,1,1,1,1,-1,A
2019-02-03,2018,Manchester City,Arsenal,3-1,3,1,1,1,4,2,H
2019-02-04,2018,West Ham United,Liverpool,1-1,1,1,1,1,2,0,D
2019-02-06,2018,Everton,Manchester City,0-2,0,2,1,1,2,-2,A
2019-02-09,2018,Brighton & Hove Albion,Burnley,1-3,1,3,1,1,4,-2,A
2019-02-09,2018,Crystal Palace,West Ham United,1-1,1,1,1,1,2,0,D
2019-02-09,2018,Fulham,Manchester United,0-3,0,3,1,1,3,-3,A
2019-02-09,2018,Huddersfield Town,Arsenal,1-2,1,2,1,1,3,-1,A
2019-02-09,2018,Liverpool,AFC Bournemouth,3-0,3,0,1,1,3,3,H
2019-02-09,2018,Southampton,Cardiff City,1-2,1,2,1,1,3,-1,A
2019-02-09,2018,Watford,Everton,1-0,1,0,1,1,1,1,H
2019-02-10,2018,Manchester City,Chelsea,6-0,6,0,1,1,6,6,H
2019-02-10,2018,Tottenham Hotspur,Leicester City,3-1,3,1,1,1,4,2,H
2019-02-11,2018,Wolverhampton Wanderers,Newcastle United,1-1,1,1,1,1,2,0,D
2019-02-22,2018,Cardiff City,Watford,1-5,1,5,1,1,6,-4,A
2019-02-22,2018,West Ham United,Fulham,3-1,3,1,1,1,4,2,H
2019-02-23,2018,AFC Bournemouth,Wolverhampton Wanderers,1-1,1,1,1,1,2,0,D
2019-02-23,2018,Burnley,Tottenham Hotspur,2-1,2,1,1,1,3,1,H
2019-02-23,2018,Leicester City,Crystal Palace,1-4,1,4,1,1,5,-3,A
2019-02-23,2018,Newcastle United,Huddersfield Town,2-0,2,0,1,1,2,2,H
2019-02-24,2018,Arsenal,Southampton,2-0,2,0,1,1,2,2,H
2019-02-24,2018,Manchester United,Liverpool,0-0,0,0,1,1,0,0,D
2019-02-26,2018,Cardiff City,Everton,0-3,0,3,1,1,3,-3,A
2019-02-26,2018,Huddersfield Town,Wolverhampton Wanderers,1-0,1,0,1,1,1,1,H
2019-02-26,2018,Leicester City,Brighton & Hove Albion,2-1,2,1,1,1,3,1,H
2019-02-26,2018,Newcastle United,Burnley,2-0,2,0,1,1,2,2,H
2019-02-27,2018,Arsenal,AFC Bournemouth,5-1,5,1,1,1,6,4,H
2019-02-27,2018,Chelsea,Tottenham Hotspur,2-0,2,0,1,1,2,2,H
2019-02-27,2018,Crystal Palace,Manchester United,1-3,1,3,1,1,4,-2,A
2019-02-27,2018,Liverpool,Watford,5-0,5,0,1,1,5,5,H
2019-02-27,2018,Manchester City,West Ham United,1-0,1,0,1,1,1,1,H
2019-02-27,2018,Southampton,Fulham,2-0,2,0,1,1,2,2,H
2019-03-02,2018,AFC Bournemouth,Manchester City,0-1,0,1,1,1,1,-1,A
2019-03-02,2018,Brighton & Hove Albion,Huddersfield Town,1-0,1,0,1,1,1,1,H
2019-03-02,2018,Burnley,Crystal Palace,1-3,1,3,1,1,4,-2,A
2019-03-02,2018,Manchester United,Southampton,3-2,3,2,1,1,5,1,H
2019-03-02,2018,Tottenham Hotspur,Arsenal,1-1,1,1,1,1,2,0,D
2019-03-02,2018,West Ham United,Newcastle United,2-0,2,0,1,1,2,2,H
2019-03-02,2018,Wolverhampton Wanderers,Cardiff City,2-0,2,0,1,1,2,2,H
2019-03-03,2018,Everton,Liverpool,0-0,0,0,1,1,0,0,D
2019-03-03,2018,Fulham,Chelsea,1-2,1,2,1,1,3,-1,A
2019-03-03,2018,Watford,Leicester City,2-1,2,1,1,1,3,1,H
2019-03-09,2018,Cardiff City,West Ham United,2-0,2,0,1,1,2,2,H
2019-03-09,2018,Crystal Palace,Brighton & Hove Albion,1-2,1,2,1,1,3,-1,A
2019-03-09,2018,Huddersfield Town,AFC Bournemouth,0-2,0,2,1,1,2,-2,A
2019-03-09,2018,Leicester City,Fulham,3-1,3,1,1,1,4,2,H
2019-03-09,2018,Manchester City,Watford,3-1,3,1,1,1,4,2,H
2019-03-09,2018,Newcastle United,Everton,3-2,3,2,1,1,5,1,H
2019-03-09,2018,Southampton,Tottenham Hotspur,2-1,2,1,1,1,3,1,H
2019-03-10,2018,Arsenal,Manchester United,2-0,2,0,1,1,2,2,H
2019-03-10,2018,Chelsea,Wolverhampton Wanderers,1-1,1,1,1,1,2,0,D
2019-03-10,2018,Liverpool,Burnley,4-2,4,2,1,1,6,2,H
2019-03-16,2018,AFC Bournemouth,Newcastle United,2-2,2,2,1,1,4,0,D
2019-03-16,2018,Burnley,Leicester City,1-2,1,2,1,1,3,-1,A
2019-03-16,2018,West Ham United,Huddersfield Town,4-3,4,3,1,1,7,1,H
2019-03-17,2018,Everton,Chelsea,2-0,2,0,1,1,2,2,H
2019-03-17,2018,Fulham,Liverpool,1-2,1,2,1,1,3,-1,A
2019-03-30,2018,Brighton & Hove Albion,Southampton,0-1,0,1,1,1,1,-1,A
2019-03-30,2018,Burnley,Wolverhampton Wanderers,2-0,2,0,1,1,2,2,H
2019-03-30,2018,Crystal Palace,Huddersfield Town,2-0,2,0,1,1,2,2,H
2019-03-30,2018,Fulham,Manchester City,0-2,0,2,1,1,2,-2,A
2019-03-30,2018,Leicester City,AFC Bournemouth,2-0,2,0,1,1,2,2,H
2019-03-30,2018,Manchester United,Watford,2-1,2,1,1,1,3,1,H
2019-03-30,2018,West Ham United,Everton,0-2,0,2,1,1,2,-2,A
2019-03-31,2018,Cardiff City,Chelsea,1-2,1,2,1,1,3,-1,A
2019-03-31,2018,Liverpool,Tottenham Hotspur,2-1,2,1,1,1,3,1,H
2019-04-01,2018,Arsenal,Newcastle United,2-0,2,0,1,1,2,2,H
2019-04-02,2018,Watford,Fulham,4-1,4,1,1,1,5,3,H
2019-04-02,2018,Wolverhampton Wanderers,Manchester United,2-1,2,1,1,1,3,1,H
2019-04-03,2018,Chelsea,Brighton & Hove Albion,3-0,3,0,1,1,3,3,H
2019-04-03,2018,Manchester City,Cardiff City,2-0,2,0,1,1,2,2,H
2019-04-03,2018,Tottenham Hotspur,Crystal Palace,2-0,2,0,1,1,2,2,H
2019-04-05,2018,Southampton,Liverpool,1-3,1,3,1,1,4,-2,A
2019-04-06,2018,AFC Bournemouth,Burnley,1-3,1,3,1,1,4,-2,A
2019-04-06,2018,Huddersfield Town,Leicester City,1-4,1,4,1,1,5,-3,A
2019-04-06,2018,Newcastle United,Crystal Palace,0-1,0,1,1,1,1,-1,A
2019-04-07,2018,Everton,Arsenal,1-0,1,0,1,1,1,1,H
2019-04-08,2018,Chelsea,West Ham United,2-0,2,0,1,1,2,2,H
2019-04-12,2018,Leicester City,Newcastle United,0-1,0,1,1,1,1,-1,A
2019-04-13,2018,Brighton & Hove Albion,AFC Bournemouth,0-5,0,5,1,1,5,-5,A
2019-04-13,2018,Burnley,Cardiff City,2-0,2,0,1,1,2,2,H
2019-04-13,2018,Fulham,Everton,2-0,2,0,1,1,2,2,H
2019-04-13,2018,Manchester United,West Ham United,2-1,2,1,1,1,3,1,H
2019-04-13,2018,Southampton,Wolverhampton Wanderers,3-1,3,1,1,1,4,2,H
2019-04-13,2018,Tottenham Hotspur,Huddersfield Town,4-0,4,0,1,1,4,4,H
2019-04-14,2018,Crystal Palace,Manchester City,1-3,1,3,1,1,4,-2,A
2019-04-14,2018,Liverpool,Chelsea,2-0,2,0,1,1,2,2,H
2019-04-15,2018,Watford,Arsenal,0-1,0,1,1,1,1,-1,A
2019-04-16,2018,Brighton & Hove Albion,Cardiff City,0-2,0,2,1,1,2,-2,A
2019-04-20,2018,AFC Bournemouth,Fulham,0-1,0,1,1,1,1,-1,A
2019-04-20,2018,Huddersfield Town,Watford,1-2,1,2,1,1,3,-1,A
2019-04-20,2018,Manchester City,Tottenham Hotspur,1-0,1,0,1,1,1,1,H
2019-04-20,2018,Newcastle United,Southampton,3-1,3,1,1,1,4,2,H
2019-04-20,2018,West Ham United,Leicester City,2-2,2,2,1,1,4,0,D
2019-04-20,2018,Wolverhampton Wanderers,Brighton & Hove Albion,0-0,0,0,1,1,0,0,D
2019-04-21,2018,Arsenal,Crystal Palace,2-3,2,3,1,1,5,-1,A
2019-04-21,2018,Cardiff City,Liverpool,0-2,0,2,1,1,2,-2,A
2019-04-21,2018,Everton,Manchester United,4-0,4,0,1,1,4,4,H
2019-04-22,2018,Chelsea,Burnley,2-2,2,2,1,1,4,0,D
2019-04-23,2018,Tottenham Hotspur,Brighton & Hove Albion,1-0,1,0,1,1,1,1,H
2019-04-23,2018,Watford,Southampton,1-1,1,1,1,1,2,0,D
2019-04-24,2018,Manchester United,Manchester City,0-2,0,2,1,1,2,-2,A
2019-04-24,2018,Wolverhampton Wanderers,Arsenal,3-1,3,1,1,1,4,2,H
2019-04-26,2018,Liverpool,Huddersfield Town,5-0,5,0,1,1,5,5,H
2019-04-27,2018,Brighton & Hove Albion,Newcastle United,1-1,1,1,1,1,2,0,D
2019-04-27,2018,Crystal Palace,Everton,0-0,0,0,1,1,0,0,D
2019-04-27,2018,Fulham,Cardiff City,1-0,1,0,1,1,1,1,H
2019-04-27,2018,Southampton,AFC Bournemouth,3-3,3,3,1,1,6,0,D
2019-04-27,2018,Tottenham Hotspur,West Ham United,0-1,0,1,1,1,1,-1,A
2019-04-27,2018,Watford,Wolverhampton Wanderers,1-2,1,2,1,1,3,-1,A
2019-04-28,2018,Burnley,Manchester City,0-1,0,1,1,1,1,-1,A
2019-04-28,2018,Leicester City,Arsenal,3-0,3,0,1,1,3,3,H
2019-04-28,2018,Manchester United,Chelsea,1-1,1,1,1,1,2,0,D
2019-05-03,2018,Everton,Burnley,2-0,2,0,1,1,2,2,H
2019-05-04,2018,AFC Bournemouth,Tottenham Hotspur,1-0,1,0,1,1,1,1,H
2019-05-04,2018,Cardiff City,Crystal Palace,2-3,2,3,1,1,5,-1,A
2019-05-04,2018,Newcastle United,Liverpool,2-3,2,3,1,1,5,-1,A
2019-05-04,2018,West Ham United,Southampton,3-0,3,0,1,1,3,3,H
2019-05-04,2018,Wolverhampton Wanderers,Fulham,1-0,1,0,1,1,1,1,H
2019-05-05,2018,Arsenal,Brighton & Hove Albion,1-1,1,1,1,1,2,0,D
2019-05-05,2018,Chelsea,Watford,3-0,3,0,1,1,3,3,H
2019-05-05,2018,Huddersfield Town,Manchester United,1-1,1,1,1,1,2,0,D
2019-05-06,2018,Manchester City,Leicester City,1-0,1,0,1,1,1,1,H
2019-05-12,2018,Brighton & Hove Albion,Manchester City,1-4,1,4,1,1,5,-3,A
2019-05-12,2018,Burnley,Arsenal,1-3,1,3,1,1,4,-2,A
2019-05-12,2018,Crystal Palace,AFC Bournemouth,5-3,5,3,1,1,8,2,H
2019-05-12,2018,Fulham,Newcastle United,0-4,0,4,1,1,4,-4,A
2019-05-12,2018,Leicester City,Chelsea,0-0,0,0,1,1,0,0,D
2019-05-12,2018,Liverpool,Wolverhampton Wanderers,2-0,2,0,1,1,2,2,H
2019-05-12,2018,Manchester United,Cardiff City,0-2,0,2,1,1,2,-2,A
2019-05-12,2018,Southampton,Huddersfield Town,1-1,1,1,1,1,2,0,D
2019-05-12,2018,Tottenham Hotspur,Everton,2-2,2,2,1,1,4,0,D
2019-05-12,2018,Watford,West Ham United,1-4,1,4,1,1,5,-3,A
2019-08-09,2019,Liverpool,Norwich City,4-1,4,1,1,1,5,3,H
2019-08-10,2019,West Ham United,Manchester City,0-5,0,5,1,1,5,-5,A
2019-08-10,2019,AFC Bournemouth,Sheffield United,1-1,1,1,1,1,2,0,D
2019-08-10,2019,Burnley,Southampton,3-0,3,0,1,1,3,3,H
2019-08-10,2019,Crystal Palace,Everton,0-0,0,0,1,1,0,0,D
2019-08-10,2019,Watford,Brighton & Hove Albion,0-3,0,3,1,1,3,-3,A
2019-08-10,2019,Tottenham Hotspur,Aston Villa,3-1,3,1,1,1,4,2,H
2019-08-11,2019,Leicester City,Wolverhampton Wanderers,0-0,0,0,1,1,0,0,D
2019-08-11,2019,Newcastle United,Arsenal,0-1,0,1,1,1,1,-1,A
2019-08-11,2019,Manchester United,Chelsea,4-0,4,0,1,1,4,4,H
2019-08-17,2019,Arsenal,Burnley,2-1,2,1,1,1,3,1,H
2019-08-17,2019,Aston Villa,AFC Bournemouth,1-2,1,2,1,1,3,-1,A
2019-08-17,2019,Brighton & Hove Albion,West Ham United,1-1,1,1,1,1,2,0,D
2019-08-17,2019,Everton,Watford,1-0,1,0,1,1,1,1,H
2019-08-17,2019,Norwich City,Newcastle United,3-1,3,1,1,1,4,2,H
2019-08-17,2019,Southampton,Liverpool,1-2,1,2,1,1,3,-1,A
2019-08-17,2019,Manchester City,Tottenham Hotspur,2-2,2,2,1,1,4,0,D
2019-08-18,2019,Sheffield United,Crystal Palace,1-0,1,0,1,1,1,1,H
2019-08-18,2019,Chelsea,Leicester City,1-1,1,1,1,1,2,0,D
2019-08-19,2019,Wolverhampton Wanderers,Manchester United,1-1,1,1,1,1,2,0,D
2019-08-23,2019,Aston Villa,Everton,2-0,2,0,1,1,2,2,H
2019-08-24,2019,Norwich City,Chelsea,2-3,2,3,1,1,5,-1,A
2019-08-24,2019,Brighton & Hove Albion,Southampton,0-2,0,2,1,1,2,-2,A
2019-08-24,2019,Manchester United,Crystal Palace,1-2,1,2,1,1,3,-1,A
2019-08-24,2019,Sheffield United,Leicester City,1-2,1,2,1,1,3,-1,A
2019-08-24,2019,Watford,West Ham United,1-3,1,3,1,1,4,-2,A
2019-08-24,2019,Liverpool,Arsenal,3-1,3,1,1,1,4,2,H
2019-08-25,2019,AFC Bournemouth,Manchester City,1-3,1,3,1,1,4,-2,A
2019-08-25,2019,Tottenham Hotspur,Newcastle United,0-1,0,1,1,1,1,-1,A
2019-08-25,2019,Wolverhampton Wanderers,Burnley,1-1,1,1,1,1,2,0,D
2019-08-31,2019,Southampton,Manchester United,1-1,1,1,1,1,2,0,D
2019-08-31,2019,Chelsea,Sheffield United,2-2,2,2,1,1,4,0,D
2019-08-31,2019,Crystal Palace,Aston Villa,1-0,1,0,1,1,1,1,H
2019-08-31,2019,Leicester City,AFC Bournemouth,3-1,3,1,1,1,4,2,H
2019-08-31,2019,Manchester City,Brighton & Hove Albion,4-0,4,0,1,1,4,4,H
2019-08-31,2019,Newcastle United,Watford,1-1,1,1,1,1,2,0,D
2019-08-31,2019,West Ham United,Norwich City,2-0,2,0,1,1,2,2,H
2019-08-31,2019,Burnley,Liverpool,0-3,0,3,1,1,3,-3,A
2019-09-01,2019,Everton,Wolverhampton Wanderers,3-2,3,2,1,1,5,1,H
2019-09-01,2019,Arsenal,Tottenham Hotspur,2-2,2,2,1,1,4,0,D
2019-09-14,2019,Liverpool,Newcastle United,3-1,3,1,1,1,4,2,H
2019-09-14,2019,Brighton & Hove Albion,Burnley,1-1,1,1,1,1,2,0,D
2019-09-14,2019,Manchester United,Leicester City,1-0,1,0,1,1,1,1,H
2019-09-14,2019,Sheffield United,Southampton,0-1,0,1,1,1,1,-1,A
2019-09-14,2019,Tottenham Hotspur,Crystal Palace,4-0,4,0,1,1,4,4,H
2019-09-14,2019,Wolverhampton Wanderers,Chelsea,2-5,2,5,1,1,7,-3,A
2019-09-14,2019,Norwich City,Manchester City,3-2,3,2,1,1,5,1,H
2019-09-15,2019,AFC Bournemouth,Everton,3-1,3,1,1,1,4,2,H
2019-09-15,2019,Watford,Arsenal,2-2,2,2,1,1,4,0,D
2019-09-16,2019,Aston Villa,West Ham United,0-0,0,0,1,1,0,0,D
2019-09-20,2019,Southampton,AFC Bournemouth,1-3,1,3,1,1,4,-2,A
2019-09-21,2019,Leicester City,Tottenham Hotspur,2-1,2,1,1,1,3,1,H
2019-09-21,2019,Burnley,Norwich City,2-0,2,0,1,1,2,2,H
2019-09-21,2019,Everton,Sheffield United,0-2,0,2,1,1,2,-2,A
2019-09-21,2019,Manchester City,Watford,8-0,8,0,1,1,8,8,H
2019-09-21,2019,Newcastle United,Brighton & Hove Albion,0-0,0,0,1,1,0,0,D
2019-09-22,2019,Crystal Palace,Wolverhampton Wanderers,1-1,1,1,1,1,2,0,D
2019-09-22,2019,West Ham United,Manchester United,2-0,2,0,1,1,2,2,H
2019-09-22,2019,Arsenal,Aston Villa,3-2,3,2,1,1,5,1,H
2019-09-22,2019,Chelsea,Liverpool,1-2,1,2,1,1,3,-1,A
2019-09-28,2019,Sheffield United,Liverpool,0-1,0,1,1,1,1,-1,A
2019-09-28,2019,Aston Villa,Burnley,2-2,2,2,1,1,4,0,D
2019-09-28,2019,AFC Bournemouth,West Ham United,2-2,2,2,1,1,4,0,D
2019-09-28,2019,Chelsea,Brighton & Hove Albion,2-0,2,0,1,1,2,2,H
2019-09-28,2019,Crystal Palace,Norwich City,2-0,2,0,1,1,2,2,H
2019-09-28,2019,Tottenham Hotspur,Southampton,2-1,2,1,1,1,3,1,H
2019-09-28,2019,Wolverhampton Wanderers,Watford,2-0,2,0,1,1,2,2,H
2019-09-28,2019,Everton,Manchester City,1-3,1,3,1,1,4,-2,A
2019-09-29,2019,Leicester City,Newcastle United,5-0,5,0,1,1,5,5,H
2019-09-30,2019,Manchester United,Arsenal,1-1,1,1,1,1,2,0,D
2019-10-05,2019,Brighton & Hove Albion,Tottenham Hotspur,3-0,3,0,1,1,3,3,H
2019-10-05,2019,Burnley,Everton,1-0,1,0,1,1,1,1,H
2019-10-05,2019,Liverpool,Leicester City,2-1,2,1,1,1,3,1,H
2019-10-05,2019,Norwich City,Aston Villa,1-5,1,5,1,1,6,-4,A
2019-10-05,2019,Watford,Sheffield United,0-0,0,0,1,1,0,0,D
2019-10-05,2019,West Ham United,Crystal Palace,1-2,1,2,1,1,3,-1,A
2019-10-06,2019,Arsenal,AFC Bournemouth,1-0,1,0,1,1,1,1,H
2019-10-06,2019,Manchester City,Wolverhampton Wanderers,0-2,0,2,1,1,2,-2,A
2019-10-06,2019,Southampton,Chelsea,1-4,1,4,1,1,5,-3,A
2019-10-06,2019,Newcastle United,Manchester United,1-0,1,0,1,1,1,1,H
2019-10-19,2019,Everton,West Ham United,2-0,2,0,1,1,2,2,H
2019-10-19,2019,Aston Villa,Brighton & Hove Albion,2-1,2,1,1,1,3,1,H
2019-10-19,2019,AFC Bournemouth,Norwich City,0-0,0,0,1,1,0,0,D
2019-10-19,2019,Chelsea,Newcastle United,1-0,1,0,1,1,1,1,H
2019-10-19,2019,Leicester City,Burnley,2-1,2,1,1,1,3,1,H
2019-10-19,2019,Tottenham Hotspur,Watford,1-1,1,1,1,1,2,0,D
2019-10-19,2019,Wolverhampton Wanderers,Southampton,1-1,1,1,1,1,2,0,D
2019-10-19,2019,Crystal Palace,Manchester City,0-2,0,2,1,1,2,-2,A
2019-10-20,2019,Manchester United,Liverpool,1-1,1,1,1,1,2,0,D
2019-10-21,2019,Sheffield United,Arsenal,1-0,1,0,1,1,1,1,H
2019-10-25,2019,Southampton,Leicester City,0-9,0,9,1,1,9,-9,A
2019-10-26,2019,Manchester City,Aston Villa,3-0,3,0,1,1,3,3,H
2019-10-26,2019,Brighton & Hove Albion,Everton,3-2,3,2,1,1,5,1,H
2019-10-26,2019,Watford,AFC Bournemouth,0-0,0,0,1,1,0,0,D
2019-10-26,2019,West Ham United,Sheffield United,1-1,1,1,1,1,2,0,D
2019-10-26,2019,Burnley,Chelsea,2-4,2,4,1,1,6,-2,A
2019-10-27,2019,Newcastle United,Wolverhampton Wanderers,1-1,1,1,1,1,2,0,D
2019-10-27,2019,Arsenal,Crystal Palace,2-2,2,2,1,1,4,0,D
2019-10-27,2019,Liverpool,Tottenham Hotspur,2-1,2,1,1,1,3,1,H
2019-10-27,2019,Norwich City,Manchester United,1-3,1,3,1,1,4,-2,A
2019-11-02,2019,AFC Bournemouth,Manchester United,1-0,1,0,1,1,1,1,H
2019-11-02,2019,Arsenal,Wolverhampton Wanderers,1-1,1,1,1,1,2,0,D
2019-11-02,2019,Aston Villa,Liverpool,1-2,1,2,1,1,3,-1,A
2019-11-02,2019,Brighton & Hove Albion,Norwich City,2-0,2,0,1,1,2,2,H
2019-11-02,2019,Manchester City,Southampton,2-1,2,1,1,1,3,1,H
2019-11-02,2019,Sheffield United,Burnley,3-0,3,0,1,1,3,3,H
2019-11-02,2019,West Ham United,Newcastle United,2-3,2,3,1,1,5,-1,A
2019-11-02,2019,Watford,Chelsea,1-2,1,2,1,1,3,-1,A
2019-11-03,2019,Crystal Palace,Leicester City,0-2,0,2,1,1,2,-2,A
2019-11-03,2019,Everton,Tottenham Hotspur,1-1,1,1,1,1,2,0,D
2019-11-08,2019,Norwich City,Watford,0-2,0,2,1,1,2,-2,A
2019-11-09,2019,Chelsea,Crystal Palace,2-0,2,0,1,1,2,2,H
2019-11-09,2019,Burnley,West Ham United,3-0,3,0,1,1,3,3,H
2019-11-09,2019,Newcastle United,AFC Bournemouth,2-1,2,1,1,1,3,1,H
2019-11-09,2019,Southampton,Everton,1-2,1,2,1,1,3,-1,A
2019-11-09,2019,Tottenham Hotspur,Sheffield United,1-1,1,1,1,1,2,0,D
2019-11-09,2019,Leicester City,Arsenal,2-0,2,0,1,1,2,2,H
2019-11-10,2019,Manchester United,Brighton & Hove Albion,3-1,3,1,1,1,4,2,H
2019-11-10,2019,Wolverhampton Wanderers,Aston Villa,2-1,2,1,1,1,3,1,H
2019-11-10,2019,Liverpool,Manchester City,3-1,3,1,1,1,4,2,H
